gameId,blueWins,blueWardsPlaced,blueWardsDestroyed,blueFirstBlood,blueKills,blueDeaths,blueAssists,blueEliteMonsters,blueDragons,blueHeralds,blueTowersDestroyed,blueTotalGold,blueAvgLevel,blueTotalExperience,blueTotalMinionsKilled,blueTotalJungleMinionsKilled,blueGoldDiff,blueExperienceDiff,blueCSPerMin,blueGoldPerMin,redWardsPlaced,redWardsDestroyed,redFirstBlood,redKills,redDeaths,redAssists,redEliteMonsters,redDragons,redHeralds,redTowersDestroyed,redTotalGold,redAvgLevel,redTotalExperience,redTotalMinionsKilled,redTotalJungleMinionsKilled,redGoldDiff,redExperienceDiff,redCSPerMin,redGoldPerMin
4853516961,1,48,1,1,8,6,4,1,0,1,0,17033,6.8,17820,210,48,660,-144,25.8,1703.3,16,0,0,5,7,5,0,0,0,0,16373,6.8,17964,221,60,-660,144,28.1,1637.3
4853468337,1,14,1,0,5,8,9,0,0,0,0,15989,6.4,16540,200,40,-2129,-2955,24.0,1598.9,13,4,1,8,5,7,0,0,0,0,18118,7.2,19495,215,60,2129,2955,27.5,1811.8
4853371725,1,14,2,0,2,2,2,0,0,0,0,15887,7.2,18651,257,71,1173,1464,32.8,1588.7,12,2,1,2,2,3,2,1,1,0,14714,6.6,17187,233,44,-1173,-1464,27.7,1471.4
4853352285,1,14,2,1,4,1,3,1,0,1,0,15681,6.6,17292,232,56,277,-638,28.8,1568.1,15,0,0,1,4,0,0,0,0,0,15404,6.8,17930,215,48,-277,638,26.3,1540.4
4852628799,0,14,1,1,4,3,4,1,1,0,0,17908,7.0,18900,250,66,1729,822,31.6,1790.8,12,1,0,3,4,4,0,0,0,0,16179,6.8,18078,224,56,-1729,-822,28.0,1617.9
4852526838,0,12,0,0,2,9,1,0,0,0,0,15465,7.0,17362,220,51,-2707,-2056,27.1,1546.5,10,0,1,9,2,6,0,0,0,0,18172,7.2,19418,223,59,2707,2056,28.2,1817.2
4852482342,1,16,1,1,2,2,2,0,0,0,0,16858,7.2,19788,258,74,1599,1664,33.2,1685.8,21,3,0,2,2,2,0,0,0,0,15259,6.8,18124,246,55,-1599,-1664,30.1,1525.9
4851757457,1,53,1,0,4,7,5,0,0,0,0,16641,7.0,17840,198,56,-673,325,25.4,1664.1,12,1,1,7,4,7,0,0,0,0,17314,6.8,17515,233,39,673,-325,27.2,1731.4
4851701123,0,13,2,1,3,7,3,0,0,0,0,14927,6.8,17046,211,52,-3246,-814,26.3,1492.7,15,1,0,7,3,11,0,0,0,0,18173,6.8,17860,240,56,3246,814,29.6,1817.3
4851657510,1,13,3,1,7,4,6,1,1,0,0,17222,7.0,17908,226,55,1324,437,28.1,1722.2,7,2,0,3,6,2,0,0,0,0,15898,6.8,17471,218,48,-1324,-437,26.6,1589.8
4851607429,1,16,1,0,3,9,1,0,0,0,0,16135,7.0,17526,220,52,-2763,-945,27.2,1613.5,16,1,1,9,3,10,0,0,0,0,18898,7.2,18471,215,60,2763,945,27.5,1889.8
4850788779,0,14,0,0,2,3,1,0,0,0,0,15947,7.0,18604,212,76,-148,-549,28.8,1594.7,15,0,1,3,2,3,1,1,0,0,16095,7.0,19153,223,56,148,549,27.9,1609.5
4850742601,0,14,5,0,4,7,2,0,0,0,0,14631,6.6,16567,198,47,-1524,196,24.5,1463.1,26,5,1,7,4,10,1,1,0,0,16155,6.4,16371,202,48,1524,-196,25.0,1615.5
4850702990,0,22,1,1,3,9,3,0,0,0,0,17308,7.0,18041,248,53,-1380,-949,30.1,1730.8,11,1,0,9,3,11,1,1,0,0,18688,7.2,18990,213,60,1380,949,27.3,1868.8
4850597265,1,18,0,1,11,3,11,2,1,1,0,19436,7.6,19924,214,67,4073,2563,28.1,1943.6,12,3,0,3,11,1,0,0,0,0,15363,7.0,17361,223,53,-4073,-2563,27.6,1536.3
4850571271,1,14,2,1,6,6,7,1,1,0,0,16756,6.6,17892,236,60,69,-105,29.6,1675.6,13,1,0,6,6,6,1,0,1,0,16687,6.8,17997,212,68,-69,105,28.0,1668.7
4849919237,1,14,1,0,8,2,7,0,0,0,0,17793,7.2,19564,242,60,3228,3212,30.2,1779.3,14,3,1,2,8,2,1,1,0,0,14565,6.8,16352,199,44,-3228,-3212,24.3,1456.5
4849878532,1,13,2,0,2,3,2,0,0,0,0,16100,7.2,19811,251,76,-165,1213,32.7,1610.0,24,3,1,3,2,4,1,1,0,0,16265,7.2,18598,250,60,165,-1213,31.0,1626.5
4849837723,0,9,0,0,5,9,5,0,0,0,0,17789,7.2,18689,243,60,-781,-1387,30.3,1778.9,11,0,1,9,5,6,1,0,1,0,18570,7.2,20076,235,60,781,1387,29.5,1857.0
4849811132,1,115,3,1,5,4,10,1,1,0,0,17452,7.2,18351,220,56,1049,-206,27.6,1745.2,13,2,0,4,5,4,0,0,0,0,16403,7.0,18557,238,52,-1049,206,29.0,1640.3
4851511117,0,34,2,1,6,5,4,0,0,0,0,16355,6.8,17698,187,66,-1641,-880,25.3,1635.5,37,2,0,5,6,5,1,1,0,0,17996,7.0,18578,245,61,1641,880,30.6,1799.6
4839962060,0,12,0,1,5,6,6,0,0,0,0,16383,6.6,16118,171,56,-1287,-3221,22.7,1638.3,10,2,0,6,5,2,1,1,0,0,17670,7.2,19339,231,75,1287,3221,30.6,1767.0
4838585371,1,24,3,1,7,9,3,0,0,0,0,16591,6.8,17323,221,64,-1324,432,28.5,1659.1,13,1,0,9,7,8,1,1,0,0,17915,6.8,16891,221,52,1324,-432,27.3,1791.5
4837397804,0,19,0,0,7,7,9,0,0,0,0,17448,6.8,17955,237,55,-493,-63,29.2,1744.8,13,0,1,7,7,6,1,1,0,0,17941,6.8,18018,224,76,493,63,30.0,1794.1
4836593643,0,15,1,0,1,8,2,0,0,0,0,14000,6.2,15564,199,59,-4084,-1975,25.8,1400.0,11,0,1,8,1,8,1,1,0,0,18084,6.8,17539,246,52,4084,1975,29.8,1808.4
4835714482,1,21,4,1,10,4,19,1,1,0,0,19502,6.8,17441,226,48,3334,-480,27.4,1950.2,11,2,0,4,10,3,0,0,0,0,16168,7.0,17921,224,63,-3334,480,28.7,1616.8
4834995199,0,15,1,0,6,9,1,0,0,0,0,15639,7.0,18457,183,68,-2230,588,25.1,1563.9,13,3,1,9,6,3,1,1,0,0,17869,7.0,17869,199,44,2230,-588,24.3,1786.9
4834208957,0,19,0,0,7,11,3,0,0,0,0,16950,6.8,17552,198,60,-1863,-649,25.8,1695.0,14,1,1,10,6,10,1,1,0,0,18813,6.8,18201,213,56,1863,649,26.9,1881.3
4833850117,0,22,1,0,8,5,7,0,0,0,0,16645,6.8,17578,203,44,-177,-49,24.7,1664.5,33,1,1,5,8,4,0,0,0,0,16822,6.8,17627,217,57,177,49,27.4,1682.2
4831760530,1,13,1,0,3,1,3,1,0,1,0,15929,7.0,18659,239,52,335,588,29.1,1592.9,15,1,1,1,3,0,1,1,0,0,15594,6.8,18071,217,72,-335,-588,28.9,1559.4
4831747338,1,11,2,0,3,4,2,0,0,0,0,16270,7.4,19188,252,72,168,1861,32.4,1627.0,20,1,1,4,3,5,1,1,0,0,16102,6.8,17327,228,52,-168,-1861,28.0,1610.2
4831447775,1,14,1,1,6,2,8,1,1,0,0,17159,7.0,18792,209,66,1904,1188,27.5,1715.9,16,1,0,2,6,5,0,0,0,0,15255,6.8,17604,241,60,-1904,-1188,30.1,1525.5
4822080376,1,17,1,0,7,6,4,0,0,0,0,17487,7.4,19296,216,64,1437,1933,28.0,1748.7,11,0,1,6,7,3,0,0,0,0,16050,6.6,17363,207,52,-1437,-1933,25.9,1605.0
4822050801,0,13,2,0,6,9,6,0,0,0,0,17127,6.6,17040,211,36,-766,-1455,24.7,1712.7,16,1,1,9,6,5,0,0,0,0,17893,7.0,18495,232,60,766,1455,29.2,1789.3
4822001070,1,22,2,1,8,3,5,1,1,0,0,18226,7.0,19094,227,48,3685,2770,27.5,1822.6,13,1,0,3,8,3,0,0,0,0,14541,6.4,16324,186,47,-3685,-2770,23.3,1454.1
4819805670,0,11,3,1,4,7,3,1,0,1,0,15434,7.0,17750,191,56,-1750,-546,24.7,1543.4,20,4,0,7,4,6,1,1,0,0,17184,6.8,18296,247,60,1750,546,30.7,1718.4
4819684629,0,8,2,1,6,10,7,0,0,0,0,17595,6.8,17370,193,56,-3224,-359,24.9,1759.5,20,1,0,10,6,10,0,0,0,0,20819,7.0,17729,226,44,3224,359,27.0,2081.9
4817969177,0,11,0,0,2,8,1,0,0,0,0,15221,6.4,16864,222,64,-4563,-2854,28.6,1522.1,24,0,1,8,2,8,2,1,1,0,19784,7.2,19718,249,75,4563,2854,32.4,1978.4
4817898670,1,55,3,0,7,5,9,1,1,0,0,18180,7.2,19079,212,60,1173,2011,27.2,1818.0,17,4,1,5,7,10,0,0,0,0,17007,6.6,17068,219,52,-1173,-2011,27.1,1700.7
4855289716,1,0,0,0,15,17,20,0,0,0,0,59189,12.0,55000,0,0,22315,20000,0.0,5918.9,89,0,1,11,9,8,0,0,0,0,36874,7.6,35000,0,0,-22315,-20000,0.0,3687.4
4855261793,1,34,0,1,12,6,10,0,0,0,0,21167,7.2,18554,195,64,5612,1868,25.9,2116.7,29,3,0,6,12,6,0,0,0,0,15555,6.6,16686,159,60,-5612,-1868,21.9,1555.5
4855044906,0,0,0,1,30,27,77,0,0,0,0,39685,11.4,43920,104,0,517,2773,10.4,3968.5,7,0,0,27,30,81,0,0,0,0,39168,11.2,41147,116,0,-517,-2773,11.6,3916.8
4855005527,1,0,0,1,24,14,50,0,0,0,1,38726,11.0,41720,97,0,3795,4303,9.7,3872.6,0,0,0,14,24,36,0,0,0,0,34931,10.6,37417,104,0,-3795,-4303,10.4,3493.1
4854920123,1,0,0,0,15,17,16,0,0,0,0,50285,10.0,47500,3,0,22765,19000,0.3,5028.5,0,0,1,11,9,11,0,0,0,0,27520,6.0,28500,0,0,-22765,-19000,0.0,2752.0
4854899023,1,1,0,0,14,19,19,0,0,0,0,61300,12.0,55000,0,0,22700,22000,0.0,6130.0,0,0,1,13,8,9,0,0,0,0,38600,7.2,33000,0,0,-22700,-22000,0.0,3860.0
4854882835,1,24,0,1,18,9,19,0,0,0,0,47550,10.0,47500,1,0,21060,19000,0.1,4755.0,11,0,0,5,14,2,0,0,0,0,26490,6.0,28500,1,0,-21060,-19000,0.1,2649.0
4854843893,0,9,2,1,4,3,3,1,1,0,0,16110,6.8,17361,204,44,92,-1572,24.8,1611.0,13,1,0,3,4,3,0,0,0,0,16018,7.0,18933,229,56,-92,1572,28.5,1601.8
4854817798,1,12,2,0,8,9,5,0,0,0,0,16337,6.8,16926,154,48,-2281,-1394,20.2,1633.7,15,0,1,9,8,5,0,0,0,0,18618,7.0,18320,192,54,2281,1394,24.6,1861.8
4854781871,0,51,0,0,6,9,7,0,0,0,0,16263,6.8,16598,175,56,-2867,-1860,23.1,1626.3,9,0,1,9,6,3,1,1,0,0,19130,6.8,18458,176,55,2867,1860,23.1,1913.0
4852608162,1,16,1,0,4,6,3,0,0,0,0,15546,6.6,17063,207,47,-1011,-2089,25.4,1554.6,11,0,1,6,4,2,0,0,0,0,16557,7.2,19152,191,64,1011,2089,25.5,1655.7
4852580083,0,47,8,0,2,9,2,0,0,0,0,13671,6.8,17010,144,56,-4604,-2649,20.0,1367.1,32,1,1,9,2,11,1,1,0,0,18275,7.4,19659,241,56,4604,2649,29.7,1827.5
4852556932,0,9,1,0,0,7,0,0,0,0,0,13066,6.8,17015,171,57,-5086,-2351,22.8,1306.6,7,2,1,7,0,3,0,0,0,0,18152,7.2,19366,234,58,5086,2351,29.2,1815.2
4850635489,1,12,0,0,3,4,6,1,0,1,0,14791,7.0,17979,216,54,-965,-42,27.0,1479.1,7,0,1,4,3,4,0,0,0,0,15756,6.8,18021,194,64,965,42,25.8,1575.6
4850493769,0,10,0,0,6,8,2,0,0,0,0,16551,7.0,18228,220,56,-1811,-976,27.6,1655.1,11,0,1,8,6,5,1,1,0,0,18362,7.2,19204,197,56,1811,976,25.3,1836.2
4850467136,1,116,0,0,5,5,5,0,0,0,0,15534,7.0,17910,179,60,-226,-445,23.9,1553.4,193,1,1,5,5,2,0,0,0,0,15760,7.2,18355,199,46,226,445,24.5,1576.0
4850444259,0,9,2,1,7,6,2,0,0,0,0,15719,6.8,17381,208,52,-737,-1121,26.0,1571.9,28,0,0,6,7,10,1,1,0,0,16456,7.0,18502,192,60,737,1121,25.2,1645.6
4849693158,1,1,0,0,23,20,66,0,0,0,0,35785,11.0,38156,108,0,-1883,-2429,10.8,3578.5,0,0,1,20,23,59,0,0,0,0,37668,11.0,40585,106,0,1883,2429,10.6,3766.8
4849659696,1,9,1,0,6,7,3,1,1,0,0,16699,7.2,19175,199,68,654,1316,26.7,1669.9,11,0,1,7,6,4,0,0,0,0,16045,6.6,17859,176,60,-654,-1316,23.6,1604.5
4856273513,1,0,0,1,11,6,33,0,0,0,1,33661,10.4,35427,116,0,837,1021,11.6,3366.1,0,0,0,6,11,12,0,0,0,0,32824,10.2,34406,118,0,-837,-1021,11.8,3282.4
4856226894,0,20,0,1,27,25,80,0,0,0,1,39702,11.4,42531,129,0,888,1153,12.9,3970.2,0,1,0,25,27,80,0,0,0,0,38814,11.0,41378,111,0,-888,-1153,11.1,3881.4
4856180623,1,0,0,1,23,15,59,0,0,0,1,37630,11.2,40075,121,0,1869,2382,12.1,3763.0,161,0,0,15,23,44,0,0,0,0,35761,10.6,37693,90,0,-1869,-2382,9.0,3576.1
4855227114,1,0,0,1,19,15,20,0,0,0,0,48190,10.0,47500,0,0,20305,19000,0.0,4819.0,0,0,0,9,13,6,0,0,0,0,27885,6.0,28500,1,0,-20305,-19000,0.1,2788.5
4855195512,1,0,0,0,14,15,13,0,0,0,0,47721,10.0,47500,0,0,19494,19000,0.0,4772.1,88,0,1,10,9,10,0,0,0,0,28227,6.0,28500,0,0,-19494,-19000,0.0,2822.7
4855168963,1,0,0,1,20,12,20,0,0,0,0,62700,12.0,55000,0,0,27600,22000,0.0,6270.0,0,0,0,4,12,5,0,0,0,0,35100,7.2,33000,4,0,-27600,-22000,0.4,3510.0
4855130508,1,22,0,1,18,18,19,0,0,0,0,46381,10.2,48680,0,0,17831,20180,0.0,4638.1,0,0,0,10,10,11,0,0,0,0,28550,6.0,28500,0,0,-17831,-20180,0.0,2855.0
4855104699,1,61,0,0,33,32,71,0,0,0,2,40484,12.0,46040,108,0,595,1928,10.8,4048.4,0,10,1,32,33,76,0,0,0,0,39889,11.8,44112,107,0,-595,-1928,10.7,3988.9
4855079212,0,2,0,1,8,11,25,0,0,0,1,33211,10.0,34786,114,0,-1661,-388,11.4,3321.1,0,0,0,11,8,36,0,0,0,0,34872,10.0,35174,117,0,1661,388,11.7,3487.2
4855047291,1,0,0,0,20,18,58,0,0,0,2,36528,10.6,37799,109,0,-353,226,10.9,3652.8,9,0,1,18,20,50,0,0,0,0,36881,10.6,37573,126,0,353,-226,12.6,3688.1
4853885850,1,14,2,1,3,3,5,0,0,0,0,14621,6.6,16389,193,52,-980,-1558,24.5,1462.1,15,3,0,3,3,4,1,1,0,0,15601,7.0,17947,253,56,980,1558,30.9,1560.1
4853837250,1,0,0,1,15,18,17,0,0,0,0,62071,12.0,55000,0,0,24123,22000,0.0,6207.1,0,0,0,11,8,9,0,0,0,0,37948,7.2,33000,0,0,-24123,-22000,0.0,3794.8
4853817769,1,1,0,0,19,13,21,0,0,0,0,47149,10.0,47500,0,0,20349,19000,0.0,4714.9,0,0,1,8,14,6,0,0,0,0,26800,6.0,28500,0,0,-20349,-19000,0.0,2680.0
4852645767,1,0,0,0,14,20,14,0,0,0,0,62113,12.0,55000,1,0,24213,22000,0.1,6211.3,5,0,1,13,7,12,0,0,0,0,37900,7.2,33000,0,0,-24213,-22000,0.0,3790.0
4852619068,1,352,0,0,11,24,18,0,0,0,0,61322,13.0,62500,0,0,23422,25000,0.0,6132.2,0,0,1,20,7,12,0,0,0,0,37900,7.8,37500,0,0,-23422,-25000,0.0,3790.0
4852578671,1,0,0,0,18,11,25,0,0,0,0,63050,12.0,55000,0,0,26900,22000,0.0,6305.0,0,0,1,11,18,4,0,0,0,0,36150,7.2,33000,0,0,-26900,-22000,0.0,3615.0
4852552725,1,369,5,0,20,23,23,0,0,0,0,47158,10.6,50525,5,0,18238,22025,0.5,4715.8,20,2,1,14,11,13,0,0,0,0,28920,6.0,28500,2,0,-18238,-22025,0.2,2892.0
4852540811,1,19,1,1,16,13,16,0,0,0,0,46360,10.0,47500,2,0,18632,19000,0.2,4636.0,0,0,0,8,11,6,0,0,0,0,27728,6.0,28500,0,0,-18632,-19000,0.0,2772.8
4852522944,1,3,0,1,20,15,22,0,0,0,0,64960,12.0,55000,0,0,27410,22000,0.0,6496.0,0,0,0,10,15,7,0,0,0,0,37550,7.2,33000,0,0,-27410,-22000,0.0,3755.0
4850937852,0,14,0,0,3,6,2,1,0,1,0,16033,6.4,16306,207,51,-1962,-1652,25.8,1603.3,78,0,1,6,3,7,1,1,0,0,17995,6.8,17958,232,60,1962,1652,29.2,1799.5
4853366790,1,17,0,1,28,21,77,0,0,0,1,38779,11.4,43037,129,0,2492,4165,12.9,3877.9,0,0,0,21,28,59,0,0,0,0,36287,10.8,38872,97,0,-2492,-4165,9.7,3628.7
4853345168,1,0,0,1,32,34,75,0,0,0,2,37710,11.6,42838,81,0,-2718,-3295,8.1,3771.0,0,0,0,34,32,92,0,0,0,0,40428,11.8,46133,114,0,2718,3295,11.4,4042.8
4853310636,1,0,0,1,14,22,29,0,0,0,0,34681,10.4,36778,106,0,-693,-1673,10.6,3468.1,2,0,0,22,14,63,0,0,0,0,35374,11.0,38451,105,0,693,1673,10.5,3537.4
4853304496,1,25,2,1,5,2,6,1,1,0,0,16162,6.8,17256,188,55,1791,656,24.3,1616.2,17,2,0,2,5,2,0,0,0,0,14371,6.4,16600,217,41,-1791,-656,25.8,1437.1
4853285712,1,8,1,1,6,7,5,0,0,0,0,16144,6.6,16700,204,48,-1900,-1053,25.2,1614.4,13,0,0,6,5,3,1,1,0,0,18044,6.6,17753,202,44,1900,1053,24.6,1804.4
4853021459,1,15,1,0,6,5,8,1,1,0,0,17635,7.0,17515,213,60,2250,629,27.3,1763.5,12,4,1,5,6,2,0,0,0,0,15385,6.6,16886,218,44,-2250,-629,26.2,1538.5
4852966404,1,11,1,1,3,4,2,0,0,0,0,15828,7.0,17835,224,59,-642,-1381,28.3,1582.8,34,1,0,4,3,7,0,0,0,0,16470,7.4,19216,246,72,642,1381,31.8,1647.0
4852915730,1,13,1,1,8,5,8,1,0,1,0,17647,7.2,18985,221,60,1888,920,28.1,1764.7,10,0,0,5,8,4,0,0,0,0,15759,6.8,18065,230,52,-1888,-920,28.2,1575.9
4852310565,0,13,2,1,5,7,2,1,1,0,0,15623,7.0,17961,221,59,-1885,470,28.0,1562.3,14,3,0,7,5,9,0,0,0,0,17508,6.8,17491,214,48,1885,-470,26.2,1750.8
4852294607,0,14,0,0,3,7,1,1,0,1,0,14590,6.6,16895,203,52,-3708,-1906,25.5,1459.0,20,1,1,7,3,7,0,0,0,0,18298,7.0,18801,232,70,3708,1906,30.2,1829.8
4851862505,0,25,2,0,6,10,6,0,0,0,0,17363,6.8,17779,202,66,-750,-603,26.8,1736.3,17,2,1,10,6,18,1,1,0,0,18113,7.0,18382,216,54,750,603,27.0,1811.3
4851828161,1,14,3,1,7,4,6,1,1,0,0,17764,7.0,18110,246,44,1248,-10,29.0,1776.4,12,1,0,4,7,5,0,0,0,0,16516,7.2,18120,224,56,-1248,10,28.0,1651.6
4851252167,1,18,0,1,30,39,64,0,0,0,0,39065,11.6,43152,100,0,-3302,-4090,10.0,3906.5,0,0,0,39,30,95,0,0,0,0,42367,12.2,47242,110,0,3302,4090,11.0,4236.7
4851246366,0,86,0,0,29,26,70,0,0,0,0,37324,11.6,42774,99,0,-605,1618,9.9,3732.4,0,4,1,26,29,64,0,0,0,0,37929,11.2,41156,104,0,605,-1618,10.4,3792.9
4851235711,1,0,0,1,16,24,36,0,0,0,2,33740,10.2,35803,100,0,-4308,-4118,10.0,3374.0,0,0,0,24,16,64,0,0,0,0,38048,11.2,39921,124,0,4308,4118,12.4,3804.8
4850522642,0,15,1,0,8,5,9,0,0,0,0,17030,6.4,16073,204,38,112,-1716,24.2,1703.0,21,1,1,5,8,3,1,1,0,0,16918,6.6,17789,216,64,-112,1716,28.0,1691.8
4850234251,1,0,0,1,25,22,63,0,0,0,0,36822,11.0,40098,98,0,-2,-568,9.8,3682.2,0,0,0,22,25,45,0,0,0,0,36824,11.0,40666,116,0,2,568,11.6,3682.4
4850225262,0,0,4,1,24,32,50,0,0,0,0,39364,11.2,40777,109,0,-255,-3158,10.9,3936.4,13,0,0,32,24,71,0,0,0,0,39619,11.8,43935,102,0,255,3158,10.2,3961.9
4850215096,0,0,0,0,21,33,43,0,0,0,2,36657,11.2,40753,94,0,-2777,-2140,9.4,3665.7,3,0,1,33,21,102,0,0,0,0,39434,11.4,42893,125,0,2777,2140,12.5,3943.4
4850198351,1,0,0,1,38,24,95,0,0,0,1,41739,12.0,45501,114,0,3618,3444,11.4,4173.9,0,0,0,24,38,56,0,0,0,0,38121,11.6,42057,100,0,-3618,-3444,10.0,3812.1
4830987159,0,13,1,0,4,8,4,0,0,0,0,16487,6.8,17781,226,52,-1953,-1037,27.8,1648.7,13,1,1,8,4,13,1,1,0,0,18440,7.2,18818,237,68,1953,1037,30.5,1844.0
4830974915,0,15,2,1,2,4,1,1,0,1,0,15259,7.0,18507,227,67,-720,1349,29.4,1525.9,13,1,0,4,2,7,1,1,0,0,15979,6.8,17158,217,64,720,-1349,28.1,1597.9
4830958147,0,14,3,1,1,0,1,1,1,0,0,15251,7.4,18744,236,60,226,765,29.6,1525.1,17,0,0,0,1,0,0,0,0,0,15025,6.8,17979,244,60,-226,-765,30.4,1502.5
4830942542,0,88,2,0,5,5,5,0,0,0,0,18065,7.4,19691,228,64,1764,2587,29.2,1806.5,15,2,1,5,5,7,0,0,0,0,16301,6.8,17104,206,51,-1764,-2587,25.7,1630.1
4830343243,1,13,0,1,4,4,4,0,0,0,0,15937,7.2,19288,230,67,-1547,332,29.7,1593.7,17,2,0,4,4,4,1,0,1,0,17484,7.2,18956,245,71,1547,-332,31.6,1748.4
4830312086,0,11,3,0,4,6,4,2,1,1,0,18017,6.6,17364,233,51,-697,-1601,28.4,1801.7,16,2,1,6,4,8,0,0,0,0,18714,7.2,18965,250,67,697,1601,31.7,1871.4
4828481792,0,7,2,0,2,7,2,0,0,0,0,16360,6.8,17947,222,56,-1191,-371,27.8,1636.0,10,0,1,7,2,11,0,0,0,0,17551,6.8,18318,227,60,1191,371,28.7,1755.1
4828448545,0,18,3,0,2,6,0,0,0,0,0,14858,6.8,17337,214,52,-3558,-625,26.6,1485.8,15,3,1,6,2,7,0,0,0,0,18416,7.0,17962,254,56,3558,625,31.0,1841.6
4817480416,1,86,2,0,3,6,2,0,0,0,0,14345,6.4,16426,218,40,-2550,-888,25.8,1434.5,15,1,1,6,3,7,0,0,0,0,16895,6.6,17314,196,52,2550,888,24.8,1689.5
4814317951,0,15,1,0,5,4,6,0,0,0,0,16413,6.8,17723,234,56,-1013,-1421,29.0,1641.3,14,0,1,3,4,2,2,1,1,0,17426,7.2,19144,227,68,1013,1421,29.5,1742.6
4813657635,1,16,2,1,9,7,7,1,1,0,0,17551,6.6,17669,221,48,647,1032,26.9,1755.1,13,1,0,7,9,9,0,0,0,0,16904,6.8,16637,199,44,-647,-1032,24.3,1690.4
4813517434,1,15,0,0,14,11,15,1,1,0,0,21200,7.2,18224,216,64,2071,1376,28.0,2120.0,20,1,1,11,14,11,1,0,1,0,19129,6.4,16848,207,44,-2071,-1376,25.1,1912.9
4813493282,0,10,2,1,4,5,3,0,0,0,0,15964,7.0,19287,236,64,363,1117,30.0,1596.4,12,2,0,5,4,5,0,0,0,0,15601,7.0,18170,216,60,-363,-1117,27.6,1560.1
4813454367,1,50,2,0,3,3,5,1,1,0,0,14500,6.6,16105,192,51,-634,-397,24.3,1450.0,12,1,1,3,3,2,0,0,0,0,15134,6.4,16502,211,63,634,397,27.4,1513.4
4813184511,1,15,0,1,2,5,3,1,1,0,0,15117,6.8,17956,241,56,-2072,-369,29.7,1511.7,13,0,0,5,2,7,0,0,0,0,17189,7.0,18325,265,63,2072,369,32.8,1718.9
4813143978,0,16,2,0,5,5,5,1,1,0,0,16103,7.0,18879,232,76,-1622,-11,30.8,1610.3,12,0,1,5,5,5,0,0,0,0,17725,7.2,18890,250,60,1622,11,31.0,1772.5
4810594571,0,16,1,1,5,8,12,0,0,0,0,15987,6.8,16970,205,55,-1476,-427,26.0,1598.7,14,1,0,8,5,9,0,0,0,0,17463,6.8,17397,223,55,1476,427,27.8,1746.3
4810573723,1,20,4,1,2,1,2,0,0,0,0,15591,6.8,18120,230,52,650,83,28.2,1559.1,15,4,0,1,2,1,0,0,0,0,14941,6.8,18037,253,54,-650,-83,30.7,1494.1
4810565801,0,5,1,0,1,10,2,0,0,0,0,13876,6.4,15888,189,60,-5039,-4803,24.9,1387.6,11,0,1,10,1,4,1,1,0,0,18915,7.4,20691,278,72,5039,4803,35.0,1891.5
4810463572,0,12,1,0,5,5,4,0,0,0,0,18329,6.8,18214,227,59,2052,436,28.6,1832.9,19,1,1,5,5,6,2,1,1,0,16277,7.0,17778,212,76,-2052,-436,28.8,1627.7
4851652023,0,80,2,0,6,11,5,1,1,0,0,17295,6.6,17109,229,42,-2155,-1008,27.1,1729.5,16,0,1,11,6,12,0,0,0,0,19450,7.0,18117,218,56,2155,1008,27.4,1945.0
4848994240,1,14,2,1,10,7,13,0,0,0,0,19031,7.2,18327,244,56,2348,1830,30.0,1903.1,11,0,0,7,10,7,0,0,0,0,16683,6.6,16497,203,52,-2348,-1830,25.5,1668.3
4848947840,0,10,3,0,3,3,4,0,0,0,0,16423,7.0,17817,235,56,-718,-1555,29.1,1642.3,15,1,1,3,3,2,1,1,0,0,17141,7.4,19372,235,68,718,1555,30.3,1714.1
4848899931,0,20,0,0,5,6,5,0,0,0,0,17304,7.0,18640,219,62,-33,56,28.1,1730.4,12,2,1,6,5,5,1,1,0,0,17337,7.0,18584,221,70,33,-56,29.1,1733.7
4842117914,0,11,2,1,3,4,3,0,0,0,0,16793,7.0,18287,249,60,661,-827,30.9,1679.3,17,3,0,4,3,2,0,0,0,0,16132,7.0,19114,242,56,-661,827,29.8,1613.2
4842077717,1,15,1,0,3,3,5,1,0,1,0,16868,7.0,18366,228,72,407,-632,30.0,1686.8,40,3,1,3,3,2,1,1,0,0,16461,7.0,18998,255,60,-407,632,31.5,1646.1
4842050438,0,16,2,1,9,5,12,2,1,1,0,18854,7.2,19050,248,74,1084,837,32.2,1885.4,14,3,0,5,9,6,0,0,0,0,17770,6.8,18213,248,60,-1084,-837,30.8,1777.0
4842019158,1,17,2,1,4,1,4,0,0,0,0,17610,7.0,18698,266,52,3351,1886,31.8,1761.0,75,1,0,1,4,1,0,0,0,0,14259,6.8,16812,220,52,-3351,-1886,27.2,1425.9
4841976237,0,17,2,0,0,2,0,0,0,0,0,14553,6.8,18093,243,62,-1170,-317,30.5,1455.3,85,2,1,2,0,2,1,1,0,0,15723,7.0,18410,234,61,1170,317,29.5,1572.3
4841923006,0,16,1,0,2,4,2,0,0,0,0,16184,7.2,18949,248,72,256,780,32.0,1618.4,9,3,1,4,2,3,1,1,0,0,15928,6.8,18169,229,51,-256,-780,28.0,1592.8
4841887018,1,91,2,1,6,7,6,0,0,0,0,17704,7.0,18119,221,47,715,391,26.8,1770.4,29,0,0,7,6,6,1,1,0,0,16989,6.8,17728,236,54,-715,-391,29.0,1698.9
4841862202,1,55,2,1,1,2,1,1,1,0,0,14989,6.8,17679,227,59,923,525,28.6,1498.9,16,0,0,2,1,2,0,0,0,0,14066,6.6,17154,201,47,-923,-525,24.8,1406.6
4841785310,0,11,1,0,3,8,5,0,0,0,0,16575,6.8,17225,233,64,-2102,-1330,29.7,1657.5,14,0,1,8,3,13,1,1,0,0,18677,7.2,18555,239,63,2102,1330,30.2,1867.7
4841764258,0,36,1,1,5,6,5,0,0,0,0,16004,6.6,17483,219,44,-1077,70,26.3,1600.4,103,4,0,6,5,6,0,0,0,0,17081,6.6,17413,242,50,1077,-70,29.2,1708.1
4841752146,1,13,1,1,7,8,9,1,1,0,0,18592,7.0,18110,228,65,-201,247,29.3,1859.2,10,2,0,8,7,10,0,0,0,0,18793,7.0,17863,233,61,201,-247,29.4,1879.3
4841436819,1,18,2,0,7,8,9,1,0,1,0,19054,7.0,17553,216,48,1827,-56,26.4,1905.4,12,7,1,8,7,4,0,0,0,0,17227,7.0,17609,222,52,-1827,56,27.4,1722.7
4841400252,1,11,1,1,3,4,3,0,0,0,0,15764,6.8,17517,240,47,-500,250,28.7,1576.4,80,1,0,4,3,5,1,1,0,0,16264,6.8,17267,191,64,500,-250,25.5,1626.4
4841354541,1,10,0,1,6,2,5,1,1,0,0,18186,7.2,18693,230,61,2351,171,29.1,1818.6,72,1,0,2,6,0,0,0,0,0,15835,7.0,18522,232,54,-2351,-171,28.6,1583.5
4841306551,0,36,1,0,5,5,2,0,0,0,0,15333,7.0,17976,184,56,-1175,-671,24.0,1533.3,84,12,1,5,5,2,1,1,0,0,16508,7.0,18647,234,60,1175,671,29.4,1650.8
4841259313,1,11,2,0,8,3,4,0,0,0,0,18106,7.4,19079,211,70,2093,670,28.1,1810.6,11,2,1,3,8,0,0,0,0,0,16013,7.0,18409,238,58,-2093,-670,29.6,1601.3
4858244970,0,2,23,0,34,39,89,0,0,0,0,39735,12.0,46107,92,0,-2948,-1035,9.2,3973.5,25,1,1,39,34,112,0,0,0,0,42683,12.0,47142,120,0,2948,1035,12.0,4268.3
4858212140,1,0,0,1,31,34,86,0,0,0,1,39457,12.0,45557,96,0,-1290,891,9.6,3945.7,27,0,0,34,31,87,0,0,0,0,40747,11.6,44666,92,0,1290,-891,9.2,4074.7
4857507451,1,0,0,1,17,14,18,0,0,0,0,63412,12.2,56000,0,0,27612,23000,0.0,6341.2,0,0,0,9,12,8,0,0,0,0,35800,7.2,33000,0,0,-27612,-23000,0.0,3580.0
4857483661,1,4,0,1,15,17,20,0,0,0,0,45600,10.0,47500,0,0,18060,19000,0.0,4560.0,0,0,0,11,9,8,0,0,0,0,27540,6.0,28500,0,0,-18060,-19000,0.0,2754.0
4857467116,1,0,0,0,12,19,13,0,0,0,0,44900,10.0,47500,0,0,15300,19000,0.0,4490.0,0,0,1,13,6,15,0,0,0,0,29600,6.0,28500,0,0,-15300,-19000,0.0,2960.0
4857443009,1,12,0,1,15,22,19,0,0,0,0,62887,12.0,55000,0,0,24963,22000,0.0,6288.7,0,0,0,17,10,9,0,0,0,0,37924,7.2,33000,0,0,-24963,-22000,0.0,3792.4
4857417583,1,77,0,1,18,17,23,0,0,0,0,62012,12.0,55000,0,0,23397,22000,0.0,6201.2,2,0,0,11,12,9,0,0,0,0,38615,7.2,33000,0,0,-23397,-22000,0.0,3861.5
4857393491,1,23,2,1,15,17,19,0,0,0,0,62020,13.6,63000,2,0,25490,30000,0.2,6202.0,0,2,0,11,9,7,0,0,0,0,36530,7.2,33000,3,0,-25490,-30000,0.3,3653.0
4857158385,1,0,0,1,29,25,84,0,0,0,1,39056,11.6,42937,109,0,2237,2173,10.9,3905.6,0,0,0,25,29,60,0,0,0,0,36819,11.2,40764,76,0,-2237,-2173,7.6,3681.9
4857138181,1,0,0,0,36,24,87,0,0,0,1,40826,12.0,45895,98,0,3281,3913,9.8,4082.6,0,0,1,24,36,60,0,0,0,0,37545,11.2,41982,91,0,-3281,-3913,9.1,3754.5
4857106190,0,0,20,0,30,24,94,0,0,0,1,38137,11.2,42099,85,0,107,1254,8.5,3813.7,55,0,1,24,30,58,0,0,0,0,38030,11.2,40845,116,0,-107,-1254,11.6,3803.0
4857080393,0,89,0,1,27,26,64,0,0,0,1,39885,11.8,44410,132,0,2017,3263,13.2,3988.5,0,0,0,26,27,62,0,0,0,0,37868,11.0,41147,97,0,-2017,-3263,9.7,3786.8
4857028524,1,14,3,1,4,5,7,0,0,0,0,17354,7.0,18231,249,56,1296,-421,30.5,1735.4,12,3,0,5,4,5,0,0,0,0,16058,7.0,18652,218,68,-1296,421,28.6,1605.8
4857009878,1,16,0,1,18,19,17,0,0,0,0,46303,10.0,47500,1,0,18103,19000,0.1,4630.3,0,0,0,11,10,10,0,0,0,0,28200,6.0,28500,0,0,-18103,-19000,0.0,2820.0
4856492026,1,5,0,1,19,18,16,0,0,0,0,46300,10.0,47500,0,0,17710,17820,0.0,4630.0,0,0,0,8,9,12,0,0,0,0,28590,6.2,29680,0,0,-17710,-17820,0.0,2859.0
4856390436,0,11,1,0,7,4,4,0,0,0,0,17824,7.2,19037,233,59,455,907,29.2,1782.4,74,1,1,4,7,1,1,1,0,0,17369,7.0,18130,215,64,-455,-907,27.9,1736.9
4856338172,1,13,3,1,7,5,10,1,1,0,0,17707,6.8,17815,246,54,805,-1327,30.0,1770.7,13,1,0,5,7,5,0,0,0,0,16902,7.4,19142,245,48,-805,1327,29.3,1690.2
4856300923,1,7,0,1,16,13,40,0,0,0,0,35095,10.8,37723,100,0,2337,2950,10.0,3509.5,0,0,0,13,16,39,0,0,0,0,32758,10.0,34773,91,0,-2337,-2950,9.1,3275.8
4856272383,0,1,0,1,23,38,54,0,0,0,1,38133,11.4,41629,98,0,-3404,-5264,9.8,3813.3,0,0,0,38,23,97,0,0,0,0,41537,12.0,46893,119,0,3404,5264,11.9,4153.7
4856234095,1,0,0,1,23,23,55,0,0,0,0,36904,11.2,41781,110,0,-723,-75,11.0,3690.4,16,0,0,23,23,63,0,0,0,0,37627,11.4,41856,114,0,723,75,11.4,3762.7
4842305776,0,12,0,0,5,7,2,1,1,0,0,16110,6.8,17586,213,55,351,292,26.8,1611.0,8,0,1,7,5,8,0,0,0,0,15759,7.0,17294,183,36,-351,-292,21.9,1575.9
4842253875,0,17,0,0,3,7,0,0,0,0,0,14886,6.8,18164,197,57,-1138,466,25.4,1488.6,8,3,1,7,3,8,0,0,0,0,16024,7.0,17698,196,56,1138,-466,25.2,1602.4
4834666513,0,17,2,0,5,7,4,0,0,0,0,16709,7.2,18952,202,72,-1008,-924,27.4,1670.9,11,3,1,7,5,5,1,1,0,0,17717,7.2,19876,225,72,1008,924,29.7,1771.7
4834087250,1,14,2,1,4,1,4,1,0,1,0,16594,7.4,19343,263,58,2617,553,32.1,1659.4,14,1,0,1,4,0,0,0,0,0,13977,7.0,18790,207,65,-2617,-553,27.2,1397.7
4834036221,0,12,0,1,6,7,6,0,0,0,0,16952,6.8,17327,210,47,-1799,-1763,25.7,1695.2,11,0,0,7,6,6,0,0,0,0,18751,7.2,19090,245,72,1799,1763,31.7,1875.1
4823859877,0,12,1,1,4,3,4,1,1,0,0,16780,6.8,18104,231,52,1077,-166,28.3,1678.0,16,1,0,3,4,1,0,0,0,0,15703,7.2,18270,225,67,-1077,166,29.2,1570.3
4823777081,0,55,1,1,4,3,3,0,0,0,0,16866,7.4,19839,246,60,789,-11,30.6,1686.6,12,3,0,3,4,3,2,1,1,0,16077,7.4,19850,255,68,-789,11,32.3,1607.7
4823721490,0,11,0,0,9,7,12,0,0,0,0,16525,6.4,15264,178,30,-913,-2269,20.8,1652.5,14,1,1,7,9,5,0,0,0,0,17438,6.8,17533,234,38,913,2269,27.2,1743.8
4823599519,1,11,2,1,6,2,5,1,0,1,0,17728,7.4,19480,246,68,2033,1935,31.4,1772.8,17,1,0,2,6,4,0,0,0,0,15695,6.6,17545,231,52,-2033,-1935,28.3,1569.5
4823533447,0,19,1,1,3,3,8,0,0,0,0,17684,7.2,19543,229,71,1178,1108,30.0,1768.4,19,3,0,3,3,1,0,0,0,0,16506,7.0,18435,253,52,-1178,-1108,30.5,1650.6
4822906067,0,16,0,0,4,6,4,0,0,0,0,15862,7.0,17547,228,48,-1343,30,27.6,1586.2,11,1,1,6,4,12,1,1,0,0,17205,6.8,17517,202,40,1343,-30,24.2,1720.5
4822838632,0,9,2,0,7,8,6,0,0,0,0,17846,7.0,18674,234,62,-35,1460,29.6,1784.6,10,2,1,8,7,10,1,1,0,0,17881,6.8,17214,228,53,35,-1460,28.1,1788.1
4821634881,1,14,3,0,7,2,10,0,0,0,0,16759,7.0,17887,219,46,2047,1481,26.5,1675.9,10,0,1,2,7,2,0,0,0,0,14712,6.6,16406,211,56,-2047,-1481,26.7,1471.2
4821580284,0,10,2,1,9,7,7,1,0,1,0,19049,7.0,17570,205,56,211,-630,26.1,1904.9,21,2,0,7,9,5,0,0,0,0,18838,7.0,18200,201,52,-211,630,25.3,1883.8
4821034559,1,13,2,1,7,6,8,1,1,0,0,17253,7.0,18123,233,48,403,-51,28.1,1725.3,14,0,0,6,7,4,0,0,0,0,16850,7.2,18174,230,60,-403,51,29.0,1685.0
4820989827,0,15,0,0,4,8,3,0,0,0,0,16255,7.0,17783,215,73,-2386,-707,28.8,1625.5,12,1,1,8,4,14,1,1,0,0,18641,7.2,18490,227,60,2386,707,28.7,1864.1
4812097635,1,14,1,0,7,3,7,0,0,0,0,17706,6.8,17967,214,64,1712,1709,27.8,1770.6,14,1,1,3,7,6,1,1,0,0,15994,6.6,16258,217,56,-1712,-1709,27.3,1599.4
4812014810,1,18,1,1,10,7,8,1,1,0,0,19492,7.4,19635,239,68,1856,2094,30.7,1949.2,12,1,0,7,10,10,0,0,0,0,17636,6.8,17541,209,52,-1856,-2094,26.1,1763.6
4811278887,1,14,0,0,4,4,5,0,0,0,0,16435,6.8,18360,204,72,-1387,-923,27.6,1643.5,16,2,1,4,4,1,2,1,1,0,17822,7.4,19283,240,56,1387,923,29.6,1782.2
4838348402,0,10,0,0,8,8,7,0,0,0,0,16911,6.6,17304,208,36,-1031,-232,24.4,1691.1,8,2,1,8,8,11,0,0,0,0,17942,6.8,17536,193,68,1031,232,26.1,1794.2
4837893619,1,13,0,1,11,5,10,1,1,0,0,17795,6.6,16718,178,44,316,-1625,22.2,1779.5,9,0,0,5,11,3,0,0,0,0,17479,7.2,18343,222,57,-316,1625,27.9,1747.9
4837864917,1,21,0,0,5,2,2,0,0,0,0,16506,6.8,17740,221,58,1651,869,27.9,1650.6,69,0,1,2,5,1,0,0,0,0,14855,6.6,16871,216,56,-1651,-869,27.2,1485.5
4837822384,1,12,0,0,5,5,4,1,1,0,0,16445,7.2,18484,242,47,7,279,28.9,1644.5,25,0,1,5,5,3,0,0,0,0,16438,7.0,18205,210,69,-7,-279,27.9,1643.8
4837797420,0,10,1,0,3,3,3,0,0,0,0,17076,7.0,18065,227,56,1671,855,28.3,1707.6,11,0,1,3,3,4,2,1,1,0,15405,6.6,17210,231,52,-1671,-855,28.3,1540.5
4836578993,1,10,4,1,3,2,3,0,0,0,0,16792,6.8,18257,214,74,427,1045,28.8,1679.2,14,2,0,2,3,5,2,1,1,0,16365,6.8,17212,226,60,-427,-1045,28.6,1636.5
4832840909,1,13,0,1,7,6,4,0,0,0,0,17796,7.4,18832,233,64,-131,304,29.7,1779.6,11,0,0,6,7,9,0,0,0,0,17927,7.0,18528,188,64,131,-304,25.2,1792.7
4832818856,0,10,2,0,3,7,2,0,0,0,0,15816,7.0,18273,251,60,-1892,-1571,31.1,1581.6,12,1,1,7,3,6,1,1,0,0,17708,7.4,19844,244,76,1892,1571,32.0,1770.8
4832783895,0,49,2,1,4,6,4,0,0,0,0,15947,7.0,18232,207,68,-2223,-568,27.5,1594.7,16,3,0,6,4,5,0,0,0,0,18170,7.0,18800,247,53,2223,568,30.0,1817.0
4832764406,1,43,1,1,9,7,9,0,0,0,0,19848,7.2,18872,208,67,3359,1149,27.5,1984.8,12,2,0,7,9,4,0,0,0,0,16489,7.0,17723,217,56,-3359,-1149,27.3,1648.9
4832742159,0,16,2,0,7,4,8,0,0,0,0,16371,7.0,18125,233,55,239,656,28.8,1637.1,15,0,1,4,7,3,0,0,0,0,16132,7.0,17469,236,48,-239,-656,28.4,1613.2
4832204612,1,37,0,0,6,3,2,1,1,0,0,17042,7.2,19648,218,72,1854,1911,29.0,1704.2,31,0,1,3,6,4,0,0,0,0,15188,7.0,17737,209,48,-1854,-1911,25.7,1518.8
4832159577,0,21,1,1,2,2,1,0,0,0,0,16362,7.2,19239,229,75,530,973,30.4,1636.2,14,2,0,2,2,2,0,0,0,0,15832,7.0,18266,255,40,-530,-973,29.5,1583.2
4831927122,0,24,2,1,8,6,9,0,0,0,0,18005,7.2,18528,227,56,1266,559,28.3,1800.5,12,4,0,5,7,6,0,0,0,0,16739,7.0,17969,219,58,-1266,-559,27.7,1673.9
4831901977,1,18,1,1,3,5,3,0,0,0,0,15091,7.0,17314,215,60,-859,-1456,27.5,1509.1,13,2,0,5,3,3,0,0,0,0,15950,7.4,18770,233,60,859,1456,29.3,1595.0
4831883602,1,30,0,1,8,4,5,0,0,0,0,18513,7.4,19248,230,63,3954,2407,29.3,1851.3,35,1,0,4,8,0,1,1,0,0,14559,6.6,16841,196,56,-3954,-2407,25.2,1455.9
4831408232,0,15,1,1,5,3,8,0,0,0,0,16620,7.0,17792,195,75,558,-487,27.0,1662.0,12,3,0,3,5,2,0,0,0,0,16062,7.0,18279,248,60,-558,487,30.8,1606.2
4831368288,0,13,3,1,9,6,11,0,0,0,0,17694,6.8,17121,204,46,-554,-1505,25.0,1769.4,15,2,0,6,9,4,0,0,0,0,18248,6.8,18626,205,71,554,1505,27.6,1824.8
4831046462,1,12,1,1,11,8,5,1,1,0,0,17965,6.6,17529,231,52,991,1662,28.3,1796.5,12,1,0,8,11,9,0,0,0,0,16974,6.4,15867,175,55,-991,-1662,23.0,1697.4
4855876912,1,0,0,0,20,20,18,0,0,0,0,63050,12.0,55000,0,0,24800,18000,0.0,6305.0,0,0,1,13,13,11,0,0,0,0,38250,8.0,37000,0,0,-24800,-18000,0.0,3825.0
4855856896,1,0,0,1,19,17,24,0,0,0,0,64162,12.0,55000,0,0,26196,22000,0.0,6416.2,5,0,0,10,12,9,0,0,0,0,37966,7.2,33000,0,0,-26196,-22000,0.0,3796.6
4855838193,1,10,0,0,18,21,22,0,0,0,0,49100,12.0,55000,0,0,19844,22000,0.0,4910.0,5,0,1,14,11,10,0,0,0,0,29256,7.2,33000,2,0,-19844,-22000,0.2,2925.6
4855819721,1,0,4,0,15,16,13,0,0,0,0,44945,10.0,47500,0,0,16395,19000,0.0,4494.5,35,0,1,10,9,8,0,0,0,0,28550,6.0,28500,14,0,-16395,-19000,1.4,2855.0
4855798673,1,20,0,1,18,14,16,0,0,0,0,46300,10.0,47500,0,0,14590,19000,0.0,4630.0,0,1,0,8,12,9,0,0,0,0,31710,6.0,28500,1,0,-14590,-19000,0.1,3171.0
4855785955,1,3,2,1,9,20,11,0,0,0,0,45170,10.0,47500,2,0,15920,19000,0.2,4517.0,30,0,0,14,3,12,0,0,0,0,29250,6.0,28500,0,0,-15920,-19000,0.0,2925.0
4855271845,1,50,0,1,15,18,18,0,0,0,0,61340,12.0,55000,0,0,23327,22000,0.0,6134.0,0,0,0,12,9,9,0,0,0,0,38013,7.2,33000,0,0,-23327,-22000,0.0,3801.3
4855243921,1,0,0,0,20,22,16,0,0,0,0,48540,10.0,47500,2,0,18885,17820,0.2,4854.0,0,0,1,11,9,12,0,0,0,0,29655,6.2,29680,1,0,-18885,-17820,0.1,2965.5
4855204571,1,0,0,1,15,13,15,0,0,0,0,46300,10.0,47500,4,0,18800,19000,0.4,4630.0,0,0,0,9,11,5,0,0,0,0,27500,6.0,28500,2,0,-18800,-19000,0.2,2750.0
4855186596,1,5,0,1,17,17,17,0,0,0,0,47902,10.0,47500,11,0,19277,19000,1.1,4790.2,0,0,0,12,12,11,0,0,0,0,28625,6.0,28500,6,0,-19277,-19000,0.6,2862.5
4855162799,1,18,0,1,17,17,18,0,0,0,0,39650,10.0,47500,0,0,11800,19000,0.0,3965.0,0,0,0,10,10,9,0,0,0,0,27850,6.0,28500,0,0,-11800,-19000,0.0,2785.0
4855096149,1,4,0,1,15,10,15,0,0,0,0,32100,10.0,47500,3,0,13400,19000,0.3,3210.0,0,0,0,5,10,5,0,0,0,0,18700,6.0,28500,2,0,-13400,-19000,0.2,1870.0
4855068432,1,234,0,0,15,20,12,0,0,0,0,45182,10.0,47500,4,0,16192,19000,0.4,4518.2,0,0,1,13,8,13,0,0,0,0,28990,6.0,28500,2,0,-16192,-19000,0.2,2899.0
4855040628,1,0,0,1,14,24,20,0,0,0,0,47443,10.0,47500,0,0,17484,19000,0.0,4744.3,0,0,0,18,8,13,0,0,0,0,29959,6.0,28500,0,0,-17484,-19000,0.0,2995.9
4855022419,1,0,0,1,20,14,16,0,0,0,0,46300,10.0,47500,0,0,18800,19000,0.0,4630.0,0,0,0,6,12,11,0,0,0,0,27500,6.0,28500,0,0,-18800,-19000,0.0,2750.0
4855008751,1,0,0,0,17,16,16,0,0,0,0,46650,10.0,47500,0,0,18800,19000,0.0,4665.0,0,0,1,9,10,9,0,0,0,0,27850,6.0,28500,0,0,-18800,-19000,0.0,2785.0
4854979817,1,19,1,1,13,20,12,0,0,0,0,64810,12.0,55000,1,0,26910,22000,0.1,6481.0,22,0,0,15,8,13,0,0,0,0,37900,7.2,33000,0,0,-26910,-22000,0.0,3790.0
4854932994,1,7,6,0,18,19,19,0,0,0,0,63805,12.0,55000,1,0,23810,22000,0.1,6380.5,31,4,1,14,13,11,0,0,0,0,39995,7.2,33000,1,0,-23810,-22000,0.1,3999.5
4854909470,1,15,0,0,14,15,15,0,0,0,0,59900,12.0,55000,0,0,23390,22000,0.0,5990.0,0,1,1,9,8,11,0,0,0,0,36510,7.2,33000,1,0,-23390,-22000,0.1,3651.0
4854529319,0,14,1,1,5,12,5,0,0,0,0,16922,6.6,16700,206,36,-3869,-1156,24.2,1692.2,16,0,0,12,5,14,0,0,0,0,20791,6.8,17856,227,40,3869,1156,26.7,2079.1
4844374637,0,35,4,0,3,5,3,0,0,0,0,14778,6.8,15987,196,56,-2006,-2876,25.2,1477.8,39,8,1,5,3,3,0,0,0,0,16784,7.2,18863,229,64,2006,2876,29.3,1678.4
4838921250,0,13,2,1,8,15,9,0,0,0,0,17316,6.4,15897,187,47,-4110,-3242,23.4,1731.6,12,0,0,15,8,11,1,1,0,0,21426,7.2,19139,227,61,4110,3242,28.8,2142.6
4838900468,0,13,3,0,3,12,4,0,0,0,0,15889,6.8,16897,213,48,-6699,-2292,26.1,1588.9,28,1,1,12,3,16,0,0,0,0,22588,7.2,19189,227,37,6699,2292,26.4,2258.8
4838050430,1,15,1,1,2,0,3,0,0,0,0,16332,7.0,18626,227,55,1811,1244,28.2,1633.2,14,2,0,0,2,0,1,1,0,0,14521,6.8,17382,231,56,-1811,-1244,28.7,1452.1
4828760142,1,55,0,1,8,2,7,1,1,0,0,17752,6.8,17923,182,53,4676,2701,23.5,1775.2,13,0,0,2,8,1,0,0,0,0,13076,6.2,15222,134,26,-4676,-2701,16.0,1307.6
4828642344,1,24,2,1,5,5,6,0,0,0,0,16403,6.6,17179,207,44,-1411,-952,25.1,1640.3,15,1,0,5,5,6,1,0,1,0,17814,6.8,18131,227,48,1411,952,27.5,1781.4
4828601667,1,54,0,0,2,4,2,0,0,0,0,15198,6.8,16374,212,68,-985,-963,28.0,1519.8,13,2,1,4,2,5,1,1,0,0,16183,6.8,17337,253,44,985,963,29.7,1618.3
4828067310,1,17,2,1,2,3,0,0,0,0,0,15994,6.8,17731,259,56,801,-186,31.5,1599.4,37,2,0,3,2,2,0,0,0,0,15193,7.0,17917,191,67,-801,186,25.8,1519.3
4826204265,0,13,0,0,7,8,10,0,0,0,0,18109,6.8,16976,214,43,-679,-472,25.7,1810.9,15,0,1,8,7,10,0,0,0,0,18788,6.6,17448,198,44,679,472,24.2,1878.8
4825509344,0,12,0,1,13,5,13,1,1,0,0,20944,7.2,19009,226,52,3545,982,27.8,2094.4,10,0,0,5,13,5,0,0,0,0,17399,7.0,18027,237,55,-3545,-982,29.2,1739.9
4824787802,1,17,3,1,12,3,11,1,1,0,0,19893,7.2,19326,248,58,4627,3460,30.6,1989.3,10,1,0,3,12,3,0,0,0,0,15266,6.2,15866,161,56,-4627,-3460,21.7,1526.6
4824726982,0,28,1,0,6,11,3,0,0,0,0,15355,6.4,16112,198,44,-4963,-3048,24.2,1535.5,15,1,1,11,6,9,1,1,0,0,20318,7.0,19160,224,67,4963,3048,29.1,2031.8
4824681494,0,15,1,0,3,10,2,0,0,0,0,14682,6.6,15716,204,48,-2539,-2086,25.2,1468.2,12,3,1,10,3,4,0,0,0,0,17221,6.6,17802,183,51,2539,2086,23.4,1722.1
4824638740,0,13,0,1,5,7,2,0,0,0,0,16162,7.0,18299,239,60,-170,-539,29.9,1616.2,13,1,0,6,4,1,0,0,0,0,16332,7.2,18838,209,60,170,539,26.9,1633.2
4824600883,0,20,0,0,1,2,1,0,0,0,0,14315,6.6,16850,199,60,-456,-1219,25.9,1431.5,9,2,1,2,1,0,1,0,1,0,14771,6.8,18069,215,50,456,1219,26.5,1477.1
4824495836,0,29,1,1,5,5,5,1,0,1,0,17511,7.2,18656,253,56,-228,-2053,30.9,1751.1,23,0,0,5,5,2,1,1,0,0,17739,7.4,20709,277,63,228,2053,34.0,1773.9
4824463927,0,29,2,1,11,1,14,0,0,0,0,19510,7.0,18114,226,39,3242,409,26.5,1951.0,10,2,0,1,11,0,0,0,0,0,16268,6.8,17705,254,48,-3242,-409,30.2,1626.8
4824432657,0,13,2,0,7,7,8,1,1,0,0,18423,6.8,18007,241,54,131,552,29.5,1842.3,19,1,1,7,7,6,1,0,1,0,18292,6.8,17455,200,52,-131,-552,25.2,1829.2
4824412723,0,98,0,0,2,9,1,0,0,0,0,14914,6.6,17572,234,64,-4238,-1901,29.8,1491.4,16,2,1,9,2,12,1,1,0,0,19152,7.4,19473,236,59,4238,1901,29.5,1915.2
4858103106,1,62,7,1,14,19,16,0,0,0,0,46164,10.0,47500,6,0,16874,19000,0.6,4616.4,13,2,0,12,7,9,0,0,0,0,29290,6.0,28500,2,0,-16874,-19000,0.2,2929.0
4858086477,1,4,0,1,24,24,28,0,0,0,0,65850,13.4,63500,0,0,27600,26000,0.0,6585.0,0,0,0,13,13,15,0,0,0,0,38250,7.8,37500,0,0,-27600,-26000,0.0,3825.0
4858074930,1,36,0,1,16,16,16,0,0,0,0,47055,10.0,47500,0,0,16627,19000,0.0,4705.5,0,0,0,10,10,8,0,0,0,0,30428,6.0,28500,0,0,-16627,-19000,0.0,3042.8
4858051637,1,5,0,1,17,21,14,0,0,0,0,62700,12.0,55000,0,0,24800,22000,0.0,6270.0,0,0,0,12,8,16,0,0,0,0,37900,7.2,33000,0,0,-24800,-22000,0.0,3790.0
4858044876,1,0,0,1,28,19,25,0,0,0,0,64800,13.0,62500,10,0,27600,28000,1.0,6480.0,0,0,0,8,17,11,0,0,0,0,37200,7.4,34500,0,0,-27600,-28000,0.0,3720.0
4856532604,1,33,0,1,20,16,18,0,0,0,0,47000,10.0,47500,0,0,18100,19000,0.0,4700.0,0,0,0,9,13,9,0,0,0,0,28900,6.0,28500,0,0,-18100,-19000,0.0,2890.0
4856518701,1,0,0,0,24,22,26,0,0,0,0,65200,12.6,58000,0,0,27300,25000,0.0,6520.0,0,0,1,11,13,7,0,0,0,0,37900,7.2,33000,0,0,-27300,-25000,0.0,3790.0
4856504987,1,355,0,1,15,18,12,0,0,0,0,45950,10.2,48500,0,0,18100,20000,0.0,4595.0,0,0,0,11,8,9,0,0,0,0,27850,6.0,28500,0,0,-18100,-20000,0.0,2785.0
4856485150,1,0,7,1,28,19,28,0,0,0,0,65900,12.8,61000,0,0,28175,25000,0.0,6590.0,37,3,0,8,17,8,0,0,0,0,37725,7.6,36000,7,0,-28175,-25000,0.7,3772.5
4856467901,1,27,0,0,18,19,20,0,0,0,0,62700,12.0,55000,0,0,24800,22000,0.0,6270.0,0,0,1,13,12,9,0,0,0,0,37900,7.2,33000,0,0,-24800,-22000,0.0,3790.0
4855458742,1,0,0,1,17,16,16,0,0,0,0,47350,10.0,47500,0,0,20200,19000,0.0,4735.0,0,0,0,9,10,9,0,0,0,0,27150,6.0,28500,0,0,-20200,-19000,0.0,2715.0
4855440310,1,47,0,1,17,21,19,0,0,0,0,62350,12.2,56000,0,0,24800,23000,0.0,6235.0,0,0,0,12,8,11,0,0,0,0,37550,7.2,33000,0,0,-24800,-23000,0.0,3755.0
4855425621,1,176,0,1,11,20,13,0,0,0,0,60267,12.0,55000,0,0,22017,21950,0.0,6026.7,176,0,0,14,5,13,0,0,0,0,38250,7.2,33050,0,0,-22017,-21950,0.0,3825.0
4855415098,1,0,0,1,13,17,11,0,0,0,0,46300,10.0,47500,0,0,14600,19000,0.0,4630.0,1,0,0,10,6,11,0,0,0,0,31700,6.0,28500,0,0,-14600,-19000,0.0,3170.0
4855400854,1,5,0,0,20,15,20,0,0,0,0,63502,12.0,55000,0,0,26990,22000,0.0,6350.2,0,0,1,8,13,6,0,0,0,0,36512,7.2,33000,0,0,-26990,-22000,0.0,3651.2
4855370583,1,3,0,0,12,22,14,0,0,0,0,43705,10.0,47500,3,0,15485,19000,0.3,4370.5,0,0,1,14,4,14,0,0,0,0,28220,6.0,28500,0,0,-15485,-19000,0.0,2822.0
4854418234,1,0,0,1,17,18,16,0,0,0,0,46650,10.2,48680,0,0,18100,20180,0.0,4665.0,0,0,0,12,11,9,0,0,0,0,28550,6.0,28500,0,0,-18100,-20180,0.0,2855.0
4854343961,1,0,0,1,23,21,15,0,0,0,0,63724,12.0,55000,1,0,25824,22000,0.1,6372.4,0,0,0,10,12,17,0,0,0,0,37900,7.2,33000,0,0,-25824,-22000,0.0,3790.0
4854327610,1,0,0,1,21,16,24,0,0,0,0,64193,12.0,55000,0,0,26961,22000,0.0,6419.3,0,0,0,7,12,8,0,0,0,0,37232,7.2,33000,0,0,-26961,-22000,0.0,3723.2
4854316352,1,0,0,0,21,28,23,0,0,0,0,47380,10.0,47500,0,0,18785,19000,0.0,4738.0,4,0,1,16,9,15,0,0,0,0,28595,6.0,28500,0,0,-18785,-19000,0.0,2859.5
4858252302,0,12,2,0,3,10,5,0,0,0,0,14279,6.6,15828,193,55,-5363,-2547,24.8,1427.9,15,1,1,10,3,16,2,1,1,0,19642,7.0,18375,228,56,5363,2547,28.4,1964.2
4858197497,1,13,1,1,8,6,6,0,0,0,0,18134,7.0,18162,230,52,-203,25,28.2,1813.4,11,3,0,6,8,5,0,0,0,0,18337,7.2,18137,246,51,203,-25,29.7,1833.7
4858155308,1,18,0,0,8,6,13,0,0,0,0,17940,6.8,17442,189,52,1603,1141,24.1,1794.0,14,0,1,6,8,4,1,1,0,0,16337,6.6,16301,173,65,-1603,-1141,23.8,1633.7
4858127265,1,10,2,1,7,5,8,1,1,0,0,17861,6.8,17073,224,52,1589,1559,27.6,1786.1,7,5,0,5,7,3,0,0,0,0,16272,6.4,15514,162,52,-1589,-1559,21.4,1627.2
4856300627,1,3,0,0,23,17,22,0,0,0,0,48678,10.0,47500,0,0,21518,19000,0.0,4867.8,0,0,1,7,13,6,0,0,0,0,27160,6.0,28500,0,0,-21518,-19000,0.0,2716.0
4853571722,1,10,2,0,22,19,21,0,0,0,0,48120,10.0,47500,3,0,20260,19000,0.3,4812.0,20,1,1,8,11,10,0,0,0,0,27860,6.0,28500,1,0,-20260,-19000,0.1,2786.0
4853553569,1,0,0,0,21,15,26,0,0,0,0,66260,13.0,62500,0,0,30445,28000,0.0,6626.0,0,0,1,10,16,5,0,0,0,0,35815,7.4,34500,0,0,-30445,-28000,0.0,3581.5
4853541960,1,3,0,0,21,14,17,0,0,0,0,53400,12.0,55000,0,0,17600,22000,0.0,5340.0,0,0,1,4,11,6,0,0,0,0,35800,7.2,33000,0,0,-17600,-22000,0.0,3580.0
4853529753,1,4,0,0,20,18,20,0,0,0,0,62706,12.0,55000,0,0,25503,22000,0.0,6270.6,0,0,1,11,13,9,0,0,0,0,37203,7.2,33000,0,0,-25503,-22000,0.0,3720.3
4853510274,1,19,0,1,18,16,21,0,0,0,0,62000,12.0,55000,0,0,25490,22000,0.0,6200.0,0,1,0,9,11,7,0,0,0,0,36510,7.2,33000,1,0,-25490,-22000,0.1,3651.0
4853470862,0,184,2,1,6,10,3,0,0,0,0,17042,6.8,17692,211,63,-1728,-217,27.4,1704.2,12,4,0,10,6,8,0,0,0,0,18770,7.2,17909,250,40,1728,217,29.0,1877.0
4852608411,1,6,0,0,17,13,16,0,0,0,0,46300,10.0,47500,0,0,18800,19000,0.0,4630.0,5,0,1,11,15,9,0,0,0,0,27500,6.0,28500,0,0,-18800,-19000,0.0,2750.0
4852595816,1,0,0,1,22,16,23,0,0,0,0,49450,10.0,47500,0,0,20900,19000,0.0,4945.0,5,0,0,8,14,9,0,0,0,0,28550,6.0,28500,0,0,-20900,-19000,0.0,2855.0
4852571947,1,0,0,1,15,17,23,0,0,0,0,47350,10.0,47500,0,0,18100,19000,0.0,4735.0,0,0,0,13,11,6,0,0,0,0,29250,6.0,28500,0,0,-18100,-19000,0.0,2925.0
4852536036,1,20,0,1,16,20,16,0,0,0,0,60600,12.0,55000,0,0,22700,22000,0.0,6060.0,0,0,0,11,7,12,0,0,0,0,37900,7.2,33000,0,0,-22700,-22000,0.0,3790.0
4852509418,1,0,0,1,15,10,15,0,0,0,0,34780,10.0,47500,2,0,15500,19000,0.2,3478.0,0,0,0,5,10,4,0,0,0,0,19280,6.0,28500,0,0,-15500,-19000,0.0,1928.0
4852494678,1,0,0,0,16,21,18,0,0,0,0,62700,12.0,55000,0,0,24800,22000,0.0,6270.0,4,0,1,15,10,13,0,0,0,0,37900,7.2,33000,0,0,-24800,-22000,0.0,3790.0
4852484777,1,0,0,1,19,14,22,0,0,0,0,47555,10.0,47500,7,0,18930,19000,0.7,4755.5,0,0,0,11,16,10,0,0,0,0,28625,6.0,28500,6,0,-18930,-19000,0.6,2862.5
4852462582,1,0,0,1,10,20,13,0,0,0,0,59675,12.0,55000,1,0,21365,22000,0.1,5967.5,0,0,0,14,4,12,0,0,0,0,38310,7.2,33000,0,0,-21365,-22000,0.0,3831.0
4849711251,1,13,2,1,3,2,2,0,0,0,0,15207,7.2,18521,221,68,-628,-552,28.9,1520.7,18,2,0,2,3,2,0,0,0,0,15835,7.2,19073,243,55,628,552,29.8,1583.5
4858074316,1,0,0,0,10,22,11,0,0,0,0,44656,10.6,50500,1,0,16034,22000,0.1,4465.6,414,0,1,15,3,13,0,0,0,0,28622,6.0,28500,1,0,-16034,-22000,0.1,2862.2
4857733977,1,0,0,1,18,18,16,0,0,0,0,45600,10.0,47500,0,0,16700,19000,0.0,4560.0,0,0,0,12,12,15,0,0,0,0,28900,6.0,28500,0,0,-16700,-19000,0.0,2890.0
4857727083,1,0,0,1,16,12,22,0,0,0,0,45600,10.0,47500,0,0,19500,19000,0.0,4560.0,0,0,0,8,12,5,0,0,0,0,26100,6.0,28500,0,0,-19500,-19000,0.0,2610.0
4857179962,1,10,0,1,23,19,13,0,0,0,0,47525,10.0,47500,1,0,15445,19000,0.1,4752.5,0,0,0,8,12,11,0,0,0,0,32080,6.0,28500,1,0,-15445,-19000,0.1,3208.0
4857155554,1,38,0,1,11,24,14,0,0,0,0,62465,12.0,55000,1,0,23335,22000,0.1,6246.5,0,1,0,19,6,12,0,0,0,0,39130,7.2,33000,3,0,-23335,-22000,0.3,3913.0
4857135566,1,0,0,1,23,16,18,0,0,0,0,48750,12.0,55000,0,0,22300,22000,0.0,4875.0,0,0,0,5,12,9,0,0,0,0,26450,7.2,33000,0,0,-22300,-22000,0.0,2645.0
4857117226,1,0,0,1,18,16,21,0,0,0,0,47000,10.0,47500,0,0,19500,19000,0.0,4700.0,0,0,0,9,11,7,0,0,0,0,27500,6.0,28500,0,0,-19500,-19000,0.0,2750.0
4856935543,1,0,12,1,14,16,9,0,0,0,0,46020,10.0,47500,0,0,16700,19000,0.0,4602.0,37,4,0,8,6,13,0,0,0,0,29320,6.0,28500,6,0,-16700,-19000,0.6,2932.0
4856927786,1,0,0,1,24,15,28,0,0,0,0,64450,12.0,55000,0,0,29241,21000,0.0,6445.0,1,0,0,5,14,2,0,0,0,0,35209,7.4,34000,0,0,-29241,-21000,0.0,3520.9
4856673070,1,0,0,1,15,22,14,0,0,0,0,49100,10.0,47500,0,0,20200,17500,0.0,4910.0,0,0,0,14,7,12,0,0,0,0,28900,6.4,30000,0,0,-20200,-17500,0.0,2890.0
4856661598,1,0,0,1,15,20,19,0,0,0,0,46345,10.0,47500,0,0,16014,19000,0.0,4634.5,0,0,0,12,7,8,0,0,0,0,30331,6.0,28500,0,0,-16014,-19000,0.0,3033.1
4856662844,1,0,9,1,14,12,13,0,0,0,0,49190,12.0,55000,3,0,19875,22000,0.3,4919.0,34,5,0,7,9,7,0,0,0,0,29315,7.2,33000,10,0,-19875,-22000,1.0,2931.5
4856649616,1,39,0,1,16,19,10,0,0,0,0,45563,10.0,47500,3,0,17013,17500,0.3,4556.3,0,0,0,10,7,13,0,0,0,0,28550,6.4,30000,0,0,-17013,-17500,0.0,2855.0
4856648118,1,89,0,1,14,13,20,0,0,0,0,47503,10.0,47500,1,0,18929,19000,0.1,4750.3,0,0,0,10,11,7,0,0,0,0,28574,6.0,28500,0,0,-18929,-19000,0.0,2857.4
4856643777,1,2,0,0,10,16,19,0,0,0,0,60680,12.0,55000,2,0,22050,20000,0.2,6068.0,0,0,1,14,8,6,0,0,0,0,38630,7.6,35000,0,0,-22050,-20000,0.0,3863.0
4856634967,1,0,0,0,14,20,13,0,0,0,0,46475,10.0,47500,2,0,15380,19000,0.2,4647.5,3,0,1,13,7,14,0,0,0,0,31095,6.0,28500,12,0,-15380,-19000,1.2,3109.5
4856620728,1,198,0,0,14,14,19,0,0,0,0,62362,12.8,59000,0,0,25466,26000,0.0,6236.2,4,0,1,11,11,5,0,0,0,0,36896,7.2,33000,0,0,-25466,-26000,0.0,3689.6
4856621771,1,0,0,1,18,20,15,0,0,0,0,61919,12.0,55000,11,0,23504,22000,1.1,6191.9,0,0,0,12,10,13,0,0,0,0,38415,7.2,33000,4,0,-23504,-22000,0.4,3841.5
4856611961,1,0,0,1,14,16,18,0,0,0,0,49100,10.0,47500,6,0,20150,19000,0.6,4910.0,0,0,0,11,9,8,0,0,0,0,28950,6.0,28500,5,0,-20150,-19000,0.5,2895.0
4856595721,1,13,0,1,16,13,18,0,0,0,0,47000,10.0,47500,0,0,18100,19000,0.0,4700.0,0,0,0,8,11,6,0,0,0,0,28900,6.0,28500,0,0,-18100,-19000,0.0,2890.0
4856239135,0,14,2,0,4,9,5,0,0,0,0,15702,6.2,15905,196,55,-2654,-2970,25.1,1570.2,10,3,1,9,4,10,1,1,0,0,18356,7.2,18875,244,56,2654,2970,30.0,1835.6
4856171669,1,12,0,0,5,3,5,1,1,0,0,16298,7.2,19286,210,64,1207,1709,27.4,1629.8,17,3,1,3,5,0,0,0,0,0,15091,6.8,17577,219,56,-1207,-1709,27.5,1509.1
4855910860,1,10,1,1,3,1,3,0,0,0,0,15981,7.0,19422,247,68,1228,1356,31.5,1598.1,11,1,0,1,3,0,0,0,0,0,14753,6.6,18066,234,60,-1228,-1356,29.4,1475.3
4855873766,0,13,1,0,8,10,7,1,1,0,0,19300,7.4,19858,221,66,-713,2070,28.7,1930.0,13,1,1,10,8,10,0,0,0,0,20013,7.0,17788,214,42,713,-2070,25.6,2001.3
4855840078,1,12,3,0,7,9,6,1,1,0,0,19559,7.6,20367,261,76,2050,3806,33.7,1955.9,13,0,1,9,7,11,0,0,0,0,17509,6.8,16561,223,44,-2050,-3806,26.7,1750.9
4854559665,1,12,2,1,9,4,8,1,0,1,0,19847,6.8,18051,237,52,4436,997,28.9,1984.7,13,0,0,4,9,5,0,0,0,0,15411,6.8,17054,218,60,-4436,-997,27.8,1541.1
4854534534,0,16,4,0,4,6,4,0,0,0,0,16290,7.2,18176,224,52,-408,570,27.6,1629.0,14,5,1,6,4,9,1,1,0,0,16698,6.8,17606,215,49,408,-570,26.4,1669.8
4854454711,1,10,2,1,7,7,5,0,0,0,0,17243,7.0,18201,217,70,1023,-218,28.7,1724.3,16,0,0,7,7,1,1,1,0,0,16220,7.0,18419,203,55,-1023,218,25.8,1622.0
4854439456,1,52,0,1,5,4,3,0,0,0,0,17071,7.2,19230,235,63,1327,944,29.8,1707.1,12,0,0,4,5,3,1,1,0,0,15744,7.0,18286,204,68,-1327,-944,27.2,1574.4
4853369629,0,42,2,1,1,3,2,1,0,1,0,14105,6.8,17332,188,74,-1000,-635,26.2,1410.5,32,3,0,3,1,7,0,0,0,0,15105,7.0,17967,211,46,1000,635,25.7,1510.5
4852421456,0,15,0,0,22,33,49,0,0,0,2,37800,11.4,42311,79,0,-3306,-3657,7.9,3780.0,0,0,1,33,22,84,0,0,0,0,41106,11.8,45968,112,0,3306,3657,11.2,4110.6
4852408037,1,0,0,0,23,34,68,0,0,0,2,38585,11.2,40590,106,0,-1414,-4767,10.6,3858.5,0,0,1,34,23,86,0,0,0,0,39999,12.0,45357,106,0,1414,4767,10.6,3999.9
4852340857,0,9,0,0,2,4,2,0,0,0,0,15331,6.6,17466,238,40,-1237,-1046,27.8,1533.1,20,2,1,4,2,6,0,0,0,0,16568,7.2,18512,225,62,1237,1046,28.7,1656.8
4852321249,0,15,2,0,9,6,11,1,0,1,0,19056,7.0,18618,217,67,2853,1054,28.4,1905.6,14,0,1,6,9,7,0,0,0,0,16203,6.8,17564,213,52,-2853,-1054,26.5,1620.3
4852307244,1,15,1,0,6,3,10,1,1,0,0,17302,6.8,18327,243,64,1276,213,30.7,1730.2,13,2,1,3,6,4,0,0,0,0,16026,6.8,18114,215,68,-1276,-213,28.3,1602.6
4851850504,1,15,4,0,4,8,4,1,1,0,0,16735,7.2,18713,233,51,-925,1186,28.4,1673.5,13,2,1,8,4,12,0,0,0,0,17660,6.8,17527,218,48,925,-1186,26.6,1766.0
4851814943,0,13,4,0,7,4,11,0,0,0,0,17595,7.2,18655,218,52,1019,-73,27.0,1759.5,13,1,1,4,7,5,0,0,0,0,16576,7.4,18728,214,76,-1019,73,29.0,1657.6
4851782884,0,12,3,1,2,9,4,1,1,0,0,14928,6.6,17405,220,60,-3421,-731,28.0,1492.8,10,1,0,9,2,12,0,0,0,0,18349,7.2,18136,213,56,3421,731,26.9,1834.9
4851733163,0,11,0,0,2,8,1,1,0,1,0,15114,6.6,17253,207,60,-3965,-2057,26.7,1511.4,20,0,1,8,2,6,1,1,0,0,19079,7.4,19310,228,76,3965,2057,30.4,1907.9
4851699175,0,14,0,1,2,4,1,1,1,0,0,15247,6.8,17520,206,76,-1531,-1167,28.2,1524.7,12,3,0,4,2,3,0,0,0,0,16778,7.2,18687,203,58,1531,1167,26.1,1677.8
4843918373,1,10,2,0,4,6,3,0,0,0,0,15923,7.0,17628,235,46,-1513,-455,28.1,1592.3,18,2,1,6,4,6,1,0,1,0,17436,7.2,18083,234,60,1513,455,29.4,1743.6
4843875202,0,14,0,0,4,4,3,0,0,0,0,14550,6.6,16703,196,51,-1641,30,24.7,1455.0,17,0,1,4,4,3,0,0,0,0,16191,6.6,16673,215,51,1641,-30,26.6,1619.1
4843852649,0,85,1,0,4,7,4,1,1,0,0,16260,6.8,18048,223,46,-3020,-2580,26.9,1626.0,13,0,1,7,4,5,1,0,1,0,19280,7.6,20628,231,74,3020,2580,30.5,1928.0
4838860813,0,11,0,1,7,5,12,0,0,0,0,18228,6.4,16828,215,44,993,631,25.9,1822.8,15,0,0,5,7,11,1,1,0,0,17235,6.6,16197,212,48,-993,-631,26.0,1723.5
4835704746,1,17,0,1,12,3,12,0,0,0,0,19924,7.0,18329,226,53,4580,2580,27.9,1992.4,10,1,0,3,12,5,0,0,0,0,15344,6.2,15749,205,48,-4580,-2580,25.3,1534.4
4835671831,0,11,1,0,2,6,3,0,0,0,0,14910,6.8,17557,227,59,-2579,-1346,28.6,1491.0,78,2,1,6,2,4,2,1,1,0,17489,7.2,18903,216,59,2579,1346,27.5,1748.9
4835289172,0,16,2,1,11,10,15,0,0,0,0,20371,6.8,18650,206,52,462,279,25.8,2037.1,13,3,0,10,11,15,2,1,1,0,19909,7.0,18371,230,65,-462,-279,29.5,1990.9
4835257523,0,12,0,0,2,7,2,0,0,0,0,15430,6.8,17581,243,60,-2611,-1624,30.3,1543.0,12,1,1,7,2,5,1,1,0,0,18041,7.2,19205,217,64,2611,1624,28.1,1804.1
4835236679,0,16,3,1,6,9,7,0,0,0,0,16694,7.0,17683,212,56,-2200,-1208,26.8,1669.4,11,6,0,9,6,10,0,0,0,0,18894,7.0,18891,247,56,2200,1208,30.3,1889.4
4835209231,1,18,0,1,10,11,8,0,0,0,0,18638,6.6,16783,167,59,-762,637,22.6,1863.8,12,2,0,11,10,11,0,0,0,0,19400,6.4,16146,198,44,762,-637,24.2,1940.0
4834946866,0,10,2,1,5,8,4,0,0,0,0,17688,7.0,17900,214,70,-370,504,28.4,1768.8,13,2,0,7,4,8,0,0,0,0,18058,6.8,17396,213,50,370,-504,26.3,1805.8
4834899726,1,10,0,1,7,1,5,0,0,0,0,16722,7.2,18911,185,56,1593,1127,24.1,1672.2,13,0,0,1,7,1,0,0,0,0,15129,7.0,17784,234,56,-1593,-1127,29.0,1512.9
4834883920,0,53,4,0,2,13,4,0,0,0,1,14738,6.2,14168,164,40,-8409,-4455,20.4,1473.8,14,4,1,13,2,11,1,0,1,0,23147,7.2,18623,248,52,8409,4455,30.0,2314.7
4834854786,1,52,6,0,4,3,4,0,0,0,0,17133,7.0,18708,221,56,457,155,27.7,1713.3,17,2,1,3,4,1,2,1,1,0,16676,7.0,18553,212,64,-457,-155,27.6,1667.6
4834811979,1,26,13,1,7,4,7,0,0,0,0,18669,7.0,18201,247,47,2259,25,29.4,1866.9,41,3,0,4,7,4,1,1,0,0,16410,7.2,18176,230,59,-2259,-25,28.9,1641.0
4834777082,1,18,2,0,8,4,6,0,0,0,0,18404,7.4,18946,211,64,2706,2398,27.5,1840.4,13,2,1,3,7,2,1,1,0,0,15698,6.6,16548,184,59,-2706,-2398,24.3,1569.8
4834735946,1,12,1,1,3,8,4,0,0,0,0,15883,6.6,17469,229,57,-1735,161,28.6,1588.3,15,1,0,8,3,13,0,0,0,0,17618,6.8,17308,227,43,1735,-161,27.0,1761.8
4834706308,1,36,2,1,4,3,7,1,1,0,0,17128,7.0,18518,242,71,1207,1124,31.3,1712.8,39,1,0,3,4,7,1,0,1,0,15921,6.8,17394,227,60,-1207,-1124,28.7,1592.1
4834683835,1,13,1,0,7,8,9,0,0,0,0,17311,6.8,18645,206,72,-148,861,27.8,1731.1,11,1,1,8,7,8,1,1,0,0,17459,6.8,17784,203,68,148,-861,27.1,1745.9
4833954099,1,13,1,0,10,10,17,1,0,1,0,18443,6.4,17130,197,54,-336,270,25.1,1844.3,14,0,1,10,10,19,0,0,0,0,18779,6.8,16860,200,73,336,-270,27.3,1877.9
4824074853,1,18,2,1,6,1,8,1,1,0,0,17149,7.0,18207,219,60,2300,802,27.9,1714.9,12,4,0,1,6,3,0,0,0,0,14849,6.8,17405,206,40,-2300,-802,24.6,1484.9
4824038138,0,9,1,0,3,6,2,1,1,0,0,15893,6.8,17525,217,52,-628,-1589,26.9,1589.3,12,1,1,6,3,2,0,0,0,0,16521,7.0,19114,240,44,628,1589,28.4,1652.1
4820629500,0,14,2,0,9,7,11,1,1,0,0,18116,6.8,17183,213,48,835,914,26.1,1811.6,15,3,1,7,9,11,0,0,0,0,17281,6.6,16269,216,48,-835,-914,26.4,1728.1
4819600381,0,12,1,0,5,6,5,0,0,0,0,15941,6.6,17251,222,52,-592,-541,27.4,1594.1,11,0,1,6,5,2,1,1,0,0,16533,6.6,17792,189,68,592,541,25.7,1653.3
4819582389,0,9,0,1,4,6,5,0,0,0,0,15939,6.6,16859,201,52,-1352,-1238,25.3,1593.9,12,1,0,6,4,10,0,0,0,0,17291,7.0,18097,211,62,1352,1238,27.3,1729.1
4819268321,1,25,2,0,7,6,9,0,0,0,0,18574,7.0,18194,220,43,2914,1266,26.3,1857.4,14,3,1,6,7,4,0,0,0,0,15660,6.6,16928,199,44,-2914,-1266,24.3,1566.0
4819258043,0,9,8,0,5,8,5,0,0,0,0,16617,7.0,17238,220,52,-2144,-2269,27.2,1661.7,34,0,1,8,5,7,2,1,1,0,18761,7.4,19507,249,68,2144,2269,31.7,1876.1
4819211454,1,14,4,1,5,3,4,0,0,0,0,16448,6.8,17165,204,61,296,-255,26.5,1644.8,13,2,0,3,5,2,0,0,0,0,16152,6.8,17420,234,54,-296,255,28.8,1615.2
4819195760,1,12,3,1,10,3,12,0,0,0,0,18949,7.0,18142,244,48,3806,1699,29.2,1894.9,17,0,0,3,10,3,0,0,0,0,15143,6.6,16443,195,56,-3806,-1699,25.1,1514.3
4819123297,1,11,0,1,8,4,8,0,0,0,0,17206,6.8,17471,226,59,746,267,28.5,1720.6,9,1,0,4,8,3,0,0,0,0,16460,6.8,17204,230,48,-746,-267,27.8,1646.0
4819099250,0,15,3,1,7,5,4,0,0,0,0,17793,6.6,17280,237,45,2434,1851,28.2,1779.3,29,1,0,5,7,7,0,0,0,0,15359,6.4,15429,211,42,-2434,-1851,25.3,1535.9
4819050166,1,12,1,1,10,9,11,0,0,0,0,20863,7.4,19713,254,60,3574,2716,31.4,2086.3,10,2,0,9,10,9,0,0,0,0,17289,6.6,16997,199,44,-3574,-2716,24.3,1728.9
4818603278,0,14,1,0,1,6,0,1,0,1,0,15216,7.4,19437,233,82,-3301,-243,31.5,1521.6,13,2,1,6,1,9,1,1,0,0,18517,7.4,19680,272,53,3301,243,32.5,1851.7
4818265725,0,14,2,0,3,6,4,0,0,0,0,15945,7.0,18267,234,64,-471,-463,29.8,1594.5,13,1,1,6,3,1,2,1,1,0,16416,7.2,18730,219,44,471,463,26.3,1641.6
4818234683,0,13,1,1,3,6,4,0,0,0,0,17365,6.8,17952,223,48,585,113,27.1,1736.5,18,1,0,6,3,11,2,1,1,0,16780,6.6,17839,232,76,-585,-113,30.8,1678.0
4818209339,0,14,0,0,5,5,9,0,0,0,0,16285,6.8,17072,216,44,-232,-710,26.0,1628.5,15,1,1,5,5,6,0,0,0,0,16517,7.0,17782,208,72,232,710,28.0,1651.7
4818172077,0,30,15,0,5,10,3,0,0,0,0,15426,6.2,15887,194,52,-3808,-2038,24.6,1542.6,62,2,1,10,5,12,0,0,0,0,19234,7.0,17925,218,57,3808,2038,27.5,1923.4
4818115659,1,14,2,1,2,1,0,1,1,0,0,15411,6.8,18061,246,52,123,466,29.8,1541.1,10,1,0,1,2,1,1,0,1,0,15288,6.8,17595,222,60,-123,-466,28.2,1528.8
4818079514,0,51,1,0,4,2,5,0,0,0,0,16176,6.8,17672,206,48,984,19,25.4,1617.6,15,1,1,2,4,3,1,1,0,0,15192,6.8,17653,220,56,-984,-19,27.6,1519.2
4817657612,0,12,2,1,5,5,6,0,0,0,0,16805,7.2,18373,243,64,556,-925,30.7,1680.5,15,1,0,5,5,5,0,0,0,0,16249,7.6,19298,224,52,-556,925,27.6,1624.9
4858289151,1,195,0,0,18,21,17,0,0,0,0,61650,12.0,55000,0,0,23750,22000,0.0,6165.0,0,0,1,13,10,12,0,0,0,0,37900,7.2,33000,0,0,-23750,-22000,0.0,3790.0
4858262302,1,0,0,1,19,19,22,0,0,0,0,62700,12.8,59000,0,0,24800,26000,0.0,6270.0,0,0,0,12,12,13,0,0,0,0,37900,7.2,33000,0,0,-24800,-26000,0.0,3790.0
4858236316,0,11,2,1,8,3,10,0,0,0,0,17084,6.8,17511,196,68,1240,-68,26.4,1708.4,10,0,0,3,8,1,0,0,0,0,15844,7.0,17579,210,56,-1240,68,26.6,1584.4
4858198153,0,158,3,0,22,23,53,0,0,0,1,36276,11.2,41429,93,0,-1177,1486,9.3,3627.6,15,0,1,23,22,51,0,0,0,0,37453,11.0,39943,102,0,1177,-1486,10.2,3745.3
4858169613,1,162,0,1,15,16,10,0,0,0,0,46670,10.0,47500,0,0,15992,19000,0.0,4667.0,6,0,0,10,9,13,0,0,0,0,30678,6.0,28500,0,0,-15992,-19000,0.0,3067.8
4856258505,1,0,0,0,16,23,35,0,0,0,1,36844,11.0,39928,111,0,-702,-1968,11.1,3684.4,0,0,1,23,16,66,0,0,0,0,37546,11.4,41896,105,0,702,1968,10.5,3754.6
4856222194,1,0,0,1,16,14,50,0,0,0,1,37127,11.0,39947,120,0,3982,5304,12.0,3712.7,0,0,0,14,16,35,0,0,0,0,33145,10.2,34643,104,0,-3982,-5304,10.4,3314.5
4856184660,1,0,0,0,22,16,66,0,0,0,0,37310,11.2,40343,108,0,3870,4478,10.8,3731.0,14,0,1,15,21,41,0,0,0,0,33440,10.6,35865,114,0,-3870,-4478,11.4,3344.0
4856147815,1,16,0,1,16,16,51,0,0,0,0,34067,10.0,34781,120,0,163,-513,12.0,3406.7,0,0,0,16,16,35,0,0,0,0,33904,10.4,35294,108,0,-163,513,10.8,3390.4
4855926197,1,16,1,0,3,4,2,0,0,0,0,13360,6.8,16900,142,59,-1414,-356,20.1,1336.0,16,1,1,4,3,3,0,0,0,0,14774,6.8,17256,181,44,1414,356,22.5,1477.4
4855214025,0,0,0,1,24,22,64,0,0,0,0,37011,11.4,41489,102,0,-1502,663,10.2,3701.1,0,0,0,22,24,39,0,0,0,0,38513,11.0,40826,100,0,1502,-663,10.0,3851.3
4855188183,0,0,4,0,26,31,66,0,0,0,0,37275,11.4,41704,91,0,-2882,-1103,9.1,3727.5,22,0,1,31,26,70,0,0,0,0,40157,11.2,42807,92,0,2882,1103,9.2,4015.7
4855155202,1,14,0,1,14,9,40,0,0,0,2,34945,10.4,35953,116,0,2708,3134,11.6,3494.5,17,0,0,9,14,18,0,0,0,0,32237,10.0,32819,94,0,-2708,-3134,9.4,3223.7
4855121681,1,15,0,0,25,23,76,0,0,0,0,36922,11.6,42905,95,0,685,2074,9.5,3692.2,0,0,1,23,25,61,0,0,0,0,36237,11.0,40831,75,0,-685,-2074,7.5,3623.7
4855097284,1,0,0,1,29,23,84,0,0,0,1,39251,11.2,41404,124,0,1630,1525,12.4,3925.1,13,0,0,23,29,53,0,0,0,0,37621,11.0,39879,99,0,-1630,-1525,9.9,3762.1
4854964411,1,34,3,1,6,5,7,0,0,0,0,17627,7.0,17790,221,48,2047,279,26.9,1762.7,34,2,0,5,6,2,0,0,0,0,15580,6.8,17511,204,52,-2047,-279,25.6,1558.0
4854934311,1,9,1,0,5,4,4,0,0,0,0,17065,7.2,18661,247,60,-599,356,30.7,1706.5,34,1,1,4,5,3,0,0,0,0,17664,7.0,18305,217,60,599,-356,27.7,1766.4
4854877615,0,11,7,0,0,4,0,0,0,0,0,13300,6.4,16685,188,40,-3205,-1548,22.8,1330.0,21,1,1,4,0,6,0,0,0,0,16505,7.0,18233,226,72,3205,1548,29.8,1650.5
4853900932,0,20,1,1,4,2,4,0,0,0,0,15392,6.6,16898,156,50,1126,147,20.6,1539.2,13,1,0,2,4,1,1,1,0,0,14266,6.6,16751,169,56,-1126,-147,22.5,1426.6
4853847968,0,12,0,0,6,2,5,1,1,0,0,15864,6.6,17428,189,56,1500,50,24.5,1586.4,10,0,1,2,6,1,1,0,1,0,14364,6.6,17378,175,52,-1500,-50,22.7,1436.4
4836118781,1,17,2,1,3,1,5,1,1,0,0,15614,6.8,17449,203,60,551,-750,26.3,1561.4,13,0,0,1,3,0,1,0,1,0,15063,6.8,18199,223,43,-551,750,26.6,1506.3
4836083215,1,13,2,0,10,4,6,0,0,0,0,18044,6.8,17892,246,45,2155,1634,29.1,1804.4,13,1,1,4,10,5,0,0,0,0,15889,6.6,16258,236,42,-2155,-1634,27.8,1588.9
4834320631,0,13,2,1,4,5,9,0,0,0,0,15950,6.6,16801,204,60,-2175,-595,26.4,1595.0,12,1,0,5,4,6,1,1,0,0,18125,6.6,17396,232,56,2175,595,28.8,1812.5
4834295583,0,14,4,0,6,10,6,0,0,0,0,17125,6.6,16261,211,64,-2500,-1419,27.5,1712.5,22,4,1,10,6,11,1,1,0,0,19625,7.0,17680,223,47,2500,1419,27.0,1962.5
4834273570,0,19,19,1,6,6,2,0,0,0,0,16130,7.0,17266,192,77,-62,-969,26.9,1613.0,42,3,0,6,6,9,2,1,1,0,16192,7.2,18235,205,58,62,969,26.3,1619.2
4834227111,1,12,2,0,5,7,4,0,0,0,0,16055,6.8,17745,231,55,-734,166,28.6,1605.5,16,3,1,7,5,4,0,0,0,0,16789,6.8,17579,196,52,734,-166,24.8,1678.9
4834177753,0,12,0,1,2,2,2,1,1,0,0,14603,6.8,17322,214,58,-669,-962,27.2,1460.3,14,2,0,2,2,2,1,0,1,0,15272,7.2,18284,213,66,669,962,27.9,1527.2
4834129390,0,18,0,1,7,7,7,0,0,0,0,16623,6.8,17614,220,48,-728,-454,26.8,1662.3,13,2,0,7,7,9,0,0,0,0,17351,7.0,18068,222,64,728,454,28.6,1735.1
4833327062,1,17,1,1,3,4,6,0,0,0,0,15452,6.8,17308,243,54,-762,-695,29.7,1545.2,20,0,0,4,3,4,1,1,0,0,16214,6.8,18003,225,61,762,695,28.6,1621.4
4829393885,0,8,3,1,3,9,2,0,0,0,0,15301,7.0,17692,230,56,-3693,-1922,28.6,1530.1,15,1,0,9,3,7,2,1,1,0,18994,7.4,19614,232,61,3693,1922,29.3,1899.4
4829363674,0,9,2,0,2,9,3,1,1,0,0,14639,6.6,17070,205,52,-4278,-2148,25.7,1463.9,14,1,1,9,2,11,0,0,0,0,18917,7.4,19218,235,60,4278,2148,29.5,1891.7
4829347708,1,16,1,1,10,2,10,0,0,0,0,19619,7.2,19320,236,48,5386,3311,28.4,1961.9,10,0,0,2,10,2,1,0,1,0,14233,6.4,16009,200,48,-5386,-3311,24.8,1423.3
4829335143,1,15,3,1,6,2,5,0,0,0,0,16879,7.0,18409,238,52,3405,1789,29.0,1687.9,13,1,0,2,6,0,0,0,0,0,13474,6.6,16620,203,60,-3405,-1789,26.3,1347.4
4829319141,0,13,2,0,5,8,3,0,0,0,0,14810,6.4,15899,164,64,-2992,-2573,22.8,1481.0,17,1,1,8,5,4,1,1,0,0,17802,7.0,18472,232,60,2992,2573,29.2,1780.2
4825969127,0,14,0,1,8,5,9,1,1,0,0,18446,7.2,18807,233,52,553,-399,28.5,1844.6,13,2,0,5,8,7,0,0,0,0,17893,7.2,19206,211,60,-553,399,27.1,1789.3
4767409833,0,13,3,0,3,3,2,0,0,0,0,14673,6.6,16633,188,56,-3534,-2558,24.4,1467.3,17,1,1,3,3,3,2,1,1,0,18207,7.2,19191,245,80,3534,2558,32.5,1820.7
4767388065,1,16,1,1,8,7,11,0,0,0,0,18025,6.8,16632,184,44,1613,234,22.8,1802.5,13,2,0,7,8,6,0,0,0,0,16412,6.4,16398,208,48,-1613,-234,25.6,1641.2
4767358640,1,15,2,0,7,12,8,0,0,0,0,17217,6.8,17445,181,72,-1743,-224,25.3,1721.7,13,1,1,12,7,12,0,0,0,0,18960,6.6,17669,238,51,1743,224,28.9,1896.0
4767345825,0,14,0,0,4,1,5,0,0,0,0,15776,7.0,18528,205,60,-940,-716,26.5,1577.6,75,1,1,1,4,1,1,1,0,0,16716,7.4,19244,249,64,940,716,31.3,1671.6
4852146758,0,0,0,1,33,39,96,0,0,0,2,42036,12.0,45303,110,0,-347,-1602,11.0,4203.6,3,0,0,39,33,95,0,0,0,0,42383,11.8,46905,122,0,347,1602,12.2,4238.3
4816722795,1,11,1,1,13,4,19,1,1,0,0,20083,7.0,18913,240,55,4486,1913,29.5,2008.3,15,1,0,4,13,3,0,0,0,0,15597,6.8,17000,209,59,-4486,-1913,26.8,1559.7
4816710786,0,15,1,0,4,8,4,0,0,0,0,16009,6.6,17199,219,52,-987,-940,27.1,1600.9,12,1,1,8,4,7,0,0,0,0,16996,6.8,18139,215,56,987,940,27.1,1699.6
4815588370,0,31,2,0,4,14,1,0,0,0,0,15402,6.8,17486,208,52,-4787,-618,26.0,1540.2,9,6,1,14,4,17,0,0,0,0,20189,7.0,18104,217,63,4787,618,28.0,2018.9
4814750840,1,17,2,0,2,7,1,0,0,0,0,14925,6.8,18103,211,68,-3281,-636,27.9,1492.5,10,2,1,7,2,6,0,0,0,0,18206,7.0,18739,236,51,3281,636,28.7,1820.6
4814725209,1,13,2,1,6,6,4,0,0,0,0,16895,7.0,17517,234,57,819,-668,29.1,1689.5,23,0,0,6,6,6,0,0,0,0,16076,7.0,18185,215,38,-819,668,25.3,1607.6
4814721764,1,12,1,1,6,8,1,1,1,0,0,18184,7.2,18368,218,68,677,1917,28.6,1818.4,14,0,0,7,5,11,0,0,0,0,17507,6.8,16451,180,48,-677,-1917,22.8,1750.7
4814705114,0,16,1,1,4,5,11,1,1,0,0,15157,6.4,15218,204,48,-2691,-3222,25.2,1515.7,13,3,0,5,4,9,0,0,0,0,17848,7.2,18440,213,56,2691,3222,26.9,1784.8
4814675746,0,9,3,0,4,7,5,1,1,0,0,15589,7.0,18042,223,56,-3125,-1345,27.9,1558.9,12,1,1,7,4,8,0,0,0,0,18714,7.2,19387,250,64,3125,1345,31.4,1871.4
4812656632,1,10,0,0,1,10,0,0,0,0,0,13939,6.8,17150,176,68,-6745,-2171,24.4,1393.9,12,2,1,10,1,11,0,0,0,0,20684,7.4,19321,249,55,6745,2171,30.4,2068.4
4812641886,1,16,1,1,7,6,8,0,0,0,0,18340,6.8,18172,241,61,1530,655,30.2,1834.0,57,0,0,6,7,9,1,1,0,0,16810,6.6,17517,190,56,-1530,-655,24.6,1681.0
4805604523,0,76,1,1,7,6,10,0,0,0,0,17140,6.8,16574,195,59,-130,554,25.4,1714.0,14,1,0,6,7,7,1,0,1,0,17270,6.4,16020,208,40,130,-554,24.8,1727.0
4805587962,1,14,0,1,9,4,15,2,1,1,0,19337,7.2,19607,239,68,2947,2574,30.7,1933.7,10,1,0,4,9,2,0,0,0,0,16390,6.8,17033,233,60,-2947,-2574,29.3,1639.0
4803256776,0,14,2,0,6,12,9,0,0,0,0,16494,6.4,16052,199,60,-2405,-1068,25.9,1649.4,9,2,1,12,6,19,1,0,1,0,18899,6.8,17120,193,56,2405,1068,24.9,1889.9
4803230283,0,15,2,1,9,6,9,0,0,0,0,17311,6.8,17743,191,52,-593,197,24.3,1731.1,15,1,0,6,9,8,0,0,0,0,17904,6.8,17546,215,48,593,-197,26.3,1790.4
4802587066,0,11,2,0,6,7,7,1,1,0,0,18183,7.0,18883,238,56,21,-210,29.4,1818.3,12,1,1,7,6,6,1,0,1,0,18162,7.2,19093,201,68,-21,210,26.9,1816.2
4802555474,1,12,2,1,8,2,5,0,0,0,0,18832,7.0,19250,293,57,4398,2326,35.0,1883.2,13,3,0,2,8,2,0,0,0,0,14434,6.8,16924,221,54,-4398,-2326,27.5,1443.4
4801710386,1,16,2,1,3,2,2,0,0,0,0,16543,7.2,18970,217,68,997,391,28.5,1654.3,11,0,0,2,3,3,0,0,0,0,15546,7.0,18579,238,64,-997,-391,30.2,1554.6
4855547995,0,0,0,1,22,18,60,0,0,0,0,36141,11.0,39592,105,0,480,1295,10.5,3614.1,0,0,0,18,22,43,0,0,0,0,35661,10.8,38297,111,0,-480,-1295,11.1,3566.1
4855540023,0,34,0,0,27,28,57,0,0,0,1,39392,11.4,43652,119,0,1816,690,11.9,3939.2,34,0,1,28,27,71,0,0,0,0,37576,11.6,42962,93,0,-1816,-690,9.3,3757.6
4855531206,1,0,0,1,38,23,101,0,0,0,0,41423,12.4,47076,88,0,4676,5665,8.8,4142.3,0,0,0,23,38,61,0,0,0,0,36747,11.4,41411,110,0,-4676,-5665,11.0,3674.7
4855522175,0,0,4,0,16,19,40,0,0,0,0,34782,10.8,36649,111,0,-1551,-991,11.1,3478.2,15,0,1,19,16,46,0,0,0,0,36333,10.8,37640,126,0,1551,991,12.6,3633.3
4855499533,0,13,1,1,6,9,2,0,0,0,0,15640,6.6,17488,217,56,-1423,-1035,27.3,1564.0,85,1,0,8,5,6,0,0,0,0,17063,7.2,18523,187,62,1423,1035,24.9,1706.3
4855486900,1,10,4,1,6,3,5,1,1,0,0,17826,7.0,18691,221,67,1788,1341,28.8,1782.6,33,2,0,3,6,1,0,0,0,0,16038,6.8,17350,199,60,-1788,-1341,25.9,1603.8
4855450654,0,67,3,1,5,9,7,0,0,0,0,16643,6.8,16910,201,48,-787,-1866,24.9,1664.3,13,0,0,9,5,4,0,0,0,0,17430,7.0,18776,231,52,787,1866,28.3,1743.0
4854317494,1,0,0,1,24,25,48,0,0,0,2,38753,11.4,42505,99,0,881,1212,9.9,3875.3,0,0,0,25,24,68,0,0,0,0,37872,11.2,41293,103,0,-881,-1212,10.3,3787.2
4853035684,1,20,1,1,5,2,4,1,1,0,0,16823,7.0,18321,193,60,1793,1946,25.3,1682.3,11,0,0,2,5,3,0,0,0,0,15030,6.6,16375,183,47,-1793,-1946,23.0,1503.0
4852592586,1,11,2,0,11,6,9,0,0,0,0,17898,7.2,18274,184,56,1708,1106,24.0,1789.8,13,1,1,6,11,4,0,0,0,0,16190,6.8,17168,214,58,-1708,-1106,27.2,1619.0
4852552630,1,13,2,0,4,6,3,0,0,0,0,15294,6.6,16588,207,44,-1782,-1097,25.1,1529.4,11,1,1,6,4,4,0,0,0,0,17076,6.8,17685,201,56,1782,1097,25.7,1707.6
4852502041,0,15,0,0,2,6,1,0,0,0,0,14596,7.0,18187,213,47,-2423,-1106,26.0,1459.6,11,2,1,6,2,5,0,0,0,0,17019,7.2,19293,226,60,2423,1106,28.6,1701.9
4852421347,0,14,1,0,6,9,4,0,0,0,0,17049,6.8,18058,207,60,-3251,-1289,26.7,1704.9,10,0,1,9,6,12,1,1,0,0,20300,7.2,19347,230,60,3251,1289,29.0,2030.0
4852402257,1,9,1,1,4,6,4,0,0,0,0,17598,7.0,18683,233,60,1875,644,29.3,1759.8,11,1,0,6,4,4,1,1,0,0,15723,6.8,18039,183,60,-1875,-644,24.3,1572.3
4852160176,1,56,1,1,6,5,8,1,1,0,0,16655,6.8,17321,206,52,888,-922,25.8,1665.5,10,0,0,5,6,5,1,0,1,0,15767,7.0,18243,193,63,-888,922,25.6,1576.7
4852139106,0,10,2,0,7,6,7,0,0,0,0,16958,7.2,18586,222,60,-173,599,28.2,1695.8,12,2,1,6,7,8,0,0,0,0,17131,6.8,17987,223,64,173,-599,28.7,1713.1
4852125011,0,7,1,0,4,9,5,0,0,0,0,17316,6.8,18742,233,64,-2413,-1299,29.7,1731.6,13,1,1,9,4,9,1,1,0,0,19729,7.4,20041,200,80,2413,1299,28.0,1972.9
4851709763,0,16,0,0,4,6,6,0,0,0,0,16197,7.0,18410,246,60,-1856,-505,30.6,1619.7,28,1,1,6,4,9,2,1,1,0,18053,6.8,18915,230,60,1856,505,29.0,1805.3
4851655309,0,8,2,1,2,8,2,1,0,1,0,14777,6.6,16944,215,52,-3123,-2759,26.7,1477.7,15,1,0,8,2,5,1,1,0,0,17900,7.2,19703,264,60,3123,2759,32.4,1790.0
4851594906,0,11,5,0,6,10,6,0,0,0,0,16973,6.6,16385,191,43,-2437,-3266,23.4,1697.3,23,1,1,10,6,8,1,1,0,0,19410,7.0,19651,211,55,2437,3266,26.6,1941.0
4857515896,1,4,0,0,7,5,2,1,1,0,0,15059,6.4,14714,78,60,1677,-221,13.8,1505.9,0,0,1,5,7,5,0,0,0,0,13382,6.2,14935,148,0,-1677,221,14.8,1338.2
4857498751,1,0,0,0,19,19,24,0,0,0,0,63050,13.0,62500,0,0,24800,25000,0.0,6305.0,0,0,1,13,13,8,0,0,0,0,38250,7.8,37500,0,0,-24800,-25000,0.0,3825.0
4857442567,0,15,2,1,7,7,7,0,0,0,0,18184,7.2,19450,231,68,1029,216,29.9,1818.4,10,0,0,7,7,9,1,0,1,0,17155,7.2,19234,221,60,-1029,-216,28.1,1715.5
4857398704,1,12,0,0,7,7,7,0,0,0,0,17438,7.0,17827,226,60,74,1085,28.6,1743.8,19,0,1,7,7,11,1,1,0,0,17364,6.6,16742,231,52,-74,-1085,28.3,1736.4
4856832075,1,11,0,0,6,7,3,0,0,0,0,16787,6.8,18147,191,60,-602,252,25.1,1678.7,9,1,1,7,6,12,1,1,0,0,17389,7.0,17895,210,52,602,-252,26.2,1738.9
4856813925,0,9,1,0,4,10,4,0,0,0,0,15568,6.6,17214,224,52,-2479,-1333,27.6,1556.8,18,2,1,10,4,9,1,1,0,0,18047,7.0,18547,204,51,2479,1333,25.5,1804.7
4856602746,0,13,1,0,10,8,11,1,0,1,0,18158,7.0,18565,234,63,425,142,29.7,1815.8,13,1,1,8,10,8,1,1,0,0,17733,7.2,18423,222,57,-425,-142,27.9,1773.3
4856577585,0,19,0,0,2,5,3,0,0,0,0,14434,6.2,15406,197,47,-2336,-3104,24.4,1443.4,13,0,1,5,2,6,0,0,0,0,16770,7.0,18510,237,60,2336,3104,29.7,1677.0
4856525877,1,32,2,1,21,14,22,0,0,0,0,47485,10.0,47500,5,0,20023,19000,0.5,4748.5,50,1,0,7,14,10,0,0,0,0,27462,6.0,28500,0,0,-20023,-19000,0.0,2746.2
4856505835,1,16,0,0,12,16,14,0,0,0,0,46030,10.0,47500,0,0,17864,19000,0.0,4603.0,0,0,1,11,7,8,0,0,0,0,28166,6.0,28500,1,0,-17864,-19000,0.1,2816.6
4854674377,0,18,0,1,4,7,3,0,0,0,0,15409,6.8,16783,197,51,-2627,-2216,24.8,1540.9,15,2,0,7,4,9,1,1,0,0,18036,7.0,18999,260,60,2627,2216,32.0,1803.6
4854649199,1,15,0,0,2,11,4,0,0,0,0,14815,6.8,16776,237,52,-4093,-1747,28.9,1481.5,13,6,1,11,2,15,1,1,0,0,18908,6.8,18523,264,47,4093,1747,31.1,1890.8
4854617698,0,12,0,1,4,8,4,0,0,0,0,15921,7.0,18205,244,47,-1916,-1029,29.1,1592.1,5,0,0,7,3,8,0,0,0,0,17837,7.2,19234,231,68,1916,1029,29.9,1783.7
4854156481,1,0,0,0,15,15,16,0,0,0,0,46650,10.0,47500,0,0,19500,19000,0.0,4665.0,4,0,1,9,9,9,0,0,0,0,27150,6.0,28500,0,0,-19500,-19000,0.0,2715.0
4854136144,1,14,0,1,20,22,15,0,0,0,0,61370,12.0,55000,0,0,22548,18000,0.0,6137.0,4,0,0,12,10,12,0,0,0,0,38822,8.0,37000,0,0,-22548,-18000,0.0,3882.2
4854104967,1,19,0,0,19,18,17,0,0,0,0,50133,10.0,47500,0,0,23333,19000,0.0,5013.3,0,0,1,8,9,7,0,0,0,0,26800,6.0,28500,0,0,-23333,-19000,0.0,2680.0
4854078766,1,15,0,1,18,16,14,0,0,0,0,47350,10.0,47500,0,0,19686,19000,0.0,4735.0,41,0,0,7,9,12,0,0,0,0,27664,6.0,28500,0,0,-19686,-19000,0.0,2766.4
4854049472,1,0,0,1,24,17,29,0,0,0,0,64800,12.4,57000,0,0,29000,24000,0.0,6480.0,0,0,0,8,15,6,0,0,0,0,35800,7.2,33000,0,0,-29000,-24000,0.0,3580.0
4853934922,1,5,0,0,17,19,19,0,0,0,0,60950,12.0,55000,0,0,23400,22000,0.0,6095.0,0,0,1,10,8,12,0,0,0,0,37550,7.2,33000,0,0,-23400,-22000,0.0,3755.0
4853908322,1,342,4,1,25,12,24,0,0,0,0,66962,12.0,55000,0,0,41014,22000,0.0,6696.2,30,1,0,5,18,6,0,0,0,0,25948,7.2,33000,5,0,-41014,-22000,0.5,2594.8
4857955424,0,11,0,0,2,6,0,1,0,1,0,14892,7.2,18674,223,64,-2639,-251,28.7,1489.2,23,1,1,6,2,9,1,1,0,0,17531,7.0,18925,221,68,2639,251,28.9,1753.1
4857932078,0,11,2,1,4,10,4,0,0,0,0,16287,6.6,17312,235,46,-2256,-1581,28.1,1628.7,14,1,0,10,4,9,1,1,0,0,18543,7.4,18893,222,68,2256,1581,29.0,1854.3
4857904403,1,13,4,0,6,4,4,0,0,0,0,17487,7.2,18502,233,50,465,385,28.3,1748.7,33,2,1,4,6,3,1,1,0,0,17022,7.0,18117,218,45,-465,-385,26.3,1702.2
4857653517,0,14,2,0,3,6,4,1,1,0,0,15674,7.0,17794,224,51,-1077,-135,27.5,1567.4,12,5,1,6,3,5,0,0,0,0,16751,7.0,17929,226,52,1077,135,27.8,1675.1
4857629263,0,14,1,1,8,8,7,1,0,1,0,16610,6.2,14948,167,48,-2189,-2675,21.5,1661.0,24,1,0,8,8,8,0,0,0,0,18799,7.0,17623,208,44,2189,2675,25.2,1879.9
4857604268,1,9,4,1,3,2,4,0,0,0,0,15672,6.8,18129,248,59,122,-558,30.7,1567.2,16,1,0,2,3,1,1,1,0,0,15550,7.0,18687,222,76,-122,558,29.8,1555.0
4857578372,0,31,3,1,4,4,5,1,1,0,0,15638,7.0,18479,235,52,-816,-829,28.7,1563.8,29,3,0,4,4,2,0,0,0,0,16454,7.2,19308,242,64,816,829,30.6,1645.4
4857546460,0,11,2,0,3,13,2,1,0,1,0,16291,7.0,18244,244,68,-3112,-813,31.2,1629.1,14,2,1,13,3,14,1,1,0,0,19403,7.2,19057,230,52,3112,813,28.2,1940.3
4857511911,0,12,1,0,3,3,2,0,0,0,0,15282,7.2,18941,234,60,-1058,853,29.4,1528.2,13,0,1,3,3,3,1,1,0,0,16340,6.8,18088,232,55,1058,-853,28.7,1634.0
4855496598,1,0,0,1,34,28,91,0,0,0,1,40957,12.2,46633,90,0,2562,4696,9.0,4095.7,15,0,0,28,34,69,0,0,0,0,38395,11.4,41937,104,0,-2562,-4696,10.4,3839.5
4854261570,1,2,0,1,39,12,103,0,0,0,1,40688,11.8,45280,103,0,5233,6761,10.3,4068.8,1,0,0,12,39,20,0,0,0,0,35455,11.0,38519,91,0,-5233,-6761,9.1,3545.5
4854243615,1,13,0,1,15,14,42,0,0,0,2,36326,10.8,37607,111,0,3028,1717,11.1,3632.6,14,4,0,14,15,29,0,0,0,0,33298,10.4,35890,75,0,-3028,-1717,7.5,3329.8
4854226548,0,0,0,0,18,24,43,0,0,0,2,35624,10.6,37365,91,0,-2650,-5247,9.1,3562.4,0,0,1,24,18,56,0,0,0,0,38274,11.6,42612,112,0,2650,5247,11.2,3827.4
4854178729,0,15,3,1,8,7,6,1,1,0,0,15791,6.6,16705,169,52,-1336,-1663,22.1,1579.1,14,3,0,7,8,7,0,0,0,0,17127,7.0,18368,204,52,1336,1663,25.6,1712.7
4854136025,1,36,2,0,2,5,0,0,0,0,0,14145,6.8,16947,170,56,-2143,-1289,22.6,1414.5,11,13,1,5,2,4,0,0,0,0,16288,7.0,18236,173,52,2143,1289,22.5,1628.8
4854075413,0,13,0,0,6,12,6,0,0,0,0,16954,6.8,18093,230,65,-2796,147,29.5,1695.4,21,1,1,12,6,17,1,0,1,0,19750,6.8,17946,211,49,2796,-147,26.0,1975.0
4850198082,1,34,2,1,4,3,6,1,1,0,0,15994,7.2,17321,223,56,85,-883,27.9,1599.4,35,2,0,3,4,1,0,0,0,0,15909,7.0,18204,213,67,-85,883,28.0,1590.9
4850183376,1,13,5,0,9,3,6,0,0,0,0,19276,7.2,19539,247,60,4389,3090,30.7,1927.6,20,1,1,3,9,3,0,0,0,0,14887,6.6,16449,180,44,-4389,-3090,22.4,1488.7
4850163009,0,13,3,1,8,6,6,1,1,0,0,17279,7.0,17657,220,55,-111,-48,27.5,1727.9,20,0,0,6,8,7,0,0,0,0,17390,6.8,17705,216,53,111,48,26.9,1739.0
4849231442,0,12,3,1,14,7,18,0,0,0,0,21397,7.0,18302,239,44,2865,1697,28.3,2139.7,21,3,0,7,14,7,0,0,0,0,18532,6.8,16605,192,51,-2865,-1697,24.3,1853.2
4844304539,1,16,10,0,9,3,8,0,0,0,0,17834,7.2,18768,240,56,3078,3423,29.6,1783.4,41,2,1,3,9,4,0,0,0,0,14756,6.6,15345,205,36,-3078,-3423,24.1,1475.6
4844258541,0,21,1,1,4,3,2,1,1,0,0,16288,6.8,19053,222,68,376,771,29.0,1628.8,13,4,0,3,4,3,0,0,0,0,15912,7.0,18282,234,60,-376,-771,29.4,1591.2
4844214923,0,12,0,0,4,4,3,0,0,0,0,14807,6.8,16785,183,55,-1185,-1306,23.8,1480.7,12,2,1,4,4,0,0,0,0,0,15992,7.2,18091,232,56,1185,1306,28.8,1599.2
4802895905,0,14,1,0,7,8,5,0,0,0,0,18168,7.0,18541,243,66,301,422,30.9,1816.8,24,0,1,8,7,9,1,1,0,0,17867,6.8,18119,219,53,-301,-422,27.2,1786.7
4802849258,0,21,1,1,7,7,10,0,0,0,0,17783,6.8,17688,222,57,716,836,27.9,1778.3,14,1,0,7,7,14,1,1,0,0,17067,6.8,16852,226,46,-716,-836,27.2,1706.7
4802045106,0,26,0,0,3,7,2,0,0,0,0,15748,7.0,18070,242,52,-2282,-1725,29.4,1574.8,14,4,1,7,3,5,1,1,0,0,18030,7.4,19795,258,68,2282,1725,32.6,1803.0
4798904571,0,12,1,1,9,8,9,0,0,0,0,17529,6.8,16763,226,48,112,-1379,27.4,1752.9,13,1,0,8,9,2,0,0,0,0,17417,7.2,18142,211,60,-112,1379,27.1,1741.7
4798866405,0,17,0,1,5,1,4,1,0,1,0,16138,7.0,17471,199,47,738,-287,24.6,1613.8,16,0,0,1,5,1,0,0,0,0,15400,7.0,17758,201,52,-738,287,25.3,1540.0
4798812448,0,56,2,0,0,0,0,0,0,0,0,14857,7.2,18860,258,60,427,362,31.8,1485.7,16,0,0,0,0,0,0,0,0,0,14430,6.8,18498,248,59,-427,-362,30.7,1443.0
4798763519,1,12,2,0,6,11,8,0,0,0,0,17710,6.8,17354,239,44,-592,406,28.3,1771.0,18,1,1,11,6,17,0,0,0,0,18302,6.8,16948,183,56,592,-406,23.9,1830.2
4798722181,1,15,0,1,1,4,1,2,1,1,0,14378,6.8,17303,207,68,-1577,-2132,27.5,1437.8,10,1,0,4,1,0,0,0,0,0,15955,7.4,19435,234,71,1577,2132,30.5,1595.5
4798678119,0,12,0,1,5,2,5,0,0,0,0,16831,7.2,19035,217,64,1449,1115,28.1,1683.1,19,2,0,2,5,3,0,0,0,0,15382,6.8,17920,207,60,-1449,-1115,26.7,1538.2
4798646737,1,15,2,1,5,3,7,0,0,0,0,17289,7.2,19455,239,68,1397,304,30.7,1728.9,12,0,0,3,5,4,0,0,0,0,15892,7.2,19151,227,63,-1397,-304,29.0,1589.2
4798418588,1,22,2,1,4,1,4,0,0,0,0,16957,7.0,19027,227,64,2654,1543,29.1,1695.7,9,0,0,1,4,2,0,0,0,0,14303,7.0,17484,216,60,-2654,-1543,27.6,1430.3
4798205005,0,12,0,1,4,7,3,0,0,0,0,15097,6.2,14761,193,40,-3214,-2575,23.3,1509.7,14,4,0,7,4,10,1,0,1,0,18311,6.6,17336,236,56,3214,2575,29.2,1831.1
4798199255,0,17,1,0,5,9,5,0,0,0,0,15784,6.6,16415,177,52,-3975,-3291,22.9,1578.4,13,1,1,9,5,8,0,0,0,0,19759,7.0,19706,237,75,3975,3291,31.2,1975.9
4798185280,1,12,2,0,8,5,7,0,0,0,0,17849,7.0,17017,195,60,1227,-1122,25.5,1784.9,13,1,1,5,8,2,0,0,0,0,16622,7.0,18139,238,68,-1227,1122,30.6,1662.2
4798161562,0,22,0,0,3,4,3,1,1,0,0,15181,6.6,17627,210,48,-2869,-950,25.8,1518.1,10,1,1,4,3,8,0,0,0,0,18050,7.0,18577,260,48,2869,950,30.8,1805.0
4798142732,1,12,3,1,5,4,3,0,0,0,0,16871,6.8,17881,223,60,1174,982,28.3,1687.1,12,2,0,4,5,4,1,1,0,0,15697,6.8,16899,219,40,-1174,-982,25.9,1569.7
4856575155,1,0,0,1,15,15,21,0,0,0,0,47000,10.0,47500,3,0,17400,19000,0.3,4700.0,0,0,0,12,12,7,0,0,0,0,29600,6.0,28500,2,0,-17400,-19000,0.2,2960.0
4856561978,1,0,0,1,21,18,17,0,0,0,0,63780,12.0,55000,0,0,26215,22000,0.0,6378.0,4,0,0,7,10,11,0,0,0,0,37565,7.2,33000,0,0,-26215,-22000,0.0,3756.5
4856550903,1,5,0,0,11,20,15,0,0,0,0,60600,13.0,62500,0,0,21300,25000,0.0,6060.0,0,0,1,16,7,14,0,0,0,0,39300,7.8,37500,0,0,-21300,-25000,0.0,3930.0
4853201293,0,38,0,0,2,5,2,0,0,0,0,15663,7.0,18441,242,64,-1782,464,30.6,1566.3,16,13,1,5,2,9,0,0,0,0,17445,7.0,17977,243,56,1782,-464,29.9,1744.5
4843580671,1,0,0,0,34,25,86,0,0,0,1,40290,11.6,43596,103,0,1471,1571,10.3,4029.0,0,0,1,25,34,60,0,0,0,0,38819,11.6,42025,94,0,-1471,-1571,9.4,3881.9
4843568813,1,1,0,1,23,27,52,0,0,0,0,37780,11.6,43345,104,0,-1156,-1284,10.4,3778.0,39,0,0,27,23,59,0,0,0,0,38936,11.6,44629,105,0,1156,1284,10.5,3893.6
4843550912,0,0,3,0,29,37,61,0,0,0,1,40505,12.0,46144,97,0,-1826,-2159,9.7,4050.5,17,0,1,37,29,98,0,0,0,0,42331,12.6,48303,116,0,1826,2159,11.6,4233.1
4843534886,0,0,0,0,29,37,79,0,0,0,1,40672,11.6,44717,95,0,-1290,-2602,9.5,4067.2,0,0,1,37,29,107,0,0,0,0,41962,12.2,47319,99,0,1290,2602,9.9,4196.2
4843514544,1,0,15,1,46,24,124,0,0,0,2,44465,12.6,50117,123,0,5715,8578,12.3,4446.5,23,0,0,24,46,57,0,0,0,0,38750,11.2,41539,103,0,-5715,-8578,10.3,3875.0
4843496076,0,68,0,0,21,31,40,0,0,0,1,36300,11.2,40656,97,0,-2646,-3477,9.7,3630.0,18,0,1,31,21,83,0,0,0,0,38946,11.8,44133,108,0,2646,3477,10.8,3894.6
4842689431,1,91,0,1,30,21,83,0,0,0,1,39409,11.6,43665,122,0,960,2403,12.2,3940.9,0,0,0,20,29,35,0,0,0,0,38449,11.4,41262,101,0,-960,-2403,10.1,3844.9
4842684888,0,0,0,1,23,20,44,0,0,0,0,37510,11.0,40746,131,0,832,892,13.1,3751.0,2,0,0,20,23,44,0,0,0,0,36678,10.8,39854,101,0,-832,-892,10.1,3667.8
4842673449,1,30,0,1,32,18,89,0,0,0,0,40755,12.0,46786,99,0,3767,7026,9.9,4075.5,0,0,0,18,32,43,0,0,0,0,36988,11.0,39760,103,0,-3767,-7026,10.3,3698.8
4842662269,0,0,0,1,15,19,28,0,0,0,2,34625,10.0,35211,118,0,-1241,-1852,11.8,3462.5,0,0,0,19,15,32,0,0,0,0,35866,10.6,37063,118,0,1241,1852,11.8,3586.6
4841352579,0,16,1,0,2,7,1,1,1,0,0,15012,7.0,18861,233,76,-2221,-426,30.9,1501.2,12,2,1,7,2,5,0,0,0,0,17233,7.4,19287,248,48,2221,426,29.6,1723.3
4841309495,0,9,1,1,6,6,6,0,0,0,0,17121,7.0,18314,211,67,-567,-448,27.8,1712.1,11,1,0,6,6,5,1,1,0,0,17688,7.2,18762,226,60,567,448,28.6,1768.8
4840432278,0,10,1,0,8,7,3,1,1,0,0,16923,7.0,18801,223,68,-644,950,29.1,1692.3,14,0,1,7,8,7,0,0,0,0,17567,6.8,17851,211,48,644,-950,25.9,1756.7
4840137212,1,14,1,0,2,3,1,0,0,0,0,17112,7.0,19057,249,60,1299,1849,30.9,1711.2,11,2,1,3,2,3,0,0,0,0,15813,6.6,17208,204,52,-1299,-1849,25.6,1581.3
4836658532,0,13,2,1,8,9,8,1,1,0,0,17122,6.8,17382,197,48,-2706,-1881,24.5,1712.2,18,2,0,9,8,7,0,0,0,0,19828,7.2,19263,186,68,2706,1881,25.4,1982.8
4836624618,1,17,5,1,5,7,3,0,0,0,0,15575,6.6,17518,225,64,-801,-695,28.9,1557.5,13,1,0,6,4,6,1,1,0,0,16376,7.0,18213,217,48,801,695,26.5,1637.6
4858288089,1,26,0,0,18,24,49,0,0,0,1,36426,11.0,39390,123,0,100,325,12.3,3642.6,0,20,1,24,18,57,0,0,0,0,36326,10.8,39065,96,0,-100,-325,9.6,3632.6
4858248203,1,0,0,0,26,33,51,0,0,0,1,36350,11.0,39374,82,0,-3662,-5542,8.2,3635.0,0,0,1,33,26,84,0,0,0,0,40012,11.8,44916,90,0,3662,5542,9.0,4001.2
4857394483,0,1,0,1,8,13,20,0,0,0,1,32086,10.0,33670,90,0,-2780,-6443,9.0,3208.6,0,0,0,13,8,34,0,0,0,0,34866,11.2,40113,114,0,2780,6443,11.4,3486.6
4857372764,0,5,0,1,23,25,52,0,0,0,0,37264,11.0,39175,91,0,-46,-3825,9.1,3726.4,89,2,0,25,23,64,0,0,0,0,37310,11.8,43000,107,0,46,3825,10.7,3731.0
4857321016,0,16,0,0,28,21,61,0,0,0,0,36927,11.2,41400,77,0,397,4110,7.7,3692.7,7,4,1,21,28,64,0,0,0,0,36530,10.6,37290,108,0,-397,-4110,10.8,3653.0
4857294969,0,1,1,0,21,29,45,0,0,0,0,36923,11.4,41226,100,0,-998,-99,10.0,3692.3,13,0,1,29,21,68,0,0,0,0,37921,11.4,41325,103,0,998,99,10.3,3792.1
4857265934,1,33,0,1,24,15,58,0,0,0,1,39009,11.4,41902,132,0,4737,4550,13.2,3900.9,0,26,0,15,24,40,0,0,0,0,34272,10.6,37352,83,0,-4737,-4550,8.3,3427.2
4857137185,0,0,0,0,27,33,56,0,0,0,0,39056,11.6,44470,97,0,-418,887,9.7,3905.6,0,0,1,33,27,90,0,0,0,0,39474,11.6,43583,112,0,418,-887,11.2,3947.4
4856206694,1,12,2,0,4,2,5,1,1,0,0,15773,6.8,17927,219,56,914,-289,27.5,1577.3,15,0,1,2,4,1,0,0,0,0,14859,7.0,18216,203,64,-914,289,26.7,1485.9
4856177765,0,0,0,0,16,20,43,0,0,0,0,34160,10.6,35461,105,0,-231,-2040,10.5,3416.0,0,0,1,20,16,50,0,0,0,0,34391,11.0,37501,111,0,231,2040,11.1,3439.1
4856137434,0,71,0,1,14,16,33,0,0,0,1,35570,10.4,36282,95,0,-103,-1882,9.5,3557.0,0,0,0,16,14,36,0,0,0,0,35673,11.0,38164,96,0,103,1882,9.6,3567.3
4856104281,0,7,0,0,10,10,28,0,0,0,0,31887,10.2,33505,118,0,-943,712,11.8,3188.7,0,0,1,10,10,29,0,0,0,0,32830,10.0,32793,109,0,943,-712,10.9,3283.0
4856076143,0,81,0,1,24,16,71,0,0,0,1,38184,11.4,41786,107,0,3465,4831,10.7,3818.4,157,0,0,16,24,37,0,0,0,0,34719,10.8,36955,68,0,-3465,-4831,6.8,3471.9
4855354285,0,0,0,1,30,19,81,0,0,0,0,38431,11.2,41876,114,0,1065,2530,11.4,3843.1,1,0,0,18,29,44,0,0,0,0,37366,10.8,39346,102,0,-1065,-2530,10.2,3736.6
4855326374,1,17,4,1,22,26,54,0,0,0,0,36891,11.2,39460,114,0,1461,-147,11.4,3689.1,13,0,0,26,22,65,0,0,0,0,35430,11.0,39607,105,0,-1461,147,10.5,3543.0
4855301037,0,0,0,1,18,33,38,0,0,0,1,35753,10.6,37234,81,0,-4110,-5415,8.1,3575.3,0,0,0,33,18,65,0,0,0,0,39863,11.4,42649,118,0,4110,5415,11.8,3986.3
4855247740,0,20,3,1,4,4,5,0,0,0,0,15512,6.6,16764,195,40,-255,-2230,23.5,1551.2,14,3,0,4,4,3,1,1,0,0,15767,7.2,18994,214,64,255,2230,27.8,1576.7
4855166452,1,15,0,0,2,5,0,1,1,0,0,14317,7.0,18054,187,64,-1322,-27,25.1,1431.7,7,0,1,5,2,3,0,0,0,0,15639,7.0,18081,207,44,1322,27,25.1,1563.9
4855101190,0,14,1,0,1,4,2,1,1,0,0,14759,6.6,16401,201,48,-2351,-1329,24.9,1475.9,18,3,1,4,1,6,0,0,0,0,17110,7.2,17730,208,48,2351,1329,25.6,1711.0
4855040632,0,17,0,0,18,24,46,0,0,0,2,34916,11.0,37402,95,0,-2319,-1584,9.5,3491.6,0,0,1,24,18,71,0,0,0,0,37235,10.8,38986,98,0,2319,1584,9.8,3723.5
4858253011,1,13,0,1,12,3,14,2,1,1,0,20272,7.4,19389,217,72,5690,2814,28.9,2027.2,9,0,0,3,12,4,0,0,0,0,14582,6.6,16575,204,52,-5690,-2814,25.6,1458.2
4858209423,1,13,2,1,6,3,4,0,0,0,0,17048,7.0,18563,234,63,1428,774,29.7,1704.8,18,2,0,3,6,4,0,0,0,0,15620,7.0,17789,224,56,-1428,-774,28.0,1562.0
4854016388,1,9,5,1,11,1,9,1,1,0,0,18992,7.0,18621,228,56,5663,2051,28.4,1899.2,37,2,0,1,11,0,0,0,0,0,13329,6.4,16570,191,58,-5663,-2051,24.9,1332.9
4853880225,0,13,2,1,4,5,2,1,1,0,0,15604,7.2,17566,211,64,-308,273,27.5,1560.4,16,2,0,5,4,8,0,0,0,0,15912,6.8,17293,189,56,308,-273,24.5,1591.2
4853838409,1,43,17,0,6,3,9,0,0,0,0,17802,7.2,18804,220,56,1380,563,27.6,1780.2,35,0,1,3,6,2,1,1,0,0,16422,7.0,18241,230,60,-1380,-563,29.0,1642.2
4853790389,1,10,1,0,6,11,6,1,1,0,0,16009,6.6,16251,164,63,-2848,-2419,22.7,1600.9,12,0,1,11,6,5,0,0,0,0,18857,7.2,18670,190,68,2848,2419,25.8,1885.7
4853742775,0,14,0,1,3,2,3,1,1,0,0,16503,7.4,19626,248,76,2325,2186,32.4,1650.3,10,1,0,2,3,3,0,0,0,0,14178,6.8,17440,172,64,-2325,-2186,23.6,1417.8
4853655378,1,13,1,1,4,4,3,0,0,0,0,15785,7.0,17812,174,56,-335,222,23.0,1578.5,11,0,0,4,4,1,0,0,0,0,16120,6.8,17590,234,56,335,-222,29.0,1612.0
4853628897,0,14,2,0,8,9,6,1,1,0,0,17290,7.0,18440,224,51,-503,1452,27.5,1729.0,15,3,1,9,8,8,0,0,0,0,17793,6.6,16988,213,60,503,-1452,27.3,1779.3
4853037865,1,29,13,1,9,6,7,0,0,0,0,19482,6.8,17434,185,52,3014,696,23.7,1948.2,40,0,0,6,9,6,0,0,0,0,16468,6.6,16738,184,40,-3014,-696,22.4,1646.8
4851925964,1,11,1,1,4,5,5,0,0,0,0,16885,7.0,18375,235,60,339,-336,29.5,1688.5,13,2,0,5,4,6,1,1,0,0,16546,7.2,18711,219,60,-339,336,27.9,1654.6
4851697028,1,13,4,0,5,13,7,1,0,1,0,17304,6.8,17985,209,59,-1232,1098,26.8,1730.4,20,2,1,13,5,14,1,1,0,0,18536,6.8,16887,183,56,1232,-1098,23.9,1853.6
4849587937,0,10,4,0,2,5,3,0,0,0,0,15234,6.8,17425,235,56,-3035,-1425,29.1,1523.4,12,0,1,5,2,4,0,0,0,0,18269,7.0,18850,231,60,3035,1425,29.1,1826.9
4849539424,1,46,0,0,8,8,9,1,0,1,0,16788,6.6,16754,188,56,-1287,-716,24.4,1678.8,13,10,1,8,8,12,1,1,0,0,18075,7.0,17470,235,36,1287,716,27.1,1807.5
4849525238,1,22,3,0,7,10,8,0,0,0,0,17136,6.8,17141,204,52,-2022,-2263,25.6,1713.6,11,2,1,10,7,16,0,0,0,0,19158,7.2,19404,246,63,2022,2263,30.9,1915.8
4849244829,0,13,0,1,1,9,1,0,0,0,0,14647,6.8,17273,221,59,-4226,-2307,28.0,1464.7,15,0,0,9,1,8,2,1,1,0,18873,7.4,19580,248,64,4226,2307,31.2,1887.3
4849210236,1,12,1,1,6,7,0,0,0,0,0,17478,7.2,19328,207,68,85,-236,27.5,1747.8,11,2,0,7,6,3,0,0,0,0,17393,7.4,19564,244,76,-85,236,32.0,1739.3
4849163881,0,31,1,0,7,7,11,0,0,0,0,17257,6.6,16780,189,52,-1317,-1273,24.1,1725.7,11,0,1,7,7,7,0,0,0,0,18574,7.0,18053,211,64,1317,1273,27.5,1857.4
4849131642,0,13,4,0,5,6,6,0,0,0,0,15314,6.8,17193,215,36,-3016,-1367,25.1,1531.4,12,0,1,6,5,11,0,0,0,0,18330,7.0,18560,231,60,3016,1367,29.1,1833.0
4857211035,1,1,0,0,37,24,97,0,0,0,0,40614,12.2,47763,110,0,5125,7695,11.0,4061.4,133,0,1,24,37,43,0,0,0,0,35489,11.0,40068,88,0,-5125,-7695,8.8,3548.9
4857109466,1,0,0,0,24,12,65,0,0,0,0,36117,11.0,40103,123,0,2364,4215,12.3,3611.7,0,0,1,12,24,27,0,0,0,0,33753,10.2,35888,110,0,-2364,-4215,11.0,3375.3
4857018813,1,0,0,1,27,19,22,0,0,0,0,65550,12.8,61000,1,0,29050,25000,0.1,6555.0,6,0,0,6,14,11,0,0,0,0,36500,7.6,36000,0,0,-29050,-25000,0.0,3650.0
4856999031,1,1,0,0,13,15,12,0,0,0,0,45652,10.2,48680,0,0,17452,20180,0.0,4565.2,7,0,1,12,10,13,0,0,0,0,28200,6.0,28500,0,0,-17452,-20180,0.0,2820.0
4856977517,1,3,0,1,22,14,19,0,0,0,0,64800,12.0,55000,0,0,27600,22000,0.0,6480.0,0,0,0,7,15,13,0,0,0,0,37200,7.2,33000,0,0,-27600,-22000,0.0,3720.0
4856965882,1,86,0,0,15,20,19,0,0,0,0,48089,10.0,47500,0,0,19488,19000,0.0,4808.9,0,0,1,16,11,11,0,0,0,0,28601,6.0,28500,0,0,-19488,-19000,0.0,2860.1
4856944440,1,0,0,1,14,14,13,0,0,0,0,47600,10.2,48680,0,0,20100,18680,0.0,4760.0,0,0,0,10,10,6,0,0,0,0,27500,6.4,30000,0,0,-20100,-18680,0.0,2750.0
4856935082,1,0,0,1,19,15,25,0,0,0,0,63050,12.2,56000,0,0,26900,23000,0.0,6305.0,5,0,0,9,13,5,0,0,0,0,36150,7.2,33000,0,0,-26900,-23000,0.0,3615.0
4856914626,1,0,0,1,22,16,19,0,0,0,0,48050,10.2,48680,0,0,20200,20180,0.0,4805.0,0,0,0,7,13,10,0,0,0,0,27850,6.0,28500,0,0,-20200,-20180,0.0,2785.0
4856908360,1,6,0,1,13,25,19,0,0,0,0,60600,12.0,55000,0,0,22000,22000,0.0,6060.0,0,0,0,18,6,13,0,0,0,0,38600,7.2,33000,0,0,-22000,-22000,0.0,3860.0
4856871697,1,0,0,1,24,26,54,0,0,0,0,36007,11.0,39337,99,0,-2316,-3800,9.9,3600.7,1,0,0,26,24,66,0,0,0,0,38323,11.4,43137,121,0,2316,3800,12.1,3832.3
4856342955,0,0,0,1,20,17,54,0,0,0,1,34361,10.4,36783,93,0,-607,-83,9.3,3436.1,2,0,0,17,20,48,0,0,0,0,34968,10.6,36866,106,0,607,83,10.6,3496.8
4856204309,1,0,0,1,23,37,50,0,0,0,1,37928,11.0,39197,100,0,-4039,-7365,10.0,3792.8,0,0,0,37,23,94,0,0,0,0,41967,11.8,46562,107,0,4039,7365,10.7,4196.7
4856010000,0,11,1,0,20,42,40,0,0,0,2,37895,11.8,43782,80,0,-5275,-2386,8.0,3789.5,21,0,1,42,20,125,0,0,0,0,43170,12.0,46168,105,0,5275,2386,10.5,4317.0
4855860420,0,14,1,0,5,5,5,0,0,0,0,16867,7.4,19162,239,72,-44,365,31.1,1686.7,9,2,1,5,5,8,1,1,0,0,16911,7.2,18797,238,68,44,-365,30.6,1691.1
4855822758,1,12,2,0,4,7,3,0,0,0,0,16168,6.8,17906,196,66,-2683,-1139,26.2,1616.8,13,2,1,7,4,4,0,0,0,0,18851,7.4,19045,224,52,2683,1139,27.6,1885.1
4855781737,0,23,0,1,19,16,46,0,0,0,1,34650,10.2,35445,90,0,-2298,-3842,9.0,3465.0,0,0,0,16,19,39,0,0,0,0,36948,11.0,39287,106,0,2298,3842,10.6,3694.8
4855759602,1,1,0,1,29,17,75,0,0,0,1,38993,11.2,41493,124,0,2682,2083,12.4,3899.3,44,0,0,17,29,46,0,0,0,0,36311,11.0,39410,100,0,-2682,-2083,10.0,3631.1
4855730881,0,0,1,0,29,22,57,0,0,0,0,38377,12.0,44166,113,0,2055,4974,11.3,3837.7,21,0,1,22,29,55,0,0,0,0,36322,10.8,39192,104,0,-2055,-4974,10.4,3632.2
4854936661,1,0,0,1,19,20,24,0,0,0,0,62255,12.8,61000,3,0,24250,25000,0.3,6225.5,0,0,0,14,13,9,0,0,0,0,38005,7.6,36000,3,0,-24250,-25000,0.3,3800.5
4857923437,1,9,0,1,16,27,18,0,0,0,0,63350,12.0,55000,0,0,24750,22000,0.0,6335.0,0,0,0,19,8,17,0,0,0,0,38600,7.2,33000,0,0,-24750,-22000,0.0,3860.0
4857913459,1,0,0,1,19,21,19,0,0,0,0,64450,13.6,65000,0,0,26900,27500,0.0,6445.0,5,0,0,13,11,10,0,0,0,0,37550,7.8,37500,0,0,-26900,-27500,0.0,3755.0
4857319205,0,16,2,1,4,4,4,0,0,0,0,16289,7.0,17596,225,55,115,-467,28.0,1628.9,14,1,0,4,4,4,1,1,0,0,16174,6.8,18063,180,48,-115,467,22.8,1617.4
4857287213,1,14,3,1,8,4,10,1,0,1,0,18232,7.0,18078,231,60,2234,-208,29.1,1823.2,8,2,0,4,8,4,0,0,0,0,15998,7.0,18286,207,52,-2234,208,25.9,1599.8
4856896433,0,25,0,0,6,3,5,0,0,0,0,16042,6.6,17739,202,58,1354,446,26.0,1604.2,11,1,1,3,6,1,0,0,0,0,14688,6.8,17293,188,58,-1354,-446,24.6,1468.8
4856885034,0,12,2,0,5,5,3,0,0,0,0,16167,6.8,18153,197,60,-754,-1645,25.7,1616.7,10,2,1,5,5,3,1,1,0,0,16921,7.4,19798,236,64,754,1645,30.0,1692.1
4856822439,0,0,0,0,29,30,75,0,0,0,1,40710,11.6,44464,109,0,1050,-1320,10.9,4071.0,7,0,1,30,29,66,0,0,0,0,39660,12.0,45784,110,0,-1050,1320,11.0,3966.0
4856801744,0,0,0,0,15,15,36,0,0,0,0,33084,10.2,35160,89,0,-475,-1966,8.9,3308.4,0,0,1,15,15,40,0,0,0,0,33559,10.6,37126,94,0,475,1966,9.4,3355.9
4856580259,0,12,3,0,4,5,3,0,0,0,0,14817,6.8,17364,207,52,-2253,-1934,25.9,1481.7,12,1,1,5,4,3,0,0,0,0,17070,7.4,19298,239,72,2253,1934,31.1,1707.0
4856391537,1,0,2,1,26,21,80,0,0,0,1,40046,11.4,42298,123,0,4479,5050,12.3,4004.6,15,0,0,21,26,51,0,0,0,0,35567,10.8,37248,80,0,-4479,-5050,8.0,3556.7
4856348353,0,37,0,1,34,24,92,0,0,0,1,39742,11.8,43873,102,0,1027,727,10.2,3974.2,0,3,0,24,34,63,0,0,0,0,38715,11.8,43146,110,0,-1027,-727,11.0,3871.5
4856325111,0,1,16,1,28,32,64,0,0,0,1,38528,11.4,41948,108,0,-695,-1461,10.8,3852.8,48,0,0,32,28,80,0,0,0,0,39223,11.6,43409,121,0,695,1461,12.1,3922.3
4855061389,1,0,0,1,26,19,64,0,0,0,1,37312,10.8,40088,104,0,127,-33,10.4,3731.2,0,0,0,18,25,49,0,0,0,0,37185,11.0,40121,114,0,-127,33,11.4,3718.5
4855027397,1,0,0,0,16,17,42,0,0,0,1,34730,10.6,37309,106,0,-1725,-1130,10.6,3473.0,6,0,1,17,16,50,0,0,0,0,36455,10.8,38439,122,0,1725,1130,12.2,3645.5
4855003745,1,0,0,1,21,19,52,0,0,0,1,37924,11.2,39879,120,0,2513,2069,12.0,3792.4,111,0,0,19,21,53,0,0,0,0,35411,10.6,37810,92,0,-2513,-2069,9.2,3541.1
4854962978,0,0,0,1,25,24,50,0,0,0,0,37432,11.2,41049,111,0,-157,1424,11.1,3743.2,0,0,0,24,25,49,0,0,0,0,37589,11.0,39625,109,0,157,-1424,10.9,3758.9
4853761860,0,65,5,0,5,6,3,0,0,0,0,15315,6.8,17906,218,52,-314,125,27.0,1531.5,15,3,1,6,5,3,1,1,0,0,15629,6.8,17781,184,56,314,-125,24.0,1562.9
4853712493,0,14,3,1,4,4,2,0,0,0,0,15662,6.4,16857,219,40,4,-952,25.9,1566.2,16,1,0,4,4,5,1,1,0,0,15658,7.0,17809,226,56,-4,952,28.2,1565.8
4853616933,1,0,0,0,27,19,83,0,0,0,1,39205,11.8,43569,95,0,1632,3434,9.5,3920.5,0,0,1,19,27,60,0,0,0,0,37573,11.0,40135,100,0,-1632,-3434,10.0,3757.3
4853591773,0,0,0,1,26,18,59,0,0,0,2,38093,11.0,40394,109,0,2284,3754,10.9,3809.3,0,0,0,18,26,41,0,0,0,0,35809,10.4,36640,97,0,-2284,-3754,9.7,3580.9
4838871278,0,13,2,0,9,4,10,0,0,0,0,17635,7.0,17539,215,56,483,-1079,27.1,1763.5,11,3,1,3,8,2,2,1,1,0,17152,7.0,18618,219,54,-483,1079,27.3,1715.2
4838843060,0,25,1,1,11,6,11,0,0,0,0,18823,7.0,18627,225,42,1481,921,26.7,1882.3,10,1,0,6,11,11,1,1,0,0,17342,7.0,17706,196,72,-1481,-921,26.8,1734.2
4837425865,0,14,0,1,5,4,7,0,0,0,0,16119,7.0,18555,192,76,388,-813,26.8,1611.9,12,1,0,4,5,0,1,1,0,0,15731,7.2,19368,241,64,-388,813,30.5,1573.1
4837404017,0,28,1,1,6,5,7,0,0,0,0,17451,6.8,17324,214,40,1561,-1619,25.4,1745.1,10,0,0,5,6,1,0,0,0,0,15890,7.0,18943,216,63,-1561,1619,27.9,1589.0
4832612343,1,9,0,0,5,3,6,1,1,0,0,16561,7.2,18396,224,60,1073,456,28.4,1656.1,13,0,1,3,5,0,0,0,0,0,15488,6.8,17940,222,56,-1073,-456,27.8,1548.8
4822593762,1,42,0,1,8,0,7,0,0,0,0,17942,7.2,18852,218,64,3873,1939,28.2,1794.2,13,3,0,0,8,0,0,0,0,0,14069,6.8,16913,218,52,-3873,-1939,27.0,1406.9
4810620914,1,13,1,0,6,5,8,1,0,1,0,17026,6.8,18582,217,72,-1313,1166,28.9,1702.6,13,2,1,5,6,6,1,1,0,0,18339,7.0,17416,216,64,1313,-1166,28.0,1833.9
4810592965,1,9,0,0,3,7,3,1,0,1,0,15017,7.0,17839,215,60,-3554,-1630,27.5,1501.7,9,0,1,7,3,7,0,0,0,0,18571,7.2,19469,252,72,3554,1630,32.4,1857.1
4806121308,0,15,0,1,4,3,3,0,0,0,0,15786,7.0,17295,213,63,-384,-1140,27.6,1578.6,11,3,0,3,4,2,1,1,0,0,16170,7.0,18435,246,70,384,1140,31.6,1617.0
4806088219,1,11,0,1,10,6,12,0,0,0,0,18881,6.8,18936,216,72,3597,2731,28.8,1888.1,7,2,0,6,10,10,1,1,0,0,15284,6.4,16205,189,56,-3597,-2731,24.5,1528.4
4802017074,0,71,1,0,2,5,3,0,0,0,0,14502,6.6,16717,197,44,-3910,-1903,24.1,1450.2,11,2,1,5,2,5,2,1,1,0,18412,6.8,18620,219,76,3910,1903,29.5,1841.2
4801988233,1,35,1,0,7,3,3,0,0,0,0,17043,7.0,18437,225,60,1403,1571,28.5,1704.3,35,4,1,3,7,3,0,0,0,0,15640,6.6,16866,196,52,-1403,-1571,24.8,1564.0
4801951835,0,33,4,1,5,5,6,0,0,0,0,16713,7.2,19104,234,60,-713,-458,29.4,1671.3,36,2,0,5,5,1,1,1,0,0,17426,7.4,19562,225,62,713,458,28.7,1742.6
4800940567,0,15,0,0,4,5,2,0,0,0,0,16591,7.2,18849,241,64,-784,510,30.5,1659.1,122,0,1,5,4,5,1,1,0,0,17375,7.0,18339,220,60,784,-510,28.0,1737.5
4800559387,1,12,2,1,10,3,8,1,1,0,0,19102,7.2,19069,249,64,3091,1398,31.3,1910.2,16,0,0,3,10,2,0,0,0,0,16011,7.0,17671,233,52,-3091,-1398,28.5,1601.1
4800517157,0,12,1,1,5,7,3,1,0,1,0,16585,7.0,18007,225,64,-650,-1524,28.9,1658.5,7,1,0,7,5,4,0,0,0,0,17235,7.4,19531,227,64,650,1524,29.1,1723.5
4800492876,1,10,0,1,6,4,5,0,0,0,0,18037,7.0,18106,224,60,2089,1725,28.4,1803.7,17,0,0,4,6,5,0,0,0,0,15948,6.6,16381,206,58,-2089,-1725,26.4,1594.8
4800461016,0,16,0,0,2,4,0,0,0,0,0,14346,7.0,18220,235,63,-1768,-540,29.8,1434.6,11,0,1,3,1,4,1,0,1,0,16114,7.2,18760,238,76,1768,540,31.4,1611.4
4800428922,1,10,1,1,8,1,7,0,0,0,0,18959,7.2,19296,249,56,3796,942,30.5,1895.9,12,1,0,1,8,1,0,0,0,0,15163,6.8,18354,224,52,-3796,-942,27.6,1516.3
4852906054,1,133,3,0,9,6,8,0,0,0,0,18510,7.2,19379,237,64,2599,1456,30.1,1851.0,12,3,1,6,9,4,1,1,0,0,15911,7.0,17923,205,64,-2599,-1456,26.9,1591.1
4852852134,1,13,1,1,7,10,8,0,0,0,0,18114,7.0,18557,234,68,667,1425,30.2,1811.4,10,2,0,10,7,11,1,1,0,0,17447,6.6,17132,202,44,-667,-1425,24.6,1744.7
4852802191,1,87,5,1,9,8,8,1,1,0,0,17851,6.8,17715,191,44,-52,-1024,23.5,1785.1,32,0,0,8,9,5,0,0,0,0,17903,6.8,18739,227,68,52,1024,29.5,1790.3
4852771305,1,13,2,1,10,3,8,0,0,0,0,19245,7.0,18211,213,60,3823,1428,27.3,1924.5,13,4,0,3,10,4,0,0,0,0,15422,6.6,16783,217,48,-3823,-1428,26.5,1542.2
4848465945,1,48,3,0,7,4,6,1,1,0,0,17707,7.0,18350,201,72,2321,2640,27.3,1770.7,20,1,1,4,7,6,0,0,0,0,15386,6.4,15710,209,52,-2321,-2640,26.1,1538.6
4847662465,1,23,3,1,6,8,3,2,1,1,0,16028,7.0,18121,198,68,-2191,-265,26.6,1602.8,15,1,0,8,6,6,0,0,0,0,18219,7.0,18386,223,48,2191,265,27.1,1821.9
4847639849,0,10,2,1,3,8,2,0,0,0,0,15147,6.6,17012,217,42,-2723,-1885,25.9,1514.7,11,0,0,8,3,3,0,0,0,0,17870,7.2,18897,251,62,2723,1885,31.3,1787.0
4847611212,0,10,0,0,2,3,4,0,0,0,0,15209,7.0,18648,240,71,-1053,309,31.1,1520.9,12,0,1,3,2,5,0,0,0,0,16262,7.0,18339,256,56,1053,-309,31.2,1626.2
4847589761,1,15,2,0,6,8,5,0,0,0,0,18661,7.0,18676,261,55,751,645,31.6,1866.1,17,2,1,8,6,8,1,1,0,0,17910,6.8,18031,228,55,-751,-645,28.3,1791.0
4847550341,1,28,2,1,7,0,10,1,1,0,0,17261,7.0,18591,228,65,2304,-12,29.3,1726.1,14,1,0,0,7,0,0,0,0,0,14957,7.2,18603,231,74,-2304,12,30.5,1495.7
4847456563,1,12,1,1,9,4,12,1,0,1,0,19846,7.2,19476,250,60,3178,1693,31.0,1984.6,9,0,0,4,9,5,1,1,0,0,16668,7.0,17783,238,56,-3178,-1693,29.4,1666.8
4847446131,0,21,3,1,3,9,5,0,0,0,0,15310,6.8,17591,238,47,-2312,-797,28.5,1531.0,13,1,0,9,3,15,0,0,0,0,17622,7.0,18388,217,60,2312,797,27.7,1762.2
4847420733,1,14,1,0,11,3,10,1,1,0,0,18650,6.6,17037,178,48,3239,-88,22.6,1865.0,10,0,1,3,11,1,1,0,1,0,15411,6.8,17125,212,55,-3239,88,26.7,1541.1
4847401243,1,9,2,1,5,4,4,1,1,0,0,16691,6.8,18016,249,60,1210,-13,30.9,1669.1,8,2,0,4,5,3,0,0,0,0,15481,6.8,18029,218,56,-1210,13,27.4,1548.1
4847320380,1,17,2,0,7,4,4,2,1,1,0,16427,7.0,17439,215,51,390,242,26.6,1642.7,16,2,1,4,7,6,0,0,0,0,16037,7.0,17197,242,40,-390,-242,28.2,1603.7
4841271418,1,10,3,0,6,7,4,0,0,0,0,16820,6.8,17955,214,68,-389,-712,28.2,1682.0,13,1,1,7,6,5,1,1,0,0,17209,7.0,18667,209,68,389,712,27.7,1720.9
4840725006,0,34,2,1,6,5,10,0,0,0,0,16287,6.8,17677,207,52,-603,-932,25.9,1628.7,13,1,0,5,6,6,1,1,0,0,16890,7.0,18609,233,60,603,932,29.3,1689.0
4840706964,1,54,0,1,11,3,10,0,0,0,0,19226,7.0,18003,222,49,3416,1751,27.1,1922.6,74,15,0,3,11,3,0,0,0,0,15810,6.4,16252,179,52,-3416,-1751,23.1,1581.0
4840687816,0,31,2,0,5,6,8,0,0,0,0,16914,7.0,18934,235,55,-74,-122,29.0,1691.4,15,2,1,6,5,7,1,1,0,0,16988,7.4,19056,230,60,74,122,29.0,1698.8
4840664892,0,12,1,0,6,5,7,0,0,0,0,16809,7.2,18796,223,64,158,180,28.7,1680.9,11,1,1,5,6,3,1,1,0,0,16651,7.0,18616,234,72,-158,-180,30.6,1665.1
4857427107,1,12,1,0,11,10,10,0,0,0,0,18452,6.8,17466,191,56,-1071,1519,24.7,1845.2,84,1,1,10,11,13,1,1,0,0,19523,6.6,15947,191,39,1071,-1519,23.0,1952.3
4855350541,1,6,0,0,14,16,18,0,0,0,0,49550,12.0,55000,0,0,20100,22000,0.0,4955.0,0,0,1,10,8,9,0,0,0,0,29450,7.2,33000,0,0,-20100,-22000,0.0,2945.0
4855334949,1,4,0,1,15,21,20,0,0,0,0,47000,10.0,47500,0,0,17400,19000,0.0,4700.0,56,0,0,15,9,11,0,0,0,0,29600,6.0,28500,0,0,-17400,-19000,0.0,2960.0
4855299515,1,39,0,1,12,12,17,0,0,0,0,30600,9.0,40000,0,0,12000,16000,0.0,3060.0,0,0,0,8,8,5,0,0,0,0,18600,5.4,24000,2,0,-12000,-16000,0.2,1860.0
4855281904,1,34,0,1,17,12,22,0,0,0,0,62950,12.0,55000,5,0,26400,21000,0.5,6295.0,9,0,0,6,11,9,0,0,0,0,36550,7.4,34000,1,0,-26400,-21000,0.1,3655.0
4855139206,1,14,0,1,14,17,16,0,0,0,0,46300,10.0,47500,0,0,18100,19000,0.0,4630.0,0,0,0,10,7,8,0,0,0,0,28200,6.0,28500,0,0,-18100,-19000,0.0,2820.0
4853070898,1,0,0,1,20,15,21,0,0,0,0,64100,12.0,55000,0,0,26900,22000,0.0,6410.0,0,0,0,9,14,7,0,0,0,0,37200,7.2,33000,0,0,-26900,-22000,0.0,3720.0
4853041221,1,0,0,0,15,18,13,0,0,0,0,60956,12.0,55000,2,0,18506,22000,0.2,6095.6,2,0,1,13,10,12,0,0,0,0,42450,7.2,33000,0,0,-18506,-22000,0.0,4245.0
4846663931,1,21,1,0,13,4,11,0,0,0,0,22407,7.2,18718,236,43,6900,4223,27.9,2240.7,11,1,1,4,13,11,0,0,0,0,15507,6.0,14495,180,48,-6900,-4223,22.8,1550.7
4844388796,1,13,0,0,3,2,3,1,1,0,0,13990,7.2,18538,175,52,-1304,12,22.7,1399.0,12,0,1,2,3,1,0,0,0,0,15294,7.2,18526,223,56,1304,-12,27.9,1529.4
4844334003,0,11,1,0,7,3,7,0,0,0,0,15722,7.0,17837,166,36,1302,1844,20.2,1572.2,13,0,1,3,7,0,0,0,0,0,14420,6.2,15993,185,44,-1302,-1844,22.9,1442.0
4844294117,1,12,0,1,10,7,7,0,0,0,0,18168,7.0,18607,242,40,1174,1894,28.2,1816.8,8,0,0,7,10,6,0,0,0,0,16994,6.6,16713,212,52,-1174,-1894,26.4,1699.4
4844243243,0,102,1,1,3,1,1,1,1,0,0,15442,7.2,18401,211,52,915,1277,26.3,1544.2,9,0,0,1,3,1,0,0,0,0,14527,6.8,17124,221,64,-915,-1277,28.5,1452.7
4844183485,0,16,2,1,9,3,13,1,1,0,0,18372,6.8,17442,175,48,3875,423,22.3,1837.2,101,2,0,3,9,2,0,0,0,0,14497,6.6,17019,188,59,-3875,-423,24.7,1449.7
4842044837,0,14,0,0,2,8,3,1,0,1,0,13988,6.4,15694,186,54,-4473,-3181,24.0,1398.8,21,1,1,8,2,12,1,1,0,0,18461,7.2,18875,228,51,4473,3181,27.9,1846.1
4842009931,1,18,0,1,8,1,10,1,1,0,0,18157,7.2,19427,250,53,3551,2244,30.3,1815.7,9,0,0,1,8,1,0,0,0,0,14606,6.6,17183,226,56,-3551,-2244,28.2,1460.6
4841981718,0,10,0,0,4,4,2,0,0,0,0,14766,6.6,16904,199,56,-2396,-1757,25.5,1476.6,18,1,1,4,4,4,0,0,0,0,17162,7.0,18661,248,47,2396,1757,29.5,1716.2
4841961849,1,21,1,0,8,3,11,0,0,0,0,17009,6.8,17647,210,49,2416,1331,25.9,1700.9,8,1,1,2,7,2,0,0,0,0,14593,6.6,16316,233,40,-2416,-1331,27.3,1459.3
4841348861,0,15,1,0,5,8,2,0,0,0,0,15011,6.8,16545,163,52,-2733,-3489,21.5,1501.1,11,3,1,7,4,2,0,0,0,0,17744,7.2,20034,241,70,2733,3489,31.1,1774.4
4840743707,0,9,1,1,10,5,7,0,0,0,0,18457,6.6,17925,180,48,3123,1108,22.8,1845.7,13,0,0,5,10,2,0,0,0,0,15334,6.6,16817,181,52,-3123,-1108,23.3,1533.4
4856105693,1,0,0,1,21,16,18,0,0,0,0,62000,13.0,62500,0,0,24100,25000,0.0,6200.0,20,0,0,7,12,12,0,0,0,0,37900,7.8,37500,0,0,-24100,-25000,0.0,3790.0
4856082960,1,0,0,0,16,19,18,0,0,0,0,46300,10.0,47500,8,0,17400,19000,0.8,4630.0,0,0,1,13,10,9,0,0,0,0,28900,6.0,28500,1,0,-17400,-19000,0.1,2890.0
4856057826,1,0,0,0,19,13,17,0,0,0,0,51250,10.0,47500,2,0,24450,19000,0.2,5125.0,0,0,1,5,11,7,0,0,0,0,26800,6.0,28500,0,0,-24450,-19000,0.0,2680.0
4835192606,0,13,2,0,5,8,4,0,0,0,0,16674,6.8,17415,253,48,-1057,-1077,30.1,1667.4,12,2,1,8,5,10,1,1,0,0,17731,7.0,18492,232,64,1057,1077,29.6,1773.1
4835157761,0,8,0,0,4,8,0,0,0,0,0,15078,6.8,17808,200,44,-2203,-594,24.4,1507.8,13,0,1,8,4,3,0,0,0,0,17281,7.0,18402,208,72,2203,594,28.0,1728.1
4835100994,1,36,1,1,11,10,10,0,0,0,0,18914,7.0,17368,203,54,-394,-15,25.7,1891.4,11,14,0,9,10,6,0,0,0,0,19308,6.8,17383,205,36,394,15,24.1,1930.8
4827054933,1,12,1,0,5,3,6,0,0,0,0,16596,6.8,17949,202,72,1288,352,27.4,1659.6,12,0,1,3,5,1,1,1,0,0,15308,6.6,17597,200,64,-1288,-352,26.4,1530.8
4827040677,0,10,5,0,7,10,9,0,0,0,0,16904,6.4,16244,185,43,-2438,-1599,22.8,1690.4,50,0,1,9,6,7,0,0,0,0,19342,6.8,17843,211,76,2438,1599,28.7,1934.2
4824171270,0,13,0,0,1,2,0,0,0,0,0,15631,7.2,18813,246,57,-1142,-921,30.3,1563.1,10,0,1,2,1,3,0,0,0,0,16773,7.2,19734,241,78,1142,921,31.9,1677.3
4824151191,1,20,2,0,6,8,4,0,0,0,0,17899,7.2,19314,251,72,-126,1250,32.3,1789.9,10,1,1,8,6,8,1,1,0,0,18025,6.8,18064,249,52,126,-1250,30.1,1802.5
4811876379,0,17,1,1,4,3,5,0,0,0,0,16211,6.8,17469,230,47,295,-1133,27.7,1621.1,10,4,0,3,4,2,2,1,1,0,15916,7.0,18602,225,52,-295,1133,27.7,1591.6
4811858068,1,10,0,0,9,6,10,1,1,0,0,17873,7.0,17782,225,48,1011,372,27.3,1787.3,12,0,1,6,9,6,0,0,0,0,16862,7.0,17410,213,60,-1011,-372,27.3,1686.2
4811840371,1,12,0,0,3,3,2,1,1,0,0,17880,7.2,19123,276,69,1572,814,34.5,1788.0,11,1,1,3,3,3,0,0,0,0,16308,7.0,18309,236,62,-1572,-814,29.8,1630.8
4811822181,1,14,2,1,3,0,3,0,0,0,0,17041,7.2,18953,245,60,1958,35,30.5,1704.1,15,0,0,0,3,0,0,0,0,0,15083,7.0,18918,262,72,-1958,-35,33.4,1508.3
4811813939,0,14,2,1,8,7,8,0,0,0,0,16817,6.8,16858,207,44,-2149,-1500,25.1,1681.7,11,0,0,7,8,5,1,0,1,0,18966,7.0,18358,229,52,2149,1500,28.1,1896.6
4810975101,1,18,3,1,3,5,6,0,0,0,0,17011,7.2,19086,276,71,-52,34,34.7,1701.1,12,2,0,5,3,8,1,0,1,0,17063,7.2,19052,236,68,52,-34,30.4,1706.3
4810940233,0,15,2,0,4,8,4,0,0,0,0,14380,6.4,15219,203,33,-4444,-3656,23.6,1438.0,51,0,1,8,4,6,0,0,0,0,18824,7.4,18875,241,61,4444,3656,30.2,1882.4
4810920392,0,40,1,1,4,8,5,0,0,0,0,16104,7.0,17828,227,48,-2804,-1419,27.5,1610.4,47,1,0,8,4,14,0,0,0,0,18908,7.0,19247,235,67,2804,1419,30.2,1890.8
4810899010,1,82,0,0,7,5,7,0,0,0,0,18767,7.2,19762,215,62,1737,982,27.7,1876.7,13,2,1,5,7,4,0,0,0,0,17030,7.0,18780,216,60,-1737,-982,27.6,1703.0
4857377360,0,38,0,1,24,29,57,0,0,0,0,38514,11.2,41110,105,0,453,-2184,10.5,3851.4,0,0,0,29,24,76,0,0,0,0,38061,11.8,43294,105,0,-453,2184,10.5,3806.1
4857353062,1,0,0,0,23,17,67,0,0,0,0,37601,11.0,40737,113,0,2457,3398,11.3,3760.1,0,0,1,17,23,42,0,0,0,0,35144,10.6,37339,106,0,-2457,-3398,10.6,3514.4
4856673327,1,49,0,1,10,5,8,1,1,0,0,17987,7.0,17868,196,50,1629,337,24.6,1798.7,12,1,0,5,10,4,0,0,0,0,16358,6.8,17531,195,58,-1629,-337,25.3,1635.8
4852957305,0,0,0,0,19,17,43,0,0,0,0,35609,11.0,40309,110,0,1973,2799,11.0,3560.9,0,0,1,17,19,32,0,0,0,0,33636,10.8,37510,94,0,-1973,-2799,9.4,3363.6
4852910733,0,19,0,0,18,17,45,0,0,0,0,36587,11.0,39304,115,0,1645,2653,11.5,3658.7,14,6,1,17,18,29,0,0,0,0,34942,10.6,36651,98,0,-1645,-2653,9.8,3494.2
4852893097,0,0,0,0,16,26,29,0,0,0,2,36089,11.0,39763,95,0,-4337,-4394,9.5,3608.9,0,0,1,26,16,68,0,0,0,0,40426,11.6,44157,108,0,4337,4394,10.8,4042.6
4851945548,0,0,0,0,21,29,58,0,0,0,1,37863,11.4,41379,104,0,-1238,-841,10.4,3786.3,0,0,1,28,20,88,0,0,0,0,39101,11.6,42220,108,0,1238,841,10.8,3910.1
4851919827,1,30,0,1,19,8,58,0,0,0,0,35202,10.6,37320,124,0,2285,3388,12.4,3520.2,260,2,0,8,19,21,0,0,0,0,32917,10.2,33932,112,0,-2285,-3388,11.2,3291.7
4851878421,0,0,0,1,21,17,46,0,0,0,1,36780,11.2,41416,105,0,1765,2721,10.5,3678.0,0,0,0,17,21,39,0,0,0,0,35015,10.8,38695,90,0,-1765,-2721,9.0,3501.5
4851856330,1,0,0,1,17,23,43,0,0,0,1,35034,10.2,35140,97,0,-2129,-4258,9.7,3503.4,0,0,0,23,17,63,0,0,0,0,37163,11.0,39398,105,0,2129,4258,10.5,3716.3
4851408913,1,8,0,1,9,1,12,1,0,1,1,20348,7.0,18314,141,48,8270,3047,18.9,2034.8,58,1,0,1,9,0,0,0,0,0,12078,6.4,15267,145,0,-8270,-3047,14.5,1207.8
4851389572,1,7,0,1,16,4,15,1,1,0,0,25551,7.8,22214,204,68,12712,7986,27.2,2555.1,0,0,0,4,16,4,0,0,0,0,12839,6.2,14228,105,0,-12712,-7986,10.5,1283.9
4850999016,0,0,0,1,24,23,58,0,0,0,0,35659,11.0,39550,106,0,-654,-1988,10.6,3565.9,0,0,0,23,24,49,0,0,0,0,36313,11.4,41538,90,0,654,1988,9.0,3631.3
4850971414,1,0,0,0,24,17,69,0,0,0,1,37481,11.0,39973,119,0,2931,3404,11.9,3748.1,1,0,1,17,24,34,0,0,0,0,34550,10.6,36569,110,0,-2931,-3404,11.0,3455.0
4850950258,0,0,0,0,33,27,76,0,0,0,2,39722,11.6,43134,107,0,-631,-2282,10.7,3972.2,0,0,1,27,33,65,0,0,0,0,40353,11.8,45416,107,0,631,2282,10.7,4035.3
4850924603,0,1,0,1,26,25,66,0,0,0,1,37797,11.0,40068,85,0,-1140,-2954,8.5,3779.7,42,0,0,25,26,70,0,0,0,0,38937,11.4,43022,121,0,1140,2954,12.1,3893.7
4850901823,1,68,0,1,18,19,32,0,0,0,0,36664,11.0,40736,117,0,1253,2556,11.7,3666.4,0,0,0,19,18,47,0,0,0,0,35411,10.8,38180,97,0,-1253,-2556,9.7,3541.1
4850111007,1,103,0,1,30,19,91,0,0,0,0,39486,11.4,43293,103,0,1806,3472,10.3,3948.6,0,0,0,19,30,61,0,0,0,0,37680,11.0,39821,95,0,-1806,-3472,9.5,3768.0
4850079671,0,112,0,0,27,33,52,0,0,0,0,40254,11.6,44857,101,0,-461,-1933,10.1,4025.4,12,0,1,33,27,83,0,0,0,0,40715,12.2,46790,107,0,461,1933,10.7,4071.5
4850043330,1,14,0,1,22,23,47,0,0,0,0,37167,11.2,40848,104,0,-802,-1500,10.4,3716.7,1,0,0,23,22,53,0,0,0,0,37969,11.2,42348,116,0,802,1500,11.6,3796.9
4855356178,1,42,0,0,15,19,16,0,0,0,0,61802,12.0,55000,0,0,22810,22000,0.0,6180.2,0,0,1,14,10,12,0,0,0,0,38992,7.2,33000,0,0,-22810,-22000,0.0,3899.2
4855332358,1,11,0,1,14,17,15,0,0,0,0,60600,12.0,55000,0,0,24100,18000,0.0,6060.0,39,0,0,12,9,10,0,0,0,0,36500,8.0,37000,0,0,-24100,-18000,0.0,3650.0
4855313403,1,0,0,0,21,16,17,0,0,0,0,64873,13.0,62500,1,0,28373,25000,0.1,6487.3,0,0,1,6,11,10,0,0,0,0,36500,7.8,37500,0,0,-28373,-25000,0.0,3650.0
4855297136,1,0,0,1,22,17,15,0,0,0,0,62115,12.0,55000,1,0,24060,22000,0.1,6211.5,0,0,0,7,12,10,0,0,0,0,38055,7.2,33000,3,0,-24060,-22000,0.3,3805.5
4855270582,1,33,0,0,15,13,13,0,0,0,0,46910,10.0,47500,24,0,18700,19000,2.4,4691.0,0,2,1,9,11,10,0,0,0,0,28210,6.0,28500,0,0,-18700,-19000,0.0,2821.0
4855249214,1,14,1,0,21,14,19,0,0,0,0,48884,10.0,47500,6,0,20284,17820,0.6,4888.4,0,0,1,9,16,12,0,0,0,0,28600,6.2,29680,0,0,-20284,-17820,0.0,2860.0
4855208489,0,12,2,1,9,6,12,0,0,0,0,19073,7.2,18333,226,56,2815,2184,28.2,1907.3,12,2,0,5,8,7,1,1,0,0,16258,6.6,16149,159,48,-2815,-2184,20.7,1625.8
4855164148,0,17,1,1,7,4,9,0,0,0,0,17630,7.0,17796,221,39,1085,-1165,26.0,1763.0,12,2,0,4,7,3,1,1,0,0,16545,7.2,18961,221,84,-1085,1165,30.5,1654.5
4855061857,1,16,1,1,6,1,4,1,1,0,0,17678,7.4,19015,243,56,3483,2563,29.9,1767.8,12,1,0,1,6,0,0,0,0,0,14195,6.4,16452,193,48,-3483,-2563,24.1,1419.5
4854994632,1,11,3,1,10,2,10,1,1,0,0,19111,7.2,18670,221,48,4232,1601,26.9,1911.1,12,1,0,2,10,2,0,0,0,0,14879,6.8,17069,210,67,-4232,-1601,27.7,1487.9
4854931666,0,12,1,1,7,4,7,0,0,0,0,16268,6.6,16752,185,64,-329,-1647,24.9,1626.8,78,0,0,4,7,5,2,1,1,0,16597,7.0,18399,217,67,329,1647,28.4,1659.7
4854827999,0,18,0,0,0,2,0,0,0,0,0,14175,6.8,17498,180,55,-1222,220,23.5,1417.5,15,0,1,2,0,1,0,0,0,0,15397,6.8,17278,200,58,1222,-220,25.8,1539.7
4854799224,0,13,2,0,2,6,3,0,0,0,0,14567,6.6,16337,216,44,-2255,-1481,26.0,1456.7,20,0,1,6,2,7,0,0,0,0,16822,7.0,17818,210,60,2255,1481,27.0,1682.2
4854775560,1,8,0,0,20,16,22,0,0,0,0,49459,10.0,47500,3,0,20906,19000,0.3,4945.9,0,0,1,11,15,9,0,0,0,0,28553,6.0,28500,1,0,-20906,-19000,0.1,2855.3
4854765808,1,0,0,0,19,21,20,0,0,0,0,62450,13.0,62000,2,0,23038,26000,0.2,6245.0,0,0,1,13,11,12,0,0,0,0,39412,7.6,36000,1,0,-23038,-26000,0.1,3941.2
4854747017,1,401,1,1,17,16,18,0,0,0,0,61866,12.0,55000,2,0,24250,22000,0.2,6186.6,112,0,0,9,10,13,0,0,0,0,37616,7.2,33000,0,0,-24250,-22000,0.0,3761.6
4854722680,1,0,0,0,14,20,16,0,0,0,0,61650,12.2,56000,0,0,23400,23000,0.0,6165.0,0,0,1,12,6,8,0,0,0,0,38250,7.2,33000,0,0,-23400,-23000,0.0,3825.0
4854711185,1,0,0,1,21,21,22,0,0,0,0,63490,12.0,55000,0,0,24582,22000,0.0,6349.0,0,0,0,13,13,10,0,0,0,0,38908,7.2,33000,0,0,-24582,-22000,0.0,3890.8
4854691288,1,0,0,1,14,16,21,0,0,0,0,60650,12.0,55000,1,0,23450,22000,0.1,6065.0,1,0,0,13,11,8,0,0,0,0,37200,7.2,33000,0,0,-23450,-22000,0.0,3720.0
4844941700,1,13,2,0,11,7,10,0,0,0,0,18755,7.0,17624,216,54,3253,1427,27.0,1875.5,13,1,1,7,11,9,0,0,0,0,15502,6.6,16197,185,48,-3253,-1427,23.3,1550.2
4844913948,1,16,1,1,6,6,10,0,0,0,0,17453,7.0,17862,233,56,600,-1118,28.9,1745.3,10,2,0,6,6,4,2,1,1,0,16853,7.0,18980,217,68,-600,1118,28.5,1685.3
4844880473,0,106,3,0,2,6,1,0,0,0,0,15383,7.2,18375,228,64,-1251,3,29.2,1538.3,11,3,1,6,2,5,0,0,0,0,16634,7.0,18372,232,52,1251,-3,28.4,1663.4
4843452709,0,14,0,1,1,8,1,0,0,0,0,13607,6.4,15878,181,56,-4989,-3259,23.7,1360.7,16,1,0,8,1,4,0,0,0,0,18596,7.0,19137,242,48,4989,3259,29.0,1859.6
4843396737,0,55,8,1,4,0,7,0,0,0,0,16309,7.0,17800,237,44,2135,31,28.1,1630.9,26,0,0,0,4,0,0,0,0,0,14174,6.8,17769,226,60,-2135,-31,28.6,1417.4
4843348863,1,14,0,0,5,4,2,1,1,0,0,15976,7.0,18047,227,72,-310,82,29.9,1597.6,12,0,1,4,5,5,0,0,0,0,16286,7.0,17965,220,59,310,-82,27.9,1628.6
4843292007,1,99,0,0,8,4,8,0,0,0,0,17470,6.6,17812,214,52,1696,-809,26.6,1747.0,12,0,1,4,8,1,0,0,0,0,15774,7.2,18621,222,59,-1696,809,28.1,1577.4
4843235370,1,11,1,1,1,4,1,1,0,1,0,15025,7.0,18580,247,68,-2029,-746,31.5,1502.5,11,0,0,4,1,3,0,0,0,0,17054,7.2,19326,252,60,2029,746,31.2,1705.4
4843199226,0,13,3,0,4,6,3,0,0,0,0,15181,7.2,18100,211,52,-2752,-564,26.3,1518.1,13,3,1,6,4,6,1,1,0,0,17933,7.2,18664,256,72,2752,564,32.8,1793.3
4843165295,0,18,4,0,7,4,8,0,0,0,0,16643,7.2,18537,236,52,-79,434,28.8,1664.3,19,3,1,4,7,2,2,1,1,0,16722,7.0,18103,224,56,79,-434,28.0,1672.2
4843109786,0,39,3,1,4,2,5,0,0,0,0,16456,7.0,18220,240,52,1559,-82,29.2,1645.6,29,4,0,2,4,2,0,0,0,0,14897,7.0,18302,219,47,-1559,82,26.6,1489.7
4843068614,0,12,0,1,7,10,8,1,1,0,0,15254,6.4,15282,151,54,-2694,-3237,20.5,1525.4,10,0,0,10,7,5,0,0,0,0,17948,7.0,18519,212,50,2694,3237,26.2,1794.8
4843040595,0,20,0,0,4,4,2,0,0,0,0,15500,6.6,16998,211,60,-1202,-510,27.1,1550.0,48,2,1,4,4,4,0,0,0,0,16702,6.8,17508,238,55,1202,510,29.3,1670.2
4843007866,1,12,3,0,5,4,8,1,1,0,0,16679,7.2,19015,241,75,161,394,31.6,1667.9,13,0,1,4,5,3,0,0,0,0,16518,7.0,18621,268,59,-161,-394,32.7,1651.8
4842977240,0,13,2,1,4,2,2,1,1,0,0,16347,7.0,18853,239,64,342,-623,30.3,1634.7,25,2,0,2,4,2,0,0,0,0,16005,7.4,19476,227,62,-342,623,28.9,1600.5
4842863146,0,30,4,1,6,5,6,0,0,0,0,17141,7.0,17416,222,56,1760,200,27.8,1714.1,13,1,0,5,6,4,1,1,0,0,15381,7.0,17216,185,52,-1760,-200,23.7,1538.1
4842847021,1,56,3,1,2,4,2,1,1,0,0,14732,6.8,17457,198,52,-598,-210,25.0,1473.2,33,1,0,4,2,6,0,0,0,0,15330,6.8,17667,221,48,598,210,26.9,1533.0
4842823631,0,12,13,0,6,4,3,1,1,0,0,17439,7.0,18803,232,70,1899,773,30.2,1743.9,30,2,1,4,6,4,0,0,0,0,15540,7.0,18030,211,60,-1899,-773,27.1,1554.0
4842811614,0,14,2,1,9,5,8,1,1,0,0,17615,7.0,18441,212,72,1296,908,28.4,1761.5,13,3,0,5,9,3,0,0,0,0,16319,6.8,17533,230,51,-1296,-908,28.1,1631.9
4842797783,1,12,1,0,1,3,1,1,1,0,0,15062,7.0,18839,221,64,-1058,-7,28.5,1506.2,11,2,1,3,1,4,0,0,0,0,16120,7.2,18846,247,67,1058,7,31.4,1612.0
4857538063,1,0,0,1,15,21,20,0,0,0,0,33793,9.0,40000,1,0,14593,16000,0.1,3379.3,0,0,0,15,9,9,0,0,0,0,19200,5.4,24000,0,0,-14593,-16000,0.0,1920.0
4857515466,1,202,0,0,14,15,15,0,0,0,0,61907,12.0,55000,9,0,23554,22000,0.9,6190.7,0,4,1,9,8,5,0,0,0,0,38353,7.2,33000,0,0,-23554,-22000,0.0,3835.3
4857497938,1,0,0,0,13,17,11,0,0,0,0,44900,10.0,47500,0,0,17400,19000,0.0,4490.0,0,0,1,10,6,12,0,0,0,0,27500,6.0,28500,0,0,-17400,-19000,0.0,2750.0
4857473390,1,5,0,1,18,18,19,0,0,0,0,53750,13.0,62500,0,0,16900,25000,0.0,5375.0,0,0,0,12,12,6,0,0,0,0,36850,7.8,37500,0,0,-16900,-25000,0.0,3685.0
4857453124,1,14,0,1,11,21,14,0,0,0,0,61148,12.0,55000,0,0,19748,22000,0.0,6114.8,0,0,0,16,6,12,0,0,0,0,41400,7.2,33000,0,0,-19748,-22000,0.0,4140.0
4857391616,0,9,0,1,2,6,2,0,0,0,0,16324,6.8,18002,190,48,-205,-39,23.8,1632.4,18,0,0,6,2,8,0,0,0,0,16529,7.0,18041,218,56,205,39,27.4,1652.9
4857351539,1,12,0,1,11,7,17,1,1,0,0,19573,6.8,17836,207,49,1770,928,25.6,1957.3,10,3,0,7,11,14,0,0,0,0,17803,6.8,16908,190,42,-1770,-928,23.2,1780.3
4857277385,1,17,2,0,4,4,2,0,0,0,0,16220,7.0,17966,222,44,273,1291,26.6,1622.0,9,4,1,4,4,11,1,1,0,0,15947,6.8,16675,227,44,-273,-1291,27.1,1594.7
4857215042,0,32,1,0,3,5,3,0,0,0,0,15377,7.0,17395,227,45,-1204,-524,27.2,1537.7,83,12,1,5,3,8,1,1,0,0,16581,7.0,17919,225,59,1204,524,28.4,1658.1
4856961770,1,16,3,1,3,5,3,1,1,0,0,16022,7.0,18106,246,60,192,41,30.6,1602.2,13,1,0,5,3,3,1,0,1,0,15830,7.0,18065,224,60,-192,-41,28.4,1583.0
4856917534,1,10,1,0,6,10,8,0,0,0,0,16931,7.0,17002,208,58,-774,-596,26.6,1693.1,35,1,1,10,6,18,0,0,0,0,17705,6.6,17598,172,53,774,596,22.5,1770.5
4856667555,1,17,2,0,6,3,2,0,0,0,0,15686,6.8,18113,235,40,770,-524,27.5,1568.6,8,1,1,3,6,1,0,0,0,0,14916,7.2,18637,220,72,-770,524,29.2,1491.6
4856658819,0,12,1,0,2,7,3,0,0,0,0,14608,6.8,16910,204,52,-3055,-2776,25.6,1460.8,12,1,1,7,2,3,1,1,0,0,17663,7.0,19686,234,73,3055,2776,30.7,1766.3
4856649032,1,0,0,0,21,17,60,0,0,0,1,36428,11.0,40468,113,0,640,3977,11.3,3642.8,0,0,1,17,21,39,0,0,0,0,35788,10.6,36491,99,0,-640,-3977,9.9,3578.8
4856634680,0,0,0,0,24,39,51,0,0,0,1,38688,11.6,43773,112,0,-2693,-2719,11.2,3868.8,31,0,1,39,24,121,0,0,0,0,41381,12.2,46492,104,0,2693,2719,10.4,4138.1
4855925798,0,13,1,0,5,10,5,0,0,0,0,15836,6.4,15991,165,52,-3654,-2352,21.7,1583.6,11,2,1,10,5,12,1,1,0,0,19490,7.2,18343,192,55,3654,2352,24.7,1949.0
4855858035,0,15,1,0,8,6,15,0,0,0,0,17460,6.6,16821,212,47,755,-605,25.9,1746.0,12,2,1,6,8,9,0,0,0,0,16705,6.6,17426,215,52,-755,605,26.7,1670.5
4855823247,1,12,4,0,5,8,9,1,1,0,0,16204,6.8,17111,235,59,-2324,-494,29.4,1620.4,10,4,1,8,5,19,0,0,0,0,18528,6.8,17605,227,44,2324,494,27.1,1852.8
4855162483,0,12,0,1,10,11,11,1,1,0,0,16165,6.4,15584,145,44,-4789,-1771,18.9,1616.5,14,0,0,11,10,13,0,0,0,0,20954,6.8,17355,204,44,4789,1771,24.8,2095.4
4855118352,1,34,0,1,36,35,94,0,0,0,1,42915,11.8,46811,116,0,2957,1180,11.6,4291.5,34,0,0,35,36,70,0,0,0,0,39958,12.0,45631,102,0,-2957,-1180,10.2,3995.8
4853742775,0,14,0,1,3,2,3,1,1,0,0,16503,7.4,19626,248,76,2325,2186,32.4,1650.3,10,1,0,2,3,3,0,0,0,0,14178,6.8,17440,172,64,-2325,-2186,23.6,1417.8
4853686028,0,13,1,0,6,7,8,0,0,0,0,16766,6.8,17294,203,48,-1551,-1423,25.1,1676.6,67,4,1,7,6,5,2,1,1,0,18317,7.2,18717,228,72,1551,1423,30.0,1831.7
4853649891,1,13,10,0,4,7,2,1,1,0,0,15072,6.6,17161,191,54,-2101,-1259,24.5,1507.2,35,0,1,7,4,5,0,0,0,0,17173,7.4,18420,216,56,2101,1259,27.2,1717.3
4853614639,0,16,1,1,6,6,8,1,1,0,0,15482,7.0,17178,207,55,-2614,-1260,26.2,1548.2,15,1,0,6,6,7,1,0,1,0,18096,7.0,18438,260,55,2614,1260,31.5,1809.6
4853203230,1,0,0,1,21,17,18,0,0,0,0,48750,10.0,47500,0,0,20900,19000,0.0,4875.0,3,0,0,6,10,8,0,0,0,0,27850,6.0,28500,0,0,-20900,-19000,0.0,2785.0
4853195331,1,0,0,1,23,14,26,0,0,0,0,64543,12.8,61000,0,0,29093,25000,0.0,6454.3,10,0,0,7,16,6,0,0,0,0,35450,7.6,36000,0,0,-29093,-25000,0.0,3545.0
4853188203,1,0,0,1,14,21,24,0,0,0,0,77410,15.0,70000,0,0,35196,31000,0.0,7741.0,0,0,0,18,11,9,0,0,0,0,42214,8.2,39000,1,0,-35196,-31000,0.1,4221.4
4853177381,1,0,0,1,18,23,15,0,0,0,0,61650,12.8,61000,0,0,23400,25000,0.0,6165.0,0,0,0,13,8,16,0,0,0,0,38250,7.6,36000,0,0,-23400,-25000,0.0,3825.0
4853166188,1,6,0,1,24,24,21,0,0,0,0,47800,10.0,47500,2,0,18850,19000,0.2,4780.0,41,0,0,12,12,18,0,0,0,0,28950,6.0,28500,1,0,-18850,-19000,0.1,2895.0
4853151317,1,0,0,1,20,20,30,0,0,0,0,64830,13.0,62500,0,0,26876,25000,0.0,6483.0,0,0,0,14,14,8,0,0,0,0,37954,7.8,37500,0,0,-26876,-25000,0.0,3795.4
4853130303,1,352,0,1,16,16,15,0,0,0,0,46650,10.0,47500,0,0,17700,19000,0.0,4665.0,5,0,0,11,11,12,0,0,0,0,28950,6.0,28500,0,0,-17700,-19000,0.0,2895.0
4852626769,1,25,0,1,7,6,3,0,0,0,0,18399,7.2,18873,230,50,2654,919,28.0,1839.9,9,0,0,6,7,2,0,0,0,0,15745,6.8,17954,212,47,-2654,-919,25.9,1574.5
4852567572,1,15,1,0,4,6,7,0,0,0,0,15752,6.8,16908,197,47,-2498,-2720,24.4,1575.2,26,2,1,6,4,6,1,0,1,0,18250,7.4,19628,261,63,2498,2720,32.4,1825.0
4852532000,0,16,1,1,3,10,6,0,0,0,0,16411,6.8,17675,210,56,-2305,-644,26.6,1641.1,12,0,0,10,3,12,0,0,0,0,18716,6.8,18319,228,48,2305,644,27.6,1871.6
4852506262,0,8,2,0,7,4,6,0,0,0,0,17988,7.0,18628,213,56,1801,113,26.9,1798.8,80,0,1,4,7,2,0,0,0,0,16187,7.0,18515,210,72,-1801,-113,28.2,1618.7
4852099263,1,9,1,1,8,10,4,0,0,0,0,16417,6.8,17514,200,47,-1637,198,24.7,1641.7,12,2,0,10,8,9,0,0,0,0,18054,6.8,17316,191,52,1637,-198,24.3,1805.4
4852061687,1,18,5,1,7,3,8,0,0,0,0,18761,6.8,17943,251,47,1989,678,29.8,1876.1,30,3,0,3,7,5,0,0,0,0,16772,6.8,17265,220,56,-1989,-678,27.6,1677.2
4852043443,1,17,2,1,12,3,12,1,1,0,0,19903,6.8,17600,193,38,3819,1351,23.1,1990.3,12,1,0,3,12,3,0,0,0,0,16084,6.4,16249,207,42,-3819,-1351,24.9,1608.4
4852024406,0,17,2,1,6,8,8,1,1,0,0,16877,6.4,15988,205,52,-1843,-1264,25.7,1687.7,15,4,0,8,6,8,0,0,0,0,18720,6.6,17252,206,60,1843,1264,26.6,1872.0
4856729413,1,4,0,1,17,18,18,0,0,0,0,48050,10.0,47500,0,0,20200,16000,0.0,4805.0,0,0,0,11,10,7,0,0,0,0,27850,6.6,31500,0,0,-20200,-16000,0.0,2785.0
4856724063,1,0,0,0,20,14,12,0,0,0,0,47000,10.0,47500,0,0,20200,19000,0.0,4700.0,3,0,1,7,13,6,0,0,0,0,26800,6.0,28500,0,0,-20200,-19000,0.0,2680.0
4856716286,1,252,0,1,26,14,23,0,0,0,0,65332,12.0,55000,3,0,28470,22000,0.3,6533.2,0,0,0,2,14,6,0,0,0,0,36862,7.2,33000,0,0,-28470,-22000,0.0,3686.2
4856711100,1,0,0,1,20,20,20,0,0,0,0,63140,12.0,55000,0,0,24073,22000,0.0,6314.0,88,0,0,13,13,10,0,0,0,0,39067,7.2,33000,0,0,-24073,-22000,0.0,3906.7
4856703993,1,0,0,1,19,16,18,0,0,0,0,47700,10.0,47500,0,0,19699,19000,0.0,4770.0,0,0,0,8,11,10,0,0,0,0,28001,6.0,28500,0,0,-19699,-19000,0.0,2800.1
4856692465,1,60,2,0,14,18,14,0,0,0,0,47720,10.0,47500,2,0,17420,19000,0.2,4772.0,0,0,1,13,9,10,0,0,0,0,30300,6.0,28500,0,0,-17420,-19000,0.0,3030.0
4856693873,1,37,2,0,13,15,15,0,0,0,0,46835,10.0,47500,7,0,17560,19000,0.7,4683.5,0,5,1,11,9,9,0,0,0,0,29275,6.0,28500,0,0,-17560,-19000,0.0,2927.5
4856679719,1,50,0,1,19,17,13,0,0,0,0,64700,12.0,55000,10,0,27780,22000,1.0,6470.0,0,3,0,7,9,10,0,0,0,0,36920,7.2,33000,2,0,-27780,-22000,0.2,3692.0
4856673529,1,0,0,0,15,21,17,0,0,0,0,45995,10.0,47500,0,0,18100,19000,0.0,4599.5,20,0,1,16,10,10,0,0,0,0,27895,6.0,28500,0,0,-18100,-19000,0.0,2789.5
4856667698,1,5,0,1,14,20,19,0,0,0,0,63750,12.0,55000,0,0,25500,21000,0.0,6375.0,0,0,0,14,8,8,0,0,0,0,38250,7.4,34000,0,0,-25500,-21000,0.0,3825.0
4856667109,1,0,0,0,21,17,23,0,0,0,0,63750,12.0,55000,0,0,27600,22000,0.0,6375.0,0,0,1,8,12,7,0,0,0,0,36150,7.2,33000,0,0,-27600,-22000,0.0,3615.0
4856657316,1,0,0,0,9,20,14,0,0,0,0,43500,10.0,47500,0,0,15300,19000,0.0,4350.0,0,0,1,15,4,9,0,0,0,0,28200,6.0,28500,0,0,-15300,-19000,0.0,2820.0
4856646704,1,0,0,0,21,25,13,0,0,0,0,63415,12.0,55000,0,0,24812,22000,0.0,6341.5,64,0,1,12,8,16,0,0,0,0,38603,7.2,33000,0,0,-24812,-22000,0.0,3860.3
4856647909,1,0,0,0,22,20,22,0,0,0,0,63180,12.0,55000,1,0,24900,22000,0.1,6318.0,0,0,1,11,13,11,0,0,0,0,38280,7.2,33000,0,0,-24900,-22000,0.0,3828.0
4856638794,1,0,0,1,16,15,24,0,0,0,0,48915,10.0,47500,3,0,22380,19000,0.3,4891.5,0,0,0,9,10,2,0,0,0,0,26535,6.0,28500,1,0,-22380,-19000,0.1,2653.5
4856630853,1,60,0,1,19,15,19,0,0,0,0,63400,12.0,55000,0,0,27600,22000,0.0,6340.0,0,0,0,7,11,7,0,0,0,0,35800,7.2,33000,0,0,-27600,-22000,0.0,3580.0
4856619229,1,0,0,1,19,17,20,0,0,0,0,49450,12.8,59000,0,0,20200,26000,0.0,4945.0,0,0,0,12,14,10,0,0,0,0,29250,7.2,33000,0,0,-20200,-26000,0.0,2925.0
4856610964,1,6,0,0,25,16,25,0,0,0,0,68650,12.0,55000,0,0,29700,22000,0.0,6865.0,0,0,1,9,18,7,0,0,0,0,38950,7.2,33000,0,0,-29700,-22000,0.0,3895.0
4856352988,1,22,0,0,12,19,17,0,0,0,0,46300,10.0,47500,0,0,16680,19000,0.0,4630.0,0,2,1,13,6,12,0,0,0,0,29620,6.0,28500,2,0,-16680,-19000,0.2,2962.0
4856305359,0,101,0,1,17,15,45,0,0,0,0,33675,10.8,37313,118,0,-1740,-1074,11.8,3367.5,40,0,0,15,17,31,0,0,0,0,35415,10.8,38387,102,0,1740,1074,10.2,3541.5
4853530187,1,12,1,1,7,1,6,0,0,0,0,17386,7.0,18337,223,61,1860,797,28.4,1738.6,13,0,0,1,7,1,0,0,0,0,15526,6.8,17540,240,44,-1860,-797,28.4,1552.6
4853501995,0,18,1,1,2,5,2,0,0,0,0,15598,6.8,17758,214,60,-1560,-1150,27.4,1559.8,13,1,0,5,2,6,0,0,0,0,17158,7.2,18908,222,52,1560,1150,27.4,1715.8
4852108037,1,11,0,1,2,3,0,0,0,0,0,15627,7.2,18874,268,60,-30,770,32.8,1562.7,11,0,0,3,2,3,0,0,0,0,15657,6.8,18104,214,60,30,-770,27.4,1565.7
4852078831,0,17,2,1,7,10,5,1,0,1,0,17575,7.2,19372,217,74,-1476,1711,29.1,1757.5,25,4,0,10,7,9,0,0,0,0,19051,7.0,17661,233,55,1476,-1711,28.8,1905.1
4852042876,0,13,1,0,5,7,8,0,0,0,0,17112,6.8,17878,228,48,227,970,27.6,1711.2,19,0,1,7,5,9,0,0,0,0,16885,6.8,16908,201,56,-227,-970,25.7,1688.5
4852013225,0,11,0,1,7,9,6,0,0,0,0,15882,6.6,17499,217,63,-3012,-732,28.0,1588.2,11,1,0,8,6,9,1,0,1,0,18894,7.0,18231,201,60,3012,732,26.1,1889.4
4851965524,0,12,1,1,6,5,7,0,0,0,0,17649,7.2,18254,217,64,598,286,28.1,1764.9,14,3,0,5,6,8,0,0,0,0,17051,6.8,17968,224,56,-598,-286,28.0,1705.1
4851925021,0,12,0,0,2,10,2,0,0,0,0,16343,6.6,17175,209,48,-2112,-63,25.7,1634.3,13,0,1,10,2,14,0,0,0,0,18455,6.6,17238,198,56,2112,63,25.4,1845.5
4851846700,0,17,1,0,7,7,3,0,0,0,0,16074,6.8,17903,212,50,-709,6,26.2,1607.4,11,1,1,7,7,7,0,0,0,0,16783,7.0,17897,205,52,709,-6,25.7,1678.3
4851795602,0,12,1,1,5,4,2,0,0,0,0,16529,6.8,17742,213,52,884,304,26.5,1652.9,15,0,0,4,5,6,1,1,0,0,15645,6.8,17438,224,56,-884,-304,28.0,1564.5
4851751726,0,14,1,1,8,6,6,0,0,0,0,17880,6.8,17696,216,52,1183,468,26.8,1788.0,10,0,0,6,8,6,0,0,0,0,16697,6.8,17228,216,50,-1183,-468,26.6,1669.7
4851699842,1,13,0,0,6,3,6,0,0,0,0,17136,7.2,18971,224,60,1370,1200,28.4,1713.6,11,4,1,3,6,3,0,0,0,0,15766,7.0,17771,254,60,-1370,-1200,31.4,1576.6
4851648893,1,16,4,1,5,3,8,1,1,0,0,16390,6.4,16680,211,62,1764,506,27.3,1639.0,14,2,0,3,5,2,0,0,0,0,14626,6.4,16174,171,56,-1764,-506,22.7,1462.6
4851562744,1,16,3,0,6,8,6,1,0,1,0,17198,7.0,18941,222,76,-622,559,29.8,1719.8,21,3,1,8,6,10,1,1,0,0,17820,7.0,18382,247,62,622,-559,30.9,1782.0
4851536993,0,8,1,0,3,4,4,1,1,0,0,15587,6.8,17951,240,47,-1752,-1266,28.7,1558.7,18,0,1,4,3,5,1,0,1,0,17339,7.2,19217,202,60,1752,1266,26.2,1733.9
4851499800,1,16,3,1,5,3,7,0,0,0,0,18182,7.2,18885,228,64,3301,371,29.2,1818.2,15,2,0,3,5,1,0,0,0,0,14881,7.4,18514,214,67,-3301,-371,28.1,1488.1
4851467908,0,17,1,1,6,4,8,2,1,1,0,18299,7.0,19040,236,76,2443,2386,31.2,1829.9,10,1,0,4,6,4,0,0,0,0,15856,6.4,16654,189,57,-2443,-2386,24.6,1585.6
4840548074,0,10,0,1,6,10,4,0,0,0,0,17362,6.8,16988,199,40,-940,-1858,23.9,1736.2,11,0,0,9,5,9,0,0,0,0,18302,7.2,18846,197,64,940,1858,26.1,1830.2
4840525083,0,15,2,0,4,9,5,0,0,0,0,15269,6.6,16099,204,52,-2828,-1489,25.6,1526.9,11,1,1,9,4,6,0,0,0,0,18097,6.8,17588,227,52,2828,1489,27.9,1809.7
4840495241,0,20,0,1,3,4,3,0,0,0,0,14789,6.6,17002,194,45,-2265,-2459,23.9,1478.9,23,1,0,4,3,3,0,0,0,0,17054,7.2,19461,204,76,2265,2459,28.0,1705.4
4855123532,0,0,32,0,15,22,33,0,0,0,1,34838,10.6,37532,104,0,-1826,-1783,10.4,3483.8,27,0,1,22,15,57,0,0,0,0,36664,11.0,39315,125,0,1826,1783,12.5,3666.4
4855092093,1,14,0,1,19,15,53,0,0,0,1,35674,11.0,39410,123,0,948,1332,12.3,3567.4,0,4,0,15,19,23,0,0,0,0,34726,10.6,38078,102,0,-948,-1332,10.2,3472.6
4855065968,0,1,0,0,21,30,52,0,0,0,1,36508,11.0,39809,106,0,-1441,-1664,10.6,3650.8,29,0,1,30,21,96,0,0,0,0,37949,11.2,41473,109,0,1441,1664,10.9,3794.9
4854849965,1,25,0,1,21,18,15,0,0,0,0,45600,10.0,47500,0,0,13600,19000,0.0,4560.0,0,0,0,9,12,13,0,0,0,0,32000,6.0,28500,0,0,-13600,-19000,0.0,3200.0
4854815435,1,0,0,1,19,18,20,0,0,0,0,48750,10.0,47500,6,0,20200,19000,0.6,4875.0,4,0,0,13,14,9,0,0,0,0,28550,6.0,28500,0,0,-20200,-19000,0.0,2855.0
4854796186,1,20,0,1,17,17,20,0,0,0,0,61698,12.0,55000,0,0,24148,21000,0.0,6169.8,0,0,0,12,12,8,0,0,0,0,37550,7.4,34000,0,0,-24148,-21000,0.0,3755.0
4854775932,1,640,0,1,20,10,17,0,0,0,0,48142,10.0,47701,1,0,20970,19201,0.1,4814.2,2,0,0,4,14,7,0,0,0,0,27172,6.0,28500,0,0,-20970,-19201,0.0,2717.2
4854755947,1,0,0,0,16,21,23,0,0,0,0,62000,12.0,55000,0,0,24800,22000,0.0,6200.0,0,0,1,14,9,9,0,0,0,0,37200,7.2,33000,0,0,-24800,-22000,0.0,3720.0
4854737982,1,0,0,1,22,15,20,0,0,0,0,48750,10.0,47500,0,0,19500,19000,0.0,4875.0,0,0,0,8,15,9,0,0,0,0,29250,6.0,28500,0,0,-19500,-19000,0.0,2925.0
4854709228,1,0,0,1,14,11,16,0,0,0,0,47150,10.0,47500,0,0,20700,19000,0.0,4715.0,0,0,0,7,10,3,0,0,0,0,26450,6.0,28500,0,0,-20700,-19000,0.0,2645.0
4854687221,1,0,0,1,20,15,24,0,0,0,0,47800,10.0,47500,2,0,20255,19000,0.2,4780.0,5,0,0,9,14,6,0,0,0,0,27545,6.0,28500,1,0,-20255,-19000,0.1,2754.5
4854673033,1,2,0,1,19,21,18,0,0,0,0,48800,10.0,47500,1,0,20200,19000,0.1,4880.0,0,0,0,14,12,11,0,0,0,0,28600,6.0,28500,1,0,-20200,-19000,0.1,2860.0
4854655767,1,59,0,1,17,17,18,0,0,0,0,62350,12.2,56000,0,0,24800,23000,0.0,6235.0,24,0,0,14,14,12,0,0,0,0,37550,7.2,33000,0,0,-24800,-23000,0.0,3755.0
4846617241,1,15,1,0,0,6,0,0,0,0,0,13200,6.2,14735,164,42,-3544,-3033,20.6,1320.0,15,0,1,6,0,4,0,0,0,0,16744,6.8,17768,206,57,3544,3033,26.3,1674.4
4843483584,1,10,1,1,10,5,7,0,0,0,0,17880,6.8,17595,213,39,3037,547,25.2,1788.0,15,1,0,5,10,3,0,0,0,0,14843,6.6,17048,183,61,-3037,-547,24.4,1484.3
4843449746,0,0,0,0,16,21,37,0,0,0,1,34343,10.6,36843,84,0,-2820,-694,8.4,3434.3,12,0,1,21,16,60,0,0,0,0,37163,10.8,37537,105,0,2820,694,10.5,3716.3
4842440265,1,10,1,1,5,6,1,0,0,0,0,16309,7.4,19391,201,72,156,1956,27.3,1630.9,13,0,0,6,5,5,2,1,1,0,16153,6.6,17435,220,56,-156,-1956,27.6,1615.3
4842225049,0,10,3,1,3,3,0,2,1,1,0,15765,7.0,18508,252,64,164,-54,31.6,1576.5,13,0,0,3,3,4,0,0,0,0,15601,7.2,18562,232,52,-164,54,28.4,1560.1
4842193673,0,10,3,1,2,5,1,0,0,0,0,14923,6.8,18038,229,66,-1770,837,29.5,1492.3,21,1,0,5,2,11,1,1,0,0,16693,6.8,17201,211,53,1770,-837,26.4,1669.3
4857427635,0,16,1,0,8,9,10,0,0,0,0,17430,7.0,17218,176,51,-1522,-2458,22.7,1743.0,11,3,1,9,8,9,1,1,0,0,18952,7.6,19676,244,67,1522,2458,31.1,1895.2
4857362363,0,13,3,0,6,3,5,0,0,0,0,18411,7.2,18722,221,60,1372,812,28.1,1841.1,14,0,1,3,6,4,0,0,0,0,17039,6.8,17910,237,48,-1372,-812,28.5,1703.9
4857307364,0,15,1,0,5,5,4,1,1,0,0,16597,6.8,17133,184,56,-103,-171,24.0,1659.7,16,0,1,5,5,3,0,0,0,0,16700,6.8,17304,210,48,103,171,25.8,1670.0
4857243752,0,7,0,1,4,5,3,0,0,0,0,16329,6.6,17303,215,48,547,-507,26.3,1632.9,13,1,0,5,4,5,0,0,0,0,15782,6.8,17810,209,44,-547,507,25.3,1578.2
4857142970,0,12,4,0,1,9,1,0,0,0,0,14487,6.8,16631,225,34,-3437,-3239,25.9,1448.7,12,1,1,9,1,5,0,0,0,0,17924,7.4,19870,237,73,3437,3239,31.0,1792.4
4857091353,1,14,0,0,7,7,2,0,0,0,0,15774,7.0,17524,196,35,-1188,-1252,23.1,1577.4,13,0,1,7,7,1,1,1,0,0,16962,7.0,18776,237,63,1188,1252,30.0,1696.2
4857050454,1,14,1,0,4,8,1,0,0,0,0,15741,7.0,18429,235,76,-1041,990,31.1,1574.1,13,0,1,8,4,7,0,0,0,0,16782,7.0,17439,217,56,1041,-990,27.3,1678.2
4857013570,1,15,1,1,8,3,5,1,1,0,0,18203,7.0,18665,214,64,2840,483,27.8,1820.3,14,1,0,3,8,5,1,0,1,0,15363,7.0,18182,197,64,-2840,-483,26.1,1536.3
4856984064,1,13,0,1,6,5,8,1,1,0,0,16982,6.8,17416,186,68,1080,-540,25.4,1698.2,9,0,0,5,6,2,0,0,0,0,15902,6.8,17956,209,52,-1080,540,26.1,1590.2
4856953047,1,35,2,1,16,8,19,1,1,0,0,19957,6.4,16532,189,42,2562,103,23.1,1995.7,20,15,0,8,16,13,0,0,0,0,17395,6.6,16429,190,42,-2562,-103,23.2,1739.5
4856922237,0,17,2,1,2,2,2,0,0,0,0,15805,7.0,18156,246,52,471,-893,29.8,1580.5,14,1,0,2,2,2,1,1,0,0,15334,7.2,19049,225,67,-471,893,29.2,1533.4
4856901879,0,16,2,1,4,5,4,0,0,0,0,14885,6.8,16956,187,52,-2824,-1073,23.9,1488.5,14,0,0,5,4,7,1,1,0,0,17709,7.0,18029,230,53,2824,1073,28.3,1770.9
4854974580,1,53,0,1,5,6,3,0,0,0,0,17003,6.8,18771,208,48,-1074,540,25.6,1700.3,12,1,0,6,5,5,1,1,0,0,18077,7.0,18231,211,56,1074,-540,26.7,1807.7
4854927749,1,16,2,1,5,6,4,1,1,0,0,17711,7.0,18033,213,72,440,1414,28.5,1771.1,17,3,0,6,5,10,1,0,1,0,17271,6.6,16619,192,46,-440,-1414,23.8,1727.1
4854894135,1,13,2,0,12,7,12,1,1,0,0,19540,7.4,19313,202,64,3055,2878,26.6,1954.0,12,1,1,7,12,8,0,0,0,0,16485,6.8,16435,204,56,-3055,-2878,26.0,1648.5
4854857222,0,8,1,0,3,9,2,0,0,0,0,14879,6.8,16852,205,56,-3354,-948,26.1,1487.9,13,1,1,9,3,12,0,0,0,0,18233,7.0,17800,206,48,3354,948,25.4,1823.3
4854819864,1,17,4,1,7,4,13,1,1,0,0,16658,6.4,16071,186,50,908,-1438,23.6,1665.8,13,3,0,4,7,5,0,0,0,0,15750,6.8,17509,229,68,-908,1438,29.7,1575.0
4854732577,0,92,0,0,5,7,5,1,1,0,0,16843,7.2,18386,224,68,-1774,-534,29.2,1684.3,10,2,1,7,5,3,0,0,0,0,18617,7.0,18920,231,67,1774,534,29.8,1861.7
4854697898,0,10,0,0,15,6,7,0,0,0,0,20764,7.2,19136,208,52,2170,1804,26.0,2076.4,12,0,1,6,15,7,0,0,0,0,18594,6.6,17332,208,46,-2170,-1804,25.4,1859.4
4854662468,0,16,1,0,5,11,1,0,0,0,0,14569,6.4,15824,157,52,-4391,-2367,20.9,1456.9,19,2,1,11,5,9,2,1,1,0,18960,7.0,18191,226,36,4391,2367,26.2,1896.0
4858262119,0,13,1,1,2,8,2,0,0,0,0,15218,6.6,16724,244,56,-1835,-607,30.0,1521.8,17,2,0,8,2,11,1,1,0,0,17053,6.8,17331,226,48,1835,607,27.4,1705.3
4858225883,1,13,1,1,7,8,6,1,1,0,0,17207,7.0,18281,204,68,879,1963,27.2,1720.7,12,2,0,8,7,10,0,0,0,0,16328,6.4,16318,191,50,-879,-1963,24.1,1632.8
4857321109,0,17,0,0,11,7,14,1,0,1,0,18340,6.6,16895,186,52,1622,646,23.8,1834.0,14,2,1,7,11,8,0,0,0,0,16718,6.4,16249,187,52,-1622,-646,23.9,1671.8
4857252280,0,17,2,1,6,3,9,0,0,0,0,16149,6.8,16948,208,44,-29,-2724,25.2,1614.9,80,5,0,3,6,1,1,1,0,0,16178,7.4,19672,220,56,29,2724,27.6,1617.8
4857198748,0,11,1,0,10,10,4,0,0,0,0,18023,7.4,18971,196,63,-84,865,25.9,1802.3,14,1,1,10,10,8,1,1,0,0,18107,6.8,18106,178,52,84,-865,23.0,1810.7
4857053894,1,14,0,0,4,8,3,1,1,0,0,16380,6.6,17242,205,44,-983,465,24.9,1638.0,35,0,1,8,4,11,0,0,0,0,17363,6.4,16777,232,40,983,-465,27.2,1736.3
4857014212,0,34,1,1,4,3,5,0,0,0,0,15819,6.8,17141,207,55,941,132,26.2,1581.9,30,0,0,3,4,2,1,1,0,0,14878,6.8,17009,196,43,-941,-132,23.9,1487.8
4856984962,0,12,1,1,5,4,5,1,1,0,0,15892,6.8,17917,204,56,55,-405,26.0,1589.2,12,3,0,4,5,2,1,0,1,0,15837,7.0,18322,213,64,-55,405,27.7,1583.7
4856966750,0,17,2,1,2,5,0,0,0,0,0,14413,7.0,18541,238,48,-2708,-1611,28.6,1441.3,16,1,0,5,2,2,1,1,0,0,17121,7.4,20152,256,83,2708,1611,33.9,1712.1
4856899625,0,0,0,0,39,35,98,0,0,0,0,39192,12.0,46069,99,0,-2007,-2448,9.9,3919.2,0,0,1,35,39,75,0,0,0,0,41199,12.4,48517,96,0,2007,2448,9.6,4119.9
4855893890,0,17,2,0,5,10,4,0,0,0,0,15950,6.8,17799,180,48,-2055,254,22.8,1595.0,16,1,1,10,5,19,0,0,0,0,18005,6.8,17545,167,60,2055,-254,22.7,1800.5
4855852546,1,13,0,1,11,7,9,1,1,0,0,18832,6.6,17271,236,44,2143,-511,28.0,1883.2,20,2,0,7,11,7,0,0,0,0,16689,6.8,17782,173,48,-2143,511,22.1,1668.9
4855288337,0,16,2,0,3,5,3,1,1,0,0,14264,6.4,15666,165,44,-3137,-1137,20.9,1426.4,12,1,1,5,3,4,0,0,0,0,17401,6.4,16803,230,24,3137,1137,25.4,1740.1
4855239445,1,13,2,1,4,3,1,1,1,0,0,16705,7.0,18492,224,68,1213,475,29.2,1670.5,15,1,0,3,4,3,0,0,0,0,15492,6.8,18017,210,48,-1213,-475,25.8,1549.2
4855187880,0,13,2,0,4,7,6,0,0,0,0,13931,6.4,16106,117,56,-3107,-2169,17.3,1393.1,8,0,1,7,4,8,0,0,0,0,17038,6.8,18275,211,54,3107,2169,26.5,1703.8
4855122126,0,54,1,0,6,4,5,0,0,0,0,15588,6.6,17202,180,44,-1057,-282,22.4,1558.8,8,1,1,4,6,5,0,0,0,0,16645,6.8,17484,219,44,1057,282,26.3,1664.5
4854041202,1,12,1,1,4,1,5,0,0,0,0,17477,7.0,18411,227,48,2887,592,27.5,1747.7,13,2,0,1,4,1,0,0,0,0,14590,6.8,17819,212,48,-2887,-592,26.0,1459.0
4853996928,0,23,1,1,5,3,3,0,0,0,0,15786,7.0,17793,206,45,-732,301,25.1,1578.6,13,0,0,3,5,1,0,0,0,0,16518,6.6,17492,206,41,732,-301,24.7,1651.8
4853924351,1,10,1,0,3,5,3,0,0,0,0,14580,6.8,17633,178,56,-1830,-687,23.4,1458.0,12,1,1,5,3,4,0,0,0,0,16410,6.8,18320,201,54,1830,687,25.5,1641.0
4851999909,1,16,1,0,3,3,7,1,1,0,0,15913,6.6,17579,213,52,-1445,-1446,26.5,1591.3,15,2,1,3,3,1,0,0,0,0,17358,7.0,19025,262,63,1445,1446,32.5,1735.8
4851960132,1,13,0,1,4,3,4,1,1,0,0,16252,7.2,18230,215,71,290,-19,28.6,1625.2,120,1,0,3,4,1,1,0,1,0,15962,7.0,18249,237,52,-290,19,28.9,1596.2
4815225265,1,12,1,1,6,4,6,1,1,0,0,17915,7.2,18969,239,68,2580,877,30.7,1791.5,13,1,0,4,6,3,0,0,0,0,15335,6.8,18092,217,72,-2580,-877,28.9,1533.5
4815163610,0,15,1,1,5,5,7,0,0,0,0,16197,6.8,17883,213,64,-398,-390,27.7,1619.7,13,3,0,5,5,4,0,0,0,0,16595,6.8,18273,239,60,398,390,29.9,1659.5
4813645329,1,15,3,1,10,3,7,1,1,0,0,19876,7.2,18775,202,60,5165,2226,26.2,1987.6,17,1,0,3,10,2,0,0,0,0,14711,6.8,16549,195,44,-5165,-2226,23.9,1471.1
4813636196,1,18,2,1,8,7,9,0,0,0,0,16697,6.8,17313,216,37,-159,905,25.3,1669.7,13,4,0,7,8,6,0,0,0,0,16856,6.6,16408,170,54,159,-905,22.4,1685.6
4813624918,1,12,2,1,10,2,9,0,0,0,0,20057,7.4,19681,255,63,6425,3597,31.8,2005.7,11,0,0,2,10,3,0,0,0,0,13632,6.4,16084,169,48,-6425,-3597,21.7,1363.2
4813613905,1,16,1,1,8,3,7,0,0,0,0,17812,7.0,18529,225,48,2109,2339,27.3,1781.2,14,2,0,3,8,3,0,0,0,0,15703,6.4,16190,191,52,-2109,-2339,24.3,1570.3
4798755130,0,10,0,0,11,8,12,0,0,0,0,17528,6.8,16748,178,44,-1,-909,22.2,1752.8,10,1,1,8,11,4,1,1,0,0,17529,6.8,17657,192,64,1,909,25.6,1752.9
4797582387,1,13,2,0,9,7,8,1,1,0,0,18013,6.4,16773,190,60,182,-1153,25.0,1801.3,24,0,1,7,9,4,0,0,0,0,17831,6.8,17926,220,48,-182,1153,26.8,1783.1
4797531150,1,11,3,1,5,5,6,0,0,0,0,15822,7.0,18333,236,55,-366,609,29.1,1582.2,10,0,0,4,4,5,0,0,0,0,16188,6.8,17724,239,48,366,-609,28.7,1618.8
4797513743,1,11,1,1,7,2,6,1,1,0,0,17027,7.0,18499,233,54,1878,1411,28.7,1702.7,13,0,0,2,7,2,0,0,0,0,15149,6.6,17088,241,55,-1878,-1411,29.6,1514.9
4797488338,1,12,1,1,6,6,8,0,0,0,0,16774,7.2,17488,229,55,445,-1029,28.4,1677.4,15,1,0,6,6,2,1,1,0,0,16329,7.0,18517,220,57,-445,1029,27.7,1632.9
4797456602,0,11,0,0,2,4,2,0,0,0,0,15152,7.0,18515,230,55,-1560,-532,28.5,1515.2,14,0,1,4,2,2,0,0,0,0,16712,7.2,19047,241,72,1560,532,31.3,1671.2
4797434465,0,56,1,0,3,7,4,0,0,0,0,15201,7.0,18234,202,67,-2441,-747,26.9,1520.1,13,3,1,7,3,5,1,1,0,0,17642,7.4,18981,218,67,2441,747,28.5,1764.2
4796967575,0,11,2,1,10,8,16,0,0,0,0,19320,6.6,16071,196,46,337,-1295,24.2,1932.0,15,2,0,8,10,12,1,1,0,0,18983,6.6,17366,208,49,-337,1295,25.7,1898.3
4796911734,1,13,13,1,11,4,14,1,0,1,0,19964,7.6,19785,242,60,3830,1293,30.2,1996.4,35,1,0,4,11,6,0,0,0,0,16134,7.2,18492,221,64,-3830,-1293,28.5,1613.4
4796879864,0,12,3,0,10,6,14,0,0,0,0,19496,6.8,18293,248,44,2084,168,29.2,1949.6,12,4,1,6,10,12,0,0,0,0,17412,7.0,18125,204,64,-2084,-168,26.8,1741.2
4792777499,1,17,0,1,3,4,4,1,1,0,0,15928,7.0,18201,222,52,253,990,27.4,1592.8,20,1,0,4,3,7,0,0,0,0,15675,6.8,17211,206,63,-253,-990,26.9,1567.5
4792754567,0,12,0,1,6,10,5,0,0,0,0,16814,6.4,17090,201,36,-1400,-1927,23.7,1681.4,9,1,0,10,6,5,0,0,0,0,18214,7.2,19017,209,68,1400,1927,27.7,1821.4
4850911061,1,35,2,0,5,7,4,0,0,0,0,16504,6.8,17933,231,72,-329,-337,30.3,1650.4,38,2,1,7,5,4,1,1,0,0,16833,7.0,18270,208,64,329,337,27.2,1683.3
4849734086,1,16,3,1,8,3,8,0,0,0,0,20332,7.0,19024,257,57,6512,1220,31.4,2033.2,70,0,0,2,7,1,0,0,0,0,13820,6.8,17804,204,44,-6512,-1220,24.8,1382.0
4848692809,1,11,1,1,8,6,5,0,0,0,0,18776,7.0,17583,207,52,1815,-413,25.9,1877.6,13,1,0,6,8,5,1,1,0,0,16961,7.2,17996,217,68,-1815,413,28.5,1696.1
4846100612,1,16,1,0,4,7,7,0,0,0,0,16482,6.8,17088,233,52,-806,156,28.5,1648.2,17,3,1,7,4,10,0,0,0,0,17288,6.6,16932,228,59,806,-156,28.7,1728.8
4846074810,0,14,3,0,3,7,3,0,0,0,0,16239,6.4,15913,187,56,-1297,-1337,24.3,1623.9,13,2,1,7,3,5,1,1,0,0,17536,6.8,17250,236,52,1297,1337,28.8,1753.6
4843982890,0,13,1,0,8,3,7,1,1,0,0,18240,7.0,18214,246,52,2091,1022,29.8,1824.0,12,0,1,3,8,3,0,0,0,0,16149,6.8,17192,208,63,-2091,-1022,27.1,1614.9
4841478951,0,12,0,1,3,9,2,0,0,0,0,14776,6.6,16465,176,83,-2605,-1623,25.9,1477.6,18,2,0,9,3,7,0,0,0,0,17381,7.2,18088,223,52,2605,1623,27.5,1738.1
4837833195,1,14,1,1,8,4,11,1,1,0,0,18909,6.8,18171,246,52,1539,-933,29.8,1890.9,22,2,0,4,8,6,1,0,1,0,17370,6.8,19104,259,49,-1539,933,30.8,1737.0
4831062514,1,13,3,1,10,2,12,1,1,0,0,18291,6.8,16978,241,59,3475,717,30.0,1829.1,12,0,0,2,10,1,1,0,1,0,14816,6.6,16261,180,48,-3475,-717,22.8,1481.6
4831020592,0,25,0,0,3,11,4,0,0,0,0,13986,6.4,15864,193,52,-6192,-2744,24.5,1398.6,13,0,1,11,3,14,0,0,0,0,20178,7.2,18608,223,46,6192,2744,26.9,2017.8
4830999858,1,11,2,1,10,3,13,1,1,0,0,19279,7.0,18878,230,56,3683,1199,28.6,1927.9,14,0,0,2,9,2,0,0,0,0,15596,6.8,17679,229,52,-3683,-1199,28.1,1559.6
4830968298,0,14,2,0,7,5,5,0,0,0,0,16910,7.2,18685,218,59,343,118,27.7,1691.0,22,1,1,4,6,4,0,0,0,0,16567,7.0,18567,247,63,-343,-118,31.0,1656.7
4830284145,1,32,1,0,6,5,6,0,0,0,0,17555,7.0,17893,239,52,946,-82,29.1,1755.5,14,2,1,5,6,8,2,1,1,0,16609,6.8,17975,225,54,-946,82,27.9,1660.9
4828173156,0,33,2,1,5,7,5,0,0,0,0,17793,7.0,18208,243,50,248,712,29.3,1779.3,80,10,0,7,5,7,1,0,1,0,17545,6.8,17496,192,53,-248,-712,24.5,1754.5
4824690331,1,20,2,1,4,1,3,1,0,1,0,17248,6.8,17462,224,56,1887,166,28.0,1724.8,12,1,0,1,4,2,1,1,0,0,15361,6.6,17296,236,56,-1887,-166,29.2,1536.1
4824633542,1,17,2,1,4,0,6,1,1,0,0,16675,7.4,20376,254,56,2011,1471,31.0,1667.5,16,4,0,0,4,0,0,0,0,0,14664,7.2,18905,236,72,-2011,-1471,30.8,1466.4
4824597161,0,13,1,1,4,4,9,1,1,0,0,16270,7.2,19020,218,66,-939,392,28.4,1627.0,19,3,0,4,4,4,1,0,1,0,17209,7.0,18628,275,62,939,-392,33.7,1720.9
4823331153,1,13,1,1,2,2,1,0,0,0,0,15268,7.0,18413,257,56,1116,552,31.3,1526.8,16,0,0,1,1,0,0,0,0,0,14152,6.8,17861,237,54,-1116,-552,29.1,1415.2
4822314684,1,15,1,0,5,3,3,0,0,0,0,16945,7.2,19730,250,64,1376,1239,31.4,1694.5,9,3,1,3,5,4,0,0,0,0,15569,7.2,18491,229,56,-1376,-1239,28.5,1556.9
4821275500,0,13,2,0,0,6,0,0,0,0,0,14516,7.0,17620,241,67,-2562,-900,30.8,1451.6,15,2,1,6,0,13,2,1,1,0,17078,7.2,18520,255,56,2562,900,31.1,1707.8
4853793260,0,10,5,1,9,4,10,1,1,0,0,19058,7.2,19087,227,52,3005,626,27.9,1905.8,13,1,0,4,9,2,1,0,1,0,16053,6.8,18461,242,72,-3005,-626,31.4,1605.3
4853724729,1,18,17,0,2,3,2,0,0,0,0,15404,7.0,18363,238,41,-1014,-95,27.9,1540.4,41,2,1,3,2,1,1,1,0,0,16418,7.0,18458,233,58,1014,95,29.1,1641.8
4852322714,1,12,1,1,6,3,8,1,1,0,0,16493,6.8,18015,219,66,1108,77,28.5,1649.3,13,2,0,3,6,3,0,0,0,0,15385,7.0,17938,231,55,-1108,-77,28.6,1538.5
4852312908,1,23,2,1,7,6,5,0,0,0,0,17939,7.2,19886,225,84,943,2170,30.9,1793.9,14,3,0,6,7,9,0,0,0,0,16996,6.8,17716,222,52,-943,-2170,27.4,1699.6
4851837264,1,11,2,1,8,4,6,1,1,0,0,18689,7.0,18038,200,56,3461,840,25.6,1868.9,14,1,0,4,8,3,0,0,0,0,15228,6.8,17198,207,52,-3461,-840,25.9,1522.8
4851637739,1,21,2,1,12,10,11,0,0,0,0,19209,7.2,19214,221,56,479,1023,27.7,1920.9,13,0,0,10,12,11,0,0,0,0,18730,6.8,18191,213,55,-479,-1023,26.8,1873.0
4851286400,0,10,2,1,6,8,9,1,1,0,0,15682,6.8,16633,194,52,-2001,-2576,24.6,1568.2,12,2,0,8,6,4,0,0,0,0,17683,7.0,19209,243,55,2001,2576,29.8,1768.3
4851276120,1,14,2,0,4,5,4,0,0,0,0,16594,7.0,18051,243,59,-21,-293,30.2,1659.4,14,2,1,5,4,4,1,1,0,0,16615,7.0,18344,234,52,21,293,28.6,1661.5
4850671544,0,23,2,1,5,7,2,0,0,0,0,16700,7.0,18818,230,68,-255,709,29.8,1670.0,15,0,0,7,5,4,1,1,0,0,16955,7.0,18109,212,60,255,-709,27.2,1695.5
4850641492,1,12,12,1,6,6,5,1,1,0,0,16099,6.6,16804,229,39,-1627,-1983,26.8,1609.9,36,2,0,6,6,4,1,0,1,0,17726,7.0,18787,242,62,1627,1983,30.4,1772.6
4849472282,1,14,2,0,5,6,7,0,0,0,0,16736,7.2,18560,241,68,1278,1970,30.9,1673.6,154,1,1,6,5,8,1,1,0,0,15458,6.6,16590,163,48,-1278,-1970,21.1,1545.8
4849250708,1,0,6,1,33,22,95,0,0,0,1,38864,11.6,43196,103,0,1234,4085,10.3,3886.4,27,0,0,22,33,62,0,0,0,0,37630,10.8,39111,99,0,-1234,-4085,9.9,3763.0
4849241280,1,0,4,0,27,32,57,0,0,0,2,40235,11.2,41455,122,0,146,-3936,12.2,4023.5,35,0,1,32,27,85,0,0,0,0,40089,11.6,45391,100,0,-146,3936,10.0,4008.9
4849226487,0,0,0,1,18,27,34,0,0,0,1,35188,10.4,36972,107,0,-1621,-3791,10.7,3518.8,0,0,0,27,18,77,0,0,0,0,36809,11.2,40763,121,0,1621,3791,12.1,3680.9
4849212678,1,0,0,1,22,20,58,0,0,0,0,36009,11.0,40417,114,0,37,1469,11.4,3600.9,0,0,0,20,22,52,0,0,0,0,35972,11.0,38948,111,0,-37,-1469,11.1,3597.2
4849191070,1,0,0,0,21,24,49,0,0,0,1,37096,11.4,41901,117,0,-281,1556,11.7,3709.6,0,0,1,24,21,75,0,0,0,0,37377,11.0,40345,95,0,281,-1556,9.5,3737.7
4849169041,1,16,26,1,24,16,56,0,0,0,0,37229,11.0,39875,107,0,487,1063,10.7,3722.9,23,0,0,16,24,37,0,0,0,0,36742,11.0,38812,118,0,-487,-1063,11.8,3674.2
4849152176,0,0,0,1,15,28,28,0,0,0,1,34840,11.0,38018,100,0,-3145,-3155,10.0,3484.0,10,0,0,28,15,56,0,0,0,0,37985,11.2,41173,118,0,3145,3155,11.8,3798.5
4849129089,1,17,0,0,24,14,69,0,0,0,1,38015,11.0,39663,101,0,3301,3102,10.1,3801.5,5,0,1,14,24,32,0,0,0,0,34714,10.2,36561,116,0,-3301,-3102,11.6,3471.4
4848837133,1,14,0,0,6,6,11,1,1,0,0,16681,6.8,17162,223,40,-1017,-911,26.3,1668.1,15,1,1,6,6,7,0,0,0,0,17698,7.2,18073,230,52,1017,911,28.2,1769.8
4858068407,1,0,0,1,16,8,17,0,0,0,0,45608,10.6,50500,0,0,20208,22000,0.0,4560.8,0,0,0,3,11,3,0,0,0,0,25400,6.0,28500,0,0,-20208,-22000,0.0,2540.0
4856318152,0,78,0,1,17,13,44,0,0,0,1,35847,10.8,37383,111,0,2264,-435,11.1,3584.7,0,0,0,13,17,32,0,0,0,0,33583,10.6,37818,90,0,-2264,435,9.0,3358.3
4856276380,1,39,0,1,15,18,47,0,0,0,0,34417,10.6,36702,96,0,-932,-569,9.6,3441.7,17,0,0,18,15,48,0,0,0,0,35349,10.6,37271,102,0,932,569,10.2,3534.9
4855943385,1,10,1,1,3,5,0,1,0,1,0,15585,7.0,18236,222,68,-793,255,29.0,1558.5,13,2,0,5,3,6,0,0,0,0,16378,6.8,17981,204,44,793,-255,24.8,1637.8
4855910860,1,10,1,1,3,1,3,0,0,0,0,15981,7.0,19422,247,68,1228,1356,31.5,1598.1,11,1,0,1,3,0,0,0,0,0,14753,6.6,18066,234,60,-1228,-1356,29.4,1475.3
4855295754,0,310,0,0,38,38,113,0,0,0,2,41501,12.6,49429,99,0,-1987,-531,9.9,4150.1,0,17,1,38,38,101,0,0,0,0,43488,12.4,49960,110,0,1987,531,11.0,4348.8
4855257835,1,22,0,1,10,2,9,0,0,0,0,19328,7.4,19702,242,60,3773,3243,30.2,1932.8,70,2,0,2,10,3,0,0,0,0,15555,6.8,16459,185,44,-3773,-3243,22.9,1555.5
4855202302,1,75,0,1,7,9,8,0,0,0,0,16921,6.6,16441,210,32,56,-816,24.2,1692.1,22,1,0,9,7,6,0,0,0,0,16865,6.8,17257,188,57,-56,816,24.5,1686.5
4855174160,1,11,1,1,7,2,7,0,0,0,0,17512,7.4,19561,200,52,1897,866,25.2,1751.2,16,2,0,2,7,3,0,0,0,0,15615,7.0,18695,244,60,-1897,-866,30.4,1561.5
4855139193,1,0,2,0,24,33,65,0,0,0,0,35825,10.8,38532,116,0,-5334,-6395,11.6,3582.5,2,0,1,33,24,97,0,0,0,0,41159,11.8,44927,110,0,5334,6395,11.0,4115.9
4855106507,1,0,0,0,34,29,96,0,0,0,2,41688,11.8,44901,114,0,2433,964,11.4,4168.8,0,0,1,29,34,74,0,0,0,0,39255,11.6,43937,94,0,-2433,-964,9.4,3925.5
4855069833,1,14,0,1,34,22,94,0,0,0,2,43659,12.0,47617,112,0,7610,9066,11.2,4365.9,0,3,0,22,34,47,0,0,0,0,36049,10.8,38551,78,0,-7610,-9066,7.8,3604.9
4854690226,1,53,0,0,2,10,2,1,1,0,0,14372,7.0,17539,172,60,-5424,-2078,23.2,1437.2,11,2,1,10,2,8,0,0,0,0,19796,7.4,19617,273,56,5424,2078,32.9,1979.6
4854662468,0,16,1,0,5,11,1,0,0,0,0,14569,6.4,15824,157,52,-4391,-2367,20.9,1456.9,19,2,1,11,5,9,2,1,1,0,18960,7.0,18191,226,36,4391,2367,26.2,1896.0
4853590979,1,16,2,0,5,6,4,0,0,0,0,17340,7.4,19330,224,76,-759,801,30.0,1734.0,18,1,1,6,5,6,0,0,0,0,18099,7.0,18529,235,51,759,-801,28.6,1809.9
4853558616,1,24,0,1,12,5,10,0,0,0,0,19920,7.6,19658,212,60,3575,1735,27.2,1992.0,14,0,0,5,12,2,1,1,0,0,16345,6.8,17923,207,64,-3575,-1735,27.1,1634.5
4853507252,1,10,2,0,8,7,7,0,0,0,0,17956,7.2,18524,212,52,140,19,26.4,1795.6,14,0,1,7,8,4,1,1,0,0,17816,7.2,18505,205,60,-140,-19,26.5,1781.6
4853108892,0,2,4,1,25,31,71,0,0,0,1,38182,11.0,39462,107,0,-1332,-3993,10.7,3818.2,20,0,0,31,25,96,0,0,0,0,39514,11.4,43455,90,0,1332,3993,9.0,3951.4
4853081611,0,68,0,0,29,27,85,0,0,0,1,40124,11.8,44573,96,0,222,3435,9.6,4012.4,0,0,1,27,29,73,0,0,0,0,39902,11.2,41138,124,0,-222,-3435,12.4,3990.2
4853052698,1,10,0,1,8,6,8,1,1,0,0,17665,7.2,18781,230,72,1911,1371,30.2,1766.5,8,1,0,6,8,6,0,0,0,0,15754,6.8,17410,180,44,-1911,-1371,22.4,1575.4
4856726441,1,13,2,1,11,8,7,0,0,0,0,19434,7.0,17552,203,60,1411,-444,26.3,1943.4,12,0,0,8,11,4,1,1,0,0,18023,7.0,17996,205,60,-1411,444,26.5,1802.3
4856718022,0,15,1,0,1,8,0,0,0,0,0,14273,6.6,16252,207,52,-2916,-956,25.9,1427.3,8,3,1,8,1,9,1,1,0,0,17189,6.6,17208,203,56,2916,956,25.9,1718.9
4839879107,0,8,2,0,5,5,4,0,0,0,0,16366,7.2,18693,219,64,-571,332,28.3,1636.6,19,1,1,5,5,5,0,0,0,0,16937,6.8,18361,219,60,571,-332,27.9,1693.7
4839757082,0,12,4,0,3,3,1,0,0,0,0,14991,6.8,17518,187,74,545,-89,26.1,1499.1,15,2,1,3,3,1,1,1,0,0,14446,6.8,17607,194,61,-545,89,25.5,1444.6
4839738453,0,11,3,1,1,3,1,0,0,0,0,15740,6.8,17608,216,60,-308,-1433,27.6,1574.0,10,0,0,3,1,5,1,1,0,0,16048,7.4,19041,218,64,308,1433,28.2,1604.8
4839711709,1,8,0,1,7,9,4,0,0,0,0,16032,6.8,17764,214,55,-2992,-1548,26.9,1603.2,10,1,0,9,7,8,0,0,0,0,19024,7.2,19312,223,68,2992,1548,29.1,1902.4
4839693434,0,13,2,0,7,8,11,0,0,0,0,16707,6.8,16972,190,36,-264,-1029,22.6,1670.7,16,1,1,8,7,3,2,1,1,0,16971,7.0,18001,232,56,264,1029,28.8,1697.1
4838521734,1,0,0,0,29,21,76,0,0,0,0,39251,11.6,43156,115,0,2395,3944,11.5,3925.1,0,0,1,21,29,44,0,0,0,0,36856,10.8,39212,81,0,-2395,-3944,8.1,3685.6
4838515455,0,62,0,1,20,15,40,0,0,0,2,35931,10.8,38427,88,0,-1027,-302,8.8,3593.1,0,0,0,15,20,41,0,0,0,0,36958,11.0,38729,111,0,1027,302,11.1,3695.8
4838505592,1,11,0,0,9,20,22,0,0,0,0,32399,10.0,34130,116,0,-4432,-5669,11.6,3239.9,0,2,1,20,9,56,0,0,0,0,36831,11.0,39799,99,0,4432,5669,9.9,3683.1
4838494599,0,0,0,0,15,30,29,0,0,0,1,35046,11.0,39987,81,0,-4269,-1688,8.1,3504.6,0,0,1,30,15,93,0,0,0,0,39315,11.2,41675,111,0,4269,1688,11.1,3931.5
4838486879,1,0,0,1,21,24,64,0,0,0,1,37971,11.0,39840,117,0,2994,-446,11.7,3797.1,0,0,0,24,21,38,0,0,0,0,34977,11.2,40286,89,0,-2994,446,8.9,3497.7
4838472186,1,0,0,0,31,20,95,0,0,0,0,38211,11.4,43070,97,0,2481,5956,9.7,3821.1,0,0,1,20,31,51,0,0,0,0,35730,10.6,37114,81,0,-2481,-5956,8.1,3573.0
4838454486,0,0,0,1,26,16,61,0,0,0,1,39464,11.4,42907,111,0,2433,3136,11.1,3946.4,0,0,0,16,26,35,0,0,0,0,37031,11.0,39771,101,0,-2433,-3136,10.1,3703.1
4838438529,0,0,0,0,17,34,39,0,0,0,0,35387,11.0,38902,99,0,-3769,-3496,9.9,3538.7,15,0,1,34,17,100,0,0,0,0,39156,11.4,42398,109,0,3769,3496,10.9,3915.6
4838418197,0,4,1,0,13,21,26,0,0,0,1,34021,10.6,36719,87,0,-3743,-3683,8.7,3402.1,8,2,1,21,13,52,0,0,0,0,37764,11.0,40402,119,0,3743,3683,11.9,3776.4
4838398152,1,0,0,0,32,20,98,0,0,0,0,39879,11.4,42688,122,0,4558,4519,12.2,3987.9,0,0,1,20,32,40,0,0,0,0,35321,10.8,38169,95,0,-4558,-4519,9.5,3532.1
4838368191,0,0,0,1,16,14,40,0,0,0,0,34775,10.6,38055,97,0,1011,-465,9.7,3477.5,0,0,0,14,16,24,0,0,0,0,33764,10.6,38520,111,0,-1011,465,11.1,3376.4
4836263909,0,11,3,1,4,7,3,0,0,0,0,15467,6.6,17053,213,51,-1853,-727,26.4,1546.7,14,1,0,7,4,8,0,0,0,0,17320,7.0,17780,226,44,1853,727,27.0,1732.0
4836234694,0,11,2,0,3,7,1,1,1,0,0,14971,6.8,17029,217,53,-3193,-1220,27.0,1497.1,15,0,1,7,3,11,1,0,1,0,18164,7.0,18249,211,54,3193,1220,26.5,1816.4
4853649891,1,13,10,0,4,7,2,1,1,0,0,15072,6.6,17161,191,54,-2101,-1259,24.5,1507.2,35,0,1,7,4,5,0,0,0,0,17173,7.4,18420,216,56,2101,1259,27.2,1717.3
4853610074,1,135,1,0,5,6,4,0,0,0,0,17348,7.2,18801,209,72,575,1363,28.1,1734.8,11,0,1,6,5,8,0,0,0,0,16773,6.6,17438,229,60,-575,-1363,28.9,1677.3
4848051762,1,12,2,0,12,8,10,1,1,0,0,20205,7.0,18505,222,48,1279,2059,27.0,2020.5,35,0,1,8,12,11,1,0,1,0,18926,6.8,16446,195,51,-1279,-2059,24.6,1892.6
4848015905,1,23,1,1,11,5,15,1,1,0,0,18988,7.2,18695,222,52,2218,1860,27.4,1898.8,15,3,0,5,11,5,0,0,0,0,16770,6.6,16835,207,56,-2218,-1860,26.3,1677.0
4845768741,0,14,2,1,4,3,1,1,0,1,0,16681,7.2,19137,237,49,1135,-61,28.6,1668.1,11,1,0,3,4,5,0,0,0,0,15546,7.2,19198,230,53,-1135,61,28.3,1554.6
4845734645,0,12,2,0,1,9,2,0,0,0,0,13504,6.4,16425,197,40,-6142,-4809,23.7,1350.4,15,0,1,9,1,7,0,0,0,0,19646,7.6,21234,217,68,6142,4809,28.5,1964.6
4820813047,0,15,1,0,5,5,4,0,0,0,0,16054,7.0,17799,247,44,-425,-1176,29.1,1605.4,14,1,1,5,5,3,2,1,1,0,16479,7.0,18975,244,67,425,1176,31.1,1647.9
4820752815,0,16,2,0,4,6,5,0,0,0,0,16007,7.2,18625,217,55,-1151,953,27.2,1600.7,13,4,1,6,4,13,1,1,0,0,17158,7.0,17672,222,60,1151,-953,28.2,1715.8
4817660426,1,17,2,1,10,2,10,0,0,0,0,19427,7.2,19553,239,52,3993,1481,29.1,1942.7,14,0,0,2,10,3,1,1,0,0,15434,7.0,18072,231,72,-3993,-1481,30.3,1543.4
4812273578,1,13,0,0,7,5,9,0,0,0,0,17350,6.8,18050,229,44,-829,-548,27.3,1735.0,13,1,1,5,7,2,1,1,0,0,18179,7.0,18598,249,51,829,548,30.0,1817.9
4811991382,1,12,0,1,5,4,9,0,0,0,0,18289,7.2,18573,237,52,1781,-56,28.9,1828.9,13,1,0,4,5,3,0,0,0,0,16508,7.2,18629,238,68,-1781,56,30.6,1650.8
4809540944,0,15,1,0,4,6,4,0,0,0,0,15212,7.2,18335,187,52,-2937,-241,23.9,1521.2,13,1,1,6,4,4,1,1,0,0,18149,7.0,18576,239,56,2937,241,29.5,1814.9
4809505738,0,13,4,1,4,4,4,1,0,1,0,16108,7.0,18087,232,64,-1080,-1596,29.6,1610.8,12,3,0,4,4,2,1,1,0,0,17188,7.0,19683,232,68,1080,1596,30.0,1718.8
4806177169,0,12,0,0,8,5,9,0,0,0,0,16158,6.8,17194,177,55,302,-980,23.2,1615.8,10,1,1,5,8,2,0,0,0,0,15856,6.8,18174,230,54,-302,980,28.4,1585.6
4792346305,0,13,0,0,4,10,4,1,0,1,0,16090,6.8,17027,197,48,-2402,-1589,24.5,1609.0,9,2,1,10,4,10,0,0,0,0,18492,7.0,18616,223,52,2402,1589,27.5,1849.2
4788965105,1,13,4,1,4,5,8,0,0,0,0,16140,6.6,17057,224,52,-1083,-1322,27.6,1614.0,12,0,0,5,4,8,1,1,0,0,17223,7.0,18379,231,68,1083,1322,29.9,1722.3
4788929770,1,24,1,0,7,5,8,0,0,0,0,17319,7.0,18266,223,58,1602,77,28.1,1731.9,12,0,1,5,7,4,1,1,0,0,15717,7.0,18189,216,60,-1602,-77,27.6,1571.7
4788877345,1,8,2,1,5,8,4,0,0,0,0,16578,6.6,16561,221,52,-1316,-2445,27.3,1657.8,20,1,0,8,5,6,1,1,0,0,17894,7.2,19006,226,63,1316,2445,28.9,1789.4
4787988016,1,12,0,0,7,13,5,0,0,0,0,18130,7.2,19235,263,63,-1145,1543,32.6,1813.0,14,1,1,13,7,23,0,0,0,0,19275,7.0,17692,206,56,1145,-1543,26.2,1927.5
4854188941,1,15,3,1,7,1,9,0,0,0,0,19325,7.4,19998,237,57,4095,1823,29.4,1932.5,15,1,0,1,7,1,0,0,0,0,15230,6.8,18175,217,70,-4095,-1823,28.7,1523.0
4854145679,1,13,1,1,7,3,4,0,0,0,0,17321,7.2,18875,259,60,2154,1251,31.9,1732.1,14,0,0,3,7,2,0,0,0,0,15167,6.8,17624,226,60,-2154,-1251,28.6,1516.7
4852547065,1,5,0,1,14,19,14,0,0,0,0,45529,10.0,47500,0,0,16979,19000,0.0,4552.9,0,0,0,11,6,13,0,0,0,0,28550,6.0,28500,0,0,-16979,-19000,0.0,2855.0
4852515751,1,38,3,0,9,5,7,1,1,0,0,18733,7.0,18347,222,68,3203,1643,29.0,1873.3,30,2,1,5,9,3,0,0,0,0,15530,6.6,16704,191,60,-3203,-1643,25.1,1553.0
4851534922,0,16,3,0,3,3,6,0,0,0,0,17224,7.4,19498,266,60,1087,-222,32.6,1722.4,16,1,1,3,3,2,1,1,0,0,16137,7.4,19720,247,72,-1087,222,31.9,1613.7
4851499782,0,9,2,0,4,5,3,1,1,0,0,15236,7.0,17829,214,58,-1756,-1051,27.2,1523.6,12,1,1,5,4,7,0,0,0,0,16992,7.2,18880,246,68,1756,1051,31.4,1699.2
4851459960,0,12,1,0,2,3,1,0,0,0,0,16555,7.0,19458,230,72,344,216,30.2,1655.5,14,2,1,3,2,3,0,0,0,0,16211,7.2,19242,236,52,-344,-216,28.8,1621.1
4851447020,0,11,3,1,4,11,5,0,0,0,0,14553,6.6,15792,189,44,-5237,-1188,23.3,1455.3,20,3,0,11,4,12,0,0,0,0,19790,6.6,16980,214,40,5237,1188,25.4,1979.0
4851413642,1,15,2,1,13,2,10,1,1,0,0,19505,7.4,20053,240,60,4861,2674,30.0,1950.5,14,0,0,2,13,3,0,0,0,0,14644,6.8,17379,208,68,-4861,-2674,27.6,1464.4
4851148763,0,14,2,1,7,6,8,0,0,0,0,18559,7.0,17726,219,48,353,-789,26.7,1855.9,15,1,0,6,7,4,0,0,0,0,18206,7.2,18515,206,52,-353,789,25.8,1820.6
4851119293,0,36,1,1,4,6,4,0,0,0,0,15514,6.8,16757,214,56,-2562,-2128,27.0,1551.4,35,5,0,6,4,6,0,0,0,0,18076,7.0,18885,258,60,2562,2128,31.8,1807.6
4851081072,0,12,1,1,5,5,6,1,1,0,0,16671,6.6,17479,224,56,-407,-1160,28.0,1667.1,14,1,0,5,5,3,0,0,0,0,17078,7.0,18639,212,60,407,1160,27.2,1707.8
4851050290,0,56,3,1,2,3,3,0,0,0,0,15552,6.8,17299,216,56,-334,-1870,27.2,1555.2,34,12,0,3,2,3,0,0,0,0,15886,7.2,19169,234,52,334,1870,28.6,1588.6
4850021150,0,14,3,0,1,4,1,0,0,0,0,16318,7.4,19733,264,72,-699,-35,33.6,1631.8,26,2,1,4,1,2,1,0,1,0,17017,7.4,19768,238,64,699,35,30.2,1701.7
4849756732,1,16,1,0,11,7,11,2,1,1,0,19771,7.0,18747,216,48,3698,1753,26.4,1977.1,14,1,1,7,11,4,0,0,0,0,16073,6.8,16994,189,59,-3698,-1753,24.8,1607.3
4849715895,0,10,3,0,2,6,3,1,1,0,0,15677,6.8,17840,232,48,-1472,-1873,28.0,1567.7,10,0,1,6,2,3,0,0,0,0,17149,7.2,19713,226,68,1472,1873,29.4,1714.9
4849690101,0,13,2,0,0,8,0,0,0,0,0,13600,6.2,16077,213,64,-6324,-5674,27.7,1360.0,16,4,1,8,0,6,0,0,0,0,19924,7.8,21751,270,65,6324,5674,33.5,1992.4
4849659750,0,12,1,0,5,8,7,0,0,0,0,16781,6.6,16857,204,44,-1298,-1713,24.8,1678.1,12,4,1,8,5,9,1,1,0,0,18079,7.0,18570,224,56,1298,1713,28.0,1807.9
4849630636,0,10,0,0,10,13,9,2,1,1,0,18034,6.6,16400,203,44,-2142,-1743,24.7,1803.4,11,0,1,12,9,11,0,0,0,0,20176,7.0,18143,220,60,2142,1743,28.0,2017.6
4849613946,1,15,6,1,6,7,9,0,0,0,0,18113,7.0,18770,235,58,708,909,29.3,1811.3,14,2,0,7,6,14,0,0,0,0,17405,7.0,17861,236,60,-708,-909,29.6,1740.5
4857415691,1,39,1,1,14,21,18,0,0,0,0,61715,12.6,59500,2,0,22000,22000,0.2,6171.5,13,3,0,15,8,13,0,0,0,0,39715,7.8,37500,2,0,-22000,-22000,0.2,3971.5
4857387511,1,21,1,0,19,18,24,0,0,0,0,62010,12.0,55000,1,0,24110,22000,0.1,6201.0,0,0,1,11,12,13,0,0,0,0,37900,7.2,33000,0,0,-24110,-22000,0.0,3790.0
4857360049,1,414,0,0,14,22,15,0,0,0,0,46135,10.0,47500,1,0,16017,19000,0.1,4613.5,0,0,1,15,7,14,0,0,0,0,30118,6.0,28500,1,0,-16017,-19000,0.1,3011.8
4857290868,1,8,0,0,7,9,3,1,0,1,1,17892,6.8,17429,204,47,-1483,380,25.1,1789.2,21,2,1,9,7,18,1,1,0,0,19375,7.0,17049,192,55,1483,-380,24.7,1937.5
4857220210,1,13,4,1,13,10,19,1,0,1,0,21313,6.8,18069,219,48,1115,-404,26.7,2131.3,15,1,0,10,13,13,0,0,0,0,20198,6.8,18473,199,49,-1115,404,24.8,2019.8
4857065959,1,0,1,1,33,16,82,0,0,0,0,38808,11.8,44226,127,0,4270,6309,12.7,3880.8,84,0,0,16,33,32,0,0,0,0,34538,10.6,37917,94,0,-4270,-6309,9.4,3453.8
4857043933,1,306,3,1,21,11,48,0,0,0,0,34577,10.8,37821,110,0,1442,1978,11.0,3457.7,12,0,0,11,21,27,0,0,0,0,33135,10.4,35843,120,0,-1442,-1978,12.0,3313.5
4857026234,1,0,0,1,21,19,16,0,0,0,0,46345,10.0,47500,0,0,18130,19000,0.0,4634.5,96,0,0,9,11,11,0,0,0,0,28215,6.0,28500,0,0,-18130,-19000,0.0,2821.5
4856557960,1,0,0,1,19,16,17,0,0,0,0,61356,12.0,55000,0,0,24156,22000,0.0,6135.6,0,0,0,8,11,10,0,0,0,0,37200,7.2,33000,0,0,-24156,-22000,0.0,3720.0
4856537526,1,0,0,1,11,19,12,0,0,0,0,44900,10.2,48680,0,0,14900,17180,0.0,4490.0,0,0,0,12,4,10,0,0,0,0,30000,6.6,31500,0,0,-14900,-17180,0.0,3000.0
4856527096,1,0,1,1,23,15,25,0,0,0,0,48710,10.0,47500,5,0,21175,19000,0.5,4871.0,16,0,0,8,16,7,0,0,0,0,27535,6.0,28500,1,1,-21175,-19000,0.2,2753.5
4856511973,1,25,0,1,24,13,25,0,0,0,0,65322,12.8,61000,0,0,28822,28000,0.0,6532.2,0,0,0,7,18,6,0,0,0,0,36500,7.2,33000,0,0,-28822,-28000,0.0,3650.0
4856478570,1,41,10,1,12,19,17,0,0,0,0,60875,12.0,55000,9,0,23665,22000,0.9,6087.5,0,2,0,14,7,9,0,0,0,0,37210,7.2,33000,0,0,-23665,-22000,0.0,3721.0
4856456648,1,4,0,1,17,17,18,0,0,0,0,63450,12.0,55000,1,0,26250,22000,0.1,6345.0,0,0,0,11,11,8,0,0,0,0,37200,7.2,33000,0,0,-26250,-22000,0.0,3720.0
4856242752,1,108,0,1,19,13,60,0,0,0,0,35374,11.0,39903,111,0,-895,1712,11.1,3537.4,0,0,0,13,19,33,0,0,0,0,36269,10.6,38191,114,0,895,-1712,11.4,3626.9
4856187197,0,0,0,0,14,14,39,0,0,0,2,33575,10.0,34026,92,0,-703,-1677,9.2,3357.5,0,0,1,14,14,35,0,0,0,0,34278,10.2,35703,114,0,703,1677,11.4,3427.8
4855813493,1,0,0,0,20,20,20,0,0,0,0,47250,10.0,47500,0,0,18700,19000,0.0,4725.0,0,0,1,12,12,12,0,0,0,0,28550,6.0,28500,0,0,-18700,-19000,0.0,2855.0
4855800337,1,5,0,1,27,13,20,0,0,0,0,76700,15.0,70000,0,0,39500,34000,0.0,7670.0,0,0,0,5,19,5,0,0,0,0,37200,7.8,36000,0,0,-39500,-34000,0.0,3720.0
4855167257,0,15,0,0,6,9,4,0,0,0,0,16361,6.6,16640,209,52,-55,184,26.1,1636.1,9,2,1,9,6,9,0,0,0,0,16416,6.8,16456,186,44,55,-184,23.0,1641.6
4855108435,0,0,0,1,20,22,53,0,0,0,1,36554,11.0,39281,109,0,-474,-752,10.9,3655.4,0,0,0,22,20,63,0,0,0,0,37028,11.0,40033,125,0,474,752,12.5,3702.8
4858152872,1,0,0,1,14,17,17,0,0,0,0,45600,10.0,47500,0,0,18100,19000,0.0,4560.0,0,0,0,13,10,13,0,0,0,0,27500,6.0,28500,0,0,-18100,-19000,0.0,2750.0
4858127110,1,352,0,0,15,14,17,0,0,0,0,47350,10.4,49910,0,0,19500,21410,0.0,4735.0,0,0,1,8,9,7,0,0,0,0,27850,6.0,28500,0,0,-19500,-21410,0.0,2785.0
4857631411,1,22,1,1,6,5,6,0,0,0,0,16178,7.0,17553,175,64,1060,158,23.9,1617.8,11,0,0,5,6,2,0,0,0,0,15118,6.8,17395,174,44,-1060,-158,21.8,1511.8
4857619983,1,0,0,1,13,19,12,0,0,0,0,61650,12.4,57000,0,0,22700,24000,0.0,6165.0,5,0,0,14,8,14,0,0,0,0,38950,7.2,33000,0,0,-22700,-24000,0.0,3895.0
4857527451,1,12,1,0,7,4,6,1,1,0,0,16481,6.8,17686,183,51,-475,-1294,23.4,1648.1,12,0,1,4,7,2,0,0,0,0,16956,7.0,18980,214,52,475,1294,26.6,1695.6
4857493865,1,0,0,0,26,23,54,0,0,0,2,39487,11.6,43729,110,0,1827,3841,11.0,3948.7,0,0,1,23,26,40,0,0,0,0,37660,11.0,39888,102,0,-1827,-3841,10.2,3766.0
4857465904,1,0,0,0,15,17,36,0,0,0,0,34146,10.4,37406,102,0,-172,-705,10.2,3414.6,0,0,1,17,15,26,0,0,0,0,34318,10.6,38111,112,0,172,705,11.2,3431.8
4857403906,0,13,2,0,9,15,13,0,0,0,0,17572,6.0,14587,166,44,-2370,-2357,21.0,1757.2,12,2,1,15,9,19,0,0,0,0,19942,6.8,16944,193,55,2370,2357,24.8,1994.2
4857348670,0,35,0,0,2,5,2,0,0,0,0,14515,7.0,18340,201,68,-2412,-469,26.9,1451.5,11,4,1,5,2,4,1,1,0,0,16927,7.0,18809,208,56,2412,469,26.4,1692.7
4856643761,0,17,2,0,1,5,0,1,1,0,0,14327,6.8,17432,205,56,-2120,-1650,26.1,1432.7,10,1,1,5,1,4,0,0,0,0,16447,7.0,19082,213,48,2120,1650,26.1,1644.7
4856630030,0,12,0,0,3,6,1,0,0,0,0,14937,6.8,17396,199,48,-2927,-1842,24.7,1493.7,12,0,1,6,3,5,0,0,0,0,17864,7.0,19238,219,60,2927,1842,27.9,1786.4
4856607499,1,11,0,0,7,7,3,1,1,0,0,16174,6.8,18483,224,56,-355,283,28.0,1617.4,17,2,1,7,7,5,0,0,0,0,16529,7.0,18200,196,66,355,-283,26.2,1652.9
4856594016,0,14,2,1,2,4,1,0,0,0,0,14854,6.8,17867,215,52,-1471,-1979,26.7,1485.4,12,2,0,4,2,3,1,0,1,0,16325,7.4,19846,234,56,1471,1979,29.0,1632.5
4856574707,1,9,2,1,7,1,3,1,1,0,0,17507,7.2,19192,249,66,4070,3382,31.5,1750.7,11,1,0,1,7,0,0,0,0,0,13437,6.4,15810,194,37,-4070,-3382,23.1,1343.7
4856543834,1,0,0,1,23,11,22,0,0,0,0,63305,12.0,55000,0,0,27495,22000,0.0,6330.5,6,0,0,4,16,6,0,0,0,0,35810,7.2,33000,0,0,-27495,-22000,0.0,3581.0
4856515344,1,39,2,0,14,13,19,0,0,0,0,45020,10.0,47500,3,0,16745,19000,0.3,4502.0,17,6,1,10,11,5,0,0,0,0,28275,6.0,28500,0,0,-16745,-19000,0.0,2827.5
4856495352,1,0,0,1,21,17,17,0,0,0,0,54500,12.0,55000,0,0,21100,18000,0.0,5450.0,0,0,0,10,14,9,0,0,0,0,33400,8.0,37000,0,0,-21100,-18000,0.0,3340.0
4856356243,1,41,8,1,14,22,14,0,0,0,0,46395,10.0,47500,2,0,16770,19000,0.2,4639.5,0,5,0,14,6,13,0,0,0,0,29625,6.0,28500,0,0,-16770,-19000,0.0,2962.5
4856220758,0,0,0,1,19,21,64,0,0,0,0,34068,10.6,37226,83,0,-3681,-4527,8.3,3406.8,0,0,0,21,19,54,0,0,0,0,37749,11.4,41753,119,0,3681,4527,11.9,3774.9
4856183084,1,0,2,1,20,10,43,0,0,0,0,35195,10.8,37774,110,0,1545,1522,11.0,3519.5,224,0,0,9,19,14,0,0,0,0,33650,10.4,36252,107,0,-1545,-1522,10.7,3365.0
4831040102,1,15,3,0,4,5,6,0,0,0,0,17059,7.2,19215,244,74,155,1632,31.8,1705.9,19,3,1,5,4,6,0,0,0,0,16904,6.8,17583,210,56,-155,-1632,26.6,1690.4
4826335399,1,14,1,1,6,5,4,1,0,1,0,20266,7.2,19955,235,72,4136,3013,30.7,2026.6,13,1,0,5,6,6,1,1,0,0,16130,6.6,16942,182,56,-4136,-3013,23.8,1613.0
4824755941,0,19,2,1,10,9,10,0,0,0,0,17612,6.6,16593,185,53,-453,-1508,23.8,1761.2,13,4,0,9,10,5,0,0,0,0,18065,7.0,18101,215,54,453,1508,26.9,1806.5
4818775256,1,14,1,1,9,3,11,0,0,0,0,18392,6.8,17843,212,55,3011,589,26.7,1839.2,15,2,0,3,9,2,0,0,0,0,15381,6.6,17254,217,52,-3011,-589,26.9,1538.1
4818712418,0,11,1,0,5,1,7,0,0,0,0,16322,6.4,16495,236,40,1621,-1183,27.6,1632.2,9,1,1,1,5,2,1,1,0,0,14701,6.8,17678,207,56,-1621,1183,26.3,1470.1
4803775157,0,11,1,0,6,9,4,0,0,0,0,16584,6.8,17680,220,50,-1822,103,27.0,1658.4,13,2,1,9,6,12,0,0,0,0,18406,6.8,17577,243,48,1822,-103,29.1,1840.6
4803746256,1,10,0,1,6,6,7,0,0,0,0,18141,7.2,19317,263,68,1717,1707,33.1,1814.1,11,0,0,6,6,11,1,1,0,0,16424,6.8,17610,189,68,-1717,-1707,25.7,1642.4
4803674528,0,14,2,1,7,6,7,0,0,0,0,18132,6.6,17306,220,68,1251,-893,28.8,1813.2,22,1,0,6,7,8,0,0,0,0,16881,7.2,18199,215,66,-1251,893,28.1,1688.1
4803634030,1,22,2,1,3,3,3,0,0,0,0,17155,7.0,19067,229,70,1961,175,29.9,1715.5,9,2,0,3,3,3,1,1,0,0,15194,7.0,18892,231,54,-1961,-175,28.5,1519.4
4798873835,1,16,1,0,4,3,2,1,1,0,0,15839,6.6,17459,195,64,461,8,25.9,1583.9,12,0,1,3,4,1,0,0,0,0,15378,6.8,17451,200,56,-461,-8,25.6,1537.8
4798831548,0,12,0,1,9,5,9,0,0,0,0,18742,7.2,18654,217,60,2669,459,27.7,1874.2,10,1,0,5,9,2,1,1,0,0,16073,7.0,18195,247,48,-2669,-459,29.5,1607.3
4798794593,1,12,1,1,7,4,6,0,0,0,0,17873,7.0,18059,232,39,1841,-170,27.1,1787.3,38,2,0,4,7,4,0,0,0,0,16032,6.8,18229,199,57,-1841,170,25.6,1603.2
4798694369,1,11,1,1,9,4,6,0,0,0,0,19130,7.0,18914,223,58,2821,241,28.1,1913.0,12,1,0,4,9,3,1,0,1,0,16309,7.0,18673,200,57,-2821,-241,25.7,1630.9
4798665816,0,9,1,0,11,9,11,0,0,0,0,19324,7.0,18193,199,40,1604,25,23.9,1932.4,14,0,1,9,11,3,0,0,0,0,17720,7.0,18168,194,62,-1604,-25,25.6,1772.0
4798633226,0,10,0,1,4,9,5,0,0,0,0,16610,6.8,17473,218,59,-2030,-1069,27.7,1661.0,12,0,0,9,4,14,1,1,0,0,18640,7.2,18542,210,65,2030,1069,27.5,1864.0
4798606098,1,11,3,1,5,3,2,1,0,1,0,15892,7.2,18729,223,52,1232,1549,27.5,1589.2,13,1,0,3,5,3,0,0,0,0,14660,6.8,17180,207,60,-1232,-1549,26.7,1466.0
4798572112,1,11,2,1,8,4,5,0,0,0,0,19485,7.2,19129,247,56,3969,1585,30.3,1948.5,13,2,0,4,8,3,0,0,0,0,15516,6.8,17544,209,48,-3969,-1585,25.7,1551.6
4798523091,1,46,0,1,5,2,8,0,0,0,0,17233,6.8,17552,200,60,1929,534,26.0,1723.3,10,3,0,2,5,2,0,0,0,0,15304,6.8,17018,227,48,-1929,-534,27.5,1530.4
4797921138,1,10,0,0,3,4,4,1,1,0,0,15888,6.8,16812,193,52,-423,190,24.5,1588.8,19,2,1,4,3,7,0,0,0,0,16311,6.8,16622,219,52,423,-190,27.1,1631.1
4797887912,1,10,1,1,7,3,3,2,1,1,0,17126,7.4,19467,215,56,1606,1981,27.1,1712.6,13,3,0,3,7,3,0,0,0,0,15520,6.8,17486,194,58,-1606,-1981,25.2,1552.0
4846407949,0,12,1,1,8,13,10,0,0,0,0,16736,6.4,15647,171,40,-2212,-3097,21.1,1673.6,20,4,0,13,8,8,0,0,0,0,18948,7.2,18744,225,57,2212,3097,28.2,1894.8
4846391307,1,16,0,1,10,7,11,1,1,0,0,18972,7.0,18436,241,55,2192,660,29.6,1897.2,15,1,0,6,9,4,0,0,0,0,16780,7.0,17776,213,49,-2192,-660,26.2,1678.0
4843445485,1,14,1,0,7,5,9,0,0,0,0,19019,7.4,19511,249,59,1968,1235,30.8,1901.9,15,1,1,5,7,4,0,0,0,0,17051,7.2,18276,222,56,-1968,-1235,27.8,1705.1
4843375370,0,14,2,0,11,5,6,1,1,0,0,17898,6.8,17852,199,52,917,264,25.1,1789.8,21,3,1,5,11,3,0,0,0,0,16981,7.0,17588,207,53,-917,-264,26.0,1698.1
4843327567,1,10,3,1,10,9,11,2,1,1,0,20264,7.0,18199,213,48,359,-147,26.1,2026.4,24,0,0,9,10,9,0,0,0,0,19905,7.0,18346,193,60,-359,147,25.3,1990.5
4843287353,1,9,1,0,8,7,6,0,0,0,0,16951,7.2,18653,196,64,-138,511,26.0,1695.1,9,0,1,7,8,5,1,0,1,0,17089,6.8,18142,230,43,138,-511,27.3,1708.9
4767949719,1,22,1,0,4,1,4,2,1,1,0,16201,6.6,17852,213,63,873,1066,27.6,1620.1,11,3,1,1,4,1,0,0,0,0,15328,6.8,16786,229,55,-873,-1066,28.4,1532.8
4766674933,0,15,1,0,2,5,0,1,0,1,0,14486,6.6,16665,198,55,-3294,-2594,25.3,1448.6,14,3,1,5,2,4,1,1,0,0,17780,7.0,19259,245,72,3294,2594,31.7,1778.0
4766653686,1,56,3,1,7,3,10,0,0,0,0,17334,7.0,17966,208,57,1683,-160,26.5,1733.4,12,0,0,3,7,1,0,0,0,0,15651,7.0,18126,212,64,-1683,160,27.6,1565.1
4759886662,1,29,4,1,7,2,4,0,0,0,0,19261,7.4,20185,259,55,3800,3099,31.4,1926.1,14,1,0,2,7,2,1,1,0,0,15461,7.0,17086,206,51,-3800,-3099,25.7,1546.1
4759870684,1,13,0,1,3,1,1,0,0,0,0,15955,7.2,18851,230,64,1478,1979,29.4,1595.5,12,0,0,1,3,1,0,0,0,0,14477,6.4,16872,218,52,-1478,-1979,27.0,1447.7
4759837241,1,11,4,1,7,2,7,0,0,0,0,16634,6.8,17815,201,60,1182,538,26.1,1663.4,16,2,0,2,7,1,1,1,0,0,15452,6.8,17277,209,68,-1182,-538,27.7,1545.2
4759804395,1,17,1,0,10,8,9,0,0,0,0,19805,6.8,18392,220,59,1907,536,27.9,1980.5,15,0,1,8,10,12,1,1,0,0,17898,7.0,17856,209,60,-1907,-536,26.9,1789.8
4759767649,0,13,2,1,1,12,2,0,0,0,0,15113,6.8,16807,217,60,-6401,-3405,27.7,1511.3,9,4,0,12,1,16,0,0,0,0,21514,7.4,20212,255,67,6401,3405,32.2,2151.4
4759732051,0,13,0,0,6,11,3,0,0,0,0,15307,6.6,16825,195,40,-3475,-1410,23.5,1530.7,21,0,1,11,6,9,1,1,0,0,18782,6.8,18235,232,52,3475,1410,28.4,1878.2
4759709875,1,17,4,1,12,5,17,0,0,0,0,18509,7.0,17360,201,42,1494,1832,24.3,1850.9,16,1,0,5,12,9,0,0,0,0,17015,6.4,15528,197,48,-1494,-1832,24.5,1701.5
4759348049,0,15,4,0,1,9,1,0,0,0,0,13422,6.2,15509,196,48,-7694,-5172,24.4,1342.2,13,1,1,9,1,6,0,0,0,0,21116,7.4,20681,257,48,7694,5172,30.5,2111.6
4759332150,0,12,3,1,4,6,2,0,0,0,0,15644,6.0,15800,195,40,-2721,-2545,23.5,1564.4,11,2,0,6,4,6,1,1,0,0,18365,7.0,18345,260,52,2721,2545,31.2,1836.5
4755611516,1,12,2,1,9,1,12,0,0,0,0,19738,7.6,20932,251,84,5223,3733,33.5,1973.8,19,4,0,1,9,0,0,0,0,0,14515,6.8,17199,227,56,-5223,-3733,28.3,1451.5
4856369050,1,10,0,0,2,10,2,0,0,0,0,15402,6.8,17234,197,60,-3455,-2391,25.7,1540.2,195,1,1,10,2,6,1,1,0,0,18857,7.4,19625,226,63,3455,2391,28.9,1885.7
4853010954,0,14,3,0,7,7,13,1,1,0,0,17481,6.4,16030,208,50,187,-958,25.8,1748.1,14,1,1,7,7,11,0,0,0,0,17294,6.4,16988,238,48,-187,958,28.6,1729.4
4852945249,0,12,2,0,6,8,4,0,0,0,0,16811,6.8,17532,225,47,-1118,-1284,27.2,1681.1,14,4,1,8,6,6,1,1,0,0,17929,7.2,18816,260,56,1118,1284,31.6,1792.9
4847624382,0,70,0,0,5,5,3,1,0,1,0,18223,7.4,20218,236,72,-6,2127,30.8,1822.3,11,2,1,5,5,7,0,0,0,0,18229,6.8,18091,255,48,6,-2127,30.3,1822.9
4847599808,1,14,1,1,7,7,12,1,0,1,0,17489,6.6,17144,202,48,1081,-304,25.0,1748.9,11,0,0,7,7,6,0,0,0,0,16408,6.8,17448,174,44,-1081,304,21.8,1640.8
4833357682,0,53,3,0,2,2,3,0,0,0,0,16812,7.0,18401,230,72,1233,776,30.2,1681.2,12,1,1,2,2,1,0,0,0,0,15579,6.8,17625,233,63,-1233,-776,29.6,1557.9
4833004382,0,32,0,0,3,7,1,0,0,0,0,15160,6.8,18239,199,56,-859,1832,25.5,1516.0,45,0,1,7,3,6,0,0,0,0,16019,6.2,16407,167,55,859,-1832,22.2,1601.9
4832938285,1,12,0,0,8,2,8,1,1,0,0,17512,7.0,18280,222,55,2056,958,27.7,1751.2,120,0,1,2,8,2,0,0,0,0,15456,6.6,17322,238,44,-2056,-958,28.2,1545.6
4832900660,0,8,3,0,3,3,6,0,0,0,0,16343,7.0,18136,239,52,871,170,29.1,1634.3,11,1,1,3,3,1,0,0,0,0,15472,7.0,17966,230,60,-871,-170,29.0,1547.2
4831854948,1,18,1,0,11,7,11,0,0,0,0,18999,7.2,18211,198,54,1895,984,25.2,1899.9,224,3,1,7,11,5,0,0,0,0,17104,6.8,17227,194,44,-1895,-984,23.8,1710.4
4831844319,0,9,0,0,5,12,3,1,1,0,0,16362,6.6,17265,213,60,-4999,-1637,27.3,1636.2,15,0,1,12,5,14,0,0,0,0,21361,7.0,18902,246,53,4999,1637,29.9,2136.1
4831826052,1,12,1,1,6,2,7,2,1,1,0,17819,7.2,18764,239,47,2365,387,28.6,1781.9,14,0,0,2,6,1,0,0,0,0,15454,7.2,18377,234,66,-2365,-387,30.0,1545.4
4831806765,0,73,4,0,0,7,0,0,0,0,0,13552,6.4,16347,183,60,-4902,-3088,24.3,1355.2,14,4,1,7,0,8,0,0,0,0,18454,7.2,19435,258,64,4902,3088,32.2,1845.4
4831787015,0,114,3,0,5,6,4,0,0,0,0,16115,6.8,17124,204,60,-2727,-1418,26.4,1611.5,18,4,1,6,5,7,1,1,0,0,18842,6.8,18542,215,71,2727,1418,28.6,1884.2
4831771546,1,9,3,1,8,3,7,1,0,1,0,18242,7.2,19250,252,68,2977,1814,32.0,1824.2,14,0,0,3,8,2,1,1,0,0,15265,7.0,17436,255,48,-2977,-1814,30.3,1526.5
4831756103,0,16,3,1,3,5,5,0,0,0,0,15659,6.8,17094,223,60,-3017,-3293,28.3,1565.9,14,0,0,5,3,5,1,1,0,0,18676,7.2,20387,246,76,3017,3293,32.2,1867.6
4827864798,0,10,0,0,0,11,0,0,0,0,0,28630,10.2,35295,105,59,-6609,-5163,16.4,2863.0,10,0,1,11,0,23,0,0,0,0,35239,11.2,40458,88,68,6609,5163,15.6,3523.9
4827833432,1,37,1,1,9,15,20,0,0,0,0,33434,10.2,34641,102,55,1179,-3456,15.7,3343.4,8,3,0,15,9,32,0,0,0,0,32255,11.0,38097,86,63,-1179,3456,14.9,3225.5
4827803664,0,12,0,0,12,13,30,0,0,0,0,30643,10.4,35518,61,59,-2730,-3671,12.0,3064.3,17,0,1,13,12,25,0,0,0,0,33373,10.8,39189,90,60,2730,3671,15.0,3337.3
4827778349,1,19,1,0,6,11,8,0,0,0,0,30629,10.4,35203,78,63,1636,693,14.1,3062.9,13,0,1,11,6,13,0,0,0,0,28993,10.2,34510,82,54,-1636,-693,13.6,2899.3
4844859882,1,10,3,0,12,4,12,0,0,0,0,19403,7.2,18359,199,56,1868,101,25.5,1940.3,15,2,1,4,12,3,1,1,0,0,17535,7.0,18258,208,50,-1868,-101,25.8,1753.5
4841555687,0,13,2,1,8,4,9,0,0,0,0,17395,6.8,17656,193,66,1248,-294,25.9,1739.5,11,1,0,4,8,4,0,0,0,0,16147,6.8,17950,214,42,-1248,294,25.6,1614.7
4841528482,1,13,3,0,12,5,12,0,0,0,0,19940,7.2,18719,261,43,4687,2564,30.4,1994.0,16,2,1,4,11,7,0,0,0,0,15253,6.6,16155,197,39,-4687,-2564,23.6,1525.3
4838418170,1,17,1,0,9,7,9,1,1,0,0,18388,6.6,17329,214,50,226,-343,26.4,1838.8,18,2,1,7,9,6,0,0,0,0,18162,6.8,17672,229,56,-226,343,28.5,1816.2
4838378242,0,12,4,0,2,8,1,0,0,0,0,14709,6.8,17328,200,56,-3546,-2596,25.6,1470.9,12,2,1,8,2,2,1,1,0,0,18255,7.4,19924,238,68,3546,2596,30.6,1825.5
4838324069,0,14,1,0,6,9,9,1,1,0,0,16662,6.8,16599,214,48,-2886,-1459,26.2,1666.2,15,1,1,9,6,9,0,0,0,0,19548,6.8,18058,213,52,2886,1459,26.5,1954.8
4838275583,1,36,4,1,5,6,4,0,0,0,0,16922,6.8,18415,213,49,-1175,-1155,26.2,1692.2,15,2,0,6,5,5,1,0,1,0,18097,7.4,19570,231,60,1175,1155,29.1,1809.7
4837442925,0,14,2,0,4,7,4,1,1,0,0,16268,6.8,17466,212,68,-1931,-942,28.0,1626.8,13,1,1,7,4,8,0,0,0,0,18199,7.0,18408,242,72,1931,942,31.4,1819.9
4837426210,0,12,1,1,10,7,9,1,1,0,0,18154,6.8,17031,203,48,530,-751,25.1,1815.4,10,0,0,7,10,6,0,0,0,0,17624,6.8,17782,235,44,-530,751,27.9,1762.4
4837407382,0,13,1,1,5,4,3,0,0,0,0,16631,6.6,16712,203,48,74,-184,25.1,1663.1,16,1,0,4,5,6,0,0,0,0,16557,6.8,16896,214,48,-74,184,26.2,1655.7
4837390059,1,13,2,0,7,7,7,0,0,0,0,17475,6.8,17629,207,40,869,1309,24.7,1747.5,15,1,1,7,7,7,0,0,0,0,16606,6.6,16320,196,48,-869,-1309,24.4,1660.6
4837368262,0,12,0,0,6,4,3,0,0,0,0,16071,6.8,18110,205,64,208,323,26.9,1607.1,13,0,1,4,6,1,1,1,0,0,15863,7.2,17787,212,59,-208,-323,27.1,1586.3
4836284212,1,11,1,1,3,8,2,1,0,1,0,15143,7.0,17804,211,68,-2380,-843,27.9,1514.3,12,0,0,8,3,9,1,1,0,0,17523,7.2,18647,222,60,2380,843,28.2,1752.3
4836268041,0,17,2,1,13,7,8,0,0,0,0,19439,7.0,19394,226,43,1909,2810,26.9,1943.9,11,3,0,6,12,9,0,0,0,0,17530,6.6,16584,190,48,-1909,-2810,23.8,1753.0
4836248178,0,14,1,1,6,9,4,0,0,0,0,15873,6.4,15415,161,56,-3092,-3091,21.7,1587.3,13,1,0,9,6,9,0,0,0,0,18965,7.2,18506,242,54,3092,3091,29.6,1896.5
4836226790,0,12,4,1,7,8,3,0,0,0,0,17337,6.8,17965,214,56,-882,54,27.0,1733.7,13,3,0,8,7,4,1,1,0,0,18219,6.6,17911,188,48,882,-54,23.6,1821.9
4832518442,0,88,1,0,3,7,3,0,0,0,0,15688,6.8,17289,234,52,-1394,-547,28.6,1568.8,10,3,1,7,3,5,0,0,0,0,17082,6.8,17836,217,48,1394,547,26.5,1708.2
4832507667,1,16,3,1,9,4,13,1,1,0,0,19373,6.8,18278,241,46,4001,497,28.7,1937.3,16,3,0,4,9,3,0,0,0,0,15372,7.0,17781,212,60,-4001,-497,27.2,1537.2
4832506809,0,15,2,0,3,8,0,1,1,0,0,15736,6.8,17103,186,56,-2170,-1331,24.2,1573.6,24,0,1,8,3,9,0,0,0,0,17906,7.0,18434,224,62,2170,1331,28.6,1790.6
4832495384,1,15,2,0,9,5,8,0,0,0,0,19465,7.4,19324,234,60,3096,2589,29.4,1946.5,9,2,1,5,9,5,0,0,0,0,16369,6.6,16735,203,40,-3096,-2589,24.3,1636.9
4857436039,1,12,1,1,8,7,9,1,1,0,0,18316,7.0,18246,222,56,455,-127,27.8,1831.6,17,1,0,7,8,9,0,0,0,0,17861,7.0,18373,202,60,-455,127,26.2,1786.1
4857392210,1,16,1,0,2,1,0,1,1,0,0,15398,7.0,18979,210,68,1196,947,27.8,1539.8,15,1,1,1,2,1,0,0,0,0,14202,7.2,18032,202,60,-1196,-947,26.2,1420.2
4857199340,1,14,0,1,26,13,31,0,0,0,0,63750,12.4,57000,0,0,29700,24000,0.0,6375.0,0,0,0,4,17,3,0,0,0,0,34050,7.2,33000,0,0,-29700,-24000,0.0,3405.0
4857172195,1,317,0,1,17,16,16,0,0,0,0,47529,10.0,47500,1,0,19498,19000,0.1,4752.9,0,0,0,10,11,12,0,0,0,0,28031,6.0,28500,1,0,-19498,-19000,0.1,2803.1
4856003400,1,105,1,1,8,7,4,0,0,0,0,17781,7.0,18510,201,48,-173,-280,24.9,1778.1,13,1,0,7,8,6,1,1,0,0,17954,7.2,18790,202,68,173,280,27.0,1795.4
4855956281,1,18,4,1,12,2,10,0,0,0,0,20023,7.0,18738,206,63,5429,1941,26.9,2002.3,14,0,0,2,12,0,0,0,0,0,14594,6.6,16797,220,44,-5429,-1941,26.4,1459.4
4855860822,1,0,0,1,24,16,21,0,0,0,0,63150,12.0,55000,2,0,26250,22000,0.2,6315.0,0,0,0,6,14,7,0,0,0,0,36900,7.2,33000,1,0,-26250,-22000,0.1,3690.0
4855828865,0,11,0,0,3,8,3,0,0,0,0,16330,7.0,18252,235,52,-2386,489,28.7,1633.0,20,0,1,8,3,19,1,0,1,0,18716,7.2,17763,192,59,2386,-489,25.1,1871.6
4855795340,1,16,3,0,13,1,19,1,1,0,0,20018,7.2,19223,239,63,5174,3086,30.2,2001.8,18,1,1,1,13,3,1,0,1,0,14844,6.4,16137,205,37,-5174,-3086,24.2,1484.4
4855491619,1,11,0,0,5,9,3,0,0,0,0,15718,6.8,17304,226,52,-1643,-1304,27.8,1571.8,15,1,1,9,5,6,0,0,0,0,17361,7.0,18608,188,56,1643,1304,24.4,1736.1
4855473497,1,24,0,1,21,15,19,0,0,0,0,56250,12.0,55000,0,0,24600,22000,0.0,5625.0,0,0,0,7,13,9,0,0,0,0,31650,7.2,33000,0,0,-24600,-22000,0.0,3165.0
4855460518,1,0,0,0,12,17,20,0,0,0,0,60915,12.0,55000,3,0,24290,22000,0.3,6091.5,0,0,1,16,11,6,0,0,0,0,36625,7.2,33000,0,0,-24290,-22000,0.0,3662.5
4855456799,1,0,0,0,11,21,13,0,0,0,0,59200,12.4,57000,0,0,21300,24000,0.0,5920.0,0,0,1,14,4,16,0,0,0,0,37900,7.2,33000,0,0,-21300,-24000,0.0,3790.0
4855435352,1,0,0,1,25,18,23,0,0,0,0,48203,10.0,47500,0,0,20353,19000,0.0,4820.3,0,0,0,7,14,8,0,0,0,0,27850,6.0,28500,0,0,-20353,-19000,0.0,2785.0
4855419856,1,8,0,1,24,11,22,0,0,0,0,47700,10.0,47500,0,0,21600,19000,0.0,4770.0,13,0,0,4,17,4,0,0,0,0,26100,6.0,28500,0,0,-21600,-19000,0.0,2610.0
4855396243,1,0,0,0,18,13,20,0,0,0,0,47061,12.0,55000,0,0,19515,22000,0.0,4706.1,221,0,1,8,13,6,0,0,0,0,27546,7.2,33000,0,0,-19515,-22000,0.0,2754.6
4854676272,1,142,1,1,8,5,7,1,1,0,0,17242,6.8,18221,223,56,1720,550,27.9,1724.2,31,4,0,5,8,2,0,0,0,0,15522,7.0,17671,205,39,-1720,-550,24.4,1552.2
4853990037,1,63,0,0,4,3,3,1,0,1,0,16107,7.0,18876,202,56,805,1398,25.8,1610.7,11,0,1,3,4,3,0,0,0,0,15302,7.0,17478,196,48,-805,-1398,24.4,1530.2
4853780963,1,15,3,1,10,8,4,2,1,1,0,18609,7.2,19341,228,60,1578,2682,28.8,1860.9,15,0,0,8,10,8,0,0,0,0,17031,6.8,16659,186,38,-1578,-2682,22.4,1703.1
4853763043,1,14,0,0,23,13,20,0,0,0,0,47350,10.0,47500,0,0,20900,17820,0.0,4735.0,0,0,1,4,14,4,0,0,0,0,26450,6.2,29680,0,0,-20900,-17820,0.0,2645.0
4820470381,1,18,0,1,5,4,5,1,0,1,0,17170,6.8,17882,205,56,1667,1056,26.1,1717.0,14,0,0,4,5,4,0,0,0,0,15503,6.6,16826,205,52,-1667,-1056,25.7,1550.3
4820441448,0,12,0,0,4,7,4,0,0,0,0,17142,6.8,18487,245,60,412,151,30.5,1714.2,9,1,1,7,4,8,0,0,0,0,16730,6.8,18336,236,48,-412,-151,28.4,1673.0
4820252743,1,15,1,1,10,3,11,0,0,0,0,18448,7.0,18565,229,48,1654,693,27.7,1844.8,13,1,0,3,10,2,0,0,0,0,16794,6.6,17872,195,60,-1654,-693,25.5,1679.4
4809494522,1,20,0,1,4,5,5,1,1,0,0,15804,6.8,17098,212,60,-901,-861,27.2,1580.4,12,3,0,5,4,6,0,0,0,0,16705,7.0,17959,216,56,901,861,27.2,1670.5
4809456503,0,10,3,0,5,7,4,0,0,0,0,15216,6.6,16702,198,46,-2315,-2520,24.4,1521.6,18,1,1,7,5,2,1,1,0,0,17531,7.4,19222,227,60,2315,2520,28.7,1753.1
4808334771,1,24,1,1,6,7,2,0,0,0,0,16577,6.6,17063,202,64,-40,-762,26.6,1657.7,15,1,0,7,6,7,0,0,0,0,16617,7.0,17825,228,56,40,762,28.4,1661.7
4808269681,1,12,0,0,8,6,9,0,0,0,0,19088,7.2,18860,220,62,1152,330,28.2,1908.8,10,1,1,6,8,6,1,1,0,0,17936,7.0,18530,223,75,-1152,-330,29.8,1793.6
4808229523,0,19,0,1,7,6,8,0,0,0,0,18411,6.8,17759,208,64,413,-903,27.2,1841.1,16,0,0,6,7,6,1,1,0,0,17998,6.8,18662,227,48,-413,903,27.5,1799.8
4804445074,1,53,2,0,6,4,7,1,0,1,0,16400,7.2,18308,202,60,269,-307,26.2,1640.0,20,0,1,4,6,1,0,0,0,0,16131,7.2,18615,243,60,-269,307,30.3,1613.1
4803408001,0,9,1,0,4,14,7,0,0,0,0,14823,6.4,15340,182,35,-6187,-3307,21.7,1482.3,10,0,1,14,4,14,1,1,0,0,21010,7.0,18647,216,68,6187,3307,28.4,2101.0
4803361499,1,12,3,0,2,1,2,0,0,0,0,17190,7.0,19009,233,56,1836,722,28.9,1719.0,15,2,1,1,2,1,0,0,0,0,15354,6.8,18287,194,56,-1836,-722,25.0,1535.4
4802733618,0,13,2,1,2,5,1,0,0,0,0,15166,6.8,17647,238,59,-979,-678,29.7,1516.6,18,4,0,5,2,3,1,1,0,0,16145,7.0,18325,255,44,979,678,29.9,1614.5
4802695343,0,14,1,1,6,3,8,1,0,1,0,17109,7.0,18969,219,70,513,473,28.9,1710.9,14,2,0,3,6,3,1,1,0,0,16596,7.2,18496,216,72,-513,-473,28.8,1659.6
4802664828,1,14,1,1,9,7,8,1,1,0,0,19879,7.4,19208,261,56,2007,1818,31.7,1987.9,12,1,0,7,9,8,0,0,0,0,17872,6.8,17390,214,56,-2007,-1818,27.0,1787.2
4802428379,1,13,1,0,5,10,7,0,0,0,1,15935,6.8,16415,191,52,-4461,-3531,24.3,1593.5,11,2,1,10,5,4,0,0,0,0,20396,7.4,19946,265,64,4461,3531,32.9,2039.6
4800510609,0,13,3,0,10,2,6,1,1,0,0,17911,7.2,18763,230,60,1308,1402,29.0,1791.1,18,1,1,2,10,2,0,0,0,0,16603,6.8,17361,194,63,-1308,-1402,25.7,1660.3
4800360065,1,25,0,1,10,9,12,0,0,0,0,18701,6.6,17536,229,54,979,-385,28.3,1870.1,127,1,0,9,10,4,0,0,0,0,17722,6.8,17921,220,51,-979,385,27.1,1772.2
4799983392,1,16,1,1,7,6,3,0,0,0,0,17667,7.2,18566,251,64,314,2619,31.5,1766.7,12,1,0,6,7,7,1,1,0,0,17353,6.4,15947,194,40,-314,-2619,23.4,1735.3
4799956037,1,11,2,0,7,8,8,1,0,1,0,17249,7.2,19319,220,69,287,1215,28.9,1724.9,13,1,1,8,7,7,1,1,0,0,16962,7.0,18104,228,51,-287,-1215,27.9,1696.2
4799922431,0,55,1,0,8,6,9,0,0,0,0,16430,7.0,17632,176,68,-569,-1263,24.4,1643.0,16,2,1,6,8,1,1,1,0,0,16999,7.2,18895,248,60,569,1263,30.8,1699.9
4857539832,1,0,0,1,15,16,16,0,0,0,0,42711,10.0,47500,0,0,12400,19000,0.0,4271.1,288,0,0,9,8,9,0,0,0,0,30311,6.0,28500,0,0,-12400,-19000,0.0,3031.1
4857519195,1,1,0,0,17,14,15,0,0,0,0,47760,10.0,47500,15,0,20260,19000,1.5,4776.0,0,0,1,7,10,8,0,0,0,0,27500,6.0,28500,1,0,-20260,-19000,0.1,2750.0
4857502748,1,0,0,0,19,18,17,0,0,0,0,47350,10.4,49000,0,0,17400,20500,0.0,4735.0,0,0,1,10,11,9,0,0,0,0,29950,6.0,28500,0,0,-17400,-20500,0.0,2995.0
4856111323,1,0,5,1,15,13,19,0,0,0,0,46325,10.0,47500,0,0,18505,19000,0.0,4632.5,32,3,0,8,10,5,0,0,0,0,27820,6.0,28500,12,0,-18505,-19000,1.2,2782.0
4856080524,1,0,0,0,20,17,23,0,0,0,0,48200,10.0,47500,11,0,20000,19000,1.1,4820.0,0,0,1,10,13,9,0,0,0,0,28200,6.0,28500,4,0,-20000,-19000,0.4,2820.0
4856064013,1,0,0,0,14,19,17,0,0,0,0,61453,12.0,55000,0,0,24184,22000,0.0,6145.3,0,0,1,13,8,10,0,0,0,0,37269,7.2,33000,0,0,-24184,-22000,0.0,3726.9
4856039205,1,19,1,0,21,18,15,0,0,0,0,62710,12.0,55000,1,0,24110,22000,0.1,6271.0,0,0,1,9,12,11,0,0,0,0,38600,7.2,33000,0,0,-24110,-22000,0.0,3860.0
4856008576,1,0,0,1,19,19,27,0,0,0,0,63050,12.0,55000,0,0,26200,22000,0.0,6305.0,0,0,0,13,13,6,0,0,0,0,36850,7.2,33000,0,0,-26200,-22000,0.0,3685.0
4855987704,1,0,0,0,14,24,19,0,0,0,0,46300,10.0,47500,0,0,16700,19000,0.0,4630.0,0,0,1,18,8,12,0,0,0,0,29600,6.0,28500,0,0,-16700,-19000,0.0,2960.0
4853229050,1,0,0,0,17,19,16,0,0,0,0,47136,10.0,47500,5,0,18366,19000,0.5,4713.6,1,0,1,12,10,13,0,0,0,0,28770,6.0,28500,2,0,-18366,-19000,0.2,2877.0
4853216727,1,0,0,1,23,13,22,0,0,0,0,48750,10.2,48680,0,0,21600,20180,0.0,4875.0,0,0,0,5,15,5,0,0,0,0,27150,6.0,28500,0,0,-21600,-20180,0.0,2715.0
4853215941,1,0,0,1,25,15,19,0,0,0,0,63750,12.0,55000,1,0,28300,22000,0.1,6375.0,0,0,0,4,14,5,0,0,0,0,35450,7.2,33000,2,0,-28300,-22000,0.2,3545.0
4853206797,1,31,7,0,19,14,19,0,0,0,0,46785,10.0,47500,3,0,18900,19000,0.3,4678.5,0,2,1,8,13,9,0,0,0,0,27885,6.0,28500,0,0,-18900,-19000,0.0,2788.5
4853190323,1,35,2,1,21,20,17,0,0,0,0,64028,12.0,55000,5,0,26808,22000,0.5,6402.8,4,4,0,13,14,13,0,0,0,0,37220,7.2,33000,0,0,-26808,-22000,0.0,3722.0
4852825961,1,13,7,1,22,20,17,0,0,0,0,48435,10.0,47500,0,0,16535,19000,0.0,4843.5,33,0,0,11,13,12,0,0,0,0,31900,6.0,28500,8,0,-16535,-19000,0.8,3190.0
4852794422,1,5,12,1,24,18,17,0,0,0,0,48694,10.4,49000,0,0,19614,19320,0.0,4869.4,34,0,0,9,15,10,0,0,0,0,29080,6.2,29680,6,0,-19614,-19320,0.6,2908.0
4852765300,1,0,0,1,20,22,14,0,0,0,0,46650,10.0,47500,0,0,18100,19000,0.0,4665.0,0,0,0,9,7,13,0,0,0,0,28550,6.0,28500,0,0,-18100,-19000,0.0,2855.0
4852744794,1,95,0,1,18,18,16,0,0,0,0,60986,12.0,55000,8,0,23361,22000,0.8,6098.6,0,0,0,10,10,12,0,0,0,0,37625,7.2,33000,6,0,-23361,-22000,0.6,3762.5
4852709968,1,297,0,1,21,16,21,0,0,0,0,62080,12.0,55000,9,0,24780,22000,0.9,6208.0,100,0,0,9,14,10,0,0,0,0,37300,7.2,33000,9,0,-24780,-22000,0.9,3730.0
4852685689,1,24,0,1,23,13,18,0,0,0,0,63540,12.0,55000,1,0,27030,22000,0.1,6354.0,0,0,0,5,15,10,0,0,0,0,36510,7.2,33000,0,0,-27030,-22000,0.0,3651.0
4858007669,1,164,3,1,7,2,7,1,1,0,0,17627,7.0,18654,223,60,2723,1803,28.3,1762.7,13,0,0,2,7,1,0,0,0,0,14904,6.6,16851,216,54,-2723,-1803,27.0,1490.4
4857963540,0,14,2,1,5,8,6,0,0,0,0,15613,6.4,15917,191,64,-2659,-1461,25.5,1561.3,12,5,0,8,5,12,1,1,0,0,18272,6.8,17378,200,57,2659,1461,25.7,1827.2
4857212598,0,141,1,1,6,5,5,1,1,0,0,16515,7.2,18974,221,64,505,325,28.5,1651.5,12,0,0,5,6,3,0,0,0,0,16010,7.0,18649,211,68,-505,-325,27.9,1601.0
4857172162,1,12,1,1,7,3,8,1,1,0,0,17753,7.2,18692,218,64,1225,424,28.2,1775.3,13,2,0,3,7,4,1,0,1,0,16528,7.0,18268,232,64,-1225,-424,29.6,1652.8
4857136576,1,14,1,1,2,1,2,0,0,0,0,15899,7.4,18830,255,60,496,-583,31.5,1589.9,16,1,0,1,2,0,1,1,0,0,15403,7.4,19413,255,68,-496,583,32.3,1540.3
4856982572,1,9,3,1,5,7,4,0,0,0,0,16254,6.8,17691,238,63,-375,-1505,30.1,1625.4,15,3,0,7,5,7,0,0,0,0,16629,7.2,19196,225,64,375,1505,28.9,1662.9
4856184917,0,45,1,1,11,10,18,1,1,0,0,18346,6.8,17687,194,40,-1423,-1540,23.4,1834.6,33,2,0,10,11,12,0,0,0,0,19769,7.2,19227,239,56,1423,1540,29.5,1976.9
4856150309,1,0,0,1,21,18,19,0,0,0,0,63490,12.0,55000,0,0,25590,22000,0.0,6349.0,0,0,0,9,12,13,0,0,0,0,37900,7.2,33000,0,0,-25590,-22000,0.0,3790.0
4856127007,1,0,0,1,16,10,24,0,0,0,0,62700,12.0,55000,0,0,27600,22000,0.0,6270.0,0,0,0,6,12,2,0,0,0,0,35100,7.2,33000,0,0,-27600,-22000,0.0,3510.0
4856092796,1,24,0,1,18,20,20,0,0,0,0,62352,12.4,58000,5,0,23265,22000,0.5,6235.2,0,0,0,14,12,14,0,0,0,0,39087,7.6,36000,0,0,-23265,-22000,0.0,3908.7
4856060666,1,0,0,0,24,20,26,0,0,0,0,65989,13.0,62500,3,0,28309,25000,0.3,6598.9,0,0,1,14,18,10,0,0,0,0,37680,7.8,37500,2,0,-28309,-25000,0.2,3768.0
4855996626,1,18,0,1,13,5,16,1,1,0,0,19797,7.0,18196,219,52,2372,1715,27.1,1979.7,17,4,0,5,13,6,0,0,0,0,17425,6.6,16481,200,56,-2372,-1715,25.6,1742.5
4855415134,0,79,2,0,7,9,9,0,0,0,0,16522,6.6,16489,159,57,-1986,-948,21.6,1652.2,15,1,1,9,7,2,1,1,0,0,18508,7.0,17437,211,46,1986,948,25.7,1850.8
4855374951,1,14,1,0,10,7,16,1,1,0,0,18228,6.8,17690,216,48,881,-170,26.4,1822.8,9,0,1,7,10,3,0,0,0,0,17347,7.0,17860,185,56,-881,170,24.1,1734.7
4855333158,1,11,1,0,3,2,0,0,0,0,0,15637,7.0,18173,220,52,882,1316,27.2,1563.7,74,3,1,2,3,4,1,1,0,0,14755,6.8,16857,204,66,-882,-1316,27.0,1475.5
4854921581,1,0,0,1,24,22,24,0,0,0,0,66200,12.8,61000,0,0,26200,25000,0.0,6620.0,0,0,0,13,15,12,0,0,0,0,40000,7.6,36000,0,0,-26200,-25000,0.0,4000.0
4854904263,1,0,0,1,22,19,21,0,0,0,0,57400,12.0,55000,0,0,21590,22000,0.0,5740.0,0,0,0,8,11,6,0,0,0,0,35810,7.2,33000,0,1,-21590,-22000,0.1,3581.0
4854885376,1,0,0,1,26,18,23,0,0,0,0,74040,14.2,67000,0,0,27840,25000,0.0,7404.0,0,0,0,8,16,11,0,0,0,0,46200,9.0,42000,0,0,-27840,-25000,0.0,4620.0
4854691897,1,12,1,1,10,8,10,1,1,0,0,18570,6.8,18223,202,72,1299,706,27.4,1857.0,17,0,0,8,10,12,0,0,0,0,17271,6.6,17517,227,40,-1299,-706,26.7,1727.1
4854589970,1,14,1,1,7,2,6,0,0,0,0,17618,7.0,18855,220,69,2171,1634,28.9,1761.8,14,2,0,2,7,2,0,0,0,0,15447,6.6,17221,234,59,-2171,-1634,29.3,1544.7
4853249291,0,10,0,1,6,9,8,0,0,0,0,17116,6.6,15934,201,51,-1753,-2761,25.2,1711.6,7,0,0,9,6,8,1,1,0,0,18869,7.0,18695,235,68,1753,2761,30.3,1886.9
4829559142,1,19,0,1,4,1,3,0,0,0,0,17376,7.4,19512,260,64,4058,3171,32.4,1737.6,20,0,0,1,4,1,0,0,0,0,13318,6.4,16341,172,44,-4058,-3171,21.6,1331.8
4829527652,0,14,0,0,3,10,4,0,0,0,0,15581,6.6,17004,221,46,-3413,-3090,26.7,1558.1,17,0,1,10,3,6,0,0,0,0,18994,7.6,20094,220,72,3413,3090,29.2,1899.4
4829487370,0,13,0,1,6,4,4,0,0,0,0,16022,6.6,16651,169,61,1283,396,23.0,1602.2,20,0,0,4,6,1,0,0,0,0,14739,6.6,16255,200,46,-1283,-396,24.6,1473.9
4829449816,0,13,1,0,6,10,5,0,0,0,0,16505,7.0,17629,219,52,-2756,-447,27.1,1650.5,16,1,1,10,6,18,0,0,0,0,19261,7.0,18076,224,56,2756,447,28.0,1926.1
4828589036,0,18,1,0,4,5,4,1,1,0,0,16195,6.8,18169,215,72,-1495,-1592,28.7,1619.5,12,1,1,5,4,2,0,0,0,0,17690,7.4,19761,251,63,1495,1592,31.4,1769.0
4828531732,1,22,0,0,4,7,5,1,0,1,0,17506,6.6,17509,201,60,-1241,-423,26.1,1750.6,14,1,1,7,4,5,0,0,0,0,18747,6.8,17932,221,48,1241,423,26.9,1874.7
4828485122,1,8,1,1,4,3,1,0,0,0,0,16134,7.0,19327,243,60,739,-51,30.3,1613.4,15,1,0,3,4,2,0,0,0,0,15395,7.0,19378,216,68,-739,51,28.4,1539.5
4828459912,1,13,1,1,5,5,4,0,0,0,0,16718,7.0,18003,227,52,1381,1620,27.9,1671.8,31,1,0,5,5,7,0,0,0,0,15337,6.6,16383,216,52,-1381,-1620,26.8,1533.7
4828438758,0,12,2,0,1,9,1,0,0,0,0,13653,6.4,16314,192,64,-4486,-3519,25.6,1365.3,21,0,1,9,1,3,0,0,0,0,18139,7.2,19833,248,68,4486,3519,31.6,1813.9
4828410472,1,19,3,0,5,3,5,0,0,0,0,16408,6.8,17927,249,48,1100,-149,29.7,1640.8,12,2,1,3,5,2,1,0,1,0,15308,7.0,18076,214,71,-1100,149,28.5,1530.8
4828375198,0,12,2,0,2,6,2,0,0,0,0,15185,7.0,18112,238,64,-1845,-490,30.2,1518.5,17,1,1,6,2,6,0,0,0,0,17030,7.0,18602,240,52,1845,490,29.2,1703.0
4818972403,1,12,0,0,7,6,3,0,0,0,0,16732,7.2,18918,217,54,629,1074,27.1,1673.2,14,0,1,6,7,6,1,1,0,0,16103,6.8,17844,173,67,-629,-1074,24.0,1610.3
4818363711,1,16,2,1,7,6,5,0,0,0,0,17083,7.0,18403,243,52,1209,268,29.5,1708.3,18,3,0,6,7,7,1,1,0,0,15874,7.2,18135,203,63,-1209,-268,26.6,1587.4
4818357404,0,10,1,0,4,5,7,1,1,0,0,14754,6.6,16038,216,36,-2873,-3441,25.2,1475.4,15,1,1,5,4,2,1,0,1,0,17627,7.2,19479,267,72,2873,3441,33.9,1762.7
4818345454,0,14,1,0,2,3,0,0,0,0,0,15775,7.2,18707,189,48,-337,9,23.7,1577.5,12,1,1,3,2,0,1,1,0,0,16112,7.0,18698,257,64,337,-9,32.1,1611.2
4818331387,0,12,1,0,4,3,4,0,0,0,0,16369,7.2,18616,227,73,880,295,30.0,1636.9,14,1,1,3,4,1,1,1,0,0,15489,7.0,18321,209,50,-880,-295,25.9,1548.9
4818311261,0,34,2,0,3,11,3,1,0,1,0,15677,6.6,16831,187,68,-3395,-3187,25.5,1567.7,74,6,1,11,3,4,1,1,0,0,19072,7.0,20018,243,64,3395,3187,30.7,1907.2
4818291824,1,14,2,0,13,8,12,1,1,0,0,21952,7.4,19880,230,68,3727,2119,29.8,2195.2,11,3,1,8,13,7,0,0,0,0,18225,7.2,17761,211,56,-3727,-2119,26.7,1822.5
4818271090,1,13,2,0,10,7,4,1,1,0,0,18290,6.8,18318,214,56,1993,1165,27.0,1829.0,11,1,1,7,10,2,0,0,0,0,16297,6.8,17153,197,52,-1993,-1165,24.9,1629.7
4844564503,0,10,3,0,6,3,5,0,0,0,0,17787,7.2,19573,220,75,1642,2330,29.5,1778.7,11,0,1,3,6,3,1,1,0,0,16145,6.8,17243,243,44,-1642,-2330,28.7,1614.5
4844545641,0,48,0,0,3,7,0,0,0,0,0,15647,7.2,18817,223,60,-1052,1256,28.3,1564.7,11,0,1,7,3,9,1,1,0,0,16699,6.6,17561,241,48,1052,-1256,28.9,1669.9
4844529425,1,18,2,0,3,4,2,0,0,0,0,16448,7.0,18389,220,51,767,340,27.1,1644.8,88,1,1,4,3,2,0,0,0,0,15681,7.0,18049,195,72,-767,-340,26.7,1568.1
4844520138,1,14,4,0,9,1,11,0,0,0,0,18662,7.2,18904,235,68,3398,1633,30.3,1866.2,85,2,1,1,9,1,1,1,0,0,15264,7.0,17271,216,56,-3398,-1633,27.2,1526.4
4839559345,1,13,1,0,2,1,1,0,0,0,0,15935,6.8,18016,245,48,1646,1791,29.3,1593.5,11,3,1,1,2,1,1,1,0,0,14289,6.6,16225,197,62,-1646,-1791,25.9,1428.9
4839549947,0,20,3,0,3,4,4,1,1,0,0,15207,6.8,17682,223,48,-1096,-1584,27.1,1520.7,10,1,1,4,3,5,1,0,1,0,16303,7.2,19266,208,64,1096,1584,27.2,1630.3
4839532092,1,35,2,1,4,3,7,1,1,0,0,15556,7.0,17471,184,56,-1452,-1037,24.0,1555.6,34,2,0,3,4,5,0,0,0,0,17008,7.0,18508,225,52,1452,1037,27.7,1700.8
4839521309,1,12,3,1,9,5,7,0,0,0,0,18035,7.2,17932,217,36,1066,609,25.3,1803.5,15,0,0,5,9,5,1,1,0,0,16969,6.8,17323,213,63,-1066,-609,27.6,1696.9
4839449066,0,25,0,0,6,8,8,0,0,0,0,16776,6.6,16803,176,57,-1528,-421,23.3,1677.6,12,2,1,8,6,11,0,0,0,0,18304,6.6,17224,192,50,1528,421,24.2,1830.4
4839417305,1,12,1,1,12,3,13,0,0,0,0,18416,7.0,18050,203,52,3880,1337,25.5,1841.6,16,0,0,3,12,1,0,0,0,0,14536,6.4,16713,220,52,-3880,-1337,27.2,1453.6
4839372262,1,13,3,1,6,7,6,1,0,1,0,17351,7.2,20078,232,52,-463,2215,28.4,1735.1,21,1,0,7,6,10,0,0,0,0,17814,6.8,17863,253,47,463,-2215,30.0,1781.4
4839339318,1,14,0,1,9,6,7,0,0,0,0,18536,7.0,17865,220,60,1387,-214,28.0,1853.6,11,1,0,6,9,4,0,0,0,0,17149,6.8,18079,192,48,-1387,214,24.0,1714.9
4839280211,0,10,0,1,3,10,2,0,0,0,0,15984,7.0,18638,232,44,-3630,-456,27.6,1598.4,11,2,0,10,3,7,1,1,0,0,19614,7.4,19094,233,67,3630,456,30.0,1961.4
4836255871,1,11,0,0,3,6,2,0,0,0,0,15179,6.8,17860,204,48,-1134,-454,25.2,1517.9,23,0,1,6,3,5,0,0,0,0,16313,7.0,18314,210,62,1134,454,27.2,1631.3
4828685628,0,107,1,1,6,2,0,1,1,0,0,16805,7.0,18910,239,52,1141,934,29.1,1680.5,13,2,0,2,6,1,0,0,0,0,15664,7.0,17976,228,57,-1141,-934,28.5,1566.4
4828634913,0,13,1,1,8,7,12,0,0,0,0,17813,7.0,17402,246,49,-442,-966,29.5,1781.3,19,0,0,7,8,6,0,0,0,0,18255,7.0,18368,235,72,442,966,30.7,1825.5
4827622846,1,16,0,0,9,26,14,0,0,0,1,33755,10.2,34371,62,43,-7987,-9346,10.5,3375.5,8,0,1,26,9,50,0,0,0,0,41742,11.4,43717,86,72,7987,9346,15.8,4174.2
4827589701,0,10,2,1,10,29,18,0,0,0,3,29277,10.4,34899,75,43,-17427,-13820,11.8,2927.7,159,0,0,29,10,63,0,0,0,0,46704,12.4,48719,112,87,17427,13820,19.9,4670.4
4827573135,1,13,1,1,19,24,51,0,0,0,2,30943,10.4,35248,78,43,-6796,-4714,12.1,3094.3,15,0,0,24,19,65,0,0,0,0,37739,11.2,39962,79,67,6796,4714,14.6,3773.9
4823372241,1,15,2,0,6,13,7,0,0,0,0,16792,6.8,16710,200,64,-3109,-1279,26.4,1679.2,15,6,1,13,6,20,2,1,1,0,19901,7.0,17989,230,52,3109,1279,28.2,1990.1
4857560014,1,0,0,1,16,16,16,0,0,0,0,44925,10.0,47500,3,0,19185,19000,0.3,4492.5,0,0,0,11,11,6,0,0,0,0,25740,6.0,28500,0,0,-19185,-19000,0.0,2574.0
4857533583,1,4,0,0,17,18,17,0,0,0,0,48050,10.2,48680,0,0,18800,20180,0.0,4805.0,0,0,1,15,14,13,0,0,0,0,29250,6.0,28500,0,0,-18800,-20180,0.0,2925.0
4857511531,1,11,0,1,17,15,23,0,0,0,0,62000,12.0,55000,0,0,26200,22000,0.0,6200.0,0,0,0,11,13,6,0,0,0,0,35800,7.2,33000,0,0,-26200,-22000,0.0,3580.0
4857469842,0,20,0,1,7,7,5,1,1,0,0,17122,6.6,17851,220,60,-34,-73,28.0,1712.2,17,0,0,7,7,9,0,0,0,0,17156,7.0,17924,209,56,34,73,26.5,1715.6
4857427653,1,8,1,1,6,5,7,1,0,1,0,19198,7.0,18566,264,56,2738,815,32.0,1919.8,11,1,0,5,6,6,1,1,0,0,16460,7.0,17751,202,52,-2738,-815,25.4,1646.0
4856602419,1,0,0,0,18,14,32,0,0,0,0,62700,12.0,55000,0,0,24800,22000,0.0,6270.0,0,0,1,11,15,1,0,0,0,0,37900,7.2,33000,0,0,-24800,-22000,0.0,3790.0
4856594208,1,0,0,1,18,18,19,0,0,0,0,63862,12.4,57000,3,0,26552,22000,0.3,6386.2,0,0,0,10,10,9,0,0,0,0,37310,7.6,35000,2,0,-26552,-22000,0.2,3731.0
4856582941,1,1,0,1,18,9,21,0,0,0,0,48050,10.0,47500,0,0,21600,19000,0.0,4805.0,39,0,0,6,15,5,0,0,0,0,26450,6.0,28500,0,0,-21600,-19000,0.0,2645.0
4856569090,1,5,1,1,11,21,14,0,0,0,0,60610,12.0,55000,1,0,22010,18000,0.1,6061.0,23,0,0,17,7,12,0,0,0,0,38600,8.0,37000,0,0,-22010,-18000,0.0,3860.0
4856552332,1,4,0,0,18,15,27,0,0,0,0,62843,12.0,55000,0,0,25604,22000,0.0,6284.3,0,0,1,10,13,7,0,0,0,0,37239,7.2,33000,0,0,-25604,-22000,0.0,3723.9
4856522086,1,9,2,1,5,7,5,1,1,0,0,16412,6.8,17451,193,64,-649,-921,25.7,1641.2,9,0,0,7,5,2,0,0,0,0,17061,7.0,18372,209,60,649,921,26.9,1706.1
4856492284,1,57,2,0,7,8,6,0,0,0,0,16434,6.6,17581,178,56,-594,930,23.4,1643.4,79,0,1,8,7,13,0,0,0,0,17028,6.6,16651,192,35,594,-930,22.7,1702.8
4856466447,0,17,1,1,6,6,7,0,0,0,0,17007,6.6,17189,202,49,-637,-1595,25.1,1700.7,26,0,0,6,6,8,0,0,0,0,17644,7.0,18784,253,52,637,1595,30.5,1764.4
4856059504,1,188,2,1,6,3,3,1,0,1,0,17333,7.4,19684,235,59,2109,1712,29.4,1733.3,12,1,0,3,6,4,0,0,0,0,15224,6.8,17972,202,56,-2109,-1712,25.8,1522.4
4856024899,0,14,10,0,3,2,2,0,0,0,0,16074,7.4,19335,245,71,-184,160,31.6,1607.4,30,1,1,2,3,2,2,1,1,0,16258,7.2,19175,216,59,184,-160,27.5,1625.8
4855972649,1,13,2,0,4,5,5,1,1,0,0,17149,7.2,19419,272,76,639,90,34.8,1714.9,16,0,1,5,4,6,0,0,0,0,16510,7.2,19329,237,59,-639,-90,29.6,1651.0
4855948764,0,8,12,0,5,15,7,0,0,0,0,15744,6.8,17296,180,56,-7260,-2392,23.6,1574.4,40,0,1,15,5,16,0,0,0,0,23004,7.4,19688,231,64,7260,2392,29.5,2300.4
4855556159,0,13,3,1,7,6,7,1,1,0,0,16841,7.0,17960,214,66,398,685,28.0,1684.1,12,3,0,6,7,9,0,0,0,0,16443,6.8,17275,212,50,-398,-685,26.2,1644.3
4855542543,1,15,3,0,8,14,9,0,0,0,0,18031,6.0,14774,192,36,-1622,-1796,22.8,1803.1,23,4,1,14,8,17,0,0,0,0,19653,6.4,16570,175,40,1622,1796,21.5,1965.3
4849790181,1,82,15,1,9,10,7,0,0,0,0,17851,6.4,16392,184,47,-1436,-1510,23.1,1785.1,32,1,0,10,9,9,1,1,0,0,19287,7.0,17902,208,44,1436,1510,25.2,1928.7
4840034162,1,12,0,0,6,6,5,1,1,0,0,16341,6.8,18004,209,49,-1319,-753,25.8,1634.1,77,0,1,5,5,5,0,0,0,0,17660,7.0,18757,221,54,1319,753,27.5,1766.0
4839771146,1,74,1,1,3,6,2,1,1,0,0,16255,7.2,18295,223,56,-1199,-600,27.9,1625.5,10,3,0,6,3,10,0,0,0,0,17454,7.0,18895,241,67,1199,600,30.8,1745.4
4839207206,0,71,1,0,3,7,2,0,0,0,0,15469,6.2,16292,202,56,-1781,-1658,25.8,1546.9,12,0,1,7,3,6,1,1,0,0,17250,7.0,17950,203,56,1781,1658,25.9,1725.0
4838996216,0,13,0,0,3,5,1,0,0,0,0,15843,7.0,18181,227,64,-1077,321,29.1,1584.3,79,1,1,5,3,4,0,0,0,0,16920,6.8,17860,228,60,1077,-321,28.8,1692.0
4825823117,1,105,0,1,18,14,30,0,0,0,0,35582,11.4,42347,77,63,2922,5868,14.0,3558.2,13,0,0,14,18,29,0,0,0,0,32660,10.4,36479,77,51,-2922,-5868,12.8,3266.0
4825791766,1,37,1,1,9,10,13,0,0,0,0,32106,10.4,35632,111,41,2153,-210,15.2,3210.6,100,0,0,10,9,11,0,0,0,0,29953,10.6,35842,75,64,-2153,210,13.9,2995.3
4825768466,0,218,0,0,8,16,18,0,0,0,0,30129,11.0,38583,84,59,-9176,-5414,14.3,3012.9,9,1,1,15,7,37,0,0,0,0,39305,11.8,43997,107,83,9176,5414,19.0,3930.5
4823672912,1,12,2,0,5,6,7,1,1,0,0,16580,6.6,17705,212,50,345,443,26.2,1658.0,14,3,1,6,5,5,0,0,0,0,16235,6.6,17262,214,52,-345,-443,26.6,1623.5
4823636564,0,72,1,0,5,7,3,1,1,0,0,15657,6.6,16494,203,56,-1766,-1224,25.9,1565.7,7,2,1,7,5,13,0,0,0,0,17423,7.0,17718,203,51,1766,1224,25.4,1742.3
4822768746,0,11,2,1,4,7,2,0,0,0,0,15255,6.6,17784,223,48,-2383,-1532,27.1,1525.5,79,0,0,7,4,4,1,1,0,0,17638,7.0,19316,233,56,2383,1532,28.9,1763.8
4822723638,1,65,2,0,4,5,3,0,0,0,0,16184,7.2,18332,235,64,-1315,628,29.9,1618.4,12,1,1,5,4,7,1,1,0,0,17499,6.8,17704,210,48,1315,-628,25.8,1749.9
4822144409,1,3,0,0,25,23,68,0,0,0,1,39153,11.8,44002,119,0,2654,4259,11.9,3915.3,13,0,1,23,25,50,0,0,0,0,36499,11.0,39743,99,0,-2654,-4259,9.9,3649.9
4822121631,1,18,0,0,20,17,45,0,0,0,2,36436,10.8,38620,105,0,1559,1573,10.5,3643.6,0,5,1,17,20,42,0,0,0,0,34877,10.8,37047,105,0,-1559,-1573,10.5,3487.7
4822096452,1,12,0,0,11,19,20,0,0,0,2,37971,11.0,39504,96,71,2499,-1587,16.7,3797.1,103,2,1,19,11,41,0,0,0,0,35472,11.2,41091,99,59,-2499,1587,15.8,3547.2
4822072425,0,17,0,0,13,25,22,0,0,0,0,32319,11.0,38148,71,59,-8932,-7745,13.0,3231.9,102,1,1,25,13,59,0,0,0,0,41251,12.0,45893,96,79,8932,7745,17.5,4125.1
4820591403,1,168,0,1,23,12,72,0,0,0,0,36814,11.4,42113,102,58,3257,8567,16.0,3681.4,10,0,0,11,22,26,0,0,0,0,33557,10.2,33546,73,59,-3257,-8567,13.2,3355.7
4820578776,0,14,1,0,20,19,41,0,0,0,1,31016,10.4,34202,58,43,-3468,-1447,10.1,3101.6,110,1,1,19,20,41,0,0,0,0,34484,10.2,35649,74,51,3468,1447,12.5,3448.4
4857952654,1,20,1,1,13,5,15,0,0,0,0,20512,7.2,19024,224,54,4569,1356,27.8,2051.2,12,2,0,5,13,6,0,0,0,0,15943,6.8,17668,217,60,-4569,-1356,27.7,1594.3
4857446240,1,12,0,1,6,3,4,2,1,1,0,17233,7.4,19868,225,76,2119,2455,30.1,1723.3,13,0,0,3,6,1,0,0,0,0,15114,6.8,17413,219,60,-2119,-2455,27.9,1511.4
4856923972,0,11,0,1,10,7,18,0,0,0,0,18625,6.8,18132,185,48,1664,-7,23.3,1862.5,13,1,0,7,10,8,0,0,0,0,16961,7.0,18139,208,52,-1664,7,26.0,1696.1
4856499747,0,13,0,0,0,6,0,0,0,0,0,14890,6.8,17446,226,52,-1769,-1897,27.8,1489.0,18,1,1,6,0,3,2,1,1,0,16659,7.2,19343,227,59,1769,1897,28.6,1665.9
4855668492,0,11,0,1,4,3,7,1,0,1,0,16767,7.0,18880,218,76,1536,602,29.4,1676.7,17,0,0,3,4,3,0,0,0,0,15231,6.8,18278,221,76,-1536,-602,29.7,1523.1
4855602564,1,14,1,1,3,6,5,1,0,1,0,15647,6.6,16946,224,52,-1357,-1151,27.6,1564.7,23,1,0,6,3,5,0,0,0,0,17004,6.8,18097,261,52,1357,1151,31.3,1700.4
4855594407,1,16,0,0,7,5,4,1,1,0,0,17468,7.0,18657,240,63,1678,1454,30.3,1746.8,13,2,1,5,7,4,0,0,0,0,15790,6.6,17203,233,48,-1678,-1454,28.1,1579.0
4855562383,0,14,0,0,7,7,5,0,0,0,0,16316,6.8,16909,208,50,-2134,-424,25.8,1631.6,12,0,1,7,7,7,0,0,0,0,18450,6.8,17333,213,54,2134,424,26.7,1845.0
4849134464,0,17,1,0,12,15,12,0,0,0,0,20101,6.4,16090,151,43,-1439,-2046,19.4,2010.1,14,2,1,15,12,11,0,0,0,0,21540,7.0,18136,211,44,1439,2046,25.5,2154.0
4849094930,0,13,2,0,8,6,7,1,0,1,0,17802,6.6,17337,197,40,1267,-361,23.7,1780.2,20,1,1,6,8,4,0,0,0,0,16535,6.8,17698,233,52,-1267,361,28.5,1653.5
4849050565,0,19,1,1,5,4,7,0,0,0,0,17318,7.2,17883,224,52,518,513,27.6,1731.8,14,4,0,4,5,5,1,1,0,0,16800,6.8,17370,218,56,-518,-513,27.4,1680.0
4848044639,0,16,1,1,2,4,4,1,1,0,0,15004,6.8,16975,205,49,-2825,-2754,25.4,1500.4,13,1,0,4,2,6,0,0,0,0,17829,7.2,19729,257,64,2825,2754,32.1,1782.9
4847806248,0,69,0,0,28,26,95,0,0,0,0,36988,11.2,40974,113,0,192,-1280,11.3,3698.8,33,0,1,26,28,61,0,0,0,0,36796,11.4,42254,100,0,-192,1280,10.0,3679.6
4846157953,1,10,1,1,8,8,7,0,0,0,0,19961,7.2,19665,255,58,2514,2968,31.3,1996.1,17,1,0,8,8,9,1,1,0,0,17447,7.0,16697,205,44,-2514,-2968,24.9,1744.7
4845953849,1,8,0,0,1,2,1,0,0,0,0,14876,6.8,18444,246,52,43,-171,29.8,1487.6,12,0,1,2,1,0,1,1,0,0,14833,7.0,18615,231,64,-43,171,29.5,1483.3
4845744291,1,35,5,1,10,3,8,1,0,1,0,20543,7.2,19886,207,62,5323,3171,26.9,2054.3,17,1,0,3,10,0,0,0,0,0,15220,6.6,16715,192,60,-5323,-3171,25.2,1522.0
4845703696,1,15,4,0,6,6,7,0,0,0,0,17372,7.0,17645,208,52,140,508,26.0,1737.2,17,3,1,6,6,8,0,0,0,0,17232,6.8,17137,213,44,-140,-508,25.7,1723.2
4845690093,1,7,4,0,4,4,4,0,0,0,0,16566,7.0,18813,214,64,529,2234,27.8,1656.6,13,1,1,4,4,2,0,0,0,0,16037,6.6,16579,185,56,-529,-2234,24.1,1603.7
4845670907,1,10,1,0,9,4,8,0,0,0,0,18320,7.0,18797,218,64,723,797,28.2,1832.0,25,0,1,4,9,5,0,0,0,0,17597,6.8,18000,206,60,-723,-797,26.6,1759.7
4847283445,1,11,4,1,11,2,13,0,0,0,0,17700,6.6,16774,182,39,1520,-1492,22.1,1770.0,26,1,0,2,11,2,0,0,0,0,16180,6.8,18266,203,72,-1520,1492,27.5,1618.0
4847276190,1,12,1,1,4,1,2,0,0,0,0,16713,7.0,18430,230,53,2319,1032,28.3,1671.3,12,2,0,1,4,1,1,0,1,0,14394,6.8,17398,200,66,-2319,-1032,26.6,1439.4
4847255651,1,14,0,0,2,6,1,0,0,0,0,15567,7.0,18227,231,54,-1092,252,28.5,1556.7,18,1,1,6,2,4,1,1,0,0,16659,6.8,17975,222,60,1092,-252,28.2,1665.9
4847242433,0,13,2,1,8,7,6,2,1,1,0,18310,6.8,18574,242,52,318,-945,29.4,1831.0,16,1,0,7,8,6,0,0,0,0,17992,7.4,19519,225,63,-318,945,28.8,1799.2
4847222528,0,12,1,1,5,5,4,0,0,0,0,16803,6.8,17849,225,56,863,17,28.1,1680.3,14,3,0,5,5,5,1,1,0,0,15940,7.2,17832,215,60,-863,-17,27.5,1594.0
4846542118,0,14,0,0,5,7,5,0,0,0,0,16695,7.0,18096,203,62,-119,42,26.5,1669.5,11,2,1,7,5,3,0,0,0,0,16814,6.8,18054,194,52,119,-42,24.6,1681.4
4846520822,0,39,0,1,9,9,11,1,1,0,0,19133,6.8,17557,213,60,552,-1276,27.3,1913.3,31,1,0,9,9,6,0,0,0,0,18581,7.0,18833,223,48,-552,1276,27.1,1858.1
4846494757,0,13,2,1,7,6,5,0,0,0,0,19933,7.2,19055,259,51,2670,951,31.0,1993.3,12,1,0,6,7,4,1,1,0,0,17263,6.8,18104,210,88,-2670,-951,29.8,1726.3
4846470350,1,6,1,1,8,8,5,1,1,0,0,17168,6.8,17295,203,62,-2328,-1170,26.5,1716.8,14,0,0,8,8,8,0,0,0,0,19496,7.2,18465,225,47,2328,1170,27.2,1949.6
4846455184,1,12,1,0,4,5,4,0,0,0,0,15339,7.0,18197,222,60,-2280,-1579,28.2,1533.9,13,1,1,5,4,2,1,1,0,0,17619,7.2,19776,259,56,2280,1579,31.5,1761.9
4846436733,1,15,2,1,7,4,9,0,0,0,0,18685,7.2,19023,238,60,1682,754,29.8,1868.5,13,2,0,4,7,4,1,0,1,0,17003,7.0,18269,209,64,-1682,-754,27.3,1700.3
4846382302,0,8,6,0,4,5,5,0,0,0,0,15985,7.0,18152,227,58,-794,-373,28.5,1598.5,21,2,1,5,4,5,1,1,0,0,16779,7.0,18525,227,64,794,373,29.1,1677.9
4846372332,0,14,3,1,6,5,6,0,0,0,0,17114,6.6,17088,195,67,223,-1418,26.2,1711.4,13,0,0,5,6,2,0,0,0,0,16891,7.0,18506,198,64,-223,1418,26.2,1689.1
4846364314,0,53,2,0,5,10,3,0,0,0,0,18388,7.0,19198,220,72,-583,362,29.2,1838.8,18,0,1,10,5,7,1,1,0,0,18971,6.8,18836,189,60,583,-362,24.9,1897.1
4846362858,0,13,1,0,5,11,5,0,0,0,0,15987,6.8,16810,183,60,-4494,-2279,24.3,1598.7,12,2,1,11,5,12,1,1,0,0,20481,7.2,19089,228,60,4494,2279,28.8,2048.1
4846346496,0,11,1,0,4,4,5,2,1,1,0,17843,7.0,18651,203,70,2694,1050,27.3,1784.3,13,0,1,4,4,1,0,0,0,0,15149,7.0,17601,218,56,-2694,-1050,27.4,1514.9
4846258236,1,20,2,1,5,5,4,0,0,0,0,16321,6.4,15580,206,32,-802,-1757,23.8,1632.1,25,1,0,5,5,3,0,0,0,0,17123,6.8,17337,211,48,802,1757,25.9,1712.3
4846237889,1,33,2,1,7,3,5,1,1,0,0,17034,6.6,17297,206,48,189,-183,25.4,1703.4,14,3,0,3,7,4,0,0,0,0,16845,6.6,17480,222,72,-189,183,29.4,1684.5
4845497553,0,18,2,1,11,7,12,0,0,0,0,19972,7.4,19348,225,64,2079,1199,28.9,1997.2,10,5,0,7,11,7,1,1,0,0,17893,7.0,18149,233,56,-2079,-1199,28.9,1789.3
4845496793,1,8,1,1,7,8,13,1,1,0,0,17182,6.8,17632,207,56,-1198,-994,26.3,1718.2,11,0,0,8,7,6,0,0,0,0,18380,6.8,18626,251,68,1198,994,31.9,1838.0
4848297699,0,13,1,1,9,8,7,0,0,0,0,17284,6.8,18595,225,56,-97,942,28.1,1728.4,26,1,0,8,9,8,0,0,0,0,17381,6.8,17653,206,51,97,-942,25.7,1738.1
4847460456,1,20,1,1,4,9,2,0,0,0,0,16297,6.8,17251,249,48,-1819,-594,29.7,1629.7,13,0,0,9,4,12,0,0,0,0,18116,6.8,17845,208,53,1819,594,26.1,1811.6
4847337916,1,12,0,0,5,5,5,0,0,0,0,15776,6.6,16836,221,48,-1417,-1940,26.9,1577.6,15,1,1,5,5,5,1,0,1,0,17193,7.2,18776,251,56,1417,1940,30.7,1719.3
4845572344,1,16,1,1,8,9,11,0,0,0,0,19877,7.2,19826,223,55,2113,2369,27.8,1987.7,18,0,0,9,8,9,0,0,0,0,17764,7.0,17457,212,55,-2113,-2369,26.7,1776.4
4845461682,0,13,0,1,18,17,52,0,0,0,1,36834,11.2,40144,104,0,381,750,10.4,3683.4,0,3,0,17,18,35,0,0,0,0,36453,10.8,39394,105,0,-381,-750,10.5,3645.3
4845458351,1,18,0,1,36,24,80,0,0,0,1,41119,12.2,47470,98,0,3706,5479,9.8,4111.9,0,4,0,24,36,54,0,0,0,0,37413,11.2,41991,98,0,-3706,-5479,9.8,3741.3
4844495208,1,0,1,1,30,24,72,0,0,0,0,38872,11.8,44480,105,0,959,1695,10.5,3887.2,16,0,0,24,30,71,0,0,0,0,37913,11.4,42785,91,0,-959,-1695,9.1,3791.3
4840590227,1,17,4,1,8,4,14,1,1,0,0,18571,6.6,17288,208,46,2318,842,25.4,1857.1,15,3,0,4,8,5,0,0,0,0,16253,6.6,16446,222,56,-2318,-842,27.8,1625.3
4840575382,1,13,0,0,1,5,2,0,0,0,0,15321,7.0,17900,225,68,-1630,-356,29.3,1532.1,16,2,1,5,1,10,1,1,0,0,16951,7.2,18256,240,60,1630,356,30.0,1695.1
4840571074,1,173,1,1,10,4,8,1,1,0,0,19465,7.0,18423,218,44,3170,673,26.2,1946.5,10,2,0,4,10,4,1,0,1,0,16295,7.0,17750,221,59,-3170,-673,28.0,1629.5
4840487771,1,14,1,1,21,27,49,0,0,0,1,35322,10.6,36413,103,0,-3431,-6443,10.3,3532.2,3,2,0,27,21,74,0,0,0,0,38753,11.4,42856,123,0,3431,6443,12.3,3875.3
4840462569,1,1,0,1,20,34,41,0,0,0,1,35697,10.4,37275,108,0,-3908,-5575,10.8,3569.7,0,0,0,34,20,94,0,0,0,0,39605,11.4,42850,117,0,3908,5575,11.7,3960.5
4840442934,1,21,0,0,24,20,61,0,0,0,0,37481,11.0,40534,121,0,3134,2761,12.1,3748.1,0,18,1,20,24,39,0,0,0,0,34347,10.6,37773,85,0,-3134,-2761,8.5,3434.7
4840418093,1,0,2,0,20,20,47,0,0,0,0,35817,10.8,38693,120,0,-389,-1078,12.0,3581.7,14,0,1,19,19,55,0,0,0,0,36206,11.2,39771,101,0,389,1078,10.1,3620.6
4839539411,1,138,0,0,7,12,5,0,0,0,0,18476,6.8,18039,203,70,-1157,1249,27.3,1847.6,19,1,1,12,7,13,0,0,0,0,19633,6.6,16790,184,44,1157,-1249,22.8,1963.3
4837998640,1,0,0,0,18,16,31,0,0,0,1,35491,10.8,38866,118,0,-234,2094,11.8,3549.1,0,0,1,16,18,45,0,0,0,0,35725,10.6,36772,97,0,234,-2094,9.7,3572.5
4837973857,1,13,0,0,10,2,10,0,0,0,0,19734,7.4,19348,243,51,4171,2166,29.4,1973.4,13,2,1,2,10,1,0,0,0,0,15563,6.8,17182,215,64,-4171,-2166,27.9,1556.3
4837697473,1,15,1,1,6,4,4,1,1,0,0,17612,7.0,18639,244,52,2029,1411,29.6,1761.2,13,1,0,4,6,4,0,0,0,0,15583,7.0,17228,199,56,-2029,-1411,25.5,1558.3
4837675160,1,11,4,1,9,3,9,1,1,0,0,17335,6.4,16267,195,52,1548,-490,24.7,1733.5,11,1,0,3,9,2,0,0,0,0,15787,6.8,16757,194,48,-1548,490,24.2,1578.7
4837649285,1,13,1,1,8,5,6,0,0,0,1,20437,7.4,19745,237,64,3889,2190,30.1,2043.7,12,0,0,5,8,3,0,0,0,0,16548,6.8,17555,207,44,-3889,-2190,25.1,1654.8
4857275395,0,53,24,0,6,6,4,0,0,0,0,17914,7.2,18596,208,60,998,1098,26.8,1791.4,41,2,1,6,6,8,0,0,0,0,16916,7.0,17498,224,49,-998,-1098,27.3,1691.6
4857159575,0,0,0,0,27,28,64,0,0,0,0,37178,11.2,40290,105,0,-2003,-3235,10.5,3717.8,88,0,1,28,27,73,0,0,0,0,39181,11.6,43525,120,0,2003,3235,12.0,3918.1
4857130666,1,0,0,0,32,26,89,0,0,0,1,40286,12.0,45675,117,0,2524,4928,11.7,4028.6,0,0,1,26,32,68,0,0,0,0,37762,11.0,40747,105,0,-2524,-4928,10.5,3776.2
4856097686,1,0,0,0,25,28,58,0,0,0,1,36991,11.2,40154,110,0,-615,-1144,11.0,3699.1,15,0,1,27,24,77,0,0,0,0,37606,11.2,41298,94,0,615,1144,9.4,3760.6
4856066508,0,0,1,0,20,31,49,0,0,0,2,36716,11.2,41021,105,0,-2722,-2306,10.5,3671.6,14,0,1,31,20,90,0,0,0,0,39438,11.6,43327,113,0,2722,2306,11.3,3943.8
4855154706,1,9,10,1,7,2,6,2,1,1,0,17463,7.2,19113,230,64,1852,1555,29.4,1746.3,34,1,0,2,7,0,0,0,0,0,15611,6.8,17558,240,56,-1852,-1555,29.6,1561.1
4855103383,0,15,1,1,7,0,7,1,1,0,0,17209,7.2,18674,238,60,3244,1588,29.8,1720.9,13,1,0,0,7,0,0,0,0,0,13965,6.8,17086,202,56,-3244,-1588,25.8,1396.5
4854735877,1,10,0,0,20,21,70,0,0,0,1,36462,11.0,39550,95,0,422,620,9.5,3646.2,59,0,1,21,20,44,0,0,0,0,36040,10.8,38930,74,0,-422,-620,7.4,3604.0
4854715413,0,0,0,1,24,21,75,0,0,0,0,35743,11.0,40362,97,0,-536,1875,9.7,3574.3,7,0,0,21,24,65,0,0,0,0,36279,10.6,38487,108,0,536,-1875,10.8,3627.9
4854680682,0,0,0,0,19,27,46,0,0,0,0,37315,11.0,39298,108,0,-1687,-2754,10.8,3731.5,0,0,1,27,19,66,0,0,0,0,39002,11.4,42052,124,0,1687,2754,12.4,3900.2
4852391863,0,0,0,1,17,19,37,0,0,0,1,38608,11.2,40494,129,0,2176,1803,12.9,3860.8,0,0,0,19,17,44,0,0,0,0,36432,11.0,38691,95,0,-2176,-1803,9.5,3643.2
4852372598,0,0,0,0,23,28,56,0,0,0,0,36935,11.4,41565,101,0,-711,-702,10.1,3693.5,0,0,1,28,23,65,0,0,0,0,37646,11.4,42267,108,0,711,702,10.8,3764.6
4852369780,0,38,0,1,12,20,33,0,0,0,2,34237,10.4,36264,82,0,-1694,-1428,8.2,3423.7,0,1,0,20,12,51,0,0,0,0,35931,10.8,37692,107,0,1694,1428,10.7,3593.1
4852357341,1,0,0,0,19,17,55,0,0,0,0,36800,10.8,37890,122,0,1711,-1806,12.2,3680.0,0,0,1,17,19,37,0,0,0,0,35089,11.0,39696,101,0,-1711,1806,10.1,3508.9
4852344409,0,1,0,1,25,28,64,0,0,0,2,39874,11.6,42033,115,0,65,100,11.5,3987.4,0,1,0,28,25,67,0,0,0,0,39809,11.6,41933,109,0,-65,-100,10.9,3980.9
4851475722,1,2,0,1,31,31,74,0,0,0,0,39023,11.6,44960,111,0,432,1518,11.1,3902.3,0,0,0,31,31,88,0,0,0,0,38591,11.8,43442,103,0,-432,-1518,10.3,3859.1
4850587072,1,0,0,1,37,24,105,0,0,0,1,40668,12.4,47967,115,0,3947,6549,11.5,4066.8,0,0,0,24,37,54,0,0,0,0,36721,11.2,41418,90,0,-3947,-6549,9.0,3672.1
4850416036,1,64,0,1,7,5,6,0,0,0,0,16448,6.6,17408,193,40,1747,2278,23.3,1644.8,103,1,0,5,7,6,0,0,0,0,14701,6.2,15130,170,36,-1747,-2278,20.6,1470.1
4850400232,1,120,2,1,4,8,0,1,0,1,0,16678,6.6,18038,191,52,-606,-492,24.3,1667.8,36,0,0,8,4,7,0,0,0,0,17284,7.0,18530,196,56,606,492,25.2,1728.4
4848342779,1,56,2,1,7,8,7,0,0,0,0,17066,7.2,18505,206,44,-146,-122,25.0,1706.6,19,2,0,8,7,1,1,0,1,0,17212,6.8,18627,203,48,146,122,25.1,1721.2
4852790684,1,13,0,0,8,2,4,0,0,0,0,17725,7.4,19876,226,67,2184,2080,29.3,1772.5,12,0,1,2,8,3,0,0,0,0,15541,6.8,17796,223,60,-2184,-2080,28.3,1554.1
4851624506,0,16,3,0,7,4,2,0,0,0,0,16675,7.0,17671,207,48,63,-745,25.5,1667.5,9,4,1,4,7,4,1,1,0,0,16612,7.0,18416,187,47,-63,745,23.4,1661.2
4851563478,1,69,0,1,8,7,9,0,0,0,0,17301,6.8,17131,195,46,1077,191,24.1,1730.1,10,2,0,7,8,7,0,0,0,0,16224,6.4,16940,220,42,-1077,-191,26.2,1622.4
4851057320,1,10,1,1,6,0,8,0,0,0,0,16157,6.6,17523,209,44,1530,430,25.3,1615.7,12,0,0,0,6,0,0,0,0,0,14627,6.8,17093,231,64,-1530,-430,29.5,1462.7
4850949539,0,11,0,0,6,2,6,1,1,0,0,15793,6.6,17522,192,46,-261,-976,23.8,1579.3,12,0,1,2,6,2,0,0,0,0,16054,7.0,18498,238,57,261,976,29.5,1605.4
4849587449,0,23,1,1,10,2,10,0,0,0,0,19090,7.0,18968,215,76,4834,1426,29.1,1909.0,14,1,0,2,10,2,0,0,0,0,14256,6.8,17542,191,68,-4834,-1426,25.9,1425.6
4849574925,0,25,2,0,7,4,4,0,0,0,0,15933,6.8,17082,179,40,-448,-591,21.9,1593.3,13,1,1,4,7,2,0,0,0,0,16381,7.0,17673,218,56,448,591,27.4,1638.1
4849549579,1,16,2,0,5,2,7,1,1,0,0,17099,7.0,17691,208,52,3693,2476,26.0,1709.9,10,3,1,2,5,1,0,0,0,0,13406,6.2,15215,180,48,-3693,-2476,22.8,1340.6
4840854143,0,0,0,1,26,25,54,0,0,0,1,37044,11.0,40417,100,0,-2296,-3685,10.0,3704.4,0,0,0,25,26,44,0,0,0,0,39340,11.6,44102,109,0,2296,3685,10.9,3934.0
4840835386,1,0,0,0,26,24,71,0,0,0,1,39541,11.4,43625,106,0,3863,2856,10.6,3954.1,81,0,1,24,26,44,0,0,0,0,35678,11.4,40769,107,0,-3863,-2856,10.7,3567.8
4840818523,0,24,0,0,17,22,32,0,0,0,1,34912,10.8,38691,104,0,-2868,-2007,10.4,3491.2,3,21,1,22,17,70,0,0,0,0,37780,11.2,40698,105,0,2868,2007,10.5,3778.0
4840807913,0,0,0,0,22,23,44,0,0,0,0,35797,10.6,37759,113,0,-1702,-4761,11.3,3579.7,14,0,1,22,21,42,0,0,0,0,37499,11.4,42520,108,0,1702,4761,10.8,3749.9
4839657817,0,9,0,0,0,3,0,0,0,0,0,13678,6.6,16802,217,48,-2543,-1603,26.5,1367.8,12,0,1,3,0,1,0,0,0,0,16221,6.8,18405,204,56,2543,1603,26.0,1622.1
4839375771,0,58,3,0,3,3,3,0,0,0,0,14503,6.8,16266,189,52,-1873,-2285,24.1,1450.3,10,1,1,3,3,2,1,1,0,0,16376,7.2,18551,219,72,1873,2285,29.1,1637.6
4839312655,0,21,1,1,6,6,2,0,0,0,0,17133,7.2,19163,223,52,743,2243,27.5,1713.3,13,1,0,6,6,7,0,0,0,0,16390,6.8,16920,205,52,-743,-2243,25.7,1639.0
4839261492,0,14,1,0,2,6,2,0,0,0,0,14980,7.0,18204,201,64,-1965,1189,26.5,1498.0,12,0,1,6,2,10,0,0,0,0,16945,6.8,17015,218,44,1965,-1189,26.2,1694.5
4839189616,1,10,0,0,2,5,3,1,1,0,0,14217,6.6,17006,201,40,-1507,-659,24.1,1421.7,12,0,1,5,2,1,1,0,1,0,15724,6.6,17665,228,72,1507,659,30.0,1572.4
4839119070,0,9,1,1,5,4,7,0,0,0,0,17712,6.8,17838,234,40,347,-814,27.4,1771.2,11,0,0,4,5,6,0,0,0,0,17365,7.2,18652,225,64,-347,814,28.9,1736.5
4838971991,1,12,3,1,8,4,7,0,0,0,0,18152,6.8,17391,193,62,242,-796,25.5,1815.2,14,2,0,4,8,5,1,1,0,0,17910,7.0,18187,201,42,-242,796,24.3,1791.0
4838943297,1,12,1,0,6,5,8,0,0,0,0,16602,7.2,18693,219,44,897,1532,26.3,1660.2,10,0,1,5,6,3,1,0,1,0,15705,6.8,17161,185,48,-897,-1532,23.3,1570.5
4845009148,0,17,1,0,1,6,1,0,0,0,0,14662,7.0,18655,208,71,-2834,-541,27.9,1466.2,14,2,1,6,1,5,1,1,0,0,17496,7.2,19196,230,68,2834,541,29.8,1749.6
4830319853,0,14,3,0,1,6,2,1,0,1,0,16035,7.0,18236,250,52,-777,339,30.2,1603.5,17,2,1,6,1,3,1,1,0,0,16812,6.8,17897,237,51,777,-339,28.8,1681.2
4830285099,1,14,0,1,12,8,10,0,0,0,0,21319,7.2,19569,225,64,3190,3917,28.9,2131.9,12,1,0,8,12,6,2,1,1,0,18129,6.2,15652,155,49,-3190,-3917,20.4,1812.9
4829374493,0,18,1,0,6,7,8,0,0,0,0,16885,7.2,18196,204,64,-17,641,26.8,1688.5,15,1,1,7,6,6,0,0,0,0,16902,6.8,17555,209,60,17,-641,26.9,1690.2
4828383147,0,33,2,1,4,4,2,1,0,1,0,17551,7.0,18167,222,40,1738,601,26.2,1755.1,30,0,0,4,4,4,0,0,0,0,15813,7.0,17566,229,59,-1738,-601,28.8,1581.3
4826413364,1,17,0,1,10,3,11,0,0,0,0,18978,7.6,19659,228,68,3701,1629,29.6,1897.8,11,3,0,3,10,2,1,1,0,0,15277,7.0,18030,223,64,-3701,-1629,28.7,1527.7
4824525573,0,12,1,0,7,5,8,0,0,0,0,17820,6.6,18081,243,59,250,-254,30.2,1782.0,16,0,1,5,7,4,0,0,0,0,17570,6.8,18335,227,49,-250,254,27.6,1757.0
4822715741,0,13,2,0,3,7,7,0,0,0,0,15718,6.8,17122,212,75,-1495,-1288,28.7,1571.8,15,1,1,7,3,5,1,1,0,0,17213,7.0,18410,234,52,1495,1288,28.6,1721.3
4816005369,1,12,2,0,6,3,7,0,0,0,0,15939,7.0,18153,197,68,637,2030,26.5,1593.9,24,1,1,3,6,3,0,0,0,0,15302,6.4,16123,182,56,-637,-2030,23.8,1530.2
4814984846,0,19,0,0,3,6,3,0,0,0,0,16888,6.8,17438,228,48,-109,-1610,27.6,1688.8,10,4,1,6,3,3,1,1,0,0,16997,7.0,19048,215,68,109,1610,28.3,1699.7
4813009708,0,27,4,0,11,6,13,0,0,0,0,18878,7.0,18450,231,40,1813,864,27.1,1887.8,12,4,1,5,10,7,1,1,0,0,17065,6.8,17586,220,48,-1813,-864,26.8,1706.5
4811021611,0,13,3,0,6,7,8,1,0,1,0,17335,7.0,17819,219,56,-1519,-1557,27.5,1733.5,13,1,1,7,6,9,1,1,0,0,18854,7.2,19376,240,68,1519,1557,30.8,1885.4
4809150398,1,15,1,0,6,8,2,1,1,0,0,17543,7.0,18233,211,47,519,307,25.8,1754.3,13,1,1,8,6,4,0,0,0,0,17024,6.8,17926,182,56,-519,-307,23.8,1702.4
4808130848,1,15,1,1,6,1,7,0,0,0,0,17513,7.0,18890,208,68,4108,3934,27.6,1751.3,11,2,0,1,6,0,1,1,0,0,13405,6.2,14956,194,47,-4108,-3934,24.1,1340.5
4806124263,0,11,0,0,4,3,2,0,0,0,0,16246,6.8,17792,238,56,-503,-1095,29.4,1624.6,11,1,1,3,4,2,1,1,0,0,16749,7.0,18887,232,63,503,1095,29.5,1674.9
4804273352,1,13,1,1,3,6,2,0,0,0,0,14678,6.6,16777,216,56,-1947,-2427,27.2,1467.8,12,1,0,6,3,3,0,0,0,0,16625,7.2,19204,210,55,1947,2427,26.5,1662.5
4802509001,0,9,1,1,4,6,3,0,0,0,0,16333,6.8,17011,193,53,-1589,-1719,24.6,1633.3,21,0,0,6,4,7,1,1,0,0,17922,7.0,18730,219,78,1589,1719,29.7,1792.2
4801556453,1,11,0,1,9,0,6,0,0,0,1,20136,7.4,20272,262,68,6780,3925,33.0,2013.6,11,0,0,0,9,0,0,0,0,0,13356,6.6,16347,217,48,-6780,-3925,26.5,1335.6
4799459639,1,13,2,0,3,2,3,0,0,0,0,16354,7.2,20109,260,72,1255,1843,33.2,1635.4,8,3,1,2,3,2,0,0,0,0,15099,7.2,18266,244,69,-1255,-1843,31.3,1509.9
4797618507,0,34,2,0,4,3,3,0,0,0,0,16023,6.8,17116,211,49,-81,490,26.0,1602.3,32,2,1,3,4,2,0,0,0,0,16104,6.4,16626,213,54,81,-490,26.7,1610.4
4856953034,1,39,4,0,4,6,9,1,1,0,0,16522,6.4,15950,203,52,-1449,-2605,25.5,1652.2,12,8,1,6,4,5,0,0,0,0,17971,7.0,18555,216,67,1449,2605,28.3,1797.1
4856927478,1,16,2,1,6,5,4,1,1,0,0,16682,7.0,18288,203,57,593,1124,26.0,1668.2,8,3,0,5,6,5,1,0,1,0,16089,6.8,17164,220,66,-593,-1124,28.6,1608.9
4822183671,1,14,2,1,5,3,5,0,0,0,0,17016,7.2,19558,260,63,1091,1404,32.3,1701.6,6,1,0,3,5,5,1,1,0,0,15925,7.0,18154,225,76,-1091,-1404,30.1,1592.5
4822166900,0,15,0,0,2,16,3,0,0,0,0,14591,6.8,16362,201,53,-7315,-4748,25.4,1459.1,11,1,1,16,2,17,0,0,0,0,21906,7.4,21110,254,62,7315,4748,31.6,2190.6
4822127746,1,11,1,0,5,6,2,1,1,0,0,16044,6.8,16968,191,60,-5,-654,25.1,1604.4,15,0,1,6,5,7,0,0,0,0,16049,6.8,17622,189,52,5,654,24.1,1604.9
4822065035,1,12,4,0,3,3,2,0,0,0,0,15276,6.8,17681,225,60,-1030,-852,28.5,1527.6,12,1,1,3,3,6,1,1,0,0,16306,7.0,18533,266,64,1030,852,33.0,1630.6
4822003507,0,15,3,1,3,1,3,1,1,0,0,15652,7.0,18003,228,40,-649,-1003,26.8,1565.2,16,2,0,1,3,1,0,0,0,0,16301,7.2,19006,250,72,649,1003,32.2,1630.1
4821874272,0,11,12,1,4,1,8,1,1,0,0,17412,7.2,18837,283,63,3354,1982,34.6,1741.2,90,0,0,1,4,2,0,0,0,0,14058,6.8,16855,214,56,-3354,-1982,27.0,1405.8
4821815548,1,11,1,1,8,1,14,1,1,0,0,18768,7.0,18642,223,56,3117,1291,27.9,1876.8,14,1,0,1,8,0,0,0,0,0,15651,6.8,17351,242,56,-3117,-1291,29.8,1565.1
4821303556,0,10,1,0,3,9,1,0,0,0,0,16305,6.6,17250,205,44,-3275,-1724,24.9,1630.5,11,1,1,9,3,14,1,0,1,0,19580,7.2,18974,227,60,3275,1724,28.7,1958.0
4821284579,0,15,1,0,5,3,5,0,0,0,0,16816,7.0,18756,238,58,32,465,29.6,1681.6,17,3,1,3,5,4,0,0,0,0,16784,6.8,18291,244,69,-32,-465,31.3,1678.4
4821263331,0,17,2,1,6,2,4,0,0,0,0,17264,7.0,18542,249,54,1967,-433,30.3,1726.4,12,3,0,2,6,2,0,0,0,0,15297,7.2,18975,225,76,-1967,433,30.1,1529.7
4821246159,0,14,1,1,10,5,9,1,0,1,0,19439,7.2,19234,226,56,2956,1686,28.2,1943.9,10,1,0,5,10,7,0,0,0,0,16483,6.8,17548,200,48,-2956,-1686,24.8,1648.3
4820648974,1,19,0,1,10,4,8,0,0,0,0,18270,6.6,17876,217,63,2953,2121,28.0,1827.0,15,1,0,4,10,5,0,0,0,0,15317,6.4,15755,179,48,-2953,-2121,22.7,1531.7
4820620816,0,12,2,1,8,9,7,0,0,0,0,18153,7.2,17873,228,44,-623,126,27.2,1815.3,17,0,0,9,8,14,0,0,0,0,18776,7.2,17747,217,60,623,-126,27.7,1877.6
4819929701,0,49,3,0,4,9,5,0,0,0,0,15472,6.8,17717,195,48,-2215,550,24.3,1547.2,20,4,1,9,4,13,1,0,1,0,17687,6.8,17167,217,44,2215,-550,26.1,1768.7
4819277135,1,13,2,1,2,4,1,1,1,0,0,15463,6.4,16104,243,50,-549,-863,29.3,1546.3,13,2,0,4,2,6,0,0,0,0,16012,6.8,16967,218,53,549,863,27.1,1601.2
4819262596,1,34,2,0,17,10,18,0,0,0,0,22907,7.0,18131,204,66,4499,3336,27.0,2290.7,35,0,1,10,17,16,0,0,0,0,18408,6.2,14795,163,46,-4499,-3336,20.9,1840.8
4819251910,0,11,1,0,4,8,1,0,0,0,0,15035,7.0,17948,213,45,-4084,-1623,25.8,1503.5,10,4,1,8,4,7,1,1,0,0,19119,7.2,19571,244,54,4084,1623,29.8,1911.9
4819214510,1,12,0,1,4,3,7,0,0,0,0,16328,6.6,17570,201,52,-191,-1098,25.3,1632.8,11,2,0,3,4,2,1,0,1,0,16519,7.0,18668,277,64,191,1098,34.1,1651.9
4858259131,0,29,2,0,10,8,9,0,0,0,0,17378,7.2,18064,210,56,-885,66,26.6,1737.8,18,3,1,8,10,7,1,1,0,0,18263,7.0,17998,213,62,885,-66,27.5,1826.3
4858216772,1,12,1,1,6,5,4,0,0,0,0,16912,7.0,18163,228,56,-147,-512,28.4,1691.2,14,2,0,5,6,6,1,1,0,0,17059,7.0,18675,211,72,147,512,28.3,1705.9
4858167162,1,13,3,0,4,5,4,0,0,0,0,17183,6.8,18253,231,56,494,319,28.7,1718.3,17,2,1,5,4,6,1,1,0,0,16689,6.6,17934,238,60,-494,-319,29.8,1668.9
4858134843,0,11,1,1,9,9,10,0,0,0,0,17337,6.8,16833,232,48,-1200,-2045,28.0,1733.7,11,0,0,9,9,5,1,1,0,0,18537,7.4,18878,213,60,1200,2045,27.3,1853.7
4857494341,1,89,3,1,11,8,8,0,0,0,0,19093,7.2,18626,197,60,1413,1933,25.7,1909.3,10,3,0,8,11,11,0,0,0,0,17680,6.6,16693,161,47,-1413,-1933,20.8,1768.0
4857457265,1,12,2,1,10,4,11,1,1,0,0,18185,7.0,17202,232,45,2046,453,27.7,1818.5,15,0,0,4,10,5,0,0,0,0,16139,6.6,16749,216,61,-2046,-453,27.7,1613.9
4857391217,1,8,1,1,9,5,11,0,0,0,0,17759,6.6,17830,238,56,2013,1446,29.4,1775.9,15,0,0,5,9,9,0,0,0,0,15746,6.6,16384,209,54,-2013,-1446,26.3,1574.6
4857350493,0,15,2,1,3,6,1,0,0,0,0,15337,7.0,17901,234,48,-963,-914,28.2,1533.7,13,1,0,6,3,3,0,0,0,0,16300,7.0,18815,214,68,963,914,28.2,1630.0
4857280337,0,12,0,0,8,6,3,0,0,0,0,17377,7.0,19255,189,72,133,1389,26.1,1737.7,15,0,1,4,6,2,1,1,0,0,17244,7.0,17866,196,54,-133,-1389,25.0,1724.4
4857226722,1,13,0,0,12,8,6,0,0,0,0,18521,7.0,18624,169,60,865,924,22.9,1852.1,11,0,1,6,10,3,0,0,0,0,17656,7.0,17700,211,52,-865,-924,26.3,1765.6
4857194005,0,195,1,1,4,3,5,1,1,0,0,15872,6.8,17991,207,56,314,-237,26.3,1587.2,13,1,0,3,4,4,0,0,0,0,15558,7.0,18228,213,67,-314,237,28.0,1555.8
4857147147,1,62,1,0,5,6,8,1,1,0,0,17196,7.0,17992,232,46,354,344,27.8,1719.6,9,1,1,6,5,8,1,0,1,0,16842,6.8,17648,213,60,-354,-344,27.3,1684.2
4856320201,1,10,2,0,6,7,5,0,0,0,0,17918,7.0,18525,250,64,1275,2352,31.4,1791.8,18,0,1,6,5,10,0,0,0,0,16643,6.6,16173,192,50,-1275,-2352,24.2,1664.3
4855353024,1,13,1,1,7,7,5,0,0,0,0,18003,7.2,18610,230,46,510,-354,27.6,1800.3,17,3,0,7,7,8,1,1,0,0,17493,7.0,18964,217,71,-510,354,28.8,1749.3
4855303647,0,11,1,0,6,14,8,0,0,0,0,16518,6.6,16497,190,62,-3464,-1489,25.2,1651.8,12,0,1,14,6,19,2,1,1,0,19982,6.8,17986,202,68,3464,1489,27.0,1998.2
4855142922,1,14,1,1,7,1,5,0,0,0,0,17052,7.4,19176,232,54,3459,1725,28.6,1705.2,15,1,0,1,7,0,0,0,0,0,13593,7.0,17451,208,48,-3459,-1725,25.6,1359.3
4855088214,0,20,0,1,4,4,3,0,0,0,0,15484,6.6,17039,221,49,680,-114,27.0,1548.4,42,1,0,4,4,3,1,1,0,0,14804,7.0,17153,218,48,-680,114,26.6,1480.4
4852815447,0,84,1,1,4,3,3,0,0,0,0,14425,6.2,15212,189,36,-2197,-3305,22.5,1442.5,11,1,0,3,4,1,2,1,1,0,16622,7.0,18517,206,60,2197,3305,26.6,1662.2
4852769181,0,9,2,0,5,4,5,0,0,0,0,15375,6.8,18130,192,60,-699,1595,25.2,1537.5,11,2,1,4,5,5,0,0,0,0,16074,6.4,16535,201,56,699,-1595,25.7,1607.4
4832566782,0,12,2,0,4,8,3,0,0,0,0,16244,6.6,17523,230,48,-2016,-1205,27.8,1624.4,13,2,1,8,4,8,1,1,0,0,18260,7.2,18728,206,62,2016,1205,26.8,1826.0
4830059847,1,8,0,0,24,22,50,0,0,0,1,39201,11.2,40684,123,0,2327,-41,12.3,3920.1,0,0,1,22,24,44,0,0,0,0,36874,11.2,40725,101,0,-2327,41,10.1,3687.4
4820479018,0,13,1,1,7,10,6,0,0,0,0,18337,7.0,18331,214,63,-481,436,27.7,1833.7,13,3,0,10,7,14,0,0,0,0,18818,7.0,17895,244,44,481,-436,28.8,1881.8
4820429611,1,26,3,0,11,6,11,0,0,0,0,19477,7.0,18006,223,40,1786,1891,26.3,1947.7,16,4,1,6,11,5,1,1,0,0,17691,6.4,16115,220,40,-1786,-1891,26.0,1769.1
4820400534,1,29,2,1,3,4,2,0,0,0,0,17439,7.4,19476,243,56,1625,377,29.9,1743.9,13,1,0,4,3,3,0,0,0,0,15814,7.0,19099,237,58,-1625,-377,29.5,1581.4
4820380202,1,14,1,0,3,5,4,0,0,0,0,16736,7.0,17829,237,52,12,-732,28.9,1673.6,17,4,1,5,3,5,1,1,0,0,16724,6.8,18561,241,60,-12,732,30.1,1672.4
4820366754,0,28,3,0,3,4,2,0,0,0,0,15368,6.8,17814,248,47,-1723,-1505,29.5,1536.8,15,3,1,4,3,6,0,0,0,0,17091,7.2,19319,228,69,1723,1505,29.7,1709.1
4819734852,1,14,1,1,8,7,14,1,1,0,0,18762,6.4,17143,206,54,1505,100,26.0,1876.2,14,0,0,7,8,11,0,0,0,0,17257,6.6,17043,201,56,-1505,-100,25.7,1725.7
4819696389,1,9,2,0,5,4,6,0,0,0,0,16961,7.0,19245,235,71,253,1145,30.6,1696.1,14,0,1,4,5,3,0,0,0,0,16708,6.8,18100,250,56,-253,-1145,30.6,1670.8
4819658705,0,10,0,0,3,7,4,1,0,1,0,16818,6.8,16918,222,52,-1929,-1562,27.4,1681.8,15,2,1,7,3,9,0,0,0,0,18747,7.0,18480,214,56,1929,1562,27.0,1874.7
4819454926,1,12,2,1,4,0,1,0,0,0,0,16370,7.4,20184,246,60,2708,2730,30.6,1637.0,11,1,0,0,4,0,1,1,0,0,13662,6.6,17454,220,60,-2708,-2730,28.0,1366.2
4818602250,1,10,3,0,2,8,1,0,0,0,0,14429,6.6,17216,214,60,-3836,-1844,27.4,1442.9,14,0,1,8,2,7,0,0,0,0,18265,7.0,19060,255,48,3836,1844,30.3,1826.5
4816691019,0,16,0,0,0,10,0,0,0,0,0,14558,6.6,16866,207,56,-4296,-1625,26.3,1455.8,12,3,1,10,0,11,1,1,0,0,18854,7.0,18491,201,56,4296,1625,25.7,1885.4
4816672576,1,24,1,0,5,5,3,1,0,1,0,18478,7.4,18998,237,53,1249,1070,29.0,1847.8,15,2,1,5,5,8,1,1,0,0,17229,7.0,17928,243,46,-1249,-1070,28.9,1722.9
4816665039,0,9,3,0,4,6,3,0,0,0,0,15704,7.0,18007,247,47,-2399,-2191,29.4,1570.4,14,1,1,6,4,6,1,0,1,0,18103,7.4,20198,251,80,2399,2191,33.1,1810.3
4815811525,0,17,4,0,3,3,3,0,0,0,0,15739,6.6,17660,256,48,-268,-537,30.4,1573.9,18,4,1,3,3,7,0,0,0,0,16007,7.2,18197,229,72,268,537,30.1,1600.7
4815787629,0,10,0,1,4,8,5,0,0,0,0,15362,6.6,15997,213,52,-4201,-4171,26.5,1536.2,13,0,0,8,4,6,0,0,0,0,19563,7.6,20168,250,66,4201,4171,31.6,1956.3
4815779361,0,7,1,0,11,19,18,0,0,0,0,18392,6.6,16109,204,50,-3801,-3399,25.4,1839.2,32,3,1,19,11,21,1,1,0,0,22193,7.2,19508,228,56,3801,3399,28.4,2219.3
4815761952,1,13,0,1,8,2,7,1,0,1,0,18782,7.2,19196,241,56,3957,1801,29.7,1878.2,23,0,0,2,8,2,0,0,0,0,14825,7.0,17395,213,61,-3957,-1801,27.4,1482.5
4815749896,1,11,2,0,4,4,4,0,0,0,0,17035,7.4,18921,226,72,970,920,29.8,1703.5,11,1,1,4,4,3,0,0,0,0,16065,6.8,18001,238,60,-970,-920,29.8,1606.5
4857505996,1,0,0,1,18,13,14,0,0,0,0,46665,10.0,47500,0,0,19500,19000,0.0,4666.5,0,0,0,4,9,7,0,0,0,0,27165,6.0,28500,0,0,-19500,-19000,0.0,2716.5
4857480871,1,17,0,1,17,13,20,0,0,0,0,45600,10.0,47500,0,0,18800,19000,0.0,4560.0,5,0,0,6,10,6,0,0,0,0,26800,6.0,28500,0,0,-18800,-19000,0.0,2680.0
4857299254,0,54,2,1,6,3,9,0,0,0,0,15380,6.4,16347,146,52,1916,-629,19.8,1538.0,15,3,0,3,6,2,0,0,0,0,13464,6.6,16976,175,48,-1916,629,22.3,1346.4
4857269768,1,32,2,1,7,3,6,0,0,0,0,19010,7.0,18672,220,48,2589,260,26.8,1901.0,34,2,0,3,7,4,0,0,0,0,16421,7.0,18412,208,56,-2589,-260,26.4,1642.1
4857236968,1,36,0,1,6,5,6,0,0,0,0,19079,7.2,19214,221,52,4923,1924,27.3,1907.9,31,1,0,5,6,0,0,0,0,0,14156,6.8,17290,170,40,-4923,-1924,21.0,1415.6
4857193133,0,35,0,0,2,2,0,0,0,0,0,13493,6.4,16509,176,56,-1761,-2314,23.2,1349.3,34,1,1,2,2,0,0,0,0,0,15254,7.0,18823,218,56,1761,2314,27.4,1525.4
4857129205,1,53,0,0,7,7,2,0,0,0,0,17965,7.2,18705,239,55,1749,3380,29.4,1796.5,10,2,1,7,7,3,0,0,0,0,16216,6.4,15325,175,56,-1749,-3380,23.1,1621.6
4857010701,0,34,0,1,4,5,6,0,0,0,0,16542,7.0,17915,207,64,-330,-573,27.1,1654.2,32,0,0,5,4,4,0,0,0,0,16872,7.0,18488,247,52,330,573,29.9,1687.2
4856974508,1,50,0,1,6,1,5,1,0,1,0,17772,7.4,19814,224,59,2460,1884,28.3,1777.2,15,0,0,1,6,1,0,0,0,0,15312,7.0,17930,211,60,-2460,-1884,27.1,1531.2
4856951220,1,50,2,0,7,3,9,0,0,0,0,16722,6.8,17403,200,51,2140,-170,25.1,1672.2,15,2,1,3,7,2,0,0,0,0,14582,7.0,17573,194,60,-2140,170,25.4,1458.2
4855433156,1,35,1,0,3,3,2,0,0,0,0,16066,6.8,17431,199,48,1207,499,24.7,1606.6,32,0,1,3,3,3,0,0,0,0,14859,7.0,16932,181,56,-1207,-499,23.7,1485.9
4855384623,1,0,0,0,17,20,18,0,0,0,0,63400,12.6,59500,0,0,23700,22000,0.0,6340.0,6,0,1,12,9,12,0,0,0,0,39700,7.8,37500,0,0,-23700,-22000,0.0,3970.0
4855370230,1,384,1,1,17,17,14,0,0,0,0,46155,10.0,47500,8,0,18290,19000,0.8,4615.5,48,3,0,8,8,8,0,0,0,0,27865,6.0,28500,0,0,-18290,-19000,0.0,2786.5
4855166850,0,0,0,1,19,21,39,0,0,0,1,35872,10.8,37461,124,0,610,-1285,12.4,3587.2,13,0,0,21,19,63,0,0,0,0,35262,10.8,38746,76,0,-610,1285,7.6,3526.2
4855128237,1,11,0,0,26,27,70,0,0,0,0,38260,11.4,42885,114,0,1345,1081,11.4,3826.0,0,0,1,27,26,68,0,0,0,0,36915,11.4,41804,92,0,-1345,-1081,9.2,3691.5
4855094159,1,0,0,1,21,15,71,0,0,0,2,38058,11.0,39005,121,0,4081,1915,12.1,3805.8,0,0,0,14,20,29,0,0,0,0,33977,10.6,37090,85,0,-4081,-1915,8.5,3397.7
4855044741,0,30,2,1,7,5,9,0,0,0,0,17097,7.0,17502,220,48,217,-1129,26.8,1709.7,34,0,0,5,7,2,0,0,0,0,16880,7.2,18631,203,71,-217,1129,27.4,1688.0
4854194355,1,6,0,0,14,15,21,0,0,0,0,61674,12.0,55000,0,0,23424,22000,0.0,6167.4,52,0,1,11,10,6,0,0,0,0,38250,7.2,33000,0,0,-23424,-22000,0.0,3825.0
4854164691,1,20,0,1,18,14,17,0,0,0,0,48640,10.0,47500,0,0,21487,19000,0.0,4864.0,0,0,0,6,10,4,0,0,0,0,27153,6.0,28500,0,0,-21487,-19000,0.0,2715.3
4854138464,1,176,0,0,14,19,14,0,0,0,0,46300,10.0,47500,0,0,16697,18775,0.0,4630.0,176,0,1,12,7,10,0,0,0,0,29603,6.0,28725,0,0,-16697,-18775,0.0,2960.3
4854010529,1,17,2,0,6,12,9,1,1,0,0,18165,7.0,17600,224,48,-811,339,27.2,1816.5,16,0,1,12,6,13,0,0,0,0,18976,7.0,17261,186,56,811,-339,24.2,1897.6
4853971019,1,15,0,0,4,5,5,1,1,0,0,15085,6.8,17635,193,52,-1862,-858,24.5,1508.5,13,0,1,5,4,7,0,0,0,0,16947,7.0,18493,212,68,1862,858,28.0,1694.7
4853726601,0,11,2,0,2,6,1,1,1,0,0,14921,6.6,17316,220,56,-1273,-709,27.6,1492.1,11,2,1,6,2,5,0,0,0,0,16194,7.0,18025,226,48,1273,709,27.4,1619.4
4853690434,1,12,2,1,4,5,2,0,0,0,0,15872,6.8,17567,203,59,-59,-88,26.2,1587.2,11,2,0,5,4,7,0,0,0,0,15931,6.8,17655,198,52,59,88,25.0,1593.1
4852858837,0,21,2,1,5,6,5,0,0,0,0,15502,6.8,17646,217,48,-1793,-1177,26.5,1550.2,79,0,0,6,5,5,1,1,0,0,17295,7.2,18823,237,56,1793,1177,29.3,1729.5
4852802191,1,87,5,1,9,8,8,1,1,0,0,17851,6.8,17715,191,44,-52,-1024,23.5,1785.1,32,0,0,8,9,5,0,0,0,0,17903,6.8,18739,227,68,52,1024,29.5,1790.3
4850790379,1,15,2,0,10,8,13,1,1,0,0,19456,6.6,17112,207,44,-18,-887,25.1,1945.6,12,5,1,8,10,10,0,0,0,0,19474,7.2,17999,220,32,18,887,25.2,1947.4
4850760403,1,14,3,0,7,8,12,1,1,0,0,17233,7.0,18382,240,68,-826,532,30.8,1723.3,15,4,1,8,7,21,0,0,0,0,18059,7.0,17850,239,47,826,-532,28.6,1805.9
4850713434,1,11,0,0,6,6,5,0,0,0,0,16497,7.0,18523,197,68,-2444,143,26.5,1649.7,83,1,1,6,6,6,1,1,0,0,18941,7.0,18380,221,56,2444,-143,27.7,1894.1
4850686362,0,12,2,1,5,12,10,0,0,0,0,14860,5.6,13125,148,19,-3808,-3256,16.7,1486.0,12,1,0,12,5,15,1,1,0,0,18668,6.4,16381,151,40,3808,3256,19.1,1866.8
4850658810,1,13,4,0,13,9,14,1,1,0,0,21078,7.0,18122,219,40,2501,2371,25.9,2107.8,17,0,1,9,13,12,0,0,0,0,18577,6.4,15751,195,48,-2501,-2371,24.3,1857.7
4844828250,1,13,0,1,3,0,3,0,0,0,0,15928,7.0,18832,200,72,2164,1980,27.2,1592.8,16,0,0,0,3,0,1,1,0,0,13764,6.8,16852,218,44,-2164,-1980,26.2,1376.4
4844793895,0,13,3,0,5,5,7,0,0,0,0,16123,6.8,17651,190,48,591,57,23.8,1612.3,10,1,1,5,5,3,0,0,0,0,15532,7.0,17594,198,52,-591,-57,25.0,1553.2
4844762320,0,16,0,0,4,4,3,0,0,0,0,16123,6.8,18224,216,44,-169,170,26.0,1612.3,12,1,1,4,4,2,0,0,0,0,16292,7.2,18054,217,60,169,-170,27.7,1629.2
4844740349,1,13,2,0,6,4,3,0,0,0,0,16180,6.8,17446,160,60,-1327,392,22.0,1618.0,10,1,1,4,6,3,0,0,0,0,17507,6.6,17054,220,36,1327,-392,25.6,1750.7
4844717691,1,11,0,1,10,9,12,0,0,0,0,18945,6.8,17056,193,69,730,-242,26.2,1894.5,10,1,0,9,10,12,1,1,0,0,18215,6.8,17298,196,46,-730,242,24.2,1821.5
4844634728,1,11,1,1,7,9,9,1,1,0,0,17879,7.0,18375,200,54,159,-297,25.4,1787.9,79,1,0,9,7,4,0,0,0,0,17720,7.2,18672,237,56,-159,297,29.3,1772.0
4844626224,0,17,2,0,7,8,10,0,0,0,0,16535,6.8,16905,220,41,-868,-1057,26.1,1653.5,65,1,1,8,7,9,0,0,0,0,17403,6.8,17962,225,59,868,1057,28.4,1740.3
4844593526,1,16,0,0,4,6,3,1,1,0,0,15627,6.8,17555,183,68,-1375,-953,25.1,1562.7,12,2,1,6,4,2,0,0,0,0,17002,7.0,18508,221,48,1375,953,26.9,1700.2
4858241517,0,10,1,1,7,9,5,0,0,0,0,17049,6.8,17326,188,52,-2497,-2371,24.0,1704.9,12,1,0,9,7,8,0,0,0,0,19546,7.4,19697,257,60,2497,2371,31.7,1954.6
4857099423,1,13,0,1,7,5,10,1,1,0,0,17594,6.8,17621,211,48,2350,1021,25.9,1759.4,12,1,0,5,7,7,1,0,1,0,15244,6.6,16600,183,47,-2350,-1021,23.0,1524.4
4857075842,0,14,5,1,6,6,9,0,0,0,0,16154,7.0,17623,212,56,-973,134,26.8,1615.4,13,0,0,6,6,7,1,1,0,0,17127,6.8,17489,240,44,973,-134,28.4,1712.7
4857037613,0,37,2,1,8,9,7,1,1,0,0,19323,7.0,19021,202,63,1082,1018,26.5,1932.3,30,0,0,9,8,11,0,0,0,0,18241,6.8,18003,211,52,-1082,-1018,26.3,1824.1
4853200605,0,0,0,0,33,26,98,0,0,0,1,39935,11.6,43687,123,0,2431,3961,12.3,3993.5,0,0,1,26,33,76,0,0,0,0,37504,11.0,39726,106,0,-2431,-3961,10.6,3750.4
4853196750,0,0,0,1,25,22,54,0,0,0,0,37704,11.2,41148,101,0,916,329,10.1,3770.4,0,0,0,22,25,56,0,0,0,0,36788,11.2,40819,94,0,-916,-329,9.4,3678.8
4853177361,0,17,0,1,31,26,79,0,0,0,1,39099,11.4,43520,93,0,-496,-707,9.3,3909.9,0,3,0,26,31,51,0,0,0,0,39595,11.6,44227,117,0,496,707,11.7,3959.5
4853043226,0,12,2,0,2,11,0,0,0,0,0,14997,6.8,17385,209,52,-5074,-2543,26.1,1499.7,131,1,1,11,2,8,0,0,0,0,20071,7.4,19928,233,74,5074,2543,30.7,2007.1
4850270368,1,11,2,1,9,4,13,0,0,0,0,16871,6.8,16529,189,53,1598,-438,24.2,1687.1,10,0,0,4,9,4,1,1,0,0,15273,6.6,16967,202,48,-1598,438,25.0,1527.3
4849351498,0,0,0,0,23,34,52,0,0,0,3,38760,11.6,43752,103,0,-1794,-1126,10.3,3876.0,0,0,1,34,23,82,0,0,0,0,40554,11.8,44878,112,0,1794,1126,11.2,4055.4
4848820274,1,78,1,0,10,5,7,0,0,0,0,18078,7.2,18387,222,39,1771,1063,26.1,1807.8,14,1,1,5,10,4,0,0,0,0,16307,7.0,17324,215,52,-1771,-1063,26.7,1630.7
4848791240,0,12,5,0,4,6,4,0,0,0,0,15257,6.4,16314,177,58,-2057,-2369,23.5,1525.7,26,0,1,6,4,5,1,0,1,0,17314,6.8,18683,221,61,2057,2369,28.2,1731.4
4848164508,0,1,0,1,41,22,130,0,0,0,3,45188,12.0,46806,110,0,5187,4063,11.0,4518.8,12,0,0,22,41,51,0,0,0,0,40001,11.2,42743,97,0,-5187,-4063,9.7,4000.1
4848144315,1,0,0,1,29,37,64,0,0,0,1,39466,11.6,44753,103,0,-3861,-4258,10.3,3946.6,0,0,0,37,29,92,0,0,0,0,43327,12.4,49011,112,0,3861,4258,11.2,4332.7
4844340995,0,12,0,1,10,7,7,0,0,0,0,17489,6.6,17493,207,42,-87,324,24.9,1748.9,65,1,0,7,10,4,0,0,0,0,17576,6.8,17169,191,57,87,-324,24.8,1757.6
4844314022,1,12,0,0,13,9,8,0,0,0,0,18994,6.8,17375,208,53,1377,525,26.1,1899.4,14,0,1,9,13,10,1,1,0,0,17617,6.6,16850,189,42,-1377,-525,23.1,1761.7
4843817382,1,0,3,0,21,22,64,0,0,0,2,37457,11.2,39938,107,0,-675,-788,10.7,3745.7,11,0,1,22,21,45,0,0,0,0,38132,11.2,40726,101,0,675,788,10.1,3813.2
4836630026,1,0,0,1,31,27,71,0,0,0,0,39729,11.6,44181,110,0,994,948,11.0,3972.9,0,0,0,27,31,67,0,0,0,0,38735,11.6,43233,101,0,-994,-948,10.1,3873.5
4836612230,1,20,0,1,29,22,77,0,0,0,2,41243,11.8,44547,115,0,3705,3430,11.5,4124.3,0,0,0,22,29,59,0,0,0,0,37538,11.2,41117,113,0,-3705,-3430,11.3,3753.8
4836587668,1,0,0,0,18,27,33,0,0,0,0,36264,10.8,38580,118,0,-1342,-4563,11.8,3626.4,0,0,1,27,18,75,0,0,0,0,37606,11.4,43143,103,0,1342,4563,10.3,3760.6
4854282934,1,38,1,1,27,24,29,0,0,0,0,64630,12.0,55000,6,0,26360,22000,0.6,6463.0,0,3,0,12,15,9,0,0,0,0,38270,7.2,33000,0,0,-26360,-22000,0.0,3827.0
4852028771,0,16,2,0,6,7,5,0,0,0,0,15744,6.6,16729,220,40,-1738,-1030,26.0,1574.4,16,3,1,7,6,6,0,0,0,0,17482,6.8,17759,210,56,1738,1030,26.6,1748.2
4852000680,0,14,0,0,5,9,5,0,0,0,0,15012,6.4,15278,207,31,-3436,-1791,23.8,1501.2,12,2,1,8,4,11,0,0,0,0,18448,6.8,17069,210,61,3436,1791,27.1,1844.8
4845404445,0,26,0,0,2,8,1,0,0,0,0,14246,6.8,17390,205,64,-4503,-2357,26.9,1424.6,13,1,1,8,2,8,1,1,0,0,18749,7.4,19747,250,76,4503,2357,32.6,1874.9
4839355767,0,10,2,0,13,22,17,0,0,0,0,34617,10.6,38216,130,58,-6420,-5676,18.8,3461.7,13,0,1,22,13,49,0,0,0,0,41037,11.6,43892,124,63,6420,5676,18.7,4103.7
4839322493,0,24,0,1,10,7,20,0,0,0,0,31986,10.6,35690,131,39,-2432,-902,17.0,3198.6,14,1,0,7,10,15,0,0,0,0,34418,10.4,36592,105,63,2432,902,16.8,3441.8
4833102814,1,11,1,1,3,2,1,2,1,1,0,16126,7.2,18782,254,72,794,987,32.6,1612.6,13,2,0,2,3,1,0,0,0,0,15332,6.8,17795,241,48,-794,-987,28.9,1533.2
4833056779,0,16,1,0,7,5,9,1,1,0,0,17491,6.8,17634,225,55,979,306,28.0,1749.1,15,1,1,5,7,6,0,0,0,0,16512,6.6,17328,197,48,-979,-306,24.5,1651.2
4832993683,0,38,1,1,7,6,4,0,0,0,0,17312,7.2,18809,256,52,-1126,-282,30.8,1731.2,12,12,0,6,7,6,1,0,1,0,18438,7.0,19091,242,44,1126,282,28.6,1843.8
4832760555,0,22,22,0,2,6,0,0,0,0,0,14677,6.8,17904,214,52,-3753,-827,26.6,1467.7,38,1,1,6,2,3,0,0,0,0,18430,7.2,18731,246,61,3753,827,30.7,1843.0
4832739192,1,9,2,0,6,6,3,1,0,1,0,17623,7.0,19138,276,56,71,1337,33.2,1762.3,16,0,1,6,6,9,0,0,0,0,17552,7.0,17801,239,47,-71,-1337,28.6,1755.2
4832723863,1,11,0,0,5,5,3,1,1,0,0,16927,7.2,19376,217,72,1184,2527,28.9,1692.7,9,1,1,5,5,7,0,0,0,0,15743,6.6,16849,202,48,-1184,-2527,25.0,1574.3
4832692026,1,13,1,1,4,1,3,0,0,0,0,15591,6.8,18081,225,48,-72,-1671,27.3,1559.1,9,1,0,1,4,0,1,1,0,0,15663,7.4,19752,259,64,72,1671,32.3,1566.3
4832673383,0,12,2,0,4,5,2,0,0,0,0,15169,6.8,17273,233,59,-1591,-447,29.2,1516.9,16,0,1,5,4,5,1,1,0,0,16760,6.8,17720,221,52,1591,447,27.3,1676.0
4832274745,1,16,2,1,10,8,7,0,0,0,0,17751,6.6,17028,222,48,220,-497,27.0,1775.1,15,0,0,7,9,5,1,1,0,0,17531,6.8,17525,230,52,-220,497,28.2,1753.1
4832238578,0,19,0,0,5,9,7,0,0,0,0,16555,6.6,17158,202,58,-3204,-1477,26.0,1655.5,13,2,1,9,5,9,0,0,0,0,19759,7.0,18635,231,50,3204,1477,28.1,1975.9
4832201255,0,19,2,0,8,3,7,0,0,0,0,18349,7.2,19098,245,53,2807,2619,29.8,1834.9,22,3,1,3,8,6,0,0,0,0,15542,6.6,16479,215,42,-2807,-2619,25.7,1554.2
4832150359,0,12,1,0,6,8,5,0,0,0,0,16969,7.2,17533,224,38,-1053,-1219,26.2,1696.9,16,4,1,8,6,7,1,1,0,0,18022,7.2,18752,214,72,1053,1219,28.6,1802.2
4832110646,1,15,2,0,3,5,3,2,1,1,0,15911,6.6,16872,222,47,-1375,-1123,26.9,1591.1,8,1,1,5,3,5,0,0,0,0,17286,7.0,17995,237,51,1375,1123,28.8,1728.6
4833589390,0,13,3,0,2,4,2,0,0,0,0,15746,6.8,17903,228,52,-747,139,28.0,1574.6,114,4,1,4,2,4,1,1,0,0,16493,6.8,17764,218,59,747,-139,27.7,1649.3
4828398296,1,103,2,1,5,4,1,1,1,0,0,18637,7.2,19290,238,69,2465,1301,30.7,1863.7,36,2,0,4,5,3,0,0,0,0,16172,7.0,17989,202,57,-2465,-1301,25.9,1617.2
4828369048,1,14,2,0,4,7,1,1,1,0,0,16553,6.8,18202,234,56,-1136,328,29.0,1655.3,21,1,1,7,4,9,0,0,0,0,17689,6.8,17874,243,48,1136,-328,29.1,1768.9
4828337318,0,15,1,0,8,12,6,0,0,0,0,18195,6.8,17357,196,63,-1701,-1033,25.9,1819.5,83,2,1,12,8,18,1,1,0,0,19896,7.2,18390,232,52,1701,1033,28.4,1989.6
4828301662,0,85,0,0,3,9,3,0,0,0,0,14830,6.4,16263,188,44,-3066,-3033,23.2,1483.0,11,6,1,9,3,8,0,0,0,0,17896,7.2,19296,237,64,3066,3033,30.1,1789.6
4827464831,0,13,0,0,2,3,3,0,0,0,0,15264,7.0,18419,243,55,-112,545,29.8,1526.4,12,4,1,3,2,7,1,1,0,0,15376,6.8,17874,209,52,112,-545,26.1,1537.6
4827427177,0,15,2,1,2,1,1,1,1,0,0,15017,6.8,17062,225,64,-307,417,28.9,1501.7,17,3,0,1,2,1,0,0,0,0,15324,6.8,16645,212,53,307,-417,26.5,1532.4
4827387515,1,12,1,1,5,8,7,1,1,0,0,17220,7.0,17612,224,55,-745,-1095,27.9,1722.0,13,0,0,8,5,8,0,0,0,0,17965,7.0,18707,239,58,745,1095,29.7,1796.5
4827282484,1,12,2,1,6,1,8,0,0,0,0,17073,6.8,17240,215,64,2958,662,27.9,1707.3,10,3,0,1,6,2,0,0,0,0,14115,6.6,16578,209,44,-2958,-662,25.3,1411.5
4825450296,1,18,4,0,4,5,0,0,0,0,0,16006,7.0,18403,239,60,-1136,89,29.9,1600.6,11,3,1,5,4,5,0,0,0,0,17142,7.2,18314,235,47,1136,-89,28.2,1714.2
4825428840,1,12,1,1,8,4,5,0,0,0,0,17224,7.4,18638,205,68,1201,1045,27.3,1722.4,13,0,0,4,8,5,1,1,0,0,16023,6.8,17593,210,52,-1201,-1045,26.2,1602.3
4825398851,0,50,4,0,5,8,5,0,0,0,0,15652,6.8,16387,201,44,-4374,-2512,24.5,1565.2,13,2,1,8,5,4,0,0,0,0,20026,7.2,18899,229,56,4374,2512,28.5,2002.6
4825378099,0,81,3,1,5,6,3,0,0,0,0,16244,7.2,18717,209,72,-2040,-664,28.1,1624.4,10,3,0,6,5,9,1,1,0,0,18284,7.4,19381,217,80,2040,664,29.7,1828.4
4825360069,0,11,1,0,1,8,1,0,0,0,0,14556,6.8,17479,209,68,-2766,-1216,27.7,1455.6,11,2,1,8,1,8,0,0,0,0,17322,7.0,18695,213,59,2766,1216,27.2,1732.2
4825346088,0,11,1,0,7,7,4,0,0,0,0,17024,7.0,18727,214,63,-154,750,27.7,1702.4,18,0,1,6,6,9,0,0,0,0,17178,7.0,17977,203,48,154,-750,25.1,1717.8
4824831666,0,9,1,0,5,6,5,0,0,0,0,16012,7.0,17914,232,46,-1291,-749,27.8,1601.2,89,1,1,6,5,6,0,0,0,0,17303,7.2,18663,228,61,1291,749,28.9,1730.3
4824796870,1,22,2,1,12,7,12,0,0,0,0,19301,6.8,17804,212,46,2562,2034,25.8,1930.1,79,3,0,7,12,12,0,0,0,0,16739,6.4,15770,190,56,-2562,-2034,24.6,1673.9
4824706611,0,40,5,0,3,5,5,0,0,0,0,16500,7.0,18035,242,55,-494,-798,29.7,1650.0,20,13,1,5,3,7,1,1,0,0,16994,7.0,18833,216,76,494,798,29.2,1699.4
4822808833,1,11,0,1,5,3,7,1,1,0,0,17383,7.0,19110,253,80,1819,299,33.3,1738.3,11,0,0,3,5,2,0,0,0,0,15564,7.2,18811,229,68,-1819,-299,29.7,1556.4
4821768729,1,13,2,1,6,8,11,1,1,0,0,17550,6.6,16875,229,56,-251,100,28.5,1755.0,14,1,0,8,6,13,1,0,1,0,17801,6.6,16775,187,60,251,-100,24.7,1780.1
4835056963,1,14,0,0,3,2,3,1,1,0,0,17091,7.2,19260,242,72,1602,1868,31.4,1709.1,14,1,1,2,3,2,0,0,0,0,15489,6.8,17392,235,56,-1602,-1868,29.1,1548.9
4812065121,0,10,1,1,4,4,5,1,0,1,0,15822,6.6,17071,228,64,831,-284,29.2,1582.2,10,3,0,3,3,5,1,1,0,0,14991,6.8,17355,222,64,-831,284,28.6,1499.1
4811902126,1,15,0,1,8,3,8,1,1,0,0,18590,7.2,19446,251,68,2434,922,31.9,1859.0,16,2,0,3,8,4,0,0,0,0,16156,7.0,18524,218,60,-2434,-922,27.8,1615.6
4811869769,0,9,2,1,5,7,8,0,0,0,0,16975,7.0,16950,237,43,-140,263,28.0,1697.5,28,1,0,7,5,7,0,0,0,0,17115,6.6,16687,198,52,140,-263,25.0,1711.5
4811845258,0,12,4,0,4,9,1,0,0,0,0,15014,6.8,17385,204,56,-3000,-438,26.0,1501.4,17,3,1,9,4,8,0,0,0,0,18014,6.8,17823,203,52,3000,438,25.5,1801.4
4810076115,0,13,3,1,4,8,3,0,0,0,0,17200,7.4,18819,234,72,-699,-891,30.6,1720.0,13,0,0,8,4,4,1,1,0,0,17899,7.2,19710,216,72,699,891,28.8,1789.9
4809949329,0,10,0,0,4,6,1,0,0,0,0,13955,6.8,17493,179,49,-3587,-1958,22.8,1395.5,12,1,1,6,4,4,0,0,0,0,17542,7.4,19451,220,65,3587,1958,28.5,1754.2
4809928328,0,22,3,1,1,0,3,0,0,0,0,14909,7.0,17596,255,52,-28,-513,30.7,1490.9,22,3,0,0,1,0,0,0,0,0,14937,7.0,18109,261,52,28,513,31.3,1493.7
4808944298,1,16,1,1,3,4,3,0,0,0,0,15720,7.0,17620,222,60,-1146,-953,28.2,1572.0,15,2,0,4,3,3,1,1,0,0,16866,7.2,18573,257,60,1146,953,31.7,1686.6
4808928497,1,11,2,1,9,4,8,1,1,0,0,21051,7.0,18384,198,64,5238,1737,26.2,2105.1,10,1,0,4,9,5,0,0,0,0,15813,6.6,16647,219,48,-5238,-1737,26.7,1581.3
4808902473,0,27,2,0,9,10,8,0,0,0,0,18665,6.8,18406,218,53,14,1545,27.1,1866.5,13,1,1,10,9,17,0,0,0,0,18651,6.8,16861,203,46,-14,-1545,24.9,1865.1
4808464946,0,11,0,0,4,12,6,0,0,0,0,15312,6.6,17117,209,56,-7272,-3190,26.5,1531.2,11,1,1,12,4,12,0,0,0,0,22584,7.4,20307,234,68,7272,3190,30.2,2258.4
4808422815,0,74,2,1,2,2,2,0,0,0,0,15144,7.0,17800,194,54,-388,394,24.8,1514.4,15,1,0,2,2,3,1,1,0,0,15532,6.8,17406,233,57,388,-394,29.0,1553.2
4808394820,0,18,2,1,10,13,16,0,0,0,0,17207,5.8,13971,185,37,-2537,-3073,22.2,1720.7,11,4,0,12,9,17,1,1,0,0,19744,6.8,17044,196,47,2537,3073,24.3,1974.4
4807986352,1,9,1,1,10,4,13,0,0,0,0,19450,7.2,18721,227,58,4574,3173,28.5,1945.0,15,0,0,4,10,4,1,1,0,0,14876,6.4,15548,170,54,-4574,-3173,22.4,1487.6
4807947461,0,65,0,0,4,5,1,0,0,0,0,15707,7.2,18969,218,60,-2683,549,27.8,1570.7,11,0,1,5,4,5,0,0,0,0,18390,7.2,18420,234,51,2683,-549,28.5,1839.0
4807900073,0,11,1,0,7,12,8,0,0,0,0,17409,6.4,16395,216,47,-3492,-2713,26.3,1740.9,13,2,1,12,7,14,0,0,0,0,20901,7.0,19108,226,56,3492,2713,28.2,2090.1
4807877280,1,16,1,0,1,7,1,0,0,0,0,15106,7.0,18092,227,58,-3083,-581,28.5,1510.6,14,1,1,7,1,7,0,0,0,0,18189,7.2,18673,234,60,3083,581,29.4,1818.9
4805209427,0,77,2,0,6,5,2,0,0,0,0,16601,6.6,17498,204,56,696,391,26.0,1660.1,19,0,1,4,5,6,1,1,0,0,15905,7.0,17107,224,49,-696,-391,27.3,1590.5
4805037282,1,13,0,1,6,6,3,0,0,0,0,17504,7.2,18492,234,51,1204,42,28.5,1750.4,14,0,0,6,6,3,0,0,0,0,16300,7.0,18450,215,56,-1204,-42,27.1,1630.0
4857824443,1,16,0,1,7,4,4,0,0,0,0,19139,7.2,19363,220,56,3813,2246,27.6,1913.9,10,1,0,4,7,5,0,0,0,0,15326,7.0,17117,206,48,-3813,-2246,25.4,1532.6
4857806527,0,10,0,0,4,9,4,0,0,0,0,15310,6.8,16674,190,48,-2114,-1954,23.8,1531.0,138,1,1,9,4,5,1,1,0,0,17424,7.2,18628,221,58,2114,1954,27.9,1742.4
4857798120,0,10,2,0,4,11,4,0,0,0,0,14723,6.6,16581,186,58,-2980,-3010,24.4,1472.3,23,0,1,11,4,7,1,1,0,0,17703,7.2,19591,220,58,2980,3010,27.8,1770.3
4856971298,1,0,0,0,25,31,55,0,0,0,0,38807,11.8,43537,115,0,495,879,11.5,3880.7,0,0,1,31,25,82,0,0,0,0,38312,11.6,42658,109,0,-495,-879,10.9,3831.2
4856947682,0,0,6,0,33,25,73,0,0,0,0,38220,11.6,44193,109,0,-1201,792,10.9,3822.0,105,0,1,25,33,48,0,0,0,0,39421,11.6,43401,108,0,1201,-792,10.8,3942.1
4854721672,0,12,0,0,3,10,4,0,0,0,0,15509,6.8,17883,224,64,-4017,-1574,28.8,1550.9,10,2,1,10,3,9,0,0,0,0,19526,7.2,19457,269,56,4017,1574,32.5,1952.6
4853847072,1,35,1,0,2,5,0,1,1,0,0,16860,7.4,19839,253,68,-574,894,32.1,1686.0,29,2,1,5,2,6,0,0,0,0,17434,7.2,18945,211,48,574,-894,25.9,1743.4
4853803277,1,10,24,1,3,4,1,1,0,1,0,15854,7.0,18736,251,56,-444,9,30.7,1585.4,99,1,0,4,3,5,1,1,0,0,16298,7.0,18727,247,44,444,-9,29.1,1629.8
4853764524,1,33,1,0,9,9,10,1,0,1,0,20040,7.2,18703,232,62,2770,1903,29.4,2004.0,31,2,1,9,9,6,1,1,0,0,17270,6.8,16800,188,62,-2770,-1903,25.0,1727.0
4853729950,0,13,0,1,5,9,5,0,0,0,0,17137,6.8,17903,227,50,-1581,-763,27.7,1713.7,12,1,0,9,5,7,0,0,0,0,18718,7.0,18666,255,57,1581,763,31.2,1871.8
4846896435,0,9,3,1,4,2,6,0,0,0,0,17244,7.0,19140,233,68,952,-1,30.1,1724.4,14,1,0,2,4,3,0,0,0,0,16292,7.2,19141,247,56,-952,1,30.3,1629.2
4846866033,0,51,1,0,1,8,0,0,0,0,0,15848,7.2,19328,213,72,-3163,645,28.5,1584.8,13,3,1,8,1,9,1,1,0,0,19011,7.2,18683,214,65,3163,-645,27.9,1901.1
4846804955,1,8,5,1,8,6,9,0,0,0,0,18247,6.8,17155,195,64,1423,-198,25.9,1824.7,24,3,0,6,8,4,1,1,0,0,16824,6.6,17353,212,58,-1423,198,27.0,1682.4
4842351591,0,12,0,0,2,6,1,0,0,0,0,15103,6.8,17506,216,60,-2077,-1204,27.6,1510.3,13,4,1,6,2,8,1,1,0,0,17180,7.2,18710,210,68,2077,1204,27.8,1718.0
4841897326,1,82,2,1,5,3,8,1,0,1,0,17078,7.2,18536,231,56,2642,788,28.7,1707.8,12,1,0,3,5,0,0,0,0,0,14436,6.8,17748,225,48,-2642,-788,27.3,1443.6
4841550902,0,128,0,0,8,8,4,1,1,0,0,17508,6.8,17410,202,54,-399,-1121,25.6,1750.8,12,1,1,8,8,11,0,0,0,0,17907,7.0,18531,237,52,399,1121,28.9,1790.7
4841511420,1,9,3,1,2,1,1,0,0,0,0,15137,7.0,17887,200,64,-1080,-2139,26.4,1513.7,12,0,0,1,2,0,0,0,0,0,16217,7.2,20026,224,48,1080,2139,27.2,1621.7
4841251153,0,40,1,0,8,6,10,0,0,0,0,17001,7.2,18237,210,56,-284,-245,26.6,1700.1,13,11,1,6,8,5,1,1,0,0,17285,7.0,18482,176,76,284,245,25.2,1728.5
4834729640,0,16,0,0,9,8,8,0,0,0,0,17161,7.0,18709,204,63,-131,98,26.7,1716.1,17,1,1,7,8,8,1,1,0,0,17292,7.2,18611,209,67,131,-98,27.6,1729.2
4834316623,1,9,0,1,16,18,23,0,0,0,2,38485,11.2,40358,120,51,1410,-906,17.1,3848.5,12,0,0,18,16,43,0,0,0,0,37075,11.0,41264,129,45,-1410,906,17.4,3707.5
4858119525,0,0,0,1,15,15,36,0,0,0,0,34780,10.6,37208,100,0,-383,-1144,10.0,3478.0,0,0,0,15,15,37,0,0,0,0,35163,10.8,38352,117,0,383,1144,11.7,3516.3
4858103770,0,0,0,0,11,25,21,0,0,0,1,33084,10.6,37140,116,0,-4505,-5649,11.6,3308.4,0,0,1,25,11,66,0,0,0,0,37589,11.2,42789,106,0,4505,5649,10.6,3758.9
4858085245,0,0,0,0,11,12,24,0,0,0,0,32921,10.0,33079,113,0,-353,-721,11.3,3292.1,0,0,1,12,11,33,0,0,0,0,33274,10.2,33800,127,0,353,721,12.7,3327.4
4858059281,0,0,0,0,26,20,70,0,0,0,0,38388,11.6,43104,104,0,472,2157,10.4,3838.8,0,0,1,20,26,63,0,0,0,0,37916,11.2,40947,93,0,-472,-2157,9.3,3791.6
4858033349,0,0,4,1,21,18,63,0,0,0,0,37019,11.2,41072,106,0,1931,1571,10.6,3701.9,20,0,0,18,21,33,0,0,0,0,35088,11.0,39501,106,0,-1931,-1571,10.6,3508.8
4858016428,0,0,0,1,31,29,86,0,0,0,2,41513,12.0,46943,118,0,3442,3062,11.8,4151.3,0,0,0,29,31,82,0,0,0,0,38071,11.6,43881,98,0,-3442,-3062,9.8,3807.1
4857148336,1,102,0,0,15,20,38,0,0,0,0,34529,10.8,37427,113,0,-746,-235,11.3,3452.9,0,1,1,20,15,33,0,0,0,0,35275,10.8,37662,98,0,746,235,9.8,3527.5
4857123742,0,48,0,1,25,18,79,0,0,0,0,37036,11.2,40227,101,0,2035,1657,10.1,3703.6,0,8,0,18,25,48,0,0,0,0,35001,10.8,38570,112,0,-2035,-1657,11.2,3500.1
4857105876,1,24,0,1,29,28,67,0,0,0,1,40136,11.8,44458,117,0,2720,2328,11.7,4013.6,10,30,0,28,29,61,0,0,0,0,37416,11.2,42130,84,0,-2720,-2328,8.4,3741.6
4857082103,1,1,0,0,19,17,19,0,0,0,0,49027,10.0,47500,2,0,21047,19000,0.2,4902.7,0,0,1,10,12,12,0,0,0,0,27980,6.0,28500,0,0,-21047,-19000,0.0,2798.0
4857060227,1,0,0,0,12,18,11,0,0,0,0,45600,10.0,47500,0,0,16700,19000,0.0,4560.0,0,0,1,12,6,13,0,0,0,0,28900,6.0,28500,0,0,-16700,-19000,0.0,2890.0
4857036526,1,2,0,1,16,11,16,0,0,0,0,47531,10.0,47500,0,0,20384,19000,0.0,4753.1,0,0,0,7,12,7,0,0,0,0,27147,6.0,28500,0,0,-20384,-19000,0.0,2714.7
4856878658,1,0,0,1,18,8,49,0,0,0,1,36278,10.8,37908,110,0,3177,3715,11.0,3627.8,2,0,0,8,18,22,0,0,0,0,33101,10.0,34193,106,0,-3177,-3715,10.6,3310.1
4856861481,1,3,0,0,23,27,67,0,0,0,0,35567,11.0,39628,93,0,-2697,-991,9.3,3556.7,0,0,1,27,23,63,0,0,0,0,38264,11.0,40619,105,0,2697,991,10.5,3826.4
4856856936,0,34,0,0,13,22,22,0,0,0,0,33941,10.6,37269,102,0,-3340,-2455,10.2,3394.1,34,0,1,22,13,57,0,0,0,0,37281,11.0,39724,104,0,3340,2455,10.4,3728.1
4856843852,0,24,0,1,18,15,47,0,0,0,2,35761,10.8,38336,94,0,2014,3604,9.4,3576.1,0,7,0,15,18,52,0,0,0,0,33747,10.0,34732,91,0,-2014,-3604,9.1,3374.7
4856825312,1,1,0,1,30,24,79,0,0,0,0,38729,11.6,42699,96,0,155,221,9.6,3872.9,110,0,0,24,30,68,0,0,0,0,38574,11.2,42478,100,0,-155,-221,10.0,3857.4
4856812472,0,0,0,0,11,17,20,0,0,0,1,32243,10.4,35233,98,0,-3832,-2272,9.8,3224.3,0,0,1,17,11,40,0,0,0,0,36075,10.8,37505,90,0,3832,2272,9.0,3607.5
4856674189,1,0,0,1,27,19,70,0,0,0,0,37699,11.4,42730,100,0,1451,4331,10.0,3769.9,12,0,0,19,27,45,0,0,0,0,36248,10.8,38399,102,0,-1451,-4331,10.2,3624.8
4856322088,1,0,0,1,24,19,59,0,0,0,0,37833,11.0,39831,118,0,1419,1402,11.8,3783.3,0,0,0,19,24,47,0,0,0,0,36414,10.8,38429,109,0,-1419,-1402,10.9,3641.4
4851600626,1,11,2,1,10,5,9,0,0,0,0,19864,7.4,18778,228,58,3549,1755,28.6,1986.4,12,0,0,5,10,4,0,0,0,0,16315,6.6,17023,228,42,-3549,-1755,27.0,1631.5
4851565854,1,10,0,1,4,6,0,0,0,0,0,16127,7.2,19174,249,68,-1393,-252,31.7,1612.7,14,1,0,6,4,5,0,0,0,0,17520,7.4,19426,248,56,1393,252,30.4,1752.0
4851523007,0,51,0,0,2,5,2,1,0,1,0,15118,7.0,17923,243,48,-1687,102,29.1,1511.8,12,2,1,5,2,6,1,1,0,0,16805,7.0,17821,254,59,1687,-102,31.3,1680.5
4846643321,0,15,1,0,2,6,2,2,1,1,0,15221,6.8,17350,211,48,-1742,94,25.9,1522.1,13,0,1,6,2,7,0,0,0,0,16963,6.6,17256,227,52,1742,-94,27.9,1696.3
4846627119,0,12,1,1,6,9,6,0,0,0,0,15731,6.0,14949,224,48,-1799,-3719,27.2,1573.1,19,0,0,7,4,4,0,0,0,0,17530,7.0,18668,247,64,1799,3719,31.1,1753.0
4833996659,0,0,23,0,17,33,46,0,0,0,2,36109,10.6,37921,98,0,-5999,-6892,9.8,3610.9,24,0,1,33,17,85,0,0,0,0,42108,11.8,44813,104,0,5999,6892,10.4,4210.8
4833219237,0,13,2,0,1,4,0,1,1,0,0,13563,6.8,17596,200,64,-2758,-717,26.4,1356.3,11,1,1,4,1,3,0,0,0,0,16321,7.0,18313,228,56,2758,717,28.4,1632.1
4832274986,1,31,3,1,7,5,5,1,0,1,0,15668,6.8,17285,192,56,-300,819,24.8,1566.8,23,1,0,5,7,4,0,0,0,0,15968,6.6,16466,172,44,300,-819,21.6,1596.8
4832226944,1,12,2,1,5,8,6,0,0,0,0,16011,6.8,17616,193,60,-1491,-827,25.3,1601.1,15,1,0,8,5,9,0,0,0,0,17502,7.0,18443,204,48,1491,827,25.2,1750.2
4829797587,1,17,1,0,12,10,6,0,0,0,0,20316,7.0,18891,223,43,3456,2942,26.6,2031.6,13,0,1,10,12,4,1,1,0,0,16860,6.4,15949,177,40,-3456,-2942,21.7,1686.0
4826358673,0,15,4,0,4,3,4,1,1,0,0,17235,7.0,18134,225,56,935,-645,28.1,1723.5,15,2,1,3,4,3,0,0,0,0,16300,7.0,18779,225,48,-935,645,27.3,1630.0
4823565194,0,12,1,1,5,7,7,1,0,1,0,17050,7.0,17587,247,59,-202,528,30.6,1705.0,14,0,0,7,5,13,1,1,0,0,17252,6.6,17059,211,56,202,-528,26.7,1725.2
4823088783,1,11,0,0,6,9,7,0,0,0,0,16088,6.6,16469,176,56,-2191,94,23.2,1608.8,10,0,1,9,6,11,0,0,0,0,18279,6.6,16375,192,49,2191,-94,24.1,1827.9
4823046116,0,13,0,1,5,3,4,1,0,1,0,16422,7.2,18589,225,72,1426,1132,29.7,1642.2,10,1,0,3,5,3,0,0,0,0,14996,7.0,17457,228,44,-1426,-1132,27.2,1499.6
4822985709,0,17,1,1,6,5,4,0,0,0,0,17690,6.8,18092,216,54,2236,1769,27.0,1769.0,8,2,0,5,6,2,0,0,0,0,15454,6.4,16323,149,49,-2236,-1769,19.8,1545.4
4818265916,0,79,1,1,6,7,4,0,0,0,0,16181,7.0,18260,232,52,-917,580,28.4,1618.1,19,1,0,6,5,12,1,1,0,0,17098,7.0,17680,219,47,917,-580,26.6,1709.8
4816475827,1,11,3,0,8,6,7,1,1,0,0,16601,7.0,18134,219,48,-198,23,26.7,1660.1,15,1,1,6,8,4,0,0,0,0,16799,7.0,18111,231,53,198,-23,28.4,1679.9
4816438485,1,11,1,0,2,6,1,0,0,0,0,15438,6.8,17601,239,44,-1870,-1633,28.3,1543.8,10,1,1,6,2,5,0,0,0,0,17308,7.4,19234,218,72,1870,1633,29.0,1730.8
4814025604,0,25,0,1,4,22,5,0,0,0,2,25884,10.4,34946,69,53,-15264,-12455,12.2,2588.4,13,1,0,22,4,32,0,0,0,0,41148,12.0,47401,127,77,15264,12455,20.4,4114.8
4805494940,0,8,1,0,2,6,0,0,0,0,0,14913,7.0,17737,216,63,-2411,-32,27.9,1491.3,10,0,1,6,2,5,0,0,0,0,17324,7.0,17769,217,56,2411,32,27.3,1732.4
4855448826,0,0,2,1,31,31,71,0,0,0,2,39729,11.6,43240,111,0,-65,5,11.1,3972.9,22,0,0,31,31,72,0,0,0,0,39794,11.4,43235,116,0,65,-5,11.6,3979.4
4855434083,1,0,0,0,31,27,88,0,0,0,1,39858,11.6,42898,104,0,1146,1489,10.4,3985.8,15,0,1,27,31,75,0,0,0,0,38712,11.2,41409,94,0,-1146,-1489,9.4,3871.2
4855414143,1,34,6,0,22,24,69,0,0,0,1,38501,11.0,40569,120,0,2224,-185,12.0,3850.1,75,0,1,24,22,60,0,0,0,0,36277,11.2,40754,92,0,-2224,185,9.2,3627.7
4855395328,0,15,6,0,17,27,51,0,0,0,1,33720,10.6,36036,103,0,-4567,-4292,10.3,3372.0,33,0,1,27,17,69,0,0,0,0,38287,11.0,40328,107,0,4567,4292,10.7,3828.7
4853474736,1,0,0,1,19,17,22,0,0,0,0,68465,12.8,61000,0,0,31002,25000,0.0,6846.5,2,0,0,11,13,9,0,0,0,0,37463,7.6,36000,0,0,-31002,-25000,0.0,3746.3
4853460922,1,7,2,0,23,14,20,0,0,0,0,48770,10.0,47500,2,0,20870,19000,0.2,4877.0,17,0,1,6,15,7,0,0,0,0,27900,6.0,28500,1,0,-20870,-19000,0.1,2790.0
4853442571,1,3,3,1,23,18,21,0,0,0,0,48070,10.0,47500,0,0,20065,19000,0.0,4807.0,40,1,0,8,13,8,0,0,0,0,28005,6.0,28500,6,0,-20065,-19000,0.6,2800.5
4853431133,1,0,0,0,21,21,55,0,0,0,0,37184,11.0,40644,100,0,1309,546,10.0,3718.4,0,0,1,21,21,48,0,0,0,0,35875,11.0,40098,101,0,-1309,-546,10.1,3587.5
4853166873,1,383,0,1,18,17,17,0,0,0,0,46100,10.2,48500,3,0,18250,18500,0.3,4610.0,37,0,0,9,10,12,0,0,0,0,27850,6.4,30000,0,0,-18250,-18500,0.0,2785.0
4853151897,1,6,0,1,21,15,15,0,0,0,0,47350,10.2,48680,0,0,20200,20180,0.0,4735.0,0,0,0,6,12,11,0,0,0,0,27150,6.0,28500,0,0,-20200,-20180,0.0,2715.0
4853130038,1,0,0,0,18,19,18,0,0,0,0,45950,10.0,47500,0,0,17400,19000,0.0,4595.0,6,0,1,10,9,14,0,0,0,0,28550,6.0,28500,0,0,-17400,-19000,0.0,2855.0
4853112288,1,382,4,0,16,19,17,0,0,0,0,46370,10.2,48680,2,0,17445,20180,0.2,4637.0,0,5,1,11,8,10,0,0,0,0,28925,6.0,28500,0,0,-17445,-20180,0.0,2892.5
4853096113,1,19,0,0,22,20,25,0,0,0,0,64563,12.0,55000,4,0,27001,21000,0.4,6456.3,80,0,1,10,12,6,0,0,0,0,37562,7.4,34000,1,0,-27001,-21000,0.1,3756.2
4853069160,1,21,0,0,20,20,19,0,0,0,0,62700,12.0,55000,0,0,24184,22000,0.0,6270.0,0,0,1,10,10,13,0,0,0,0,38516,7.2,33000,0,0,-24184,-22000,0.0,3851.6
4852949353,1,16,0,1,27,26,85,0,0,0,1,37987,11.4,42330,122,0,-1732,-650,12.2,3798.7,2,0,0,26,27,74,0,0,0,0,39719,11.4,42980,105,0,1732,650,10.5,3971.9
4851066229,0,9,0,0,24,37,51,0,0,0,2,37358,11.2,41545,98,0,-2965,-3888,9.8,3735.8,0,0,1,37,24,85,0,0,0,0,40323,11.8,45433,114,0,2965,3888,11.4,4032.3
4851049982,0,21,0,0,22,40,43,0,0,0,1,35731,10.6,38573,83,0,-8112,-7534,8.3,3573.1,37,5,1,40,22,97,0,0,0,0,43843,11.6,46107,119,0,8112,7534,11.9,4384.3
4850976468,1,26,0,1,25,24,71,0,0,0,1,37959,11.0,40141,103,0,90,-19,10.3,3795.9,0,3,0,24,25,62,0,0,0,0,37869,11.0,40160,105,0,-90,19,10.5,3786.9
4850951621,1,26,0,1,24,21,63,0,0,0,2,37059,11.0,39443,107,0,317,-1042,10.7,3705.9,0,0,0,21,24,42,0,0,0,0,36742,11.2,40485,105,0,-317,1042,10.5,3674.2
4850666576,1,0,0,1,31,21,81,0,0,0,1,39654,11.8,44185,116,0,2939,3091,11.6,3965.4,0,0,0,21,31,42,0,0,0,0,36715,11.2,41094,91,0,-2939,-3091,9.1,3671.5
4855851497,1,8,2,0,7,8,7,0,0,0,0,19492,7.4,19559,194,72,2395,2582,26.6,1949.2,93,0,1,8,7,6,1,1,0,0,17097,6.6,16977,174,59,-2395,-2582,23.3,1709.7
4855817301,1,10,1,1,8,5,7,0,0,0,0,17970,6.8,17819,215,60,313,-652,27.5,1797.0,15,1,0,5,8,6,1,1,0,0,17657,7.0,18471,226,68,-313,652,29.4,1765.7
4855785446,0,12,2,1,10,4,6,0,0,0,0,19368,7.2,19493,212,56,1548,1943,26.8,1936.8,12,1,0,4,10,4,1,1,0,0,17820,6.6,17550,213,52,-1548,-1943,26.5,1782.0
4853840195,1,9,0,0,6,10,6,0,0,0,0,16456,6.6,17295,197,48,-2396,-956,24.5,1645.6,9,1,1,10,6,11,0,0,0,0,18852,7.0,18251,222,51,2396,956,27.3,1885.2
4853802763,1,8,1,0,6,3,3,1,1,0,0,16661,7.0,18966,236,60,1955,1418,29.6,1666.1,15,0,1,3,6,1,0,0,0,0,14706,6.8,17548,210,54,-1955,-1418,26.4,1470.6
4853760037,0,9,3,0,2,2,2,0,0,0,0,14883,6.8,17338,221,56,-338,-697,27.7,1488.3,20,1,1,2,2,1,1,1,0,0,15221,7.0,18035,220,48,338,697,26.8,1522.1
4852176559,0,86,0,0,5,12,5,0,0,0,0,16300,6.8,17429,211,55,-2529,-545,26.6,1630.0,12,0,1,12,5,10,0,0,0,0,18829,7.0,17974,203,49,2529,545,25.2,1882.9
4852157520,0,11,15,0,9,7,8,0,0,0,0,17763,7.0,18217,205,40,-583,-59,24.5,1776.3,33,1,1,7,9,9,1,1,0,0,18346,6.8,18276,235,56,583,59,29.1,1834.6
4848286636,0,14,1,0,4,5,7,0,0,0,0,16058,6.8,17663,239,56,99,-150,29.5,1605.8,14,0,1,5,4,5,0,0,0,0,15959,7.0,17813,210,72,-99,150,28.2,1595.9
4848278289,0,13,2,0,4,5,3,0,0,0,0,15548,6.6,16281,211,40,-2000,-1391,25.1,1554.8,15,1,1,5,4,5,0,0,0,0,17548,7.0,17672,221,52,2000,1391,27.3,1754.8
4848263053,0,18,0,1,6,5,4,0,0,0,0,17206,7.2,18883,208,59,1506,1246,26.7,1720.6,13,2,0,5,6,4,0,0,0,0,15700,7.0,17637,212,48,-1506,-1246,26.0,1570.0
4848240018,0,12,1,0,4,5,6,0,0,0,0,17861,6.8,17788,227,38,2544,605,26.5,1786.1,14,0,1,5,4,5,1,1,0,0,15317,6.6,17183,180,48,-2544,-605,22.8,1531.7
4847697762,1,20,2,1,7,4,10,0,0,0,0,17846,7.2,18454,218,50,2465,256,26.8,1784.6,11,3,0,4,7,1,1,1,0,0,15381,7.0,18198,229,46,-2465,-256,27.5,1538.1
4847661141,1,19,0,1,7,2,6,0,0,0,0,17392,6.6,17559,220,44,2622,777,26.4,1739.2,12,0,0,2,7,2,0,0,0,0,14770,7.0,16782,204,48,-2622,-777,25.2,1477.0
4847642374,1,14,2,1,11,4,10,0,0,0,0,19724,7.0,18315,208,57,5053,2940,26.5,1972.4,13,0,0,4,11,6,0,0,0,0,14671,6.4,15375,183,36,-5053,-2940,21.9,1467.1
4847604626,0,18,2,1,6,4,7,0,0,0,0,17123,7.0,18673,205,48,1000,466,25.3,1712.3,11,3,0,4,6,2,1,1,0,0,16123,7.2,18207,220,68,-1000,-466,28.8,1612.3
4841963368,0,20,1,0,4,4,4,0,0,0,0,16355,6.8,17332,198,52,1969,-255,25.0,1635.5,14,5,1,4,4,0,0,0,0,0,14386,7.2,17587,189,48,-1969,255,23.7,1438.6
4841950792,0,8,1,0,2,6,4,0,0,0,0,13808,6.4,15571,191,56,-3321,-2295,24.7,1380.8,10,3,1,6,2,8,0,0,0,0,17129,6.8,17866,232,56,3321,2295,28.8,1712.9
4841919428,0,29,3,0,2,5,1,0,0,0,0,14255,6.8,17038,196,52,-2957,-2373,24.8,1425.5,13,2,1,5,2,2,0,0,0,0,17212,7.2,19411,235,68,2957,2373,30.3,1721.2
4841272858,0,12,1,1,8,10,6,0,0,0,0,18391,6.8,17691,197,40,1504,386,23.7,1839.1,17,0,0,9,7,8,0,0,0,0,16887,6.6,17305,191,40,-1504,-386,23.1,1688.7
4858281929,1,12,2,1,6,5,9,0,0,0,0,18256,7.2,18728,229,64,394,-100,29.3,1825.6,13,1,0,5,6,4,1,0,1,0,17862,7.0,18828,227,64,-394,100,29.1,1786.2
4858240793,1,14,0,1,11,4,19,0,0,0,0,20246,7.2,17922,211,56,4434,3238,26.7,2024.6,11,2,0,4,11,4,0,0,0,0,15812,6.2,14684,173,43,-4434,-3238,21.6,1581.2
4858191607,1,11,0,1,12,5,15,0,0,0,0,19470,6.8,18087,219,56,3793,736,27.5,1947.0,8,0,0,5,12,3,0,0,0,0,15677,6.8,17351,219,44,-3793,-736,26.3,1567.7
4858149572,1,13,0,0,3,4,4,0,0,0,0,15962,7.0,18371,213,72,-1306,-757,28.5,1596.2,10,1,1,4,3,2,0,0,0,0,17268,7.2,19128,236,68,1306,757,30.4,1726.8
4858111016,0,13,1,1,4,8,4,0,0,0,0,16921,6.6,17769,233,64,-1435,-685,29.7,1692.1,22,2,0,8,4,10,2,1,1,0,18356,7.2,18454,245,56,1435,685,30.1,1835.6
4858072283,0,10,3,0,4,7,3,1,0,1,0,15514,7.0,17607,203,55,-1984,-588,25.8,1551.4,34,0,1,7,4,5,0,0,0,0,17498,6.8,18195,222,61,1984,588,28.3,1749.8
4858049645,1,17,5,0,9,2,12,1,1,0,0,20332,7.4,20017,248,73,3625,1809,32.1,2033.2,19,2,1,2,9,2,0,0,0,0,16707,7.2,18208,252,49,-3625,-1809,30.1,1670.7
4858015715,1,15,1,0,3,10,5,0,0,0,0,15880,6.8,17624,219,68,-3109,-1315,28.7,1588.0,13,0,1,10,3,9,1,1,0,0,18989,7.2,18939,241,55,3109,1315,29.6,1898.9
4857298882,0,52,2,0,3,6,5,0,0,0,0,15367,6.8,17452,207,52,-2086,-2344,25.9,1536.7,13,1,1,6,3,4,0,0,0,0,17453,7.2,19796,245,68,2086,2344,31.3,1745.3
4857263530,1,12,2,1,3,4,1,0,0,0,0,15791,7.0,18838,221,56,-562,933,27.7,1579.1,11,3,0,4,3,4,1,1,0,0,16353,6.8,17905,246,56,562,-933,30.2,1635.3
4857197536,0,75,0,0,4,7,2,0,0,0,0,16600,7.0,18310,211,56,-1471,-800,26.7,1660.0,13,2,1,7,4,6,1,1,0,0,18071,7.0,19110,232,72,1471,800,30.4,1807.1
4856994313,0,37,8,1,9,5,11,0,0,0,0,17348,6.8,17339,209,52,-138,-1341,26.1,1734.8,54,4,0,5,9,4,1,1,0,0,17486,7.2,18680,232,70,138,1341,30.2,1748.6
4854869028,0,16,1,0,3,5,2,1,1,0,0,14750,6.8,16715,181,60,-1222,-2951,24.1,1475.0,12,1,1,5,3,5,0,0,0,0,15972,7.4,19666,188,76,1222,2951,26.4,1597.2
4854825926,0,13,0,0,5,7,3,1,1,0,0,16955,7.2,18978,244,48,-256,246,29.2,1695.5,10,0,1,7,5,8,0,0,0,0,17211,7.4,18732,217,75,256,-246,29.2,1721.1
4854307603,0,12,1,1,8,3,9,0,0,0,0,16884,6.8,17320,201,44,2196,739,24.5,1688.4,21,1,0,3,8,3,1,1,0,0,14688,6.6,16581,192,56,-2196,-739,24.8,1468.8
4853822351,0,14,2,0,4,5,2,0,0,0,0,15995,6.8,17708,219,48,-1481,-1143,26.7,1599.5,9,2,1,5,4,5,0,0,0,0,17476,7.2,18851,233,58,1481,1143,29.1,1747.6
4853669881,0,11,2,0,9,8,11,0,0,0,0,19348,6.8,18263,222,56,-275,25,27.8,1934.8,8,1,1,8,9,12,0,0,0,0,19623,6.8,18238,207,56,275,-25,26.3,1962.3
4853631902,0,14,2,0,1,1,1,0,0,0,0,15104,7.0,18749,268,60,448,395,32.8,1510.4,29,1,1,1,1,0,1,1,0,0,14656,6.8,18354,232,58,-448,-395,29.0,1465.6
4853610379,1,60,1,0,12,7,16,1,1,0,0,20585,7.2,19454,205,59,2874,1705,26.4,2058.5,12,1,1,7,12,9,0,0,0,0,17711,6.8,17749,248,52,-2874,-1705,30.0,1771.1
4852724616,0,8,1,0,5,9,5,0,0,0,0,16524,7.2,18581,229,56,-1406,640,28.5,1652.4,10,1,1,9,5,9,0,0,0,0,17930,6.8,17941,243,52,1406,-640,29.5,1793.0
4857387340,1,10,0,0,14,18,15,0,0,0,0,60950,12.2,56000,0,0,21764,23000,0.0,6095.0,0,0,1,15,11,16,0,0,0,0,39186,7.2,33000,0,0,-21764,-23000,0.0,3918.6
4856999405,1,0,0,0,18,15,18,0,0,0,0,63400,12.0,55000,0,0,26200,22000,0.0,6340.0,26,0,1,9,12,8,0,0,0,0,37200,7.2,33000,0,0,-26200,-22000,0.0,3720.0
4856988184,1,20,0,1,20,13,20,0,0,0,0,61650,12.0,55000,0,0,23870,22000,0.0,6165.0,0,0,0,12,19,8,0,0,0,0,37780,7.2,33000,0,0,-23870,-22000,0.0,3778.0
4856966557,1,24,2,1,18,16,16,0,0,0,0,47426,10.0,47500,2,0,18876,17500,0.2,4742.6,4,0,0,10,12,11,0,0,0,0,28550,6.4,30000,0,0,-18876,-17500,0.0,2855.0
4856950674,1,0,0,0,15,15,18,0,0,0,0,61300,12.0,55000,0,0,23993,22000,0.0,6130.0,0,0,1,10,10,8,0,0,0,0,37307,7.2,33000,0,0,-23993,-22000,0.0,3730.7
4855951525,1,0,0,1,26,24,76,0,0,0,0,38514,11.4,43736,114,0,616,2267,11.4,3851.4,0,0,0,24,26,62,0,0,0,0,37898,11.2,41469,93,0,-616,-2267,9.3,3789.8
4855326635,1,0,0,1,26,22,67,0,0,0,1,39262,11.6,43296,118,0,3735,2407,11.8,3926.2,0,0,0,22,26,47,0,0,0,0,35527,11.0,40889,98,0,-3735,-2407,9.8,3552.7
4855164248,1,11,5,0,6,6,5,0,0,0,0,17054,6.8,18166,225,40,-103,-530,26.5,1705.4,14,0,1,6,6,3,0,0,0,0,17157,7.0,18696,250,52,103,530,30.2,1715.7
4855117269,1,2,0,1,18,28,43,0,0,0,1,37098,10.6,37957,124,0,10,-2524,12.4,3709.8,130,0,0,28,18,69,0,0,0,0,37088,11.0,40481,107,0,-10,2524,10.7,3708.8
4855082203,1,0,0,0,26,19,76,0,0,0,1,40481,11.2,41822,123,0,4897,4051,12.3,4048.1,0,0,1,19,26,60,0,0,0,0,35584,10.8,37771,77,0,-4897,-4051,7.7,3558.4
4855041526,1,0,0,1,15,19,31,0,0,0,1,35392,10.6,36692,98,0,-1967,-3719,9.8,3539.2,0,0,0,19,15,57,0,0,0,0,37359,11.0,40411,104,0,1967,3719,10.4,3735.9
4854991566,1,11,2,0,6,4,5,1,0,1,0,18665,7.2,19557,236,64,3224,1192,30.0,1866.5,13,3,1,3,5,2,1,1,0,0,15441,7.0,18365,225,70,-3224,-1192,29.5,1544.1
4854955389,1,11,0,0,18,19,26,0,0,0,0,63650,12.6,59500,0,0,25400,18000,0.0,6365.0,4,0,1,11,10,10,0,0,0,0,38250,8.6,41500,0,0,-25400,-18000,0.0,3825.0
4854784008,1,10,0,1,17,18,16,0,0,0,0,45600,10.0,47500,0,0,16000,19000,0.0,4560.0,0,0,0,9,8,15,0,0,0,0,29600,6.0,28500,0,0,-16000,-19000,0.0,2960.0
4854759975,1,0,0,0,13,17,14,0,0,0,0,60106,12.0,55000,0,0,21506,22000,0.0,6010.6,15,0,1,13,9,12,0,0,0,0,38600,7.2,33000,0,0,-21506,-22000,0.0,3860.0
4854741252,1,0,0,0,19,22,21,0,0,0,0,63629,12.0,55000,0,0,24329,22000,0.0,6362.9,10,0,1,13,10,11,0,0,0,0,39300,7.2,33000,0,0,-24329,-22000,0.0,3930.0
4854605470,1,0,0,0,11,22,12,0,0,0,0,61030,12.0,55000,2,0,19235,22000,0.2,6103.0,0,0,1,15,4,13,0,0,0,0,41795,7.2,33000,1,0,-19235,-22000,0.1,4179.5
4854591722,1,43,0,1,20,19,20,0,0,0,0,52245,12.0,55000,0,0,21325,22000,0.0,5224.5,0,0,0,8,9,11,0,0,0,0,30920,7.2,33000,0,0,-21325,-22000,0.0,3092.0
4854582922,1,124,1,1,12,17,14,0,0,0,0,61135,12.0,55000,6,0,22835,20000,0.6,6113.5,0,3,0,11,6,12,0,0,0,0,38300,7.6,35000,0,0,-22835,-20000,0.0,3830.0
4854567945,1,0,0,1,13,21,12,0,0,0,0,46685,10.0,47500,0,0,17230,19000,0.0,4668.5,0,0,0,12,4,14,0,0,0,0,29455,6.0,28500,1,0,-17230,-19000,0.1,2945.5
4853867154,1,16,1,1,8,4,6,0,0,0,0,18212,7.0,18147,223,48,2088,392,27.1,1821.2,11,4,0,4,8,3,0,0,0,0,16124,6.8,17755,205,52,-2088,-392,25.7,1612.4
4853808623,1,13,2,1,10,3,11,0,0,0,0,18924,7.4,19826,241,72,3541,2048,31.3,1892.4,22,1,0,2,9,3,1,1,0,0,15383,7.0,17778,218,64,-3541,-2048,28.2,1538.3
4853773571,0,12,1,0,2,3,3,0,0,0,0,15382,6.8,17838,199,56,-36,-802,25.5,1538.2,14,0,1,3,2,1,0,0,0,0,15418,7.0,18640,226,64,36,802,29.0,1541.8
4853156612,1,12,2,0,7,6,9,0,0,0,0,17960,6.8,18077,205,56,107,-153,26.1,1796.0,23,2,1,6,7,5,0,0,0,0,17853,7.0,18230,220,64,-107,153,28.4,1785.3
4853125573,1,14,2,1,7,4,2,1,1,0,0,17441,7.6,20019,251,64,809,1603,31.5,1744.1,9,4,0,4,7,3,0,0,0,0,16632,7.2,18416,247,56,-809,-1603,30.3,1663.2
4853092935,0,20,0,0,6,10,3,0,0,0,0,17684,7.0,18184,221,49,302,1612,27.0,1768.4,12,1,1,10,6,9,0,0,0,0,17382,6.6,16572,186,42,-302,-1612,22.8,1738.2
4850621744,0,12,0,0,6,5,4,0,0,0,0,16625,6.8,17171,212,52,-246,-421,26.4,1662.5,13,1,1,5,6,5,2,1,1,0,16871,7.0,17592,222,56,246,421,27.8,1687.1
4843071183,0,17,4,0,6,12,6,0,0,0,0,17486,6.6,16902,216,52,-1466,-705,26.8,1748.6,26,2,1,12,6,16,0,0,0,0,18952,6.8,17607,223,50,1466,705,27.3,1895.2
4843043464,1,21,6,1,11,6,15,1,1,0,0,18293,7.0,18364,230,65,1830,1227,29.5,1829.3,33,5,0,6,11,5,0,0,0,0,16463,6.8,17137,185,43,-1830,-1227,22.8,1646.3
4843015880,0,14,2,0,7,11,9,0,0,0,0,18218,7.0,18379,250,60,-2099,7,31.0,1821.8,14,1,1,11,7,15,1,1,0,0,20317,7.2,18372,216,58,2099,-7,27.4,2031.7
4842726778,1,100,0,0,6,5,5,1,1,0,0,16621,6.8,17859,224,56,-591,-275,28.0,1662.1,6,0,1,5,6,6,0,0,0,0,17212,6.6,18134,266,48,591,275,31.4,1721.2
4842711862,1,33,0,1,10,3,11,1,1,0,1,20113,7.0,17464,210,52,5079,1685,26.2,2011.3,32,0,0,3,10,6,0,0,0,0,15034,6.4,15779,181,36,-5079,-1685,21.7,1503.4
4842693435,1,13,0,1,3,3,2,0,0,0,0,16069,7.0,18446,231,48,618,79,27.9,1606.9,11,0,0,3,3,2,1,1,0,0,15451,7.2,18367,227,72,-618,-79,29.9,1545.1
4842685997,1,14,0,1,7,1,2,0,0,0,0,17726,7.6,20284,257,68,4928,5238,32.5,1772.6,10,0,0,1,7,1,0,0,0,0,12798,6.2,15046,166,52,-4928,-5238,21.8,1279.8
4842669314,0,10,3,1,7,11,9,0,0,0,0,16760,6.8,16906,214,52,-1719,-679,26.6,1676.0,16,1,0,10,6,13,1,1,0,0,18479,6.8,17585,232,56,1719,679,28.8,1847.9
4842643671,0,10,2,1,7,5,8,0,0,0,0,18842,6.8,17855,228,48,3294,1529,27.6,1884.2,13,0,0,5,7,5,0,0,0,0,15548,6.6,16326,221,52,-3294,-1529,27.3,1554.8
4842630809,0,14,3,0,7,6,8,0,0,0,0,16545,6.4,16629,188,52,-1508,-1213,24.0,1654.5,17,0,1,6,7,8,0,0,0,0,18053,6.8,17842,245,52,1508,1213,29.7,1805.3
4842603271,0,9,2,0,2,5,2,1,1,0,0,14985,6.6,17589,227,51,-1402,-793,27.8,1498.5,9,1,1,5,2,4,1,0,1,0,16387,7.0,18382,205,67,1402,793,27.2,1638.7
4857876090,1,19,4,0,12,2,15,1,1,0,0,20153,6.8,17737,226,52,5762,2773,27.8,2015.3,26,2,1,2,12,2,0,0,0,0,14391,6.2,14964,190,54,-5762,-2773,24.4,1439.1
4857850712,0,36,1,1,2,1,3,1,0,1,0,16995,7.2,19681,273,68,1733,1178,34.1,1699.5,12,16,0,1,2,0,0,0,0,0,15262,7.2,18503,237,68,-1733,-1178,30.5,1526.2
4857829680,0,33,2,0,12,10,11,0,0,0,0,19872,7.0,19007,209,43,1451,1137,25.2,1987.2,17,5,1,10,12,8,1,0,1,0,18421,6.8,17870,218,48,-1451,-1137,26.6,1842.1
4857816192,0,17,16,1,5,4,4,0,0,0,0,16516,6.8,18540,212,68,-253,29,28.0,1651.6,34,2,0,4,5,6,0,0,0,0,16769,7.0,18511,256,68,253,-29,32.4,1676.9
4857801070,1,16,18,1,6,3,2,1,0,1,0,17558,7.2,19297,232,56,2005,1600,28.8,1755.8,34,0,0,3,6,2,0,0,0,0,15553,6.8,17697,213,50,-2005,-1600,26.3,1555.3
4857776718,0,13,9,1,8,5,7,1,1,0,0,17763,7.2,18844,229,60,690,470,28.9,1776.3,38,2,0,5,8,3,1,0,1,0,17073,7.0,18374,216,68,-690,-470,28.4,1707.3
4857763517,1,15,11,0,8,5,7,1,1,0,0,17534,7.0,18770,209,60,780,1580,26.9,1753.4,38,2,1,5,8,5,0,0,0,0,16754,6.6,17190,222,44,-780,-1580,26.6,1675.4
4857739066,1,14,2,0,3,7,5,1,1,0,0,15094,6.8,16908,216,51,-2794,-1860,26.7,1509.4,16,0,1,7,3,7,0,0,0,0,17888,7.4,18768,244,60,2794,1860,30.4,1788.8
4857730305,1,12,2,1,8,3,9,1,1,0,0,18790,7.4,19529,224,72,3565,2455,29.6,1879.0,12,1,0,3,8,1,0,0,0,0,15225,7.0,17074,216,52,-3565,-2455,26.8,1522.5
4857713712,0,11,7,0,4,12,2,0,0,0,0,15784,6.8,17880,196,67,-3637,-689,26.3,1578.4,28,0,1,12,4,10,1,1,0,0,19421,7.0,18569,251,28,3637,689,27.9,1942.1
4857686828,0,0,0,0,9,11,21,0,0,0,1,31874,10.2,34465,81,0,-4312,-2234,8.1,3187.4,0,0,1,11,9,31,0,0,0,0,36186,10.4,36699,107,0,4312,2234,10.7,3618.6
4857663401,1,0,0,1,25,17,75,0,0,0,0,35767,11.0,38544,110,0,423,-758,11.0,3576.7,1,0,0,17,25,31,0,0,0,0,35344,10.8,39302,113,0,-423,758,11.3,3534.4
4853674529,0,13,0,1,25,19,81,0,0,0,0,37896,11.4,42426,92,0,513,1996,9.2,3789.6,0,1,0,19,25,47,0,0,0,0,37383,11.4,40430,112,0,-513,-1996,11.2,3738.3
4853651769,0,0,0,0,19,30,61,0,0,0,1,36504,10.8,38482,107,0,-3056,-4135,10.7,3650.4,0,0,1,30,19,82,0,0,0,0,39560,11.4,42617,112,0,3056,4135,11.2,3956.0
4853613570,0,34,0,1,20,18,45,0,0,0,1,36244,11.0,38724,116,0,-1857,-2110,11.6,3624.4,34,0,0,18,20,48,0,0,0,0,38101,11.2,40834,114,0,1857,2110,11.4,3810.1
4853599453,0,0,0,1,16,22,40,0,0,0,0,36177,10.4,37841,119,0,-2422,-3135,11.9,3617.7,0,0,0,22,16,54,0,0,0,0,38599,11.2,40976,116,0,2422,3135,11.6,3859.9
4853441979,1,0,0,1,29,24,85,0,0,0,1,37598,11.2,40517,101,0,-2843,-2379,10.1,3759.8,0,0,0,24,29,55,0,0,0,0,40441,11.4,42896,114,0,2843,2379,11.4,4044.1
4853430044,0,1,0,0,14,31,31,0,0,0,2,34848,10.4,36159,108,0,-5329,-9333,10.8,3484.8,0,0,1,31,14,89,0,0,0,0,40177,11.8,45492,118,0,5329,9333,11.8,4017.7
4853411014,1,5,17,1,34,29,75,0,0,0,1,40283,12.0,45429,117,0,1331,-181,11.7,4028.3,19,0,0,29,34,66,0,0,0,0,38952,11.8,45610,93,0,-1331,181,9.3,3895.2
4853324119,1,0,0,0,18,25,45,0,0,0,1,36400,11.0,39268,103,0,-1508,-2467,10.3,3640.0,2,0,1,25,18,58,0,0,0,0,37908,11.2,41735,108,0,1508,2467,10.8,3790.8
4849137024,1,0,2,1,12,8,31,0,0,0,0,33345,10.0,34400,123,0,1653,1577,12.3,3334.5,12,0,0,8,12,12,0,0,0,0,31692,9.8,32823,112,0,-1653,-1577,11.2,3169.2
4849109453,1,0,0,1,22,19,63,0,0,0,0,36419,10.6,38883,115,0,-475,-71,11.5,3641.9,0,0,0,19,22,40,0,0,0,0,36894,11.0,38954,114,0,475,71,11.4,3689.4
4849081171,0,12,0,0,19,30,48,0,0,0,1,37053,11.4,40766,91,0,-1942,-1456,9.1,3705.3,0,1,1,30,19,57,0,0,0,0,38995,11.4,42222,103,0,1942,1456,10.3,3899.5
4849059924,1,0,0,1,23,19,70,0,0,0,1,38796,11.4,41022,119,0,3145,2589,11.9,3879.6,0,0,0,19,23,48,0,0,0,0,35651,10.8,38433,111,0,-3145,-2589,11.1,3565.1
4849019552,1,0,0,1,21,22,56,0,0,0,0,37986,11.0,40383,107,0,2451,1788,10.7,3798.6,9,0,0,22,21,49,0,0,0,0,35535,10.8,38595,95,0,-2451,-1788,9.5,3553.5
4848120656,1,15,3,1,6,3,1,0,0,0,0,16619,6.8,17899,215,56,2599,2129,27.1,1661.9,14,2,0,3,6,2,0,0,0,0,14020,6.4,15770,145,52,-2599,-2129,19.7,1402.0
4848078250,0,17,0,1,3,8,7,1,1,0,0,16145,6.6,17336,229,48,-1507,-1193,27.7,1614.5,11,1,0,8,3,6,0,0,0,0,17652,7.0,18529,193,36,1507,1193,22.9,1765.2
4848046820,0,12,1,0,2,5,1,0,0,0,0,15326,6.8,17842,210,39,-1455,-1507,24.9,1532.6,11,0,1,5,2,5,0,0,0,0,16781,7.4,19349,208,52,1455,1507,26.0,1678.1
4847999227,1,14,2,1,4,4,3,0,0,0,0,15786,6.8,17569,209,48,1113,448,25.7,1578.6,42,0,0,4,4,6,1,1,0,0,14673,6.6,17121,176,60,-1113,-448,23.6,1467.3
4847959848,0,13,1,0,5,7,3,0,0,0,0,16076,6.8,17428,184,48,-339,208,23.2,1607.6,11,1,1,7,5,6,1,1,0,0,16415,6.8,17220,183,56,339,-208,23.9,1641.5
4846086616,1,0,0,1,35,26,74,0,0,0,1,41468,12.0,46216,104,0,2802,3371,10.4,4146.8,0,0,0,26,35,85,0,0,0,0,38666,11.6,42845,102,0,-2802,-3371,10.2,3866.6
4840566810,0,12,0,0,8,9,11,0,0,0,0,17213,6.6,15843,222,35,-2044,-1271,25.7,1721.3,17,0,1,9,8,13,0,0,0,0,19257,6.8,17114,236,52,2044,1271,28.8,1925.7
4838661273,1,83,1,0,8,7,11,1,0,1,0,18358,7.0,18468,221,60,1187,-107,28.1,1835.8,11,3,1,7,8,7,0,0,0,0,17171,7.2,18575,216,54,-1187,107,27.0,1717.1
4838401173,1,68,1,0,8,8,5,1,0,1,0,16283,6.8,17582,153,64,-2089,-763,21.7,1628.3,11,0,1,8,8,11,1,1,0,0,18372,7.0,18345,201,59,2089,763,26.0,1837.2
4838361283,0,15,1,0,7,5,6,0,0,0,0,17360,7.0,18048,219,60,1568,510,27.9,1736.0,26,1,1,5,7,6,1,1,0,0,15792,7.0,17538,190,48,-1568,-510,23.8,1579.2
4838331627,0,12,1,1,6,7,8,0,0,0,0,16668,6.6,17359,208,51,-675,190,25.9,1666.8,18,1,0,7,6,6,1,1,0,0,17343,6.4,17169,203,53,675,-190,25.6,1734.3
4838305301,1,11,0,1,9,1,7,1,1,0,0,18235,7.4,19175,205,60,4383,1531,26.5,1823.5,10,1,0,1,9,0,0,0,0,0,13852,6.8,17644,180,72,-4383,-1531,25.2,1385.2
4836361861,0,16,0,0,6,6,7,1,1,0,0,17387,6.8,17682,215,52,370,-121,26.7,1738.7,11,3,1,6,6,6,0,0,0,0,17017,6.8,17803,242,56,-370,121,29.8,1701.7
4836188663,0,0,0,0,37,32,84,0,0,0,0,40770,12.2,47756,115,0,1242,3485,11.5,4077.0,0,0,1,32,37,79,0,0,0,0,39528,11.8,44271,110,0,-1242,-3485,11.0,3952.8
4856671479,1,22,3,0,12,21,14,0,0,0,0,47046,10.0,47500,3,0,15626,19000,0.3,4704.6,11,2,1,15,6,13,0,0,0,0,31420,6.0,28500,2,0,-15626,-19000,0.2,3142.0
4856670985,1,0,0,0,18,13,14,0,0,0,0,62000,12.0,55000,0,0,24800,22000,0.0,6200.0,0,0,1,7,12,10,0,0,0,0,37200,7.2,33000,0,0,-24800,-22000,0.0,3720.0
4856668811,1,0,0,1,19,19,17,0,0,0,0,46405,10.0,47500,1,0,17740,19000,0.1,4640.5,6,0,0,11,11,13,0,0,0,0,28665,6.0,28500,2,0,-17740,-19000,0.2,2866.5
4856660048,1,5,0,1,17,20,20,0,0,0,0,63050,13.0,62500,0,0,24090,25000,0.0,6305.0,119,1,0,14,11,14,0,0,0,0,38960,7.8,37500,1,0,-24090,-25000,0.1,3896.0
4856650379,1,6,1,0,17,21,14,0,0,0,0,61660,12.6,59500,1,0,22710,22000,0.1,6166.0,0,0,1,13,9,16,0,0,0,0,38950,7.8,37500,0,0,-22710,-22000,0.0,3895.0
4856647277,1,33,1,1,30,16,22,0,0,0,0,65510,12.0,55000,1,0,29680,22000,0.1,6551.0,0,3,0,3,17,9,0,0,0,0,35830,7.2,33000,3,0,-29680,-22000,0.3,3583.0
4856638229,1,5,0,0,17,17,15,0,0,0,0,46300,10.6,50500,0,0,18090,22000,0.0,4630.0,0,1,1,12,12,10,0,0,0,0,28210,6.0,28500,1,0,-18090,-22000,0.1,2821.0
4856631974,1,6,0,1,25,17,23,0,0,0,0,63400,13.8,66500,0,0,24980,29000,0.0,6340.0,0,0,0,6,14,9,0,0,0,0,38420,7.8,37500,0,0,-24980,-29000,0.0,3842.0
4856625792,1,0,0,1,25,14,23,0,0,0,0,63200,12.0,55000,3,0,24250,22000,0.3,6320.0,8,0,0,5,16,8,0,0,0,0,38950,7.2,33000,0,0,-24250,-22000,0.0,3895.0
4856616074,1,198,0,1,13,21,15,0,0,0,0,59618,12.0,55000,1,0,21244,22000,0.1,5961.8,0,0,0,13,5,13,0,0,0,0,38374,7.2,33000,2,0,-21244,-22000,0.2,3837.4
4856601326,1,0,0,1,16,18,18,0,0,0,0,47000,10.0,47500,0,0,18100,19000,0.0,4700.0,0,0,0,11,9,8,0,0,0,0,28900,6.0,28500,0,0,-18100,-19000,0.0,2890.0
4856593953,1,358,0,1,15,12,15,0,0,0,0,62000,12.0,55000,0,0,26200,22000,0.0,6200.0,4,0,0,7,10,4,0,0,0,0,35800,7.2,33000,0,0,-26200,-22000,0.0,3580.0
4856586872,1,5,0,0,16,20,16,0,0,0,0,61385,12.0,55000,1,0,23390,22000,0.1,6138.5,0,0,1,12,8,13,0,0,0,0,37995,7.2,33000,1,0,-23390,-22000,0.1,3799.5
4856562679,1,23,5,0,14,13,12,0,0,0,0,45065,10.0,47500,2,0,17450,19000,0.2,4506.5,2,3,1,8,9,6,0,0,0,0,27615,6.0,28500,1,0,-17450,-19000,0.1,2761.5
4856558839,1,0,0,0,14,21,12,0,0,0,0,47350,10.0,47500,0,0,18800,19000,0.0,4735.0,0,0,1,14,7,13,0,0,0,0,28550,6.0,28500,0,0,-18800,-19000,0.0,2855.0
4856537231,1,59,0,1,11,11,13,0,0,0,0,29227,9.6,43000,0,0,11412,19000,0.0,2922.7,0,0,0,9,9,7,0,0,0,0,17815,5.4,24000,0,0,-11412,-19000,0.0,1781.5
4856520450,1,0,0,0,14,21,14,0,0,0,0,60950,12.0,55000,0,0,20900,21000,0.0,6095.0,0,0,1,14,7,12,0,0,0,0,40050,7.4,34000,0,0,-20900,-21000,0.0,4005.0
4856513981,1,0,0,1,18,20,24,0,0,0,0,65050,12.0,55000,0,0,26800,22000,0.0,6505.0,0,0,0,14,12,9,0,0,0,0,38250,7.2,33000,0,0,-26800,-22000,0.0,3825.0
4856495604,1,198,0,0,12,20,19,0,0,0,0,45620,12.0,55000,0,0,16694,22000,0.0,4562.0,4,0,1,14,6,9,0,0,0,0,28926,7.2,33000,0,0,-16694,-22000,0.0,2892.6
4856189303,1,0,0,1,15,20,10,0,0,0,0,60085,12.0,55000,0,0,22535,22000,0.0,6008.5,6,0,0,10,5,15,0,0,0,0,37550,7.2,33000,0,0,-22535,-22000,0.0,3755.0
4857729492,0,15,0,0,13,8,10,0,0,0,0,19411,6.8,17327,202,40,2493,1861,24.2,1941.1,14,2,1,8,13,6,1,1,0,0,16918,6.2,15466,172,56,-2493,-1861,22.8,1691.8
4856644982,0,10,1,1,3,7,3,0,0,0,0,16711,7.0,18527,249,63,-1748,788,31.2,1671.1,15,0,0,7,3,9,2,1,1,0,18459,7.0,17739,205,57,1748,-788,26.2,1845.9
4856561878,0,12,0,0,7,10,10,0,0,0,0,17409,6.4,16338,190,40,-3116,-7,23.0,1740.9,16,2,1,10,7,14,0,0,0,0,20525,6.4,16345,192,31,3116,7,22.3,2052.5
4855356622,1,53,0,0,4,3,5,1,1,0,0,17204,7.4,19894,215,80,1114,2150,29.5,1720.4,16,1,1,3,4,3,0,0,0,0,16090,6.8,17744,225,56,-1114,-2150,28.1,1609.0
4855320935,0,11,1,0,5,11,5,1,1,0,0,16606,7.0,18315,212,67,-2812,158,27.9,1660.6,8,0,1,11,5,10,0,0,0,0,19418,6.6,18157,221,48,2812,-158,26.9,1941.8
4855257354,0,16,0,1,11,6,17,0,0,0,0,20114,6.6,17565,202,40,2598,155,24.2,2011.4,13,1,0,6,11,5,0,0,0,0,17516,6.8,17410,221,44,-2598,-155,26.5,1751.6
4840536300,1,12,4,1,9,5,11,1,1,0,0,18200,6.8,17697,203,52,2047,871,25.5,1820.0,12,3,0,5,9,5,0,0,0,0,16153,6.8,16826,209,44,-2047,-871,25.3,1615.3
4837505782,1,13,1,0,6,4,7,0,0,0,0,18092,6.8,18143,223,49,833,37,27.2,1809.2,14,1,1,4,6,3,0,0,0,0,17259,6.8,18106,224,60,-833,-37,28.4,1725.9
4837488135,1,133,0,1,10,7,11,1,1,0,0,18303,6.6,17062,235,40,1809,215,27.5,1830.3,10,1,0,6,9,7,0,0,0,0,16494,6.8,16847,183,47,-1809,-215,23.0,1649.4
4818200066,0,13,0,0,3,10,4,0,0,0,0,15360,6.8,16966,191,56,-4041,-2432,24.7,1536.0,11,2,1,10,3,9,0,0,0,0,19401,7.2,19398,241,60,4041,2432,30.1,1940.1
4818174840,0,15,1,0,6,9,7,0,0,0,0,15687,6.4,15863,175,52,-3467,-2193,22.7,1568.7,15,1,1,9,6,10,1,1,0,0,19154,6.8,18056,215,67,3467,2193,28.2,1915.4
4816091456,1,13,0,1,34,23,80,0,0,0,0,41480,12.0,46382,94,75,2243,3744,16.9,4148.0,12,0,0,23,34,45,0,0,0,0,39237,11.4,42638,97,59,-2243,-3744,15.6,3923.7
4816050585,0,15,4,1,5,4,5,0,0,0,0,17617,7.0,17992,236,60,2585,-132,29.6,1761.7,13,2,0,4,5,2,0,0,0,0,15032,7.0,18124,197,48,-2585,132,24.5,1503.2
4804810884,1,19,4,1,9,4,9,0,0,0,0,17877,6.4,16525,227,47,2676,331,27.4,1787.7,13,3,0,4,9,5,0,0,0,0,15201,6.6,16194,170,56,-2676,-331,22.6,1520.1
4804789346,1,15,3,0,3,2,3,0,0,0,0,15449,7.0,17701,227,60,576,342,28.7,1544.9,10,2,1,2,3,3,0,0,0,0,14873,6.8,17359,237,40,-576,-342,27.7,1487.3
4804760509,1,14,2,0,8,4,10,0,0,0,0,18173,7.2,18912,258,56,3145,1868,31.4,1817.3,15,2,1,4,8,4,0,0,0,0,15028,6.6,17044,194,57,-3145,-1868,25.1,1502.8
4804746345,1,15,1,1,9,3,11,0,0,0,0,18978,7.0,18812,228,64,4423,1299,29.2,1897.8,140,1,0,3,9,1,0,0,0,0,14555,7.0,17513,204,64,-4423,-1299,26.8,1455.5
4802987327,0,33,0,0,9,7,14,0,0,0,0,17156,6.6,16619,195,60,70,-43,25.5,1715.6,32,1,1,7,9,12,2,1,1,0,17086,6.8,16662,174,56,-70,43,23.0,1708.6
4802944209,0,32,0,0,2,4,4,0,0,0,0,15152,6.4,16401,217,52,-2815,-2430,26.9,1515.2,33,1,1,4,2,6,0,0,0,0,17967,7.2,18831,197,59,2815,2430,25.6,1796.7
4794426447,1,9,4,1,6,4,8,1,1,0,0,16129,6.6,16152,203,45,556,-991,24.8,1612.9,27,0,0,4,6,4,0,0,0,0,15573,6.8,17143,183,50,-556,991,23.3,1557.3
4856320450,0,16,1,0,5,12,2,0,0,0,0,15865,6.4,16270,182,68,-3270,-2061,25.0,1586.5,40,1,1,12,5,14,1,1,0,0,19135,7.0,18331,233,60,3270,2061,29.3,1913.5
4854899439,0,15,2,0,3,2,1,0,0,0,0,15121,6.8,17793,234,39,-417,-990,27.3,1512.1,14,1,1,2,3,0,1,1,0,0,15538,7.0,18783,228,72,417,990,30.0,1553.8
4854083113,1,34,0,1,21,14,56,0,0,0,1,37311,11.0,37682,124,0,3876,1921,12.4,3731.1,0,11,0,14,21,44,0,0,0,0,33435,10.6,35761,113,0,-3876,-1921,11.3,3343.5
4854054321,0,0,0,0,27,34,68,0,0,0,1,40183,11.6,44454,111,0,-643,-1228,11.1,4018.3,0,0,1,34,27,99,0,0,0,0,40826,12.0,45682,110,0,643,1228,11.0,4082.6
4854026356,0,28,0,1,20,34,42,0,0,0,1,38003,11.2,41312,96,0,-1692,-2910,9.6,3800.3,0,24,0,34,20,104,0,0,0,0,39695,12.0,44222,108,0,1692,2910,10.8,3969.5
4853995467,1,17,0,1,32,27,92,0,0,0,1,37943,11.2,42126,101,0,-1217,-611,10.1,3794.3,0,0,0,27,32,63,0,0,0,0,39160,11.6,42737,105,0,1217,611,10.5,3916.0
4853964970,1,0,0,1,17,16,16,0,0,0,0,47532,10.0,47500,0,0,18458,19000,0.0,4753.2,0,0,0,8,9,10,0,0,0,0,29074,6.0,28500,0,0,-18458,-19000,0.0,2907.4
4853938289,1,0,0,1,15,17,15,0,0,0,0,62000,12.0,55000,0,0,24200,22000,0.0,6200.0,0,0,0,9,7,9,0,0,0,0,37800,7.2,33000,0,0,-24200,-22000,0.0,3780.0
4853916847,1,0,0,1,20,16,18,0,0,0,0,63695,12.0,55000,0,0,26139,22000,0.0,6369.5,0,0,0,7,11,7,0,0,0,0,37556,7.2,33000,0,0,-26139,-22000,0.0,3755.6
4853886189,1,35,1,1,17,18,17,0,0,0,0,63090,12.0,55000,2,0,22897,22000,0.2,6309.0,0,11,0,10,9,12,0,0,0,0,40193,7.2,33000,0,0,-22897,-22000,0.0,4019.3
4853851030,1,0,0,0,11,15,11,0,0,0,0,47000,10.0,47500,0,0,19500,19000,0.0,4700.0,0,0,1,11,7,9,0,0,0,0,27500,6.0,28500,0,0,-19500,-19000,0.0,2750.0
4853826485,1,3,0,1,12,16,18,0,0,0,0,62700,12.0,55000,0,0,26200,22000,0.0,6270.0,0,0,0,13,9,5,0,0,0,0,36500,7.2,33000,0,1,-26200,-22000,0.1,3650.0
4853806384,1,0,0,0,14,20,16,0,0,0,0,60950,12.0,55000,0,0,23400,20000,0.0,6095.0,0,0,1,11,5,11,0,0,0,0,37550,7.6,35000,0,0,-23400,-20000,0.0,3755.0
4853783914,1,0,0,0,14,13,19,0,0,0,0,47350,10.0,47500,0,0,20200,19000,0.0,4735.0,3,0,1,9,10,5,0,0,0,0,27150,6.0,28500,0,0,-20200,-19000,0.0,2715.0
4853755640,1,1,0,1,16,17,18,0,0,0,0,46000,10.0,47500,1,0,16700,19000,0.1,4600.0,32,0,0,10,9,10,0,0,0,0,29300,6.0,28500,1,0,-16700,-19000,0.1,2930.0
4853738250,1,0,0,1,20,24,19,0,0,0,0,62000,13.0,61980,0,0,23350,24480,0.0,6200.0,17,0,0,12,8,18,0,0,0,0,38650,7.8,37500,1,0,-23350,-24480,0.1,3865.0
4853716237,1,0,0,0,19,15,22,0,0,0,0,47105,10.0,47500,0,0,19575,19000,0.0,4710.5,0,0,1,11,15,8,0,0,0,0,27530,6.0,28500,0,0,-19575,-19000,0.0,2753.0
4853075637,1,0,0,0,27,25,22,0,0,0,0,53100,10.0,47500,3,0,23750,19000,0.3,5310.0,0,0,1,10,12,13,0,0,0,0,29350,6.0,28500,2,0,-23750,-19000,0.2,2935.0
4853055432,1,0,0,0,16,15,11,0,0,0,0,45950,10.0,47500,0,0,17400,19000,0.0,4595.0,0,0,1,9,10,14,0,0,0,0,28550,6.0,28500,0,0,-17400,-19000,0.0,2855.0
4853033126,1,8,0,1,19,10,16,0,0,0,0,62700,12.0,55000,0,0,27600,22000,0.0,6270.0,0,0,0,3,12,5,0,0,0,0,35100,7.2,33000,0,0,-27600,-22000,0.0,3510.0
4854752181,1,13,1,1,7,4,7,0,0,0,0,17784,6.8,18073,226,48,1951,912,27.4,1778.4,12,0,0,4,7,2,0,0,0,0,15833,6.8,17161,199,56,-1951,-912,25.5,1583.3
4854723543,1,15,17,1,12,5,11,1,1,0,0,19409,7.2,19481,243,52,2686,1510,29.5,1940.9,31,1,0,5,12,3,0,0,0,0,16723,7.0,17971,211,64,-2686,-1510,27.5,1672.3
4854688254,1,17,0,0,3,6,1,1,1,0,0,15720,7.4,19223,242,56,-1711,775,29.8,1572.0,12,2,1,6,3,8,0,0,0,0,17431,7.0,18448,241,60,1711,-775,30.1,1743.1
4854662986,0,38,0,0,5,7,5,0,0,0,0,16239,6.8,17511,223,51,-753,-1443,27.4,1623.9,10,9,1,6,4,4,0,0,0,0,16992,7.2,18954,233,64,753,1443,29.7,1699.2
4847752215,0,12,0,1,3,6,3,0,0,0,0,14377,6.6,16875,155,45,-3018,-1779,20.0,1437.7,10,0,0,6,3,3,0,0,0,0,17395,7.2,18654,225,58,3018,1779,28.3,1739.5
4847718102,0,14,2,0,6,8,6,0,0,0,0,16085,6.6,16341,169,48,-1867,-1636,21.7,1608.5,10,1,1,8,6,8,0,0,0,0,17952,6.8,17977,215,64,1867,1636,27.9,1795.2
4841617834,0,17,2,1,7,4,12,1,1,0,0,19685,6.8,17201,218,48,1253,-763,26.6,1968.5,14,4,0,4,7,4,0,0,0,0,18432,6.8,17964,238,57,-1253,763,29.5,1843.2
4841594078,0,16,1,1,6,6,7,0,0,0,0,17025,6.8,17210,241,27,-499,-1288,26.8,1702.5,12,1,0,6,6,3,0,0,0,0,17524,6.8,18498,254,52,499,1288,30.6,1752.4
4837261348,0,12,1,0,6,4,7,1,1,0,0,17311,6.6,17255,215,55,1484,-670,27.0,1731.1,8,0,1,4,6,2,0,0,0,0,15827,6.8,17925,203,64,-1484,670,26.7,1582.7
4835336615,0,53,0,1,7,6,3,0,0,0,0,16290,7.0,17871,208,47,210,360,25.5,1629.0,12,1,0,6,7,4,0,0,0,0,16080,6.8,17511,233,52,-210,-360,28.5,1608.0
4835323183,1,11,1,0,9,13,9,1,0,1,0,19405,6.8,16849,195,56,725,-651,25.1,1940.5,18,1,1,13,9,7,0,0,0,0,18680,6.8,17500,179,48,-725,651,22.7,1868.0
4835302097,0,28,3,0,6,6,6,1,1,0,0,17811,6.6,17216,210,52,926,159,26.2,1781.1,12,2,1,6,6,5,0,0,0,0,16885,6.6,17057,198,62,-926,-159,26.0,1688.5
4835266790,0,14,1,1,4,4,4,1,1,0,0,16136,7.2,18224,229,64,-264,-639,29.3,1613.6,13,2,0,4,4,3,0,0,0,0,16400,7.2,18863,225,57,264,639,28.2,1640.0
4835228284,0,15,3,1,7,4,10,0,0,0,0,17604,7.6,20122,248,60,1958,2186,30.8,1760.4,16,0,0,3,6,3,1,1,0,0,15646,7.0,17936,269,48,-1958,-2186,31.7,1564.6
4834255885,1,34,4,0,3,4,4,1,1,0,0,15569,6.8,17253,232,56,397,664,28.8,1556.9,39,2,1,4,3,4,0,0,0,0,15172,6.6,16589,188,38,-397,-664,22.6,1517.2
4834226510,0,11,0,0,4,6,5,0,0,0,0,16460,6.8,18358,245,64,-904,-401,30.9,1646.0,10,0,1,6,4,10,1,1,0,0,17364,7.0,18759,236,60,904,401,29.6,1736.4
4834199333,1,18,0,1,10,3,11,0,0,0,0,19038,7.2,19175,239,56,4692,3041,29.5,1903.8,14,1,0,3,10,2,1,0,1,0,14346,6.4,16134,181,44,-4692,-3041,22.5,1434.6
4833151430,0,29,2,0,9,11,9,0,0,0,0,18347,6.6,16820,212,54,-1009,-767,26.6,1834.7,32,1,1,11,9,15,0,0,0,0,19356,7.0,17587,215,57,1009,767,27.2,1935.6
4833103276,0,12,2,0,6,5,5,0,0,0,0,16763,6.8,17444,208,52,40,-1010,26.0,1676.3,10,1,1,5,6,5,0,0,0,0,16723,6.8,18454,259,48,-40,1010,30.7,1672.3
4830741363,0,18,1,1,6,5,3,0,0,0,0,17179,7.4,19300,208,56,464,956,26.4,1717.9,12,0,0,5,6,5,0,0,0,0,16715,7.0,18344,238,47,-464,-956,28.5,1671.5
4847310202,0,67,1,0,3,8,0,1,0,1,0,14906,6.8,17397,211,44,-3463,-748,25.5,1490.6,12,1,1,8,3,10,0,0,0,0,18369,6.8,18145,224,62,3463,748,28.6,1836.9
4840456228,1,33,1,1,4,2,3,1,0,1,0,15331,6.8,18252,189,72,141,630,26.1,1533.1,9,1,0,2,4,2,0,0,0,0,15190,6.8,17622,218,60,-141,-630,27.8,1519.0
4840417873,0,14,4,0,7,11,12,0,0,0,0,17106,7.0,17527,241,52,-4413,-2738,29.3,1710.6,16,3,1,11,7,18,1,1,0,0,21519,7.6,20265,242,76,4413,2738,31.8,2151.9
4840376988,0,8,5,0,4,7,1,0,0,0,0,15851,7.0,18211,236,52,-2040,-1657,28.8,1585.1,14,0,1,7,4,4,0,0,0,0,17891,7.2,19868,219,67,2040,1657,28.6,1789.1
4840330053,1,13,1,0,10,7,10,0,0,0,0,19106,7.0,18659,216,52,2141,1152,26.8,1910.6,114,3,1,7,10,10,1,0,1,0,16965,7.0,17507,213,60,-2141,-1152,27.3,1696.5
4840278389,1,16,2,1,4,1,2,0,0,0,0,17519,7.0,19043,223,56,2090,770,27.9,1751.9,14,0,0,1,4,1,0,0,0,0,15429,7.2,18273,194,66,-2090,-770,26.0,1542.9
4840238404,0,15,0,0,1,10,3,0,0,0,0,13967,6.4,16435,201,56,-5049,-2584,25.7,1396.7,8,0,1,10,1,10,0,0,0,0,19016,7.2,19019,221,57,5049,2584,27.8,1901.6
4840195382,1,10,1,0,6,6,2,1,0,1,0,17693,7.6,20135,222,68,418,2152,29.0,1769.3,14,1,1,6,6,5,0,0,0,0,17275,7.0,17983,223,51,-418,-2152,27.4,1727.5
4838567276,1,9,1,1,6,0,6,1,1,0,0,16743,6.8,17249,217,59,3528,1209,27.6,1674.3,11,0,0,0,6,0,0,0,0,0,13215,6.4,16040,197,52,-3528,-1209,24.9,1321.5
4838554468,0,5,0,0,6,8,1,0,0,0,0,15568,6.6,16669,187,52,-2359,-1581,23.9,1556.8,10,0,1,8,6,7,0,0,0,0,17927,7.2,18250,190,63,2359,1581,25.3,1792.7
4835200321,0,14,1,0,7,9,6,0,0,0,0,17245,6.8,17248,196,62,-2121,-971,25.8,1724.5,11,1,1,9,7,10,0,0,0,0,19366,7.0,18219,229,53,2121,971,28.2,1936.6
4835155817,0,14,2,0,3,7,3,1,1,0,0,14956,6.6,16572,204,52,-2319,-1522,25.6,1495.6,15,1,1,7,3,11,1,0,1,0,17275,7.0,18094,209,60,2319,1522,26.9,1727.5
4835116579,1,17,1,1,10,7,14,2,1,1,0,19958,7.0,18702,256,60,3774,3273,31.6,1995.8,16,1,0,7,10,6,0,0,0,0,16184,6.4,15429,178,42,-3774,-3273,22.0,1618.4
4835081999,1,16,0,1,8,6,5,1,1,0,0,18616,7.0,18884,232,63,2315,1237,29.5,1861.6,10,2,0,6,8,12,0,0,0,0,16301,6.8,17647,220,60,-2315,-1237,28.0,1630.1
4833902916,0,16,2,0,5,8,7,1,1,0,0,17200,6.8,17411,240,48,-50,414,28.8,1720.0,24,4,1,8,5,11,0,0,0,0,17250,6.6,16997,223,49,50,-414,27.2,1725.0
4833868889,0,16,1,0,7,6,6,0,0,0,0,17789,7.2,19053,222,51,-598,67,27.3,1778.9,9,1,1,6,7,9,0,0,0,0,18387,7.2,18986,255,60,598,-67,31.5,1838.7
4833827644,1,14,2,1,10,6,8,0,0,0,0,17674,6.8,18050,218,46,880,536,26.4,1767.4,21,0,0,6,10,4,0,0,0,0,16794,7.2,17514,201,58,-880,-536,25.9,1679.4
4833809283,0,13,2,0,1,5,1,0,0,0,0,14481,6.8,17776,228,67,-2927,-1381,29.5,1448.1,88,2,1,5,1,6,1,1,0,0,17408,7.4,19157,240,60,2927,1381,30.0,1740.8
4832137564,0,20,3,1,8,5,9,0,0,0,0,17663,7.0,17737,235,47,1084,808,28.2,1766.3,14,0,0,5,8,4,0,0,0,0,16579,6.6,16929,206,64,-1084,-808,27.0,1657.9
4836265305,1,15,1,1,8,5,10,0,0,0,0,17574,7.0,18549,234,44,906,298,27.8,1757.4,78,0,0,5,8,4,1,1,0,0,16668,7.0,18251,229,52,-906,-298,28.1,1666.8
4824051032,1,10,0,1,7,4,7,1,1,0,0,17508,7.0,18350,222,59,1210,1164,28.1,1750.8,11,2,0,4,7,5,0,0,0,0,16298,6.8,17186,196,64,-1210,-1164,26.0,1629.8
4824017295,0,10,3,0,8,12,6,0,0,0,0,16193,6.4,15924,190,52,-2673,-1398,24.2,1619.3,14,0,1,12,8,13,1,1,0,0,18866,6.8,17322,219,60,2673,1398,27.9,1886.6
4823980448,0,13,1,1,4,3,2,1,0,1,0,17117,7.2,19930,229,76,1743,3063,30.5,1711.7,12,0,0,3,4,6,1,1,0,0,15374,6.6,16867,185,48,-1743,-3063,23.3,1537.4
4823542260,1,13,2,0,2,7,2,1,1,0,0,16040,6.8,17914,218,64,-1451,-776,28.2,1604.0,16,1,1,7,2,11,0,0,0,0,17491,7.2,18690,218,67,1451,776,28.5,1749.1
4822693175,1,16,0,1,7,9,6,1,1,0,0,17423,6.8,17079,173,57,-636,-521,23.0,1742.3,9,0,0,9,7,7,0,0,0,0,18059,6.8,17600,219,42,636,521,26.1,1805.9
4822657561,1,11,0,1,7,9,9,1,1,0,0,16942,6.8,17417,205,56,92,1248,26.1,1694.2,19,2,0,9,7,11,0,0,0,0,16850,6.4,16169,172,40,-92,-1248,21.2,1685.0
4822652746,1,28,4,1,6,1,5,1,0,1,0,17407,7.0,18331,230,49,2799,1336,27.9,1740.7,10,1,0,1,6,0,0,0,0,0,14608,6.6,16995,207,55,-2799,-1336,26.2,1460.8
4822631030,1,30,2,0,5,8,4,0,0,0,0,16408,6.8,17522,198,59,-816,-1222,25.7,1640.8,30,1,1,8,5,6,1,1,0,0,17224,7.0,18744,221,64,816,1222,28.5,1722.4
4822606195,1,15,0,1,1,3,2,1,0,1,0,16198,7.0,18492,236,59,-47,-957,29.5,1619.8,12,1,0,3,1,3,1,1,0,0,16245,7.2,19449,216,72,47,957,28.8,1624.5
4822322940,1,16,0,1,3,0,3,1,0,1,0,16808,7.2,19537,263,70,2257,909,33.3,1680.8,14,2,0,0,3,0,0,0,0,0,14551,7.2,18628,247,58,-2257,-909,30.5,1455.1
4822305937,1,14,0,0,10,9,9,1,1,0,0,18241,6.8,16663,201,52,-247,114,25.3,1824.1,10,1,1,9,10,6,0,0,0,0,18488,6.6,16549,183,52,247,-114,23.5,1848.8
4821843306,0,22,0,0,5,3,5,0,0,0,0,15100,6.6,16676,196,36,4,-382,23.2,1510.0,23,1,1,3,5,4,0,0,0,0,15096,6.8,17058,207,56,-4,382,26.3,1509.6
4821802390,1,13,0,1,11,5,12,0,0,0,0,18472,7.4,19122,234,56,2485,1302,29.0,1847.2,10,0,0,5,11,3,0,0,0,0,15987,6.8,17820,219,64,-2485,-1302,28.3,1598.7
4818756819,1,16,0,0,5,7,10,0,0,0,0,16175,6.6,16179,185,60,-2404,-2159,24.5,1617.5,77,0,1,7,5,7,1,0,1,0,18579,7.0,18338,249,56,2404,2159,30.5,1857.9
4817823011,0,17,2,0,4,7,5,0,0,0,0,16399,7.0,17806,226,61,-341,-351,28.7,1639.9,13,0,1,7,4,11,0,0,0,0,16740,7.0,18157,210,54,341,351,26.4,1674.0
4817791689,1,17,2,1,9,6,11,0,0,0,1,19197,6.8,17624,218,48,2731,467,26.6,1919.7,10,1,0,6,9,5,0,0,0,0,16466,6.8,17157,170,68,-2731,-467,23.8,1646.6
4817771056,1,19,6,0,3,3,3,1,1,0,0,15751,7.0,18025,223,56,-47,769,27.9,1575.1,11,1,1,3,3,4,0,0,0,0,15798,6.8,17256,222,56,47,-769,27.8,1579.8
4817743402,1,87,1,1,7,5,8,0,0,0,0,18012,7.0,18492,223,55,1632,606,27.8,1801.2,17,0,0,5,7,6,1,1,0,0,16380,6.8,17886,208,56,-1632,-606,26.4,1638.0
4803154996,0,15,2,1,14,10,23,1,0,1,0,19598,6.8,16585,193,60,1253,-66,25.3,1959.8,7,2,0,10,14,11,1,1,0,0,18345,6.6,16651,208,56,-1253,66,26.4,1834.5
4848199685,0,12,1,0,4,9,1,0,0,0,0,15722,6.6,17511,202,56,-1674,-183,25.8,1572.2,21,2,1,9,4,8,0,0,0,0,17396,6.8,17694,190,55,1674,183,24.5,1739.6
4848182678,1,81,0,1,6,1,6,1,1,0,0,18080,7.0,18594,231,59,4294,2965,29.0,1808.0,18,1,0,1,6,2,0,0,0,0,13786,6.4,15629,188,56,-4294,-2965,24.4,1378.6
4848160829,1,56,2,0,7,5,8,0,0,0,0,17404,6.8,17774,209,51,899,71,26.0,1740.4,10,1,1,5,7,5,1,0,1,0,16505,7.0,17703,214,62,-899,-71,27.6,1650.5
4848121577,0,14,2,0,10,9,10,0,0,0,0,19100,7.0,18257,234,55,-500,-256,28.9,1910.0,24,1,1,9,10,10,0,0,0,0,19600,7.2,18513,208,65,500,256,27.3,1960.0
4848090500,1,13,16,0,7,6,6,1,1,0,0,17639,7.2,19365,193,80,-327,1251,27.3,1763.9,44,2,1,6,7,10,0,0,0,0,17966,7.0,18114,237,51,327,-1251,28.8,1796.6
4848055745,1,15,0,1,6,6,7,1,1,0,0,16268,6.8,17475,217,51,-159,-48,26.8,1626.8,13,1,0,6,6,4,1,0,1,0,16427,6.6,17523,235,47,159,48,28.2,1642.7
4848010687,1,15,2,0,5,3,6,0,0,0,0,18230,7.0,18197,266,48,3104,1103,31.4,1823.0,17,2,1,3,5,3,0,0,0,0,15126,6.8,17094,232,38,-3104,-1103,27.0,1512.6
4846012140,1,83,4,1,7,5,4,2,1,1,0,17968,7.2,18891,217,61,1931,2254,27.8,1796.8,15,1,0,5,7,5,0,0,0,0,16037,6.6,16637,223,56,-1931,-2254,27.9,1603.7
4845982662,0,12,0,0,5,10,5,0,0,0,0,16188,7.2,17973,224,64,-4171,390,28.8,1618.8,13,0,1,9,4,8,0,0,0,0,20359,6.8,17583,220,49,4171,-390,26.9,2035.9
4845949543,0,14,3,0,4,8,2,0,0,0,0,15435,6.8,17576,201,52,-2181,258,25.3,1543.5,17,1,1,8,4,7,1,1,0,0,17616,7.0,17318,204,60,2181,-258,26.4,1761.6
4845863634,1,15,1,1,2,2,0,0,0,0,0,16376,6.8,17655,235,44,1681,439,27.9,1637.6,20,1,0,2,2,1,1,1,0,0,14695,6.8,17216,205,47,-1681,-439,25.2,1469.5
4845844952,1,47,2,0,5,6,3,0,0,0,0,17674,7.0,18258,227,52,971,1813,27.9,1767.4,11,0,1,6,5,6,0,0,0,0,16703,6.6,16445,197,42,-971,-1813,23.9,1670.3
4833750922,0,13,1,1,4,7,6,0,0,0,0,17130,7.0,18162,227,56,241,-1198,28.3,1713.0,20,1,0,6,3,4,1,0,1,0,16889,7.2,19360,215,71,-241,1198,28.6,1688.9
4833717522,0,15,1,0,5,9,3,1,1,0,0,16159,6.6,16874,181,52,-2720,-1708,23.3,1615.9,14,2,1,9,5,6,0,0,0,0,18879,7.0,18582,243,55,2720,1708,29.8,1887.9
4833690485,0,34,2,1,3,4,2,1,0,1,0,15237,6.6,17511,209,51,-996,114,26.0,1523.7,35,2,0,4,3,4,0,0,0,0,16233,6.6,17397,216,55,996,-114,27.1,1623.3
4832735549,0,34,0,0,7,7,5,0,0,0,0,17748,7.0,19156,230,67,-484,1171,29.7,1774.8,9,8,1,7,7,7,0,0,0,0,18232,6.8,17985,240,50,484,-1171,29.0,1823.2
4832725286,0,10,2,1,4,13,4,0,0,0,0,16139,6.2,15324,172,52,-3753,-3222,22.4,1613.9,12,2,0,13,4,10,0,0,0,0,19892,7.0,18546,225,47,3753,3222,27.2,1989.2
4832701511,0,32,4,1,5,6,9,0,0,0,0,17029,6.6,16901,211,56,-298,-405,26.7,1702.9,41,3,0,6,5,4,0,0,0,0,17327,6.8,17306,194,64,298,405,25.8,1732.7
4832684100,0,36,1,1,4,8,3,0,0,0,0,16594,6.6,18252,235,60,-2206,192,29.5,1659.4,41,2,0,8,4,10,1,1,0,0,18800,6.8,18060,217,56,2206,-192,27.3,1880.0
4782445590,0,13,3,0,5,14,7,1,1,0,0,15474,6.4,15134,174,52,-4849,-1677,22.6,1547.4,35,3,1,14,5,12,0,0,0,0,20323,7.0,16811,203,53,4849,1677,25.6,2032.3
4858208208,0,22,0,1,3,9,3,0,0,0,0,16450,7.0,17619,205,64,-2644,-1513,26.9,1645.0,13,0,0,9,3,7,1,1,0,0,19094,7.2,19132,216,56,2644,1513,27.2,1909.4
4856988811,1,13,3,1,5,6,8,0,0,0,0,16994,6.8,17017,204,48,859,-805,25.2,1699.4,16,0,0,6,5,6,0,0,0,0,16135,6.8,17822,199,52,-859,805,25.1,1613.5
4856091914,0,16,2,1,6,9,8,1,1,0,0,16766,7.0,17372,225,56,-1896,-639,28.1,1676.6,23,1,0,9,6,14,0,0,0,0,18662,7.0,18011,237,45,1896,639,28.2,1866.2
4854938726,0,15,1,0,1,8,2,0,0,0,0,14018,6.4,15496,191,50,-4605,-2997,24.1,1401.8,9,0,1,8,1,10,0,0,0,0,18623,7.2,18493,233,62,4605,2997,29.5,1862.3
4854544279,1,19,0,1,21,21,62,0,0,0,0,36566,11.0,40097,103,0,1112,-636,10.3,3656.6,32,0,0,21,21,43,0,0,0,0,35454,11.2,40733,85,0,-1112,636,8.5,3545.4
4854507616,0,3,0,1,30,22,71,0,0,0,0,39456,11.4,41949,105,0,3632,697,10.5,3945.6,0,0,0,22,30,45,0,0,0,0,35824,11.0,41252,93,0,-3632,-697,9.3,3582.4
4854498559,0,72,0,0,25,37,77,0,0,0,2,39834,11.8,43910,113,0,-1272,-1990,11.3,3983.4,34,0,1,37,25,92,0,0,0,0,41106,12.0,45900,100,0,1272,1990,10.0,4110.6
4851476403,0,13,2,1,2,1,1,0,0,0,0,14323,6.8,18002,211,48,-819,-538,25.9,1432.3,15,1,0,1,2,0,0,0,0,0,15142,7.0,18540,257,60,819,538,31.7,1514.2
4851430632,1,17,2,1,5,5,7,0,0,0,0,16573,7.0,18360,253,60,769,-627,31.3,1657.3,14,3,0,5,5,4,0,0,0,0,15804,7.2,18987,193,60,-769,627,25.3,1580.4
4850771736,0,14,4,0,2,8,1,0,0,0,0,14352,6.6,16090,183,46,-6431,-4591,22.9,1435.2,24,3,1,8,2,8,1,1,0,0,20783,7.6,20681,249,68,6431,4591,31.7,2078.3
4850679387,1,14,1,1,2,0,1,1,1,0,0,16017,7.2,19160,259,64,2036,937,32.3,1601.7,15,0,0,0,2,0,0,0,0,0,13981,6.8,18223,239,52,-2036,-937,29.1,1398.1
4850568597,1,15,1,1,9,0,8,0,0,0,0,17147,6.8,17855,242,36,4090,2259,27.8,1714.7,10,3,0,0,9,0,0,0,0,0,13057,6.2,15596,177,48,-4090,-2259,22.5,1305.7
4850549942,0,13,1,0,0,5,0,0,0,0,0,12601,6.8,16868,166,48,-4393,-2458,21.4,1260.1,15,2,1,5,0,3,1,1,0,0,16994,7.2,19326,266,56,4393,2458,32.2,1699.4
4848437505,1,15,2,1,10,4,11,1,0,1,0,19009,7.2,18803,227,60,3643,1572,28.7,1900.9,12,1,0,3,9,2,1,1,0,0,15366,6.8,17231,224,52,-3643,-1572,27.6,1536.6
4847503428,0,15,2,1,9,5,6,0,0,0,0,17389,6.8,16645,186,51,891,-1284,23.7,1738.9,14,3,0,5,9,5,0,0,0,0,16498,6.8,17929,224,64,-891,1284,28.8,1649.8
4847396156,0,13,0,0,18,26,51,0,0,0,1,34710,10.8,37608,89,0,-2809,-4838,8.9,3471.0,0,2,1,26,18,62,0,0,0,0,37519,11.6,42446,123,0,2809,4838,12.3,3751.9
4847383014,1,0,0,0,43,34,109,0,0,0,1,44608,12.4,49775,126,0,3547,3977,12.6,4460.8,0,0,1,34,43,78,0,0,0,0,41061,12.0,45798,101,0,-3547,-3977,10.1,4106.1
4847374842,1,11,0,1,21,10,58,0,0,0,0,36583,11.0,39957,115,0,2953,5912,11.5,3658.3,14,2,0,10,21,23,0,0,0,0,33630,10.2,34045,118,0,-2953,-5912,11.8,3363.0
4846610628,1,32,3,0,2,7,1,1,1,0,0,14772,6.8,17707,215,64,-1734,-1054,27.9,1477.2,35,0,1,7,2,7,1,0,1,0,16506,7.0,18761,206,57,1734,1054,26.3,1650.6
4840717666,1,14,17,0,6,2,6,0,0,0,0,18086,7.4,19667,221,88,3028,1871,30.9,1808.6,32,0,1,2,6,1,1,0,1,0,15058,6.6,17796,222,49,-3028,-1871,27.1,1505.8
4830114204,1,18,0,0,5,7,3,1,0,1,0,17329,6.8,17845,195,56,-706,904,25.1,1732.9,13,0,1,7,5,5,1,1,0,0,18035,6.4,16941,200,44,706,-904,24.4,1803.5
4829768512,1,8,2,1,10,4,9,1,1,0,0,18886,6.8,17982,234,48,1951,-40,28.2,1888.6,14,0,0,4,10,4,0,0,0,0,16935,7.2,18022,214,64,-1951,40,27.8,1693.5
4829726329,0,13,0,1,5,8,3,0,0,0,0,17581,6.8,18044,251,62,666,1090,31.3,1758.1,14,1,0,8,5,6,0,0,0,0,16915,6.6,16954,207,48,-666,-1090,25.5,1691.5
4829699116,1,12,0,1,13,4,13,1,1,0,0,20148,7.0,18600,235,60,3723,2778,29.5,2014.8,18,1,0,4,13,4,0,0,0,0,16425,6.4,15822,201,56,-3723,-2778,25.7,1642.5
4829641794,0,13,6,1,7,7,7,0,0,0,0,17292,7.0,18204,235,44,25,384,27.9,1729.2,17,1,0,7,7,7,0,0,0,0,17267,7.0,17820,231,59,-25,-384,29.0,1726.7
4829602225,1,69,1,1,10,3,12,1,1,0,0,17287,6.4,16323,174,46,3100,453,22.0,1728.7,12,0,0,3,10,5,0,0,0,0,14187,6.4,15870,202,47,-3100,-453,24.9,1418.7
4829577886,1,11,1,0,10,6,9,0,0,0,0,17737,6.8,17004,177,64,1877,261,24.1,1773.7,12,1,1,6,10,4,0,0,0,0,15860,6.8,16743,194,48,-1877,-261,24.2,1586.0
4829490945,1,53,3,1,10,3,14,0,0,0,0,18235,7.0,18245,200,52,2285,477,25.2,1823.5,11,1,0,3,10,3,1,0,1,0,15950,6.6,17768,225,57,-2285,-477,28.2,1595.0
4829444559,1,14,1,1,4,3,4,1,1,0,0,17047,6.8,17379,199,60,1436,262,25.9,1704.7,12,0,0,3,4,3,0,0,0,0,15611,6.8,17117,213,52,-1436,-262,26.5,1561.1
4829417495,0,58,1,0,6,4,8,0,0,0,0,16335,6.8,17442,183,52,-1679,-261,23.5,1633.5,12,3,1,4,6,7,0,0,0,0,18014,6.8,17703,243,64,1679,261,30.7,1801.4
4829391622,1,37,1,1,11,5,14,1,1,0,0,20509,7.2,18898,263,52,4118,1986,31.5,2050.9,31,1,0,5,11,5,0,0,0,0,16391,6.4,16912,202,55,-4118,-1986,25.7,1639.1
4805095954,0,11,0,0,2,3,1,0,0,0,0,15538,6.8,17712,223,64,317,-475,28.7,1553.8,12,2,1,3,2,3,1,1,0,0,15221,7.0,18187,248,56,-317,475,30.4,1522.1
4805067374,1,11,3,0,9,3,10,2,1,1,0,19459,7.0,18727,222,59,4310,1229,28.1,1945.9,14,1,1,3,9,1,0,0,0,0,15149,6.8,17498,230,52,-4310,-1229,28.2,1514.9
4805046599,0,19,4,0,6,5,3,0,0,0,0,16107,6.6,16543,184,48,-1733,-1270,23.2,1610.7,12,1,1,5,6,5,1,1,0,0,17840,7.0,17813,202,84,1733,1270,28.6,1784.0
4805027399,1,23,0,1,5,2,2,1,1,0,0,16429,7.0,18255,221,64,1321,1131,28.5,1642.9,9,2,0,2,5,2,0,0,0,0,15108,6.6,17124,191,67,-1321,-1131,25.8,1510.8
4804294318,1,15,4,1,9,5,13,1,0,1,0,19640,7.2,19665,233,61,3804,3072,29.4,1964.0,13,0,0,5,9,7,0,0,0,0,15836,6.8,16593,159,55,-3804,-3072,21.4,1583.6
4804221609,0,12,4,1,8,6,6,0,0,0,0,16546,6.8,17305,218,48,-797,-267,26.6,1654.6,15,0,0,6,8,3,0,0,0,0,17343,6.8,17572,198,48,797,267,24.6,1734.3
4804194981,1,14,1,1,6,5,14,0,0,0,0,16614,7.0,17621,238,48,-1127,-1170,28.6,1661.4,12,1,0,5,6,5,0,0,0,0,17741,6.8,18791,267,50,1127,1170,31.7,1774.1
4804156307,1,23,2,1,5,3,11,0,0,0,0,16896,7.0,17172,255,51,918,-801,30.6,1689.6,15,3,0,3,5,2,2,1,1,0,15978,7.0,17973,224,68,-918,801,29.2,1597.8
4804129386,1,15,1,1,4,1,2,1,1,0,0,16523,6.8,17756,241,52,1732,78,29.3,1652.3,13,3,0,1,4,3,0,0,0,0,14791,6.8,17678,221,47,-1732,-78,26.8,1479.1
4858301152,1,13,0,1,14,6,14,0,0,0,0,21971,6.8,18086,225,48,5691,1792,27.3,2197.1,12,0,0,6,14,3,0,0,0,0,16280,6.4,16294,173,60,-5691,-1792,23.3,1628.0
4858216980,1,11,1,0,10,3,17,1,1,0,0,18890,7.2,19859,243,72,3918,3359,31.5,1889.0,13,2,1,3,10,3,0,0,0,0,14972,6.4,16500,222,56,-3918,-3359,27.8,1497.2
4858156345,0,8,0,0,5,16,5,0,0,0,0,16248,6.4,16405,211,51,-4195,-2543,26.2,1624.8,39,1,1,16,5,21,1,1,0,0,20443,7.2,18948,195,68,4195,2543,26.3,2044.3
4858109500,0,17,2,0,6,6,3,1,1,0,0,16358,7.0,17768,219,52,913,764,27.1,1635.8,9,0,1,6,6,6,1,0,1,0,15445,6.6,17004,183,47,-913,-764,23.0,1544.5
4858075424,1,10,0,1,7,5,15,1,1,0,0,17579,7.2,19025,238,67,1169,694,30.5,1757.9,85,0,0,5,7,6,0,0,0,0,16410,7.2,18331,244,52,-1169,-694,29.6,1641.0
4858043591,1,126,5,0,2,4,2,0,0,0,0,15483,7.0,18786,249,60,-726,802,30.9,1548.3,15,3,1,4,2,5,2,1,1,0,16209,6.8,17984,245,52,726,-802,29.7,1620.9
4858007669,1,164,3,1,7,2,7,1,1,0,0,17627,7.0,18654,223,60,2723,1803,28.3,1762.7,13,0,0,2,7,1,0,0,0,0,14904,6.6,16851,216,54,-2723,-1803,27.0,1490.4
4857990212,1,79,0,1,10,1,13,0,0,0,0,18180,6.8,17535,219,54,3382,1246,27.3,1818.0,11,0,0,1,10,3,1,1,0,0,14798,6.4,16289,158,61,-3382,-1246,21.9,1479.8
4857969761,0,18,1,0,4,9,7,0,0,0,0,16164,6.6,16622,191,56,-3252,-2262,24.7,1616.4,127,1,1,9,4,10,1,1,0,0,19416,7.2,18884,218,64,3252,2262,28.2,1941.6
4857932963,0,112,1,1,6,6,4,0,0,0,0,16317,7.0,17993,224,51,-292,-1023,27.5,1631.7,11,1,0,6,6,6,1,1,0,0,16609,7.0,19016,233,72,292,1023,30.5,1660.9
4857524574,1,0,0,0,11,20,13,0,0,0,0,49751,12.0,55000,0,0,17651,22000,0.0,4975.1,0,0,1,14,5,14,0,0,0,0,32100,7.2,33000,0,0,-17651,-22000,0.0,3210.0
4857502444,1,0,0,0,15,19,17,0,0,0,0,47145,10.0,47500,1,0,18130,17820,0.1,4714.5,0,0,1,14,10,9,0,0,0,0,29015,6.2,29680,1,0,-18130,-17820,0.1,2901.5
4857488862,1,20,0,1,16,22,9,0,0,0,0,60600,13.0,62500,0,0,21300,21000,0.0,6060.0,0,0,0,12,6,14,0,0,0,0,39300,8.6,41500,0,0,-21300,-21000,0.0,3930.0
4857464949,1,0,0,0,16,15,17,0,0,0,0,46300,10.0,47500,0,0,18800,17500,0.0,4630.0,0,0,1,9,10,5,0,0,0,0,27500,6.4,30000,0,0,-18800,-17500,0.0,2750.0
4857391217,1,8,1,1,9,5,11,0,0,0,0,17759,6.6,17830,238,56,2013,1446,29.4,1775.9,15,0,0,5,9,9,0,0,0,0,15746,6.6,16384,209,54,-2013,-1446,26.3,1574.6
4857346380,1,14,2,1,6,10,6,1,1,0,0,16901,6.6,16494,208,54,-1506,-2354,26.2,1690.1,12,2,0,10,6,5,0,0,0,0,18407,7.2,18848,218,62,1506,2354,28.0,1840.7
4857315368,0,30,0,1,6,8,3,0,0,0,0,16795,6.8,17583,228,55,-504,-392,28.3,1679.5,15,2,0,8,6,6,1,1,0,0,17299,7.0,17975,205,59,504,392,26.4,1729.9
4857274127,0,15,1,0,6,7,8,1,0,1,0,16254,6.8,17959,225,52,-2098,-841,27.7,1625.4,15,2,1,6,5,5,0,0,0,0,18352,7.2,18800,233,47,2098,841,28.0,1835.2
4857221374,0,14,3,1,9,2,14,2,1,1,0,17519,6.8,17535,186,44,2235,475,23.0,1751.9,15,1,0,2,9,3,0,0,0,0,15284,6.6,17060,210,60,-2235,-475,27.0,1528.4
4857056539,1,176,0,1,7,3,11,1,1,0,0,18132,7.0,18232,203,56,1770,-130,25.9,1813.2,9,0,0,3,7,1,0,0,0,0,16362,7.0,18362,221,64,-1770,130,28.5,1636.2
4834835833,1,9,5,0,3,5,2,1,1,0,0,14502,6.2,15791,194,48,-2918,-3506,24.2,1450.2,14,1,1,5,3,3,1,0,1,0,17420,7.2,19297,211,56,2918,3506,26.7,1742.0
4834804434,0,14,2,0,9,6,9,0,0,0,0,19205,7.0,19098,219,56,1805,1274,27.5,1920.5,13,1,1,6,9,4,0,0,0,0,17400,7.0,17824,213,51,-1805,-1274,26.4,1740.0
4834778821,1,16,4,0,5,3,5,0,0,0,0,16194,6.6,17452,230,52,748,-265,28.2,1619.4,13,1,1,3,5,2,0,0,0,0,15446,6.8,17717,227,52,-748,265,27.9,1544.6
4834760191,1,76,0,1,16,8,19,0,0,0,0,20068,6.8,18104,217,56,2249,471,27.3,2006.8,14,0,0,8,16,6,1,0,1,0,17819,7.0,17633,187,74,-2249,-471,26.1,1781.9
4834722615,0,15,0,1,5,7,5,1,0,1,0,17366,6.8,18365,230,52,-170,237,28.2,1736.6,9,0,0,7,5,8,1,1,0,0,17536,7.0,18128,200,63,170,-237,26.3,1753.6
4834694545,0,12,1,0,5,4,7,1,1,0,0,16064,7.2,18088,222,56,690,-569,27.8,1606.4,14,1,1,4,5,1,1,0,1,0,15374,7.0,18657,202,70,-690,569,27.2,1537.4
4834669479,1,17,1,0,7,4,4,1,0,1,0,18126,7.0,18898,245,52,1308,1134,29.7,1812.6,21,4,1,4,7,4,0,0,0,0,16818,7.0,17764,221,52,-1308,-1134,27.3,1681.8
4834653630,0,10,2,0,2,9,2,0,0,0,0,14647,7.0,17769,206,68,-4138,-716,27.4,1464.7,18,1,1,9,2,13,1,0,1,0,18785,7.0,18485,232,60,4138,716,29.2,1878.5
4834241404,0,15,7,1,4,7,4,1,1,0,0,15385,6.8,17312,216,44,-1645,-1557,26.0,1538.5,18,4,0,6,3,7,0,0,0,0,17030,7.2,18869,214,71,1645,1557,28.5,1703.0
4834179401,0,12,1,0,7,12,10,0,0,0,0,16849,6.6,17056,219,51,-2641,-806,27.0,1684.9,16,4,1,12,7,16,0,0,0,0,19490,6.8,17862,227,62,2641,806,28.9,1949.0
4834140791,0,14,2,1,8,4,10,1,1,0,0,16989,6.8,17246,199,54,1167,-752,25.3,1698.9,15,1,0,4,8,4,1,0,1,0,15822,7.0,17998,212,67,-1167,752,27.9,1582.2
4834092870,0,54,2,1,7,11,9,0,0,0,0,17387,7.0,17094,193,50,-2682,-1700,24.3,1738.7,14,1,0,11,7,11,0,0,0,0,20069,7.0,18794,220,56,2682,1700,27.6,2006.9
4834048987,1,16,2,0,4,5,5,1,1,0,0,16161,7.2,18164,217,60,-1194,-94,27.7,1616.1,12,0,1,5,4,4,1,0,1,0,17355,7.0,18258,201,56,1194,94,25.7,1735.5
4834021356,0,29,1,0,2,6,2,0,0,0,0,15177,7.0,17845,221,68,-1571,-1215,28.9,1517.7,12,1,1,6,2,6,1,1,0,0,16748,7.2,19060,209,60,1571,1215,26.9,1674.8
4833974188,1,14,3,1,6,6,9,0,0,0,0,16518,6.4,16709,218,44,-1263,-2497,26.2,1651.8,12,4,0,6,6,6,0,0,0,0,17781,7.0,19206,224,68,1263,2497,29.2,1778.1
4832835592,1,13,2,1,7,5,3,1,1,0,0,18072,7.4,19706,251,63,1909,799,31.4,1807.2,23,1,0,5,7,3,0,0,0,0,16163,7.2,18907,210,69,-1909,-799,27.9,1616.3
4832822017,0,34,4,0,7,9,3,0,0,0,0,16639,6.8,17604,212,48,-1994,-997,26.0,1663.9,38,4,1,9,7,9,2,1,1,0,18633,7.2,18601,220,44,1994,997,26.4,1863.3
4832806074,1,16,0,1,8,1,6,1,1,0,0,18354,7.0,18849,209,64,3648,1786,27.3,1835.4,11,0,0,1,8,2,0,0,0,0,14706,6.6,17063,188,68,-3648,-1786,25.6,1470.6
4832774364,1,12,2,1,7,4,5,0,0,0,0,17350,6.8,17165,236,48,981,-1267,28.4,1735.0,15,1,0,4,7,3,1,1,0,0,16369,7.2,18432,260,64,-981,1267,32.4,1636.9
4832732987,1,13,0,0,6,9,9,1,1,0,0,17847,6.6,16862,212,59,323,-1245,27.1,1784.7,20,0,1,9,6,7,0,0,0,0,17524,6.8,18107,202,46,-323,1245,24.8,1752.4
4858301472,1,0,0,1,29,19,82,0,0,0,0,38905,11.4,41885,111,0,3323,2639,11.1,3890.5,0,0,0,19,29,58,0,0,0,0,35582,11.0,39246,88,0,-3323,-2639,8.8,3558.2
4858287784,1,0,0,1,17,19,13,0,0,0,0,62050,12.0,55000,1,0,23315,22000,0.1,6205.0,0,0,0,10,8,9,0,0,0,0,38735,7.2,33000,0,0,-23315,-22000,0.0,3873.5
4858265896,1,64,0,1,18,16,16,0,0,0,0,45950,10.0,47500,0,0,17400,19000,0.0,4595.0,0,0,0,10,12,11,0,0,0,0,28550,6.0,28500,0,0,-17400,-19000,0.0,2855.0
4858231655,1,0,0,1,19,27,21,0,0,0,0,64167,12.0,55000,1,0,25448,22000,0.1,6416.7,7,0,0,15,7,13,0,0,0,0,38719,7.2,33000,2,0,-25448,-22000,0.2,3871.9
4857391315,1,0,0,1,19,15,18,0,0,0,0,62440,12.0,55000,0,0,25581,22000,0.0,6244.0,0,0,0,8,12,10,0,0,0,0,36859,7.2,33000,0,0,-25581,-22000,0.0,3685.9
4857374123,1,0,0,1,23,13,24,0,0,0,0,62705,12.0,55000,0,0,26880,22000,0.0,6270.5,0,0,0,6,16,6,0,0,0,0,35825,7.2,33000,0,0,-26880,-22000,0.0,3582.5
4857350011,1,0,0,1,19,15,13,0,0,0,0,62018,12.0,55000,0,0,25518,21000,0.0,6201.8,20,0,0,6,10,9,0,0,0,0,36500,7.4,34000,0,0,-25518,-21000,0.0,3650.0
4857312402,0,7,2,1,14,11,42,0,0,0,0,32771,10.6,35534,86,0,-2759,-1633,8.6,3277.1,20,0,0,11,14,32,0,0,0,0,35530,10.6,37167,113,0,2759,1633,11.3,3553.0
4857286997,1,0,1,1,20,20,20,0,0,0,0,63060,12.0,55000,1,0,22710,22000,0.1,6306.0,27,0,0,10,10,8,0,0,0,0,40350,7.2,33000,0,0,-22710,-22000,0.0,4035.0
4856291393,1,21,2,1,8,1,8,0,0,0,0,17452,7.2,18961,214,64,2638,1513,27.8,1745.2,15,4,0,1,8,1,1,1,0,0,14814,6.8,17448,203,52,-2638,-1513,25.5,1481.4
4856251022,1,76,0,0,17,26,21,0,0,0,1,36659,11.0,40182,120,0,69,-13,12.0,3665.9,0,0,1,26,17,57,0,0,0,0,36590,11.2,40195,103,0,-69,13,10.3,3659.0
4856206722,1,0,0,1,24,20,55,0,0,0,1,37576,11.2,41093,109,0,3138,3554,10.9,3757.6,0,0,0,20,24,44,0,0,0,0,34438,10.4,37539,116,0,-3138,-3554,11.6,3443.8
4856173148,1,0,0,0,29,20,77,0,0,0,2,41455,11.8,43916,118,0,4356,3387,11.8,4145.5,0,0,1,20,29,40,0,0,0,0,37099,11.0,40529,91,0,-4356,-3387,9.1,3709.9
4856133986,1,20,0,0,19,16,17,0,0,0,0,63050,12.0,55000,0,0,26900,22000,0.0,6305.0,0,0,1,10,13,8,0,0,0,0,36150,7.2,33000,0,0,-26900,-22000,0.0,3615.0
4855353081,1,10,1,1,6,6,8,0,0,0,0,18312,7.2,19278,249,51,2594,1207,30.0,1831.2,11,0,0,6,6,7,0,0,0,0,15718,7.0,18071,201,60,-2594,-1207,26.1,1571.8
4855320688,1,4,0,0,17,22,21,0,0,0,0,63400,13.0,62500,0,0,25500,25000,0.0,6340.0,0,0,1,13,8,12,0,0,0,0,37900,7.8,37500,0,0,-25500,-25000,0.0,3790.0
4855306127,0,20,4,1,26,33,56,0,0,0,1,37351,11.0,40235,111,0,-3368,-5061,11.1,3735.1,27,2,0,33,26,87,0,0,0,0,40719,11.8,45296,107,0,3368,5061,10.7,4071.9
4855215297,1,18,0,1,18,25,15,0,0,0,0,48050,10.0,47500,0,0,18765,19000,0.0,4805.0,0,1,0,14,7,11,0,0,0,0,29285,6.0,28500,2,0,-18765,-19000,0.2,2928.5
4855195015,1,0,0,1,20,23,21,0,0,0,0,63450,12.0,55000,2,0,24825,22000,0.2,6345.0,0,0,0,13,10,9,0,0,0,0,38625,7.2,33000,1,0,-24825,-22000,0.1,3862.5
4854813840,1,0,0,1,21,14,21,0,0,0,0,49950,10.4,49000,0,0,22800,20500,0.0,4995.0,0,0,0,8,15,6,0,0,0,0,27150,6.0,28500,0,0,-22800,-20500,0.0,2715.0
4858259131,0,29,2,0,10,8,9,0,0,0,0,17378,7.2,18064,210,56,-885,66,26.6,1737.8,18,3,1,8,10,7,1,1,0,0,18263,7.0,17998,213,62,885,-66,27.5,1826.3
4858216772,1,12,1,1,6,5,4,0,0,0,0,16912,7.0,18163,228,56,-147,-512,28.4,1691.2,14,2,0,5,6,6,1,1,0,0,17059,7.0,18675,211,72,147,512,28.3,1705.9
4858167162,1,13,3,0,4,5,4,0,0,0,0,17183,6.8,18253,231,56,494,319,28.7,1718.3,17,2,1,5,4,6,1,1,0,0,16689,6.6,17934,238,60,-494,-319,29.8,1668.9
4858134843,0,11,1,1,9,9,10,0,0,0,0,17337,6.8,16833,232,48,-1200,-2045,28.0,1733.7,11,0,0,9,9,5,1,1,0,0,18537,7.4,18878,213,60,1200,2045,27.3,1853.7
4857494341,1,89,3,1,11,8,8,0,0,0,0,19093,7.2,18626,197,60,1413,1933,25.7,1909.3,10,3,0,8,11,11,0,0,0,0,17680,6.6,16693,161,47,-1413,-1933,20.8,1768.0
4857457265,1,12,2,1,10,4,11,1,1,0,0,18185,7.0,17202,232,45,2046,453,27.7,1818.5,15,0,0,4,10,5,0,0,0,0,16139,6.6,16749,216,61,-2046,-453,27.7,1613.9
4857391217,1,8,1,1,9,5,11,0,0,0,0,17759,6.6,17830,238,56,2013,1446,29.4,1775.9,15,0,0,5,9,9,0,0,0,0,15746,6.6,16384,209,54,-2013,-1446,26.3,1574.6
4857350493,0,15,2,1,3,6,1,0,0,0,0,15337,7.0,17901,234,48,-963,-914,28.2,1533.7,13,1,0,6,3,3,0,0,0,0,16300,7.0,18815,214,68,963,914,28.2,1630.0
4857280337,0,12,0,0,8,6,3,0,0,0,0,17377,7.0,19255,189,72,133,1389,26.1,1737.7,15,0,1,4,6,2,1,1,0,0,17244,7.0,17866,196,54,-133,-1389,25.0,1724.4
4857226722,1,13,0,0,12,8,6,0,0,0,0,18521,7.0,18624,169,60,865,924,22.9,1852.1,11,0,1,6,10,3,0,0,0,0,17656,7.0,17700,211,52,-865,-924,26.3,1765.6
4857194005,0,195,1,1,4,3,5,1,1,0,0,15872,6.8,17991,207,56,314,-237,26.3,1587.2,13,1,0,3,4,4,0,0,0,0,15558,7.0,18228,213,67,-314,237,28.0,1555.8
4857147147,1,62,1,0,5,6,8,1,1,0,0,17196,7.0,17992,232,46,354,344,27.8,1719.6,9,1,1,6,5,8,1,0,1,0,16842,6.8,17648,213,60,-354,-344,27.3,1684.2
4856320201,1,10,2,0,6,7,5,0,0,0,0,17918,7.0,18525,250,64,1275,2352,31.4,1791.8,18,0,1,6,5,10,0,0,0,0,16643,6.6,16173,192,50,-1275,-2352,24.2,1664.3
4855353024,1,13,1,1,7,7,5,0,0,0,0,18003,7.2,18610,230,46,510,-354,27.6,1800.3,17,3,0,7,7,8,1,1,0,0,17493,7.0,18964,217,71,-510,354,28.8,1749.3
4855303647,0,11,1,0,6,14,8,0,0,0,0,16518,6.6,16497,190,62,-3464,-1489,25.2,1651.8,12,0,1,14,6,19,2,1,1,0,19982,6.8,17986,202,68,3464,1489,27.0,1998.2
4855142922,1,14,1,1,7,1,5,0,0,0,0,17052,7.4,19176,232,54,3459,1725,28.6,1705.2,15,1,0,1,7,0,0,0,0,0,13593,7.0,17451,208,48,-3459,-1725,25.6,1359.3
4855088214,0,20,0,1,4,4,3,0,0,0,0,15484,6.6,17039,221,49,680,-114,27.0,1548.4,42,1,0,4,4,3,1,1,0,0,14804,7.0,17153,218,48,-680,114,26.6,1480.4
4852815447,0,84,1,1,4,3,3,0,0,0,0,14425,6.2,15212,189,36,-2197,-3305,22.5,1442.5,11,1,0,3,4,1,2,1,1,0,16622,7.0,18517,206,60,2197,3305,26.6,1662.2
4852769181,0,9,2,0,5,4,5,0,0,0,0,15375,6.8,18130,192,60,-699,1595,25.2,1537.5,11,2,1,4,5,5,0,0,0,0,16074,6.4,16535,201,56,699,-1595,25.7,1607.4
4857326966,0,14,0,0,5,7,2,0,0,0,0,15674,7.0,17745,228,48,-2407,-719,27.6,1567.4,15,2,1,7,5,7,1,1,0,0,18081,6.8,18464,220,59,2407,719,27.9,1808.1
4857284967,1,12,1,0,7,7,4,1,1,0,0,17524,7.0,18859,225,72,905,1582,29.7,1752.4,12,3,1,6,6,6,0,0,0,0,16619,6.8,17277,215,40,-905,-1582,25.5,1661.9
4855299308,0,14,0,1,8,5,6,0,0,0,0,17466,7.0,18814,238,60,990,546,29.8,1746.6,10,1,0,5,8,4,0,0,0,0,16476,6.8,18268,220,65,-990,-546,28.5,1647.6
4855218308,0,12,0,1,6,4,5,0,0,0,0,17854,7.0,19177,227,69,331,564,29.6,1785.4,14,2,0,4,6,2,1,1,0,0,17523,7.0,18613,241,58,-331,-564,29.9,1752.3
4855164513,0,11,2,0,4,11,2,1,1,0,0,16836,7.0,17629,213,61,-2652,-1273,27.4,1683.6,13,1,1,11,4,12,1,0,1,0,19488,7.0,18902,232,55,2652,1273,28.7,1948.8
4855122969,0,18,2,1,6,5,13,0,0,0,0,18078,6.8,18009,240,58,2742,2072,29.8,1807.8,16,2,0,5,6,10,1,1,0,0,15336,6.2,15937,193,58,-2742,-2072,25.1,1533.6
4855071972,1,25,3,1,6,1,7,0,0,0,0,17573,7.0,17718,220,60,2282,-620,28.0,1757.3,8,4,0,1,6,2,0,0,0,0,15291,7.0,18338,221,56,-2282,620,27.7,1529.1
4854771912,1,0,6,0,27,37,66,0,0,0,1,39408,11.6,43956,111,0,-2673,-3004,11.1,3940.8,20,0,1,37,27,106,0,0,0,0,42081,12.2,46960,95,0,2673,3004,9.5,4208.1
4854736629,0,2,0,1,26,30,53,0,0,0,0,38853,11.4,42469,121,0,99,-1451,12.1,3885.3,19,0,0,30,26,62,0,0,0,0,38754,11.8,43920,104,0,-99,1451,10.4,3875.4
4854720738,0,0,0,1,28,26,68,0,0,0,0,39804,12.0,45284,100,0,1334,2101,10.0,3980.4,0,0,0,26,28,58,0,0,0,0,38470,11.6,43183,116,0,-1334,-2101,11.6,3847.0
4854182295,1,0,3,0,29,26,76,0,0,0,0,38163,11.4,42234,121,0,-271,-221,12.1,3816.3,5,0,1,25,28,59,0,0,0,0,38434,11.6,42455,116,0,271,221,11.6,3843.4
4854150286,1,0,20,1,27,20,72,0,0,0,0,40232,11.8,45446,118,0,4959,5973,11.8,4023.2,22,0,0,20,27,47,0,0,0,0,35273,11.0,39473,94,0,-4959,-5973,9.4,3527.3
4854128245,1,0,0,0,31,25,81,0,0,0,0,40625,12.0,46395,113,0,4187,7586,11.3,4062.5,9,0,1,25,31,67,0,0,0,0,36438,10.8,38809,87,0,-4187,-7586,8.7,3643.8
4854098519,0,0,0,1,26,38,68,0,0,0,1,37692,11.4,41456,100,0,-5925,-6576,10.0,3769.2,10,0,0,38,26,101,0,0,0,0,43617,12.2,48032,123,0,5925,6576,12.3,4361.7
4852689766,0,13,0,1,2,5,2,0,0,0,0,16073,7.0,19102,230,68,-268,715,29.8,1607.3,9,0,0,5,2,7,0,0,0,0,16341,6.8,18387,211,46,268,-715,25.7,1634.1
4852652610,0,12,2,0,6,9,2,0,0,0,0,17229,7.0,18318,230,49,-396,1349,27.9,1722.9,14,1,1,9,6,9,0,0,0,0,17625,6.8,16969,224,38,396,-1349,26.2,1762.5
4852006555,1,0,0,1,24,22,66,0,0,0,1,40590,11.6,43452,119,0,3158,3827,11.9,4059.0,0,0,0,22,24,46,0,0,0,0,37432,11.0,39625,111,0,-3158,-3827,11.1,3743.2
4851986340,1,66,0,0,22,22,51,0,0,0,1,36383,11.0,40445,109,0,-1855,401,10.9,3638.3,43,4,1,22,22,58,0,0,0,0,38238,11.0,40044,115,0,1855,-401,11.5,3823.8
4851960073,1,4,0,1,29,24,74,0,0,0,1,39096,11.0,41025,114,0,243,-2133,11.4,3909.6,12,0,0,24,29,61,0,0,0,0,38853,11.2,43158,112,0,-243,2133,11.2,3885.3
4851929592,0,34,0,1,25,19,80,0,0,0,0,38107,11.2,42121,118,0,1001,2185,11.8,3810.7,34,0,0,19,25,50,0,0,0,0,37106,11.0,39936,114,0,-1001,-2185,11.4,3710.6
4847063058,1,14,0,0,5,3,7,1,0,1,0,17315,6.8,18000,230,76,2288,839,30.6,1731.5,9,1,1,3,5,1,0,0,0,0,15027,6.6,17161,223,52,-2288,-839,27.5,1502.7
4844479815,0,11,0,0,1,5,2,0,0,0,0,14498,7.0,18092,206,64,-2187,-749,27.0,1449.8,14,0,1,5,1,5,0,0,0,0,16685,7.2,18841,236,60,2187,749,29.6,1668.5
4826546528,1,54,1,0,4,5,4,0,0,0,0,16076,7.0,18435,224,60,-255,-354,28.4,1607.6,14,2,1,5,4,4,1,1,0,0,16331,7.2,18789,223,60,255,354,28.3,1633.1
4826510603,1,8,2,1,8,7,11,0,0,0,0,18837,7.4,19378,231,64,2605,3632,29.5,1883.7,12,0,0,7,8,3,0,0,0,0,16232,6.4,15746,142,68,-2605,-3632,21.0,1623.2
4826486766,0,12,5,1,2,7,2,0,0,0,0,14802,6.8,16941,222,48,-5049,-4386,27.0,1480.2,17,3,0,7,2,4,2,1,1,0,19851,7.6,21327,251,68,5049,4386,31.9,1985.1
4826465736,1,25,2,0,7,3,8,0,0,0,0,17690,7.0,18433,218,57,2111,2441,27.5,1769.0,15,4,1,3,7,3,0,0,0,0,15579,6.4,15992,196,40,-2111,-2441,23.6,1557.9
4826234188,1,14,8,1,7,9,5,0,0,0,0,15745,6.6,16268,165,44,-2187,-3298,20.9,1574.5,42,1,0,9,7,6,1,1,0,0,17932,7.2,19566,212,63,2187,3298,27.5,1793.2
4826205717,1,13,1,1,4,4,0,0,0,0,0,14348,7.0,17462,167,46,-1415,26,21.3,1434.8,12,1,0,4,4,3,0,0,0,0,15763,6.8,17436,193,52,1415,-26,24.5,1576.3
4825839704,1,14,3,1,9,3,9,1,0,1,0,19805,7.0,18304,231,56,3464,1421,28.7,1980.5,11,2,0,3,9,5,0,0,0,0,16341,7.0,16883,206,42,-3464,-1421,24.8,1634.1
4825810133,0,30,0,0,4,6,4,0,0,0,0,15400,6.6,16687,189,60,-1161,-1685,24.9,1540.0,34,0,1,6,4,6,0,0,0,0,16561,6.8,18372,197,52,1161,1685,24.9,1656.1
4825731667,0,51,0,0,1,6,1,0,0,0,0,14332,6.8,17193,222,56,-2854,-1204,27.8,1433.2,15,1,1,6,1,6,1,1,0,0,17186,7.2,18397,253,66,2854,1204,31.9,1718.6
4825697014,0,13,2,1,3,9,2,0,0,0,0,15248,6.6,17074,234,56,-2916,-1812,29.0,1524.8,11,2,0,9,3,8,1,1,0,0,18164,7.0,18886,221,68,2916,1812,28.9,1816.4
4825652817,1,13,1,0,6,3,5,1,0,1,0,18444,7.4,19593,248,58,1999,1810,30.6,1844.4,12,1,1,3,6,5,1,1,0,0,16445,6.8,17783,244,48,-1999,-1810,29.2,1644.5
4825541100,1,34,2,1,4,4,0,0,0,0,0,15711,6.6,16835,221,51,-160,-498,27.2,1571.1,13,4,0,4,4,4,1,1,0,0,15871,6.8,17333,227,56,160,498,28.3,1587.1
4825504014,1,15,2,1,5,4,4,0,0,0,0,16328,7.0,17253,204,52,1608,616,25.6,1632.8,17,4,0,4,5,1,0,0,0,0,14720,6.6,16637,193,64,-1608,-616,25.7,1472.0
4825466070,1,14,0,1,10,5,10,0,0,0,0,18510,7.0,18968,238,56,2136,1518,29.4,1851.0,9,0,0,5,10,4,0,0,0,0,16374,6.6,17450,179,64,-2136,-1518,24.3,1637.4
4825424673,0,28,2,0,6,8,5,1,1,0,0,18005,7.0,18448,218,58,-1523,-862,27.6,1800.5,12,2,1,8,6,9,0,0,0,0,19528,7.4,19310,221,68,1523,862,28.9,1952.8
4825398456,0,21,0,1,6,6,9,1,1,0,0,16528,6.8,17088,208,52,-907,-665,26.0,1652.8,11,1,0,6,6,6,0,0,0,0,17435,6.8,17753,219,60,907,665,27.9,1743.5
4858068407,1,0,0,1,16,8,17,0,0,0,0,45608,10.6,50500,0,0,20208,22000,0.0,4560.8,0,0,0,3,11,3,0,0,0,0,25400,6.0,28500,0,0,-20208,-22000,0.0,2540.0
4856318152,0,78,0,1,17,13,44,0,0,0,1,35847,10.8,37383,111,0,2264,-435,11.1,3584.7,0,0,0,13,17,32,0,0,0,0,33583,10.6,37818,90,0,-2264,435,9.0,3358.3
4856276380,1,39,0,1,15,18,47,0,0,0,0,34417,10.6,36702,96,0,-932,-569,9.6,3441.7,17,0,0,18,15,48,0,0,0,0,35349,10.6,37271,102,0,932,569,10.2,3534.9
4855943385,1,10,1,1,3,5,0,1,0,1,0,15585,7.0,18236,222,68,-793,255,29.0,1558.5,13,2,0,5,3,6,0,0,0,0,16378,6.8,17981,204,44,793,-255,24.8,1637.8
4855910860,1,10,1,1,3,1,3,0,0,0,0,15981,7.0,19422,247,68,1228,1356,31.5,1598.1,11,1,0,1,3,0,0,0,0,0,14753,6.6,18066,234,60,-1228,-1356,29.4,1475.3
4855295754,0,310,0,0,38,38,113,0,0,0,2,41501,12.6,49429,99,0,-1987,-531,9.9,4150.1,0,17,1,38,38,101,0,0,0,0,43488,12.4,49960,110,0,1987,531,11.0,4348.8
4855257835,1,22,0,1,10,2,9,0,0,0,0,19328,7.4,19702,242,60,3773,3243,30.2,1932.8,70,2,0,2,10,3,0,0,0,0,15555,6.8,16459,185,44,-3773,-3243,22.9,1555.5
4855202302,1,75,0,1,7,9,8,0,0,0,0,16921,6.6,16441,210,32,56,-816,24.2,1692.1,22,1,0,9,7,6,0,0,0,0,16865,6.8,17257,188,57,-56,816,24.5,1686.5
4855174160,1,11,1,1,7,2,7,0,0,0,0,17512,7.4,19561,200,52,1897,866,25.2,1751.2,16,2,0,2,7,3,0,0,0,0,15615,7.0,18695,244,60,-1897,-866,30.4,1561.5
4855139193,1,0,2,0,24,33,65,0,0,0,0,35825,10.8,38532,116,0,-5334,-6395,11.6,3582.5,2,0,1,33,24,97,0,0,0,0,41159,11.8,44927,110,0,5334,6395,11.0,4115.9
4855106507,1,0,0,0,34,29,96,0,0,0,2,41688,11.8,44901,114,0,2433,964,11.4,4168.8,0,0,1,29,34,74,0,0,0,0,39255,11.6,43937,94,0,-2433,-964,9.4,3925.5
4855069833,1,14,0,1,34,22,94,0,0,0,2,43659,12.0,47617,112,0,7610,9066,11.2,4365.9,0,3,0,22,34,47,0,0,0,0,36049,10.8,38551,78,0,-7610,-9066,7.8,3604.9
4854690226,1,53,0,0,2,10,2,1,1,0,0,14372,7.0,17539,172,60,-5424,-2078,23.2,1437.2,11,2,1,10,2,8,0,0,0,0,19796,7.4,19617,273,56,5424,2078,32.9,1979.6
4854662468,0,16,1,0,5,11,1,0,0,0,0,14569,6.4,15824,157,52,-4391,-2367,20.9,1456.9,19,2,1,11,5,9,2,1,1,0,18960,7.0,18191,226,36,4391,2367,26.2,1896.0
4853590979,1,16,2,0,5,6,4,0,0,0,0,17340,7.4,19330,224,76,-759,801,30.0,1734.0,18,1,1,6,5,6,0,0,0,0,18099,7.0,18529,235,51,759,-801,28.6,1809.9
4853558616,1,24,0,1,12,5,10,0,0,0,0,19920,7.6,19658,212,60,3575,1735,27.2,1992.0,14,0,0,5,12,2,1,1,0,0,16345,6.8,17923,207,64,-3575,-1735,27.1,1634.5
4853507252,1,10,2,0,8,7,7,0,0,0,0,17956,7.2,18524,212,52,140,19,26.4,1795.6,14,0,1,7,8,4,1,1,0,0,17816,7.2,18505,205,60,-140,-19,26.5,1781.6
4853108892,0,2,4,1,25,31,71,0,0,0,1,38182,11.0,39462,107,0,-1332,-3993,10.7,3818.2,20,0,0,31,25,96,0,0,0,0,39514,11.4,43455,90,0,1332,3993,9.0,3951.4
4853081611,0,68,0,0,29,27,85,0,0,0,1,40124,11.8,44573,96,0,222,3435,9.6,4012.4,0,0,1,27,29,73,0,0,0,0,39902,11.2,41138,124,0,-222,-3435,12.4,3990.2
4853052698,1,10,0,1,8,6,8,1,1,0,0,17665,7.2,18781,230,72,1911,1371,30.2,1766.5,8,1,0,6,8,6,0,0,0,0,15754,6.8,17410,180,44,-1911,-1371,22.4,1575.4
4848199685,0,12,1,0,4,9,1,0,0,0,0,15722,6.6,17511,202,56,-1674,-183,25.8,1572.2,21,2,1,9,4,8,0,0,0,0,17396,6.8,17694,190,55,1674,183,24.5,1739.6
4848182678,1,81,0,1,6,1,6,1,1,0,0,18080,7.0,18594,231,59,4294,2965,29.0,1808.0,18,1,0,1,6,2,0,0,0,0,13786,6.4,15629,188,56,-4294,-2965,24.4,1378.6
4848160829,1,56,2,0,7,5,8,0,0,0,0,17404,6.8,17774,209,51,899,71,26.0,1740.4,10,1,1,5,7,5,1,0,1,0,16505,7.0,17703,214,62,-899,-71,27.6,1650.5
4848121577,0,14,2,0,10,9,10,0,0,0,0,19100,7.0,18257,234,55,-500,-256,28.9,1910.0,24,1,1,9,10,10,0,0,0,0,19600,7.2,18513,208,65,500,256,27.3,1960.0
4848090500,1,13,16,0,7,6,6,1,1,0,0,17639,7.2,19365,193,80,-327,1251,27.3,1763.9,44,2,1,6,7,10,0,0,0,0,17966,7.0,18114,237,51,327,-1251,28.8,1796.6
4848055745,1,15,0,1,6,6,7,1,1,0,0,16268,6.8,17475,217,51,-159,-48,26.8,1626.8,13,1,0,6,6,4,1,0,1,0,16427,6.6,17523,235,47,159,48,28.2,1642.7
4848010687,1,15,2,0,5,3,6,0,0,0,0,18230,7.0,18197,266,48,3104,1103,31.4,1823.0,17,2,1,3,5,3,0,0,0,0,15126,6.8,17094,232,38,-3104,-1103,27.0,1512.6
4846012140,1,83,4,1,7,5,4,2,1,1,0,17968,7.2,18891,217,61,1931,2254,27.8,1796.8,15,1,0,5,7,5,0,0,0,0,16037,6.6,16637,223,56,-1931,-2254,27.9,1603.7
4845982662,0,12,0,0,5,10,5,0,0,0,0,16188,7.2,17973,224,64,-4171,390,28.8,1618.8,13,0,1,9,4,8,0,0,0,0,20359,6.8,17583,220,49,4171,-390,26.9,2035.9
4845949543,0,14,3,0,4,8,2,0,0,0,0,15435,6.8,17576,201,52,-2181,258,25.3,1543.5,17,1,1,8,4,7,1,1,0,0,17616,7.0,17318,204,60,2181,-258,26.4,1761.6
4845863634,1,15,1,1,2,2,0,0,0,0,0,16376,6.8,17655,235,44,1681,439,27.9,1637.6,20,1,0,2,2,1,1,1,0,0,14695,6.8,17216,205,47,-1681,-439,25.2,1469.5
4845844952,1,47,2,0,5,6,3,0,0,0,0,17674,7.0,18258,227,52,971,1813,27.9,1767.4,11,0,1,6,5,6,0,0,0,0,16703,6.6,16445,197,42,-971,-1813,23.9,1670.3
4833750922,0,13,1,1,4,7,6,0,0,0,0,17130,7.0,18162,227,56,241,-1198,28.3,1713.0,20,1,0,6,3,4,1,0,1,0,16889,7.2,19360,215,71,-241,1198,28.6,1688.9
4833717522,0,15,1,0,5,9,3,1,1,0,0,16159,6.6,16874,181,52,-2720,-1708,23.3,1615.9,14,2,1,9,5,6,0,0,0,0,18879,7.0,18582,243,55,2720,1708,29.8,1887.9
4833690485,0,34,2,1,3,4,2,1,0,1,0,15237,6.6,17511,209,51,-996,114,26.0,1523.7,35,2,0,4,3,4,0,0,0,0,16233,6.6,17397,216,55,996,-114,27.1,1623.3
4832735549,0,34,0,0,7,7,5,0,0,0,0,17748,7.0,19156,230,67,-484,1171,29.7,1774.8,9,8,1,7,7,7,0,0,0,0,18232,6.8,17985,240,50,484,-1171,29.0,1823.2
4832725286,0,10,2,1,4,13,4,0,0,0,0,16139,6.2,15324,172,52,-3753,-3222,22.4,1613.9,12,2,0,13,4,10,0,0,0,0,19892,7.0,18546,225,47,3753,3222,27.2,1989.2
4832701511,0,32,4,1,5,6,9,0,0,0,0,17029,6.6,16901,211,56,-298,-405,26.7,1702.9,41,3,0,6,5,4,0,0,0,0,17327,6.8,17306,194,64,298,405,25.8,1732.7
4832684100,0,36,1,1,4,8,3,0,0,0,0,16594,6.6,18252,235,60,-2206,192,29.5,1659.4,41,2,0,8,4,10,1,1,0,0,18800,6.8,18060,217,56,2206,-192,27.3,1880.0
4782445590,0,13,3,0,5,14,7,1,1,0,0,15474,6.4,15134,174,52,-4849,-1677,22.6,1547.4,35,3,1,14,5,12,0,0,0,0,20323,7.0,16811,203,53,4849,1677,25.6,2032.3
4858347470,1,0,0,1,20,10,61,0,0,0,0,35978,10.6,36972,120,0,2591,3520,12.0,3597.8,0,0,0,10,20,26,0,0,0,0,33387,9.8,33452,98,0,-2591,-3520,9.8,3338.7
4858260612,0,3,0,0,15,23,41,0,0,0,1,33890,10.6,36392,97,0,-3366,-3123,9.7,3389.0,13,0,1,23,15,68,0,0,0,0,37256,11.0,39515,115,0,3366,3123,11.5,3725.6
4857558978,0,0,4,0,14,26,45,0,0,0,0,34519,10.4,36540,93,0,-5344,-5941,9.3,3451.9,102,0,1,26,14,59,0,0,0,0,39863,11.6,42481,114,0,5344,5941,11.4,3986.3
4857539265,1,0,0,1,17,22,48,0,0,0,1,36971,11.0,40042,117,0,2968,2574,11.7,3697.1,0,0,0,22,17,49,0,0,0,0,34003,10.6,37468,85,0,-2968,-2574,8.5,3400.3
4857513384,0,0,0,0,28,24,78,0,0,0,0,40025,11.6,43299,114,0,2664,1526,11.4,4002.5,0,0,1,24,28,61,0,0,0,0,37361,11.4,41773,107,0,-2664,-1526,10.7,3736.1
4857490184,1,0,0,0,12,16,40,0,0,0,0,34105,10.2,35577,104,0,-1146,-1685,10.4,3410.5,0,0,1,16,12,43,0,0,0,0,35251,10.6,37262,112,0,1146,1685,11.2,3525.1
4857446919,0,11,1,1,3,4,5,0,0,0,0,15782,6.6,17167,235,42,35,-966,27.7,1578.2,14,2,0,4,3,4,1,1,0,0,15747,7.0,18133,208,60,-35,966,26.8,1574.7
4857393302,1,11,2,0,1,1,2,0,0,0,0,14567,7.0,18247,210,64,-1085,544,27.4,1456.7,11,0,1,1,1,0,1,1,0,0,15652,6.6,17703,243,64,1085,-544,30.7,1565.2
4857290288,0,0,0,1,20,16,66,0,0,0,2,37637,10.8,38515,113,0,2381,2534,11.3,3763.7,2,0,0,16,20,45,0,0,0,0,35256,10.6,35981,107,0,-2381,-2534,10.7,3525.6
4857263906,0,68,0,1,21,24,64,0,0,0,2,36385,10.4,37515,95,0,-2290,-3670,9.5,3638.5,0,0,0,24,21,73,0,0,0,0,38675,11.2,41185,117,0,2290,3670,11.7,3867.5
4857237444,1,34,0,1,23,14,70,0,0,0,2,37895,11.0,39627,107,0,5623,3726,10.7,3789.5,34,0,0,14,23,36,0,0,0,0,32272,10.4,35901,70,0,-5623,-3726,7.0,3227.2
4856540201,0,0,0,1,11,13,18,0,0,0,1,34171,10.4,36404,108,0,-1678,-1183,10.8,3417.1,0,0,0,13,11,36,0,0,0,0,35849,10.8,37587,115,0,1678,1183,11.5,3584.9
4856522803,1,234,1,0,23,32,57,0,0,0,1,38072,11.2,40550,110,0,-2309,-3601,11.0,3807.2,4,0,1,32,23,90,0,0,0,0,40381,11.6,44151,128,0,2309,3601,12.8,4038.1
4856492357,0,11,0,0,30,29,77,0,0,0,2,39282,11.4,42991,93,0,-570,324,9.3,3928.2,126,0,1,29,30,78,0,0,0,0,39852,11.4,42667,105,0,570,-324,10.5,3985.2
4856456612,0,18,3,0,1,3,2,0,0,0,0,14287,6.8,17679,233,56,-1197,-807,28.9,1428.7,16,0,1,3,1,3,0,0,0,0,15484,6.8,18486,222,60,1197,807,28.2,1548.4
4856418180,0,10,2,0,4,7,3,1,1,0,0,15522,6.8,17050,221,51,-1990,-1187,27.2,1552.2,13,1,1,7,4,8,0,0,0,0,17512,7.0,18237,221,52,1990,1187,27.3,1751.2
4856361196,1,12,9,0,2,3,1,1,1,0,0,16693,7.2,18799,231,56,844,384,28.7,1669.3,32,0,1,3,2,3,0,0,0,0,15849,7.2,18415,203,48,-844,-384,25.1,1584.9
4856325306,1,0,0,0,17,21,48,0,0,0,2,35290,10.6,37240,98,0,-2358,-2326,9.8,3529.0,0,0,1,21,17,65,0,0,0,0,37648,10.8,39566,103,0,2358,2326,10.3,3764.8
4856291698,1,0,9,1,19,22,51,0,0,0,0,38001,11.0,40499,116,0,1222,721,11.6,3800.1,57,0,0,22,19,59,0,0,0,0,36779,11.0,39778,81,0,-1222,-721,8.1,3677.9
4856249179,0,2,2,0,12,25,32,0,0,0,2,33218,10.4,35215,101,0,-5277,-4652,10.1,3321.8,14,0,1,25,12,76,0,0,0,0,38495,11.0,39867,109,0,5277,4652,10.9,3849.5
4854752181,1,13,1,1,7,4,7,0,0,0,0,17784,6.8,18073,226,48,1951,912,27.4,1778.4,12,0,0,4,7,2,0,0,0,0,15833,6.8,17161,199,56,-1951,-912,25.5,1583.3
4854723543,1,15,17,1,12,5,11,1,1,0,0,19409,7.2,19481,243,52,2686,1510,29.5,1940.9,31,1,0,5,12,3,0,0,0,0,16723,7.0,17971,211,64,-2686,-1510,27.5,1672.3
4854688254,1,17,0,0,3,6,1,1,1,0,0,15720,7.4,19223,242,56,-1711,775,29.8,1572.0,12,2,1,6,3,8,0,0,0,0,17431,7.0,18448,241,60,1711,-775,30.1,1743.1
4854662986,0,38,0,0,5,7,5,0,0,0,0,16239,6.8,17511,223,51,-753,-1443,27.4,1623.9,10,9,1,6,4,4,0,0,0,0,16992,7.2,18954,233,64,753,1443,29.7,1699.2
4847752215,0,12,0,1,3,6,3,0,0,0,0,14377,6.6,16875,155,45,-3018,-1779,20.0,1437.7,10,0,0,6,3,3,0,0,0,0,17395,7.2,18654,225,58,3018,1779,28.3,1739.5
4847718102,0,14,2,0,6,8,6,0,0,0,0,16085,6.6,16341,169,48,-1867,-1636,21.7,1608.5,10,1,1,8,6,8,0,0,0,0,17952,6.8,17977,215,64,1867,1636,27.9,1795.2
4841617834,0,17,2,1,7,4,12,1,1,0,0,19685,6.8,17201,218,48,1253,-763,26.6,1968.5,14,4,0,4,7,4,0,0,0,0,18432,6.8,17964,238,57,-1253,763,29.5,1843.2
4841594078,0,16,1,1,6,6,7,0,0,0,0,17025,6.8,17210,241,27,-499,-1288,26.8,1702.5,12,1,0,6,6,3,0,0,0,0,17524,6.8,18498,254,52,499,1288,30.6,1752.4
4837261348,0,12,1,0,6,4,7,1,1,0,0,17311,6.6,17255,215,55,1484,-670,27.0,1731.1,8,0,1,4,6,2,0,0,0,0,15827,6.8,17925,203,64,-1484,670,26.7,1582.7
4835336615,0,53,0,1,7,6,3,0,0,0,0,16290,7.0,17871,208,47,210,360,25.5,1629.0,12,1,0,6,7,4,0,0,0,0,16080,6.8,17511,233,52,-210,-360,28.5,1608.0
4835323183,1,11,1,0,9,13,9,1,0,1,0,19405,6.8,16849,195,56,725,-651,25.1,1940.5,18,1,1,13,9,7,0,0,0,0,18680,6.8,17500,179,48,-725,651,22.7,1868.0
4835302097,0,28,3,0,6,6,6,1,1,0,0,17811,6.6,17216,210,52,926,159,26.2,1781.1,12,2,1,6,6,5,0,0,0,0,16885,6.6,17057,198,62,-926,-159,26.0,1688.5
4835266790,0,14,1,1,4,4,4,1,1,0,0,16136,7.2,18224,229,64,-264,-639,29.3,1613.6,13,2,0,4,4,3,0,0,0,0,16400,7.2,18863,225,57,264,639,28.2,1640.0
4835228284,0,15,3,1,7,4,10,0,0,0,0,17604,7.6,20122,248,60,1958,2186,30.8,1760.4,16,0,0,3,6,3,1,1,0,0,15646,7.0,17936,269,48,-1958,-2186,31.7,1564.6
4834255885,1,34,4,0,3,4,4,1,1,0,0,15569,6.8,17253,232,56,397,664,28.8,1556.9,39,2,1,4,3,4,0,0,0,0,15172,6.6,16589,188,38,-397,-664,22.6,1517.2
4834226510,0,11,0,0,4,6,5,0,0,0,0,16460,6.8,18358,245,64,-904,-401,30.9,1646.0,10,0,1,6,4,10,1,1,0,0,17364,7.0,18759,236,60,904,401,29.6,1736.4
4834199333,1,18,0,1,10,3,11,0,0,0,0,19038,7.2,19175,239,56,4692,3041,29.5,1903.8,14,1,0,3,10,2,1,0,1,0,14346,6.4,16134,181,44,-4692,-3041,22.5,1434.6
4833151430,0,29,2,0,9,11,9,0,0,0,0,18347,6.6,16820,212,54,-1009,-767,26.6,1834.7,32,1,1,11,9,15,0,0,0,0,19356,7.0,17587,215,57,1009,767,27.2,1935.6
4833103276,0,12,2,0,6,5,5,0,0,0,0,16763,6.8,17444,208,52,40,-1010,26.0,1676.3,10,1,1,5,6,5,0,0,0,0,16723,6.8,18454,259,48,-40,1010,30.7,1672.3
4830741363,0,18,1,1,6,5,3,0,0,0,0,17179,7.4,19300,208,56,464,956,26.4,1717.9,12,0,0,5,6,5,0,0,0,0,16715,7.0,18344,238,47,-464,-956,28.5,1671.5
4853249291,0,10,0,1,6,9,8,0,0,0,0,17116,6.6,15934,201,51,-1753,-2761,25.2,1711.6,7,0,0,9,6,8,1,1,0,0,18869,7.0,18695,235,68,1753,2761,30.3,1886.9
4829559142,1,19,0,1,4,1,3,0,0,0,0,17376,7.4,19512,260,64,4058,3171,32.4,1737.6,20,0,0,1,4,1,0,0,0,0,13318,6.4,16341,172,44,-4058,-3171,21.6,1331.8
4829527652,0,14,0,0,3,10,4,0,0,0,0,15581,6.6,17004,221,46,-3413,-3090,26.7,1558.1,17,0,1,10,3,6,0,0,0,0,18994,7.6,20094,220,72,3413,3090,29.2,1899.4
4829487370,0,13,0,1,6,4,4,0,0,0,0,16022,6.6,16651,169,61,1283,396,23.0,1602.2,20,0,0,4,6,1,0,0,0,0,14739,6.6,16255,200,46,-1283,-396,24.6,1473.9
4829449816,0,13,1,0,6,10,5,0,0,0,0,16505,7.0,17629,219,52,-2756,-447,27.1,1650.5,16,1,1,10,6,18,0,0,0,0,19261,7.0,18076,224,56,2756,447,28.0,1926.1
4828589036,0,18,1,0,4,5,4,1,1,0,0,16195,6.8,18169,215,72,-1495,-1592,28.7,1619.5,12,1,1,5,4,2,0,0,0,0,17690,7.4,19761,251,63,1495,1592,31.4,1769.0
4828531732,1,22,0,0,4,7,5,1,0,1,0,17506,6.6,17509,201,60,-1241,-423,26.1,1750.6,14,1,1,7,4,5,0,0,0,0,18747,6.8,17932,221,48,1241,423,26.9,1874.7
4828485122,1,8,1,1,4,3,1,0,0,0,0,16134,7.0,19327,243,60,739,-51,30.3,1613.4,15,1,0,3,4,2,0,0,0,0,15395,7.0,19378,216,68,-739,51,28.4,1539.5
4828459912,1,13,1,1,5,5,4,0,0,0,0,16718,7.0,18003,227,52,1381,1620,27.9,1671.8,31,1,0,5,5,7,0,0,0,0,15337,6.6,16383,216,52,-1381,-1620,26.8,1533.7
4828438758,0,12,2,0,1,9,1,0,0,0,0,13653,6.4,16314,192,64,-4486,-3519,25.6,1365.3,21,0,1,9,1,3,0,0,0,0,18139,7.2,19833,248,68,4486,3519,31.6,1813.9
4828410472,1,19,3,0,5,3,5,0,0,0,0,16408,6.8,17927,249,48,1100,-149,29.7,1640.8,12,2,1,3,5,2,1,0,1,0,15308,7.0,18076,214,71,-1100,149,28.5,1530.8
4828375198,0,12,2,0,2,6,2,0,0,0,0,15185,7.0,18112,238,64,-1845,-490,30.2,1518.5,17,1,1,6,2,6,0,0,0,0,17030,7.0,18602,240,52,1845,490,29.2,1703.0
4818972403,1,12,0,0,7,6,3,0,0,0,0,16732,7.2,18918,217,54,629,1074,27.1,1673.2,14,0,1,6,7,6,1,1,0,0,16103,6.8,17844,173,67,-629,-1074,24.0,1610.3
4818363711,1,16,2,1,7,6,5,0,0,0,0,17083,7.0,18403,243,52,1209,268,29.5,1708.3,18,3,0,6,7,7,1,1,0,0,15874,7.2,18135,203,63,-1209,-268,26.6,1587.4
4818357404,0,10,1,0,4,5,7,1,1,0,0,14754,6.6,16038,216,36,-2873,-3441,25.2,1475.4,15,1,1,5,4,2,1,0,1,0,17627,7.2,19479,267,72,2873,3441,33.9,1762.7
4818345454,0,14,1,0,2,3,0,0,0,0,0,15775,7.2,18707,189,48,-337,9,23.7,1577.5,12,1,1,3,2,0,1,1,0,0,16112,7.0,18698,257,64,337,-9,32.1,1611.2
4818331387,0,12,1,0,4,3,4,0,0,0,0,16369,7.2,18616,227,73,880,295,30.0,1636.9,14,1,1,3,4,1,1,1,0,0,15489,7.0,18321,209,50,-880,-295,25.9,1548.9
4818311261,0,34,2,0,3,11,3,1,0,1,0,15677,6.6,16831,187,68,-3395,-3187,25.5,1567.7,74,6,1,11,3,4,1,1,0,0,19072,7.0,20018,243,64,3395,3187,30.7,1907.2
4818291824,1,14,2,0,13,8,12,1,1,0,0,21952,7.4,19880,230,68,3727,2119,29.8,2195.2,11,3,1,8,13,7,0,0,0,0,18225,7.2,17761,211,56,-3727,-2119,26.7,1822.5
4818271090,1,13,2,0,10,7,4,1,1,0,0,18290,6.8,18318,214,56,1993,1165,27.0,1829.0,11,1,1,7,10,2,0,0,0,0,16297,6.8,17153,197,52,-1993,-1165,24.9,1629.7
4856932513,1,0,4,0,18,16,23,0,0,0,0,62730,13.0,62500,10,0,25380,25000,1.0,6273.0,44,0,1,11,13,7,0,0,0,0,37350,7.8,37500,6,0,-25380,-25000,0.6,3735.0
4856923152,1,7,0,1,15,15,19,0,0,0,0,62725,12.0,55000,1,0,24815,22000,0.1,6272.5,0,1,0,12,12,8,0,0,0,0,37910,7.2,33000,1,0,-24815,-22000,0.1,3791.0
4855705896,1,4,0,1,22,14,23,0,0,0,0,63341,12.0,55000,0,0,28591,22000,0.0,6334.1,0,0,0,5,13,4,0,0,0,0,34750,7.2,33000,0,0,-28591,-22000,0.0,3475.0
4855687680,1,11,5,0,19,15,18,0,0,0,0,64580,12.0,55000,2,0,28120,22000,0.2,6458.0,26,2,1,8,12,7,0,0,0,0,36460,7.2,33000,10,0,-28120,-22000,1.0,3646.0
4853547847,1,13,0,1,8,4,10,0,0,0,1,20329,7.0,18949,260,68,5714,2326,32.8,2032.9,9,0,0,4,8,1,1,1,0,0,14615,6.4,16623,203,52,-5714,-2326,25.5,1461.5
4852499034,0,14,15,1,5,2,6,1,1,0,0,16921,7.0,18922,225,71,719,-735,29.6,1692.1,36,0,0,2,5,1,0,0,0,0,16202,7.4,19657,223,64,-719,735,28.7,1620.2
4852464883,1,16,3,1,8,6,6,0,0,0,0,16902,6.8,17387,228,42,-1021,-856,27.0,1690.2,16,4,0,6,8,6,0,0,0,0,17923,7.2,18243,243,48,1021,856,29.1,1792.3
4852429157,0,13,1,1,1,4,1,0,0,0,0,15381,7.2,18081,230,57,-1185,-1370,28.7,1538.1,14,2,0,4,1,1,1,1,0,0,16566,7.2,19451,252,61,1185,1370,31.3,1656.6
4852402369,1,10,1,0,2,7,3,0,0,0,0,14981,6.8,17212,198,60,-2826,-1720,25.8,1498.1,10,2,1,7,2,7,0,0,0,0,17807,7.0,18932,241,64,2826,1720,30.5,1780.7
4852223080,1,31,0,1,4,3,1,0,0,0,0,15632,7.0,18158,212,72,632,941,28.4,1563.2,28,11,0,3,4,2,1,0,1,0,15000,6.8,17217,190,60,-632,-941,25.0,1500.0
4851366072,1,13,0,1,9,13,3,1,1,0,0,17972,7.0,18092,200,59,-1498,-703,25.9,1797.2,12,4,0,13,9,11,0,0,0,0,19470,7.0,18795,209,56,1498,703,26.5,1947.0
4850475798,1,15,1,0,6,3,5,0,0,0,0,16698,7.0,18746,211,52,1547,1204,26.3,1669.8,14,2,1,3,6,2,0,0,0,0,15151,6.8,17542,221,55,-1547,-1204,27.6,1515.1
4850320836,0,13,0,0,6,5,8,0,0,0,0,17108,6.6,17602,244,58,1067,-190,30.2,1710.8,11,0,1,5,6,5,0,0,0,0,16041,6.8,17792,173,57,-1067,190,23.0,1604.1
4848041160,1,12,1,1,5,3,3,1,1,0,0,17655,7.4,19957,212,60,3025,2098,27.2,1765.5,9,0,0,3,5,1,0,0,0,0,14630,6.8,17859,172,56,-3025,-2098,22.8,1463.0
4847981213,1,13,0,1,7,6,6,0,0,0,0,21691,7.4,19799,237,59,5952,2705,29.6,2169.1,9,0,0,6,7,2,1,1,0,0,15739,6.6,17094,179,56,-5952,-2705,23.5,1573.9
4843288263,0,16,1,0,1,3,2,1,1,0,0,14197,7.0,17877,226,56,-1302,-2354,28.2,1419.7,13,0,1,3,1,1,0,0,0,0,15499,7.2,20231,226,76,1302,2354,30.2,1549.9
4843254005,0,8,0,0,3,6,2,0,0,0,0,14662,6.6,16150,184,45,-1897,-2440,22.9,1466.2,15,1,1,6,3,4,0,0,0,0,16559,7.0,18590,225,50,1897,2440,27.5,1655.9
4843193662,1,13,4,0,2,5,1,0,0,0,0,14018,6.6,16935,184,64,-3616,-2797,24.8,1401.8,9,2,1,5,2,5,0,0,0,0,17634,7.2,19732,250,76,3616,2797,32.6,1763.4
4843157852,1,13,1,1,2,6,2,0,0,0,0,14985,6.8,16820,191,52,-1092,-639,24.3,1498.5,10,1,0,6,2,4,1,1,0,0,16077,6.8,17459,177,55,1092,639,23.2,1607.7
4819412043,0,16,0,0,2,5,2,0,0,0,0,15151,6.8,16240,191,38,-2406,-2071,22.9,1515.1,12,2,1,5,2,5,0,0,0,0,17557,7.0,18311,240,57,2406,2071,29.7,1755.7
4819391305,1,14,2,1,9,7,11,1,0,1,0,18316,6.6,17532,213,61,1722,252,27.4,1831.6,13,1,0,7,9,5,0,0,0,0,16594,6.6,17280,201,46,-1722,-252,24.7,1659.4
4819368564,1,15,3,1,3,0,3,1,0,1,0,16690,7.0,19343,242,72,1971,853,31.4,1669.0,13,1,0,0,3,0,1,1,0,0,14719,7.0,18490,271,60,-1971,-853,33.1,1471.9
4819358134,0,32,1,0,1,4,1,1,0,1,0,14911,7.2,19026,253,63,-880,620,31.6,1491.1,35,3,1,4,1,3,1,1,0,0,15791,7.2,18406,216,64,880,-620,28.0,1579.1
4819343226,0,21,1,1,4,2,5,0,0,0,0,16426,7.0,18122,233,40,108,488,27.3,1642.6,13,1,0,2,4,1,0,0,0,0,16318,7.0,17634,208,56,-108,-488,26.4,1631.8
4819276014,0,13,1,1,8,8,7,0,0,0,0,18346,6.8,17613,241,48,122,-360,28.9,1834.6,75,2,0,8,8,11,1,1,0,0,18224,6.8,17973,229,52,-122,360,28.1,1822.4
4819245651,1,14,3,0,2,1,1,0,0,0,0,15342,7.2,18989,233,68,-480,726,30.1,1534.2,13,2,1,1,2,1,0,0,0,0,15822,7.2,18263,243,56,480,-726,29.9,1582.2
4819143828,1,15,0,1,3,2,3,1,1,0,0,17218,7.2,19898,263,64,1860,1114,32.7,1721.8,8,1,0,2,3,0,1,0,1,0,15358,7.0,18784,256,64,-1860,-1114,32.0,1535.8
4818393123,1,12,0,1,3,1,3,1,1,0,0,15289,6.8,17556,190,72,-6,100,26.2,1528.9,12,0,0,1,3,0,0,0,0,0,15295,6.8,17456,214,48,6,-100,26.2,1529.5
4818253657,1,42,1,1,7,3,8,1,1,0,0,17523,7.2,18560,222,64,1715,-223,28.6,1752.3,8,0,0,3,7,1,0,0,0,0,15808,7.0,18783,240,72,-1715,223,31.2,1580.8
4818185149,1,14,3,0,6,4,12,0,0,0,0,17036,7.0,18405,220,72,-33,307,29.2,1703.6,15,2,1,4,6,5,0,0,0,0,17069,7.0,18098,252,58,33,-307,31.0,1706.9
4818099799,1,18,3,0,6,2,5,0,0,0,0,17425,7.0,19272,266,55,1894,2181,32.1,1742.5,14,2,1,2,6,3,1,1,0,0,15531,6.8,17091,238,56,-1894,-2181,29.4,1553.1
4818031949,0,53,2,1,3,6,5,0,0,0,0,16879,6.8,17753,241,50,-1249,30,29.1,1687.9,19,2,0,6,3,11,1,1,0,0,18128,7.0,17723,223,58,1249,-30,28.1,1812.8
4817593033,1,11,0,0,7,6,13,0,0,0,0,17288,6.6,17334,226,57,-58,-161,28.3,1728.8,14,1,1,6,7,8,1,0,1,0,17346,6.8,17495,226,48,58,161,27.4,1734.6
4817570589,1,14,1,0,6,4,7,0,0,0,0,16935,6.8,17505,218,47,117,752,26.5,1693.5,22,1,1,4,6,6,0,0,0,0,16818,6.8,16753,205,57,-117,-752,26.2,1681.8
4817559911,0,11,0,1,8,6,7,0,0,0,0,17974,6.8,17920,241,64,531,918,30.5,1797.4,14,1,0,6,8,10,0,0,0,0,17443,6.6,17002,238,43,-531,-918,28.1,1744.3
4817540196,0,12,2,1,5,5,7,0,0,0,0,16950,7.2,18763,247,63,-241,-346,31.0,1695.0,14,2,0,5,5,7,1,1,0,0,17191,7.0,19109,267,64,241,346,33.1,1719.1
4817526999,0,13,3,0,4,4,2,1,1,0,0,15648,7.0,18749,205,76,-286,418,28.1,1564.8,13,3,1,4,4,3,0,0,0,0,15934,7.2,18331,229,60,286,-418,28.9,1593.4
4817514854,1,13,0,0,4,7,3,0,0,0,0,16763,7.0,18095,220,56,-1169,300,27.6,1676.3,12,0,1,7,4,15,2,1,1,0,17932,6.8,17795,246,57,1169,-300,30.3,1793.2
4817507863,1,12,16,1,6,3,4,1,1,0,0,16475,7.0,17947,254,56,411,-206,31.0,1647.5,30,0,0,3,6,2,0,0,0,0,16064,6.8,18153,243,54,-411,206,29.7,1606.4
4858289802,0,14,1,1,7,10,6,1,1,0,0,16982,6.8,18228,215,68,-1707,22,28.3,1698.2,13,3,0,9,6,13,0,0,0,0,18689,7.0,18206,218,48,1707,-22,26.6,1868.9
4858253011,1,13,0,1,12,3,14,2,1,1,0,20272,7.4,19389,217,72,5690,2814,28.9,2027.2,9,0,0,3,12,4,0,0,0,0,14582,6.6,16575,204,52,-5690,-2814,25.6,1458.2
4858209423,1,13,2,1,6,3,4,0,0,0,0,17048,7.0,18563,234,63,1428,774,29.7,1704.8,18,2,0,3,6,4,0,0,0,0,15620,7.0,17789,224,56,-1428,-774,28.0,1562.0
4854016388,1,9,5,1,11,1,9,1,1,0,0,18992,7.0,18621,228,56,5663,2051,28.4,1899.2,37,2,0,1,11,0,0,0,0,0,13329,6.4,16570,191,58,-5663,-2051,24.9,1332.9
4853880225,0,13,2,1,4,5,2,1,1,0,0,15604,7.2,17566,211,64,-308,273,27.5,1560.4,16,2,0,5,4,8,0,0,0,0,15912,6.8,17293,189,56,308,-273,24.5,1591.2
4853838409,1,43,17,0,6,3,9,0,0,0,0,17802,7.2,18804,220,56,1380,563,27.6,1780.2,35,0,1,3,6,2,1,1,0,0,16422,7.0,18241,230,60,-1380,-563,29.0,1642.2
4853790389,1,10,1,0,6,11,6,1,1,0,0,16009,6.6,16251,164,63,-2848,-2419,22.7,1600.9,12,0,1,11,6,5,0,0,0,0,18857,7.2,18670,190,68,2848,2419,25.8,1885.7
4853742775,0,14,0,1,3,2,3,1,1,0,0,16503,7.4,19626,248,76,2325,2186,32.4,1650.3,10,1,0,2,3,3,0,0,0,0,14178,6.8,17440,172,64,-2325,-2186,23.6,1417.8
4853655378,1,13,1,1,4,4,3,0,0,0,0,15785,7.0,17812,174,56,-335,222,23.0,1578.5,11,0,0,4,4,1,0,0,0,0,16120,6.8,17590,234,56,335,-222,29.0,1612.0
4853628897,0,14,2,0,8,9,6,1,1,0,0,17290,7.0,18440,224,51,-503,1452,27.5,1729.0,15,3,1,9,8,8,0,0,0,0,17793,6.6,16988,213,60,503,-1452,27.3,1779.3
4853037865,1,29,13,1,9,6,7,0,0,0,0,19482,6.8,17434,185,52,3014,696,23.7,1948.2,40,0,0,6,9,6,0,0,0,0,16468,6.6,16738,184,40,-3014,-696,22.4,1646.8
4851925964,1,11,1,1,4,5,5,0,0,0,0,16885,7.0,18375,235,60,339,-336,29.5,1688.5,13,2,0,5,4,6,1,1,0,0,16546,7.2,18711,219,60,-339,336,27.9,1654.6
4851697028,1,13,4,0,5,13,7,1,0,1,0,17304,6.8,17985,209,59,-1232,1098,26.8,1730.4,20,2,1,13,5,14,1,1,0,0,18536,6.8,16887,183,56,1232,-1098,23.9,1853.6
4849587937,0,10,4,0,2,5,3,0,0,0,0,15234,6.8,17425,235,56,-3035,-1425,29.1,1523.4,12,0,1,5,2,4,0,0,0,0,18269,7.0,18850,231,60,3035,1425,29.1,1826.9
4849539424,1,46,0,0,8,8,9,1,0,1,0,16788,6.6,16754,188,56,-1287,-716,24.4,1678.8,13,10,1,8,8,12,1,1,0,0,18075,7.0,17470,235,36,1287,716,27.1,1807.5
4849525238,1,22,3,0,7,10,8,0,0,0,0,17136,6.8,17141,204,52,-2022,-2263,25.6,1713.6,11,2,1,10,7,16,0,0,0,0,19158,7.2,19404,246,63,2022,2263,30.9,1915.8
4849244829,0,13,0,1,1,9,1,0,0,0,0,14647,6.8,17273,221,59,-4226,-2307,28.0,1464.7,15,0,0,9,1,8,2,1,1,0,18873,7.4,19580,248,64,4226,2307,31.2,1887.3
4849210236,1,12,1,1,6,7,0,0,0,0,0,17478,7.2,19328,207,68,85,-236,27.5,1747.8,11,2,0,7,6,3,0,0,0,0,17393,7.4,19564,244,76,-85,236,32.0,1739.3
4849163881,0,31,1,0,7,7,11,0,0,0,0,17257,6.6,16780,189,52,-1317,-1273,24.1,1725.7,11,0,1,7,7,7,0,0,0,0,18574,7.0,18053,211,64,1317,1273,27.5,1857.4
4858072559,0,11,0,1,11,7,21,0,0,0,0,17993,6.6,16871,212,44,-543,-2187,25.6,1799.3,13,1,0,7,11,5,1,1,0,0,18536,7.2,19058,248,72,543,2187,32.0,1853.6
4858057831,0,12,1,1,5,7,9,0,0,0,0,15803,6.4,15807,211,44,-1531,-2693,25.5,1580.3,13,1,0,7,5,9,1,1,0,0,17334,6.8,18500,215,76,1531,2693,29.1,1733.4
4858037212,1,12,16,1,6,2,4,0,0,0,0,17880,7.0,18997,260,59,3220,1711,31.9,1788.0,33,1,0,1,5,1,0,0,0,0,14660,6.6,17286,219,52,-3220,-1711,27.1,1466.0
4857992427,0,12,2,0,3,3,3,0,0,0,0,15247,6.8,17035,204,40,-788,-984,24.4,1524.7,15,3,1,3,3,2,0,0,0,0,16035,7.0,18019,206,68,788,984,27.4,1603.5
4857518018,1,0,0,1,22,14,21,0,0,0,0,63996,12.8,59000,0,0,27146,26000,0.0,6399.6,0,0,0,7,15,7,0,0,0,0,36850,7.2,33000,0,0,-27146,-26000,0.0,3685.0
4857491324,1,33,1,1,22,14,26,0,0,0,0,64633,12.0,55000,4,0,29133,21000,0.4,6463.3,0,1,0,7,15,4,0,0,0,0,35500,7.4,34000,0,0,-29133,-21000,0.0,3550.0
4857470403,1,0,0,1,19,16,21,0,0,0,0,63075,12.4,57000,1,0,25525,24000,0.1,6307.5,0,0,0,11,14,10,0,0,0,0,37550,7.2,33000,0,0,-25525,-24000,0.0,3755.0
4857449383,1,12,0,0,17,18,12,0,0,0,0,46716,10.0,47500,1,0,18860,19000,0.1,4671.6,256,0,1,11,10,11,0,0,0,0,27856,6.0,28500,0,0,-18860,-19000,0.0,2785.6
4857421691,1,0,0,1,20,18,20,0,0,0,0,63969,12.0,55000,1,0,26249,22000,0.1,6396.9,0,0,0,11,13,7,0,0,0,0,37720,7.2,33000,2,0,-26249,-22000,0.2,3772.0
4857408894,1,0,0,0,19,26,13,0,0,0,0,63821,12.0,55000,0,0,23815,22000,0.0,6382.1,252,0,1,15,8,22,0,0,0,0,40006,7.2,33000,0,0,-23815,-22000,0.0,4000.6
4857384448,1,0,0,0,23,20,24,0,0,0,0,65079,13.0,62500,1,0,26821,25000,0.1,6507.9,284,0,1,12,15,13,0,0,0,0,38258,7.8,37500,0,0,-26821,-25000,0.0,3825.8
4857359608,1,35,0,1,21,19,19,0,0,0,0,63085,12.0,55000,8,0,24975,22000,0.8,6308.5,19,0,0,12,14,16,0,0,0,0,38110,7.2,33000,4,0,-24975,-22000,0.4,3811.0
4857338378,1,0,0,0,18,11,15,0,0,0,0,51882,10.0,47500,3,0,25347,19000,0.3,5188.2,0,0,1,6,13,5,0,0,0,0,26535,6.0,28500,1,0,-25347,-19000,0.1,2653.5
4857310756,1,216,0,1,18,20,18,0,0,0,0,46853,10.0,47500,2,0,18109,19000,0.2,4685.3,13,0,0,13,11,12,0,0,0,0,28744,6.0,28500,1,0,-18109,-19000,0.1,2874.4
4857280748,1,72,0,0,11,19,9,0,0,0,0,45150,10.0,47500,4,0,15900,19000,0.4,4515.0,19,0,1,14,6,13,0,0,0,0,29250,6.0,28500,5,0,-15900,-19000,0.5,2925.0
4855300455,1,13,0,1,7,7,3,0,0,0,0,18005,7.0,18315,233,52,1255,57,28.5,1800.5,10,0,0,7,7,9,0,0,0,0,16750,7.2,18258,204,56,-1255,-57,26.0,1675.0
4855250371,0,15,4,0,7,3,6,2,1,1,0,16445,6.6,17187,202,52,415,-136,25.4,1644.5,12,4,1,3,7,3,0,0,0,0,16030,6.8,17323,227,44,-415,136,27.1,1603.0
4855187642,1,16,1,0,0,3,0,0,0,0,0,14672,6.8,17914,230,52,-1915,-779,28.2,1467.2,26,2,1,3,0,1,0,0,0,0,16587,7.0,18693,265,44,1915,779,30.9,1658.7
4855136980,1,20,5,0,7,7,4,1,0,1,0,19168,7.2,19448,233,58,1878,2448,29.1,1916.8,16,1,1,7,7,8,1,1,0,0,17290,7.0,17000,159,52,-1878,-2448,21.1,1729.0
4855091903,0,0,0,0,18,15,52,0,0,0,0,34680,11.0,38524,101,0,1259,2116,10.1,3468.0,0,0,1,15,18,37,0,0,0,0,33421,10.6,36408,120,0,-1259,-2116,12.0,3342.1
4857177612,0,81,1,0,7,5,14,0,0,0,0,17234,7.2,18841,221,45,-441,174,26.6,1723.4,19,2,1,5,7,8,0,0,0,0,17675,7.2,18667,226,64,441,-174,29.0,1767.5
4849397146,1,11,0,0,10,7,5,0,0,0,0,17980,6.8,17611,234,47,1649,-41,28.1,1798.0,11,0,1,7,10,7,1,1,0,0,16331,6.8,17652,187,64,-1649,41,25.1,1633.1
4845126123,1,13,0,0,7,6,11,0,0,0,0,16647,7.0,17823,217,35,-123,249,25.2,1664.7,9,0,1,6,7,6,1,1,0,0,16770,6.8,17574,221,64,123,-249,28.5,1677.0
4836988795,0,58,0,0,3,8,3,1,1,0,0,14269,6.4,15825,178,52,-4273,-3079,23.0,1426.9,17,1,1,8,3,6,0,0,0,0,18542,7.0,18904,218,52,4273,3079,27.0,1854.2
4832270935,1,17,1,1,6,5,3,0,0,0,0,15863,7.0,17371,228,44,-1171,-2039,27.2,1586.3,12,1,0,5,6,5,1,1,0,0,17034,7.2,19410,232,72,1171,2039,30.4,1703.4
4830522967,1,12,14,0,2,3,2,0,0,0,0,15716,7.2,18915,225,76,-1159,-1317,30.1,1571.6,38,3,1,3,2,5,0,0,0,0,16875,7.4,20232,247,60,1159,1317,30.7,1687.5
4830462811,0,54,3,1,7,3,4,0,0,0,0,17381,7.0,19250,217,72,1452,629,28.9,1738.1,12,1,0,3,7,1,0,0,0,0,15929,7.0,18621,230,56,-1452,-629,28.6,1592.9
4830431487,0,13,0,1,10,10,7,0,0,0,0,16881,7.0,17953,189,56,-1700,-1102,24.5,1688.1,13,0,0,9,9,10,1,1,0,0,18581,7.2,19055,211,76,1700,1102,28.7,1858.1
4830393189,0,74,3,0,3,8,1,1,0,1,0,17587,6.6,17875,228,67,-416,-74,29.5,1758.7,18,1,1,8,3,9,0,0,0,0,18003,7.0,17949,232,40,416,74,27.2,1800.3
4828783279,1,33,0,1,17,14,18,1,1,0,0,23260,7.0,18301,203,60,2238,803,26.3,2326.0,30,0,0,14,17,21,0,0,0,0,21022,7.0,17498,162,44,-2238,-803,20.6,2102.2
4828742949,1,7,0,1,6,7,3,0,0,0,0,16557,7.0,17496,219,69,-1110,29,28.8,1655.7,10,1,0,7,6,10,0,0,0,0,17667,6.6,17467,211,48,1110,-29,25.9,1766.7
4828696380,0,12,3,0,5,12,5,0,0,0,0,15192,6.6,15827,177,20,-4213,-1537,19.7,1519.2,20,0,1,12,5,10,1,1,0,0,19405,7.0,17364,161,68,4213,1537,22.9,1940.5
4828653315,0,15,3,0,1,6,0,0,0,0,0,13706,7.0,18171,195,64,-4543,-731,25.9,1370.6,13,2,1,6,1,8,0,0,0,0,18249,7.2,18902,210,55,4543,731,26.5,1824.9
4827856922,1,80,1,1,5,5,2,0,0,0,0,16274,7.0,16993,199,56,-1228,-892,25.5,1627.4,10,1,0,5,5,2,0,0,0,0,17502,7.2,17885,213,59,1228,892,27.2,1750.2
4827819843,1,117,2,1,6,5,4,2,1,1,0,16906,7.0,18017,209,68,910,734,27.7,1690.6,8,2,0,5,6,4,0,0,0,0,15996,6.8,17283,201,39,-910,-734,24.0,1599.6
4827767889,0,6,0,1,9,4,4,0,0,0,0,18512,7.0,18623,208,52,2844,705,26.0,1851.2,9,0,0,4,9,2,0,0,0,0,15668,7.0,17918,202,75,-2844,-705,27.7,1566.8
4827713714,1,13,0,1,2,2,2,0,0,0,0,15273,7.0,17656,226,52,-790,-1635,27.8,1527.3,12,0,0,2,2,2,0,0,0,0,16063,7.0,19291,249,76,790,1635,32.5,1606.3
4827691401,0,17,1,0,0,4,0,1,0,1,0,14126,7.0,17896,221,66,-1392,-140,28.7,1412.6,13,3,1,4,0,4,0,0,0,0,15518,7.0,18036,222,52,1392,140,27.4,1551.8
4827650848,0,14,1,0,6,8,5,1,0,1,0,17201,7.0,18598,213,64,-2084,-1743,27.7,1720.1,14,1,1,8,6,15,1,1,0,0,19285,7.4,20341,208,71,2084,1743,27.9,1928.5
4827611992,0,16,3,1,4,2,2,1,1,0,0,15507,7.2,19059,230,40,-493,-657,27.0,1550.7,15,0,0,2,4,1,0,0,0,0,16000,7.2,19716,238,72,493,657,31.0,1600.0
4835056963,1,14,0,0,3,2,3,1,1,0,0,17091,7.2,19260,242,72,1602,1868,31.4,1709.1,14,1,1,2,3,2,0,0,0,0,15489,6.8,17392,235,56,-1602,-1868,29.1,1548.9
4812065121,0,10,1,1,4,4,5,1,0,1,0,15822,6.6,17071,228,64,831,-284,29.2,1582.2,10,3,0,3,3,5,1,1,0,0,14991,6.8,17355,222,64,-831,284,28.6,1499.1
4811902126,1,15,0,1,8,3,8,1,1,0,0,18590,7.2,19446,251,68,2434,922,31.9,1859.0,16,2,0,3,8,4,0,0,0,0,16156,7.0,18524,218,60,-2434,-922,27.8,1615.6
4811869769,0,9,2,1,5,7,8,0,0,0,0,16975,7.0,16950,237,43,-140,263,28.0,1697.5,28,1,0,7,5,7,0,0,0,0,17115,6.6,16687,198,52,140,-263,25.0,1711.5
4811845258,0,12,4,0,4,9,1,0,0,0,0,15014,6.8,17385,204,56,-3000,-438,26.0,1501.4,17,3,1,9,4,8,0,0,0,0,18014,6.8,17823,203,52,3000,438,25.5,1801.4
4810076115,0,13,3,1,4,8,3,0,0,0,0,17200,7.4,18819,234,72,-699,-891,30.6,1720.0,13,0,0,8,4,4,1,1,0,0,17899,7.2,19710,216,72,699,891,28.8,1789.9
4809949329,0,10,0,0,4,6,1,0,0,0,0,13955,6.8,17493,179,49,-3587,-1958,22.8,1395.5,12,1,1,6,4,4,0,0,0,0,17542,7.4,19451,220,65,3587,1958,28.5,1754.2
4809928328,0,22,3,1,1,0,3,0,0,0,0,14909,7.0,17596,255,52,-28,-513,30.7,1490.9,22,3,0,0,1,0,0,0,0,0,14937,7.0,18109,261,52,28,513,31.3,1493.7
4808944298,1,16,1,1,3,4,3,0,0,0,0,15720,7.0,17620,222,60,-1146,-953,28.2,1572.0,15,2,0,4,3,3,1,1,0,0,16866,7.2,18573,257,60,1146,953,31.7,1686.6
4808928497,1,11,2,1,9,4,8,1,1,0,0,21051,7.0,18384,198,64,5238,1737,26.2,2105.1,10,1,0,4,9,5,0,0,0,0,15813,6.6,16647,219,48,-5238,-1737,26.7,1581.3
4808902473,0,27,2,0,9,10,8,0,0,0,0,18665,6.8,18406,218,53,14,1545,27.1,1866.5,13,1,1,10,9,17,0,0,0,0,18651,6.8,16861,203,46,-14,-1545,24.9,1865.1
4808464946,0,11,0,0,4,12,6,0,0,0,0,15312,6.6,17117,209,56,-7272,-3190,26.5,1531.2,11,1,1,12,4,12,0,0,0,0,22584,7.4,20307,234,68,7272,3190,30.2,2258.4
4808422815,0,74,2,1,2,2,2,0,0,0,0,15144,7.0,17800,194,54,-388,394,24.8,1514.4,15,1,0,2,2,3,1,1,0,0,15532,6.8,17406,233,57,388,-394,29.0,1553.2
4808394820,0,18,2,1,10,13,16,0,0,0,0,17207,5.8,13971,185,37,-2537,-3073,22.2,1720.7,11,4,0,12,9,17,1,1,0,0,19744,6.8,17044,196,47,2537,3073,24.3,1974.4
4807986352,1,9,1,1,10,4,13,0,0,0,0,19450,7.2,18721,227,58,4574,3173,28.5,1945.0,15,0,0,4,10,4,1,1,0,0,14876,6.4,15548,170,54,-4574,-3173,22.4,1487.6
4807947461,0,65,0,0,4,5,1,0,0,0,0,15707,7.2,18969,218,60,-2683,549,27.8,1570.7,11,0,1,5,4,5,0,0,0,0,18390,7.2,18420,234,51,2683,-549,28.5,1839.0
4807900073,0,11,1,0,7,12,8,0,0,0,0,17409,6.4,16395,216,47,-3492,-2713,26.3,1740.9,13,2,1,12,7,14,0,0,0,0,20901,7.0,19108,226,56,3492,2713,28.2,2090.1
4807877280,1,16,1,0,1,7,1,0,0,0,0,15106,7.0,18092,227,58,-3083,-581,28.5,1510.6,14,1,1,7,1,7,0,0,0,0,18189,7.2,18673,234,60,3083,581,29.4,1818.9
4805209427,0,77,2,0,6,5,2,0,0,0,0,16601,6.6,17498,204,56,696,391,26.0,1660.1,19,0,1,4,5,6,1,1,0,0,15905,7.0,17107,224,49,-696,-391,27.3,1590.5
4805037282,1,13,0,1,6,6,3,0,0,0,0,17504,7.2,18492,234,51,1204,42,28.5,1750.4,14,0,0,6,6,3,0,0,0,0,16300,7.0,18450,215,56,-1204,-42,27.1,1630.0
4858331546,1,29,0,1,17,15,22,0,0,0,0,64935,12.0,55000,6,0,28056,22000,0.6,6493.5,1,2,0,11,13,5,0,0,0,0,36879,7.2,33000,0,0,-28056,-22000,0.0,3687.9
4858197802,0,0,0,1,21,19,51,0,0,0,1,36709,10.8,39915,117,0,-602,-90,11.7,3670.9,0,0,0,19,21,53,0,0,0,0,37311,11.0,40005,103,0,602,90,10.3,3731.1
4858035031,1,0,0,0,16,18,38,0,0,0,0,33912,10.8,37435,108,0,-3100,-1554,10.8,3391.2,0,0,1,18,16,50,0,0,0,0,37012,11.0,38989,115,0,3100,1554,11.5,3701.2
4857493748,0,0,0,1,26,27,52,0,0,0,1,37934,11.0,38709,109,0,-566,-4693,10.9,3793.4,0,0,0,27,26,83,0,0,0,0,38500,11.6,43402,113,0,566,4693,11.3,3850.0
4857455683,1,0,0,1,32,33,91,0,0,0,2,40753,11.6,43486,105,0,286,-2992,10.5,4075.3,0,0,0,33,32,85,0,0,0,0,40467,12.2,46478,113,0,-286,2992,11.3,4046.7
4857193624,0,35,0,0,30,29,84,0,0,0,0,39365,11.2,41896,109,0,-1069,-3075,10.9,3936.5,0,0,1,29,30,66,0,0,0,0,40434,11.8,44971,106,0,1069,3075,10.6,4043.4
4856914798,1,22,0,1,31,22,84,0,0,0,2,38773,11.4,42693,109,0,1119,4164,10.9,3877.3,0,2,0,22,31,57,0,0,0,0,37654,10.8,38529,110,0,-1119,-4164,11.0,3765.4
4856598231,1,0,0,1,36,32,98,0,0,0,2,43499,12.2,48091,109,0,3425,3765,10.9,4349.9,0,0,0,32,36,76,0,0,0,0,40074,11.6,44326,118,0,-3425,-3765,11.8,4007.4
4856587498,1,18,0,1,27,18,77,0,0,0,3,40282,11.6,43937,115,0,4995,5720,11.5,4028.2,0,0,0,18,27,36,0,0,0,0,35287,10.8,38217,103,0,-4995,-5720,10.3,3528.7
4855707926,0,0,0,1,32,32,100,0,0,0,0,41125,12.0,46285,98,0,2730,2676,9.8,4112.5,0,0,0,32,32,88,0,0,0,0,38395,11.4,43609,113,0,-2730,-2676,11.3,3839.5
4855689957,0,0,0,0,37,30,96,0,0,0,0,39314,12.0,45346,100,0,1019,2506,10.0,3931.4,0,0,1,30,37,81,0,0,0,0,38295,11.4,42840,96,0,-1019,-2506,9.6,3829.5
4855484140,1,12,0,0,31,28,86,0,0,0,0,41286,11.8,44638,118,0,3116,1090,11.8,4128.6,0,0,1,28,31,84,0,0,0,0,38170,11.6,43548,109,0,-3116,-1090,10.9,3817.0
4855434111,0,0,7,0,21,28,57,0,0,0,1,34993,10.8,36971,99,0,-5441,-5620,9.9,3499.3,26,0,1,28,21,74,0,0,0,0,40434,11.4,42591,116,0,5441,5620,11.6,4043.4
4854236200,1,21,0,0,17,20,44,0,0,0,2,35753,10.8,38576,114,0,-737,-787,11.4,3575.3,0,0,1,20,17,53,0,0,0,0,36490,11.0,39363,102,0,737,787,10.2,3649.0
4854205332,0,19,0,0,22,24,58,0,0,0,1,36551,11.2,39772,90,0,-2831,-1084,9.0,3655.1,0,0,1,24,22,70,0,0,0,0,39382,11.0,40856,93,0,2831,1084,9.3,3938.2
4854151296,1,17,1,1,5,4,3,0,0,0,0,16634,7.0,18629,222,64,1559,797,28.6,1663.4,21,2,0,4,5,3,0,0,0,0,15075,6.8,17832,199,60,-1559,-797,25.9,1507.5
4854100181,0,14,1,1,5,5,3,0,0,0,0,15577,6.8,16968,185,47,-1466,-1473,23.2,1557.7,17,2,0,5,5,4,1,1,0,0,17043,7.0,18441,213,61,1466,1473,27.4,1704.3
4854071518,0,0,0,1,30,29,78,0,0,0,2,39170,11.6,43395,101,0,-1496,132,10.1,3917.0,2,0,0,28,29,68,0,0,0,0,40666,11.4,43263,110,0,1496,-132,11.0,4066.6
4854042973,0,0,0,1,17,31,34,0,0,0,1,34352,10.4,36476,84,0,-8770,-8196,8.4,3435.2,0,0,0,31,17,96,0,0,0,0,43122,12.0,44672,122,0,8770,8196,12.2,4312.2
4853138748,1,14,1,0,1,3,1,0,0,0,0,13797,6.6,16326,201,52,-4236,-2731,25.3,1379.7,12,1,1,3,1,1,0,0,0,0,18033,7.2,19057,247,40,4236,2731,28.7,1803.3
4849750962,1,14,2,1,3,0,3,0,0,0,0,14828,6.6,17473,212,52,697,111,26.4,1482.8,12,4,0,0,3,0,0,0,0,0,14131,6.8,17362,215,67,-697,-111,28.2,1413.1
4849725743,1,14,0,0,12,6,16,0,0,0,0,19026,6.8,16629,199,43,3124,1342,24.2,1902.6,14,1,1,6,12,6,0,0,0,0,15902,6.0,15287,166,64,-3124,-1342,23.0,1590.2
4849688270,1,12,1,1,6,4,1,0,0,0,0,17417,7.2,18557,231,56,1733,1001,28.7,1741.7,14,0,0,4,6,4,1,1,0,0,15684,6.8,17556,175,64,-1733,-1001,23.9,1568.4
4849664199,1,14,1,1,7,5,4,1,0,1,0,17578,7.0,19059,221,72,1679,1162,29.3,1757.8,12,2,0,5,7,6,1,1,0,0,15899,6.8,17897,210,60,-1679,-1162,27.0,1589.9
4843842269,0,12,3,0,5,3,4,0,0,0,0,15771,7.0,18886,224,48,-19,537,27.2,1577.1,13,2,1,3,5,2,0,0,0,0,15790,7.0,18349,208,55,19,-537,26.3,1579.0
4838559680,0,7,0,0,21,23,59,0,0,0,1,38600,11.4,41728,112,0,366,1516,11.2,3860.0,0,0,1,23,21,58,0,0,0,0,38234,11.0,40212,107,0,-366,-1516,10.7,3823.4
4838553574,0,0,0,1,35,45,63,0,0,0,2,41518,12.0,46339,114,0,-2408,-3756,11.4,4151.8,18,0,0,45,35,107,0,0,0,0,43926,12.6,50095,118,0,2408,3756,11.8,4392.6
4838549432,1,0,0,1,27,22,70,0,0,0,2,39006,11.6,42249,112,0,7,-1136,11.2,3900.6,0,0,0,22,27,48,0,0,0,0,38999,11.4,43385,106,0,-7,1136,10.6,3899.9
4838540593,0,0,0,1,29,26,77,0,0,0,0,37915,11.6,42556,113,0,-29,1298,11.3,3791.5,0,0,0,26,29,46,0,0,0,0,37944,11.2,41258,104,0,29,-1298,10.4,3794.4
4838533697,0,17,0,0,22,29,54,0,0,0,0,37952,11.6,42059,103,0,-998,-2126,10.3,3795.2,0,12,1,29,22,89,0,0,0,0,38950,12.0,44185,121,0,998,2126,12.1,3895.0
4838530315,0,0,0,0,17,27,46,0,0,0,1,36779,11.0,39105,109,0,-2290,-3846,10.9,3677.9,0,0,1,27,17,86,0,0,0,0,39069,11.4,42951,106,0,2290,3846,10.6,3906.9
4838520584,0,0,0,1,24,12,58,0,0,0,2,37253,10.8,39351,108,0,1681,2575,10.8,3725.3,157,0,0,12,24,32,0,0,0,0,35572,10.6,36776,109,0,-1681,-2575,10.9,3557.2
4838513377,0,0,0,0,21,34,60,0,0,0,2,36303,11.0,39133,99,0,-3983,-7017,9.9,3630.3,2,0,1,34,21,81,0,0,0,0,40286,12.0,46150,103,0,3983,7017,10.3,4028.6
4838508056,0,0,0,0,24,35,70,0,0,0,2,39710,11.4,41754,103,0,-2332,-4245,10.3,3971.0,67,0,1,35,24,101,0,0,0,0,42042,11.8,45999,121,0,2332,4245,12.1,4204.2
4837392538,0,0,0,0,13,18,37,0,0,0,1,35530,10.6,37211,100,0,-2827,-2333,10.0,3553.0,8,0,1,18,13,59,0,0,0,0,38357,11.0,39544,129,0,2827,2333,12.9,3835.7
4837389880,0,34,4,1,16,23,48,0,0,0,1,35127,11.0,38587,101,0,-2846,-3452,10.1,3512.7,53,0,0,23,16,57,0,0,0,0,37973,11.4,42039,97,0,2846,3452,9.7,3797.3
4837335263,1,10,2,1,7,9,4,1,1,0,0,16491,6.8,17468,198,63,-2336,-991,26.1,1649.1,11,0,0,9,7,10,0,0,0,0,18827,7.0,18459,207,45,2336,991,25.2,1882.7
4837301417,0,11,1,1,1,1,2,2,1,1,0,14595,7.2,18189,231,56,-472,-310,28.7,1459.5,15,0,0,1,1,1,0,0,0,0,15067,7.0,18499,232,56,472,310,28.8,1506.7
4837278821,0,22,3,0,3,2,3,0,0,0,0,14945,7.0,17632,213,52,-1546,-2645,26.5,1494.5,15,2,1,2,3,1,1,1,0,0,16491,7.6,20277,242,72,1546,2645,31.4,1649.1
4836266189,1,14,3,1,6,2,7,0,0,0,0,16164,7.0,18825,196,60,626,-53,25.6,1616.4,13,1,0,2,6,1,0,0,0,0,15538,7.0,18878,255,55,-626,53,31.0,1553.8
4846768893,1,13,1,1,10,4,13,0,0,0,0,18869,7.2,19092,223,76,2992,1459,29.9,1886.9,104,0,0,4,10,3,0,0,0,0,15877,7.0,17633,219,62,-2992,-1459,28.1,1587.7
4840389652,0,13,3,0,2,7,2,0,0,0,0,15347,6.8,17297,228,56,-2179,-337,28.4,1534.7,20,1,1,7,2,6,0,0,0,0,17526,6.8,17634,226,47,2179,337,27.3,1752.6
4835019727,0,35,1,0,1,5,0,0,0,0,0,14678,7.0,17768,217,60,-1410,7,27.7,1467.8,12,11,1,5,1,4,1,1,0,0,16088,7.0,17761,224,55,1410,-7,27.9,1608.8
4834983215,0,11,0,1,10,8,14,0,0,0,0,19848,7.2,18720,227,56,1240,193,28.3,1984.8,9,1,0,8,10,5,1,1,0,0,18608,7.2,18527,227,60,-1240,-193,28.7,1860.8
4834943817,1,18,0,0,5,12,2,0,0,0,0,16390,6.8,17053,213,55,-3963,-1673,26.8,1639.0,16,1,1,12,5,12,1,1,0,0,20353,7.2,18726,238,56,3963,1673,29.4,2035.3
4834907408,0,12,0,0,6,10,6,0,0,0,0,16765,7.0,18199,215,54,-3154,-1669,26.9,1676.5,9,1,1,10,6,9,0,0,0,0,19919,7.2,19868,237,54,3154,1669,29.1,1991.9
4834494164,0,36,2,0,3,4,5,0,0,0,0,15166,6.6,17177,230,52,-1798,-1561,28.2,1516.6,41,1,1,4,3,6,1,1,0,0,16964,7.2,18738,222,60,1798,1561,28.2,1696.4
4834478981,0,11,4,0,2,2,1,0,0,0,0,15598,7.0,19179,249,56,525,1315,30.5,1559.8,14,0,1,2,2,2,1,1,0,0,15073,6.8,17864,225,64,-525,-1315,28.9,1507.3
4833906733,0,12,0,1,5,5,3,1,0,1,0,16808,7.0,18761,231,69,-165,-196,30.0,1680.8,15,1,0,5,5,4,0,0,0,0,16973,7.2,18957,238,52,165,196,29.0,1697.3
4832636762,1,15,1,0,1,3,0,0,0,0,0,15183,7.4,19700,254,76,-762,780,33.0,1518.3,11,3,1,3,1,5,2,1,1,0,15945,7.2,18920,248,56,762,-780,30.4,1594.5
4832610273,0,54,0,0,2,3,1,0,0,0,0,14987,7.0,18775,193,58,-725,1203,25.1,1498.7,16,2,1,3,2,3,0,0,0,0,15712,6.8,17572,235,53,725,-1203,28.8,1571.2
4832589540,1,57,3,0,6,7,5,1,1,0,0,16465,7.0,18295,226,60,-713,191,28.6,1646.5,13,3,1,7,6,3,0,0,0,0,17178,7.2,18104,221,60,713,-191,28.1,1717.8
4831692890,1,56,2,1,4,3,5,0,0,0,0,15477,7.0,17074,196,64,-140,-783,26.0,1547.7,12,2,0,3,4,3,0,0,0,0,15617,7.0,17857,250,56,140,783,30.6,1561.7
4831544012,1,14,2,0,3,7,1,1,1,0,0,15190,6.8,17469,206,52,-1692,-1497,25.8,1519.0,17,2,1,7,3,7,0,0,0,0,16882,7.2,18966,236,56,1692,1497,29.2,1688.2
4831512204,0,17,6,1,9,11,10,1,1,0,0,18579,7.0,17966,220,48,-577,725,26.8,1857.9,14,1,0,11,9,10,0,0,0,0,19156,6.8,17241,200,64,577,-725,26.4,1915.6
4831481365,0,12,3,1,6,6,8,1,0,1,0,16426,6.6,16834,204,57,-456,-1475,26.1,1642.6,12,3,0,6,6,3,0,0,0,0,16882,6.8,18309,247,62,456,1475,30.9,1688.2
4831456991,0,13,1,1,5,6,5,0,0,0,0,16321,7.0,17230,220,52,-1193,-417,27.2,1632.1,29,1,0,6,5,4,0,0,0,0,17514,6.8,17647,209,63,1193,417,27.2,1751.4
4831411949,0,20,2,0,7,9,8,0,0,0,0,16525,6.4,15722,191,35,-1234,-2706,22.6,1652.5,12,1,1,9,7,6,1,1,0,0,17759,7.0,18428,224,64,1234,2706,28.8,1775.9
4831376973,0,11,0,0,1,10,1,0,0,0,0,13505,6.4,15526,217,40,-5024,-2600,25.7,1350.5,12,1,1,10,1,16,0,0,0,0,18529,7.0,18126,224,60,5024,2600,28.4,1852.9
4831330429,0,13,1,0,4,9,6,0,0,0,0,16155,6.6,16568,197,66,-2046,-120,26.3,1615.5,27,1,1,9,4,14,0,0,0,0,18201,6.6,16688,232,46,2046,120,27.8,1820.1
4849573429,1,54,0,1,6,7,5,0,0,0,0,16583,7.0,18357,235,53,-1196,-691,28.8,1658.3,10,3,0,7,6,8,1,1,0,0,17779,7.2,19048,251,60,1196,691,31.1,1777.9
4849552635,1,11,0,1,13,12,12,1,1,0,0,19773,7.0,17756,203,39,-25,-308,24.2,1977.3,16,3,0,11,12,11,0,0,0,0,19798,7.0,18064,208,52,25,308,26.0,1979.8
4849540912,0,11,2,0,2,9,2,0,0,0,0,14391,6.6,16794,188,51,-4059,-1928,23.9,1439.1,13,2,1,9,2,7,0,0,0,0,18450,7.0,18722,230,44,4059,1928,27.4,1845.0
4849310204,0,15,1,0,4,6,4,0,0,0,0,16275,7.0,17700,249,51,238,-1882,30.0,1627.5,10,0,1,6,4,3,0,0,0,0,16037,7.4,19582,219,51,-238,1882,27.0,1603.7
4849290378,1,13,0,1,5,6,3,0,0,0,0,15936,6.8,17120,217,53,-10,-1340,27.0,1593.6,22,1,0,6,5,2,0,0,0,0,15946,7.2,18460,199,57,10,1340,25.6,1594.6
4849262583,0,15,1,1,6,6,11,0,0,0,0,18694,6.8,17328,222,44,752,-292,26.6,1869.4,16,1,0,6,6,6,1,0,1,0,17942,7.0,17620,244,55,-752,292,29.9,1794.2
4847068389,1,9,0,0,3,8,4,2,1,1,0,15205,6.8,16852,240,37,-2396,-781,27.7,1520.5,9,0,1,8,3,10,0,0,0,0,17601,6.8,17633,227,52,2396,781,27.9,1760.1
4847006387,1,14,0,1,3,2,7,0,0,0,0,16249,6.4,16148,204,48,828,-911,25.2,1624.9,14,3,0,2,3,1,0,0,0,0,15421,6.8,17059,212,54,-828,911,26.6,1542.1
4846963109,0,15,1,1,3,6,1,0,0,0,0,16255,7.2,18859,231,60,-1966,-384,29.1,1625.5,23,2,0,6,3,6,1,1,0,0,18221,7.2,19243,250,60,1966,384,31.0,1822.1
4846912375,0,11,1,1,3,7,5,1,0,1,0,16926,6.8,17939,202,66,-1643,-899,26.8,1692.6,15,0,0,7,3,9,1,1,0,0,18569,7.2,18838,246,60,1643,899,30.6,1856.9
4846883902,1,12,1,0,8,5,4,1,0,1,0,19896,7.4,19838,249,68,4060,3255,31.7,1989.6,13,0,1,5,8,8,1,1,0,0,15836,6.8,16583,217,48,-4060,-3255,26.5,1583.6
4846809724,1,13,1,1,8,4,14,1,1,0,0,19267,6.8,18063,196,52,2997,998,24.8,1926.7,11,1,0,4,8,7,0,0,0,0,16270,6.8,17065,198,50,-2997,-998,24.8,1627.0
4846778348,0,12,0,1,4,5,5,0,0,0,0,16353,7.0,18141,249,59,-1172,-1212,30.8,1635.3,16,0,0,5,4,5,1,1,0,0,17525,7.4,19353,237,75,1172,1212,31.2,1752.5
4846086843,0,10,2,0,1,5,1,0,0,0,0,15260,6.6,17990,234,58,-519,489,29.2,1526.0,15,1,1,5,1,10,0,0,0,0,15779,6.8,17501,225,41,519,-489,26.6,1577.9
4846047830,0,22,1,0,4,8,4,0,0,0,0,14564,6.4,15545,180,40,-2580,-998,22.0,1456.4,10,2,1,8,4,10,1,1,0,0,17144,6.6,16543,186,47,2580,998,23.3,1714.4
4845997350,1,10,3,0,7,7,9,0,0,0,0,17165,7.0,17902,223,48,-1313,-1139,27.1,1716.5,85,2,1,7,7,8,1,1,0,0,18478,7.2,19041,217,57,1313,1139,27.4,1847.8
4845967314,1,14,0,1,7,5,9,0,0,0,0,17968,7.0,18337,222,51,2107,471,27.3,1796.8,14,1,0,5,7,6,1,1,0,0,15861,6.8,17866,193,64,-2107,-471,25.7,1586.1
4845928698,0,21,3,0,3,6,1,0,0,0,0,15521,7.0,17694,182,48,-3100,-2139,23.0,1552.1,11,3,1,6,3,5,0,0,0,0,18621,7.2,19833,248,68,3100,2139,31.6,1862.1
4845762058,0,99,0,0,5,6,4,0,0,0,0,16526,7.0,18003,207,52,-357,-1141,25.9,1652.6,30,0,1,6,5,4,1,1,0,0,16883,7.2,19144,201,47,357,1141,24.8,1688.3
4845740460,1,13,2,0,7,4,8,0,0,0,0,17983,6.8,17631,212,64,1894,594,27.6,1798.3,13,0,1,4,7,2,0,0,0,0,16089,6.6,17037,211,48,-1894,-594,25.9,1608.9
4845009148,0,17,1,0,1,6,1,0,0,0,0,14662,7.0,18655,208,71,-2834,-541,27.9,1466.2,14,2,1,6,1,5,1,1,0,0,17496,7.2,19196,230,68,2834,541,29.8,1749.6
4830319853,0,14,3,0,1,6,2,1,0,1,0,16035,7.0,18236,250,52,-777,339,30.2,1603.5,17,2,1,6,1,3,1,1,0,0,16812,6.8,17897,237,51,777,-339,28.8,1681.2
4830285099,1,14,0,1,12,8,10,0,0,0,0,21319,7.2,19569,225,64,3190,3917,28.9,2131.9,12,1,0,8,12,6,2,1,1,0,18129,6.2,15652,155,49,-3190,-3917,20.4,1812.9
4829374493,0,18,1,0,6,7,8,0,0,0,0,16885,7.2,18196,204,64,-17,641,26.8,1688.5,15,1,1,7,6,6,0,0,0,0,16902,6.8,17555,209,60,17,-641,26.9,1690.2
4828383147,0,33,2,1,4,4,2,1,0,1,0,17551,7.0,18167,222,40,1738,601,26.2,1755.1,30,0,0,4,4,4,0,0,0,0,15813,7.0,17566,229,59,-1738,-601,28.8,1581.3
4826413364,1,17,0,1,10,3,11,0,0,0,0,18978,7.6,19659,228,68,3701,1629,29.6,1897.8,11,3,0,3,10,2,1,1,0,0,15277,7.0,18030,223,64,-3701,-1629,28.7,1527.7
4824525573,0,12,1,0,7,5,8,0,0,0,0,17820,6.6,18081,243,59,250,-254,30.2,1782.0,16,0,1,5,7,4,0,0,0,0,17570,6.8,18335,227,49,-250,254,27.6,1757.0
4822715741,0,13,2,0,3,7,7,0,0,0,0,15718,6.8,17122,212,75,-1495,-1288,28.7,1571.8,15,1,1,7,3,5,1,1,0,0,17213,7.0,18410,234,52,1495,1288,28.6,1721.3
4816005369,1,12,2,0,6,3,7,0,0,0,0,15939,7.0,18153,197,68,637,2030,26.5,1593.9,24,1,1,3,6,3,0,0,0,0,15302,6.4,16123,182,56,-637,-2030,23.8,1530.2
4814984846,0,19,0,0,3,6,3,0,0,0,0,16888,6.8,17438,228,48,-109,-1610,27.6,1688.8,10,4,1,6,3,3,1,1,0,0,16997,7.0,19048,215,68,109,1610,28.3,1699.7
4813009708,0,27,4,0,11,6,13,0,0,0,0,18878,7.0,18450,231,40,1813,864,27.1,1887.8,12,4,1,5,10,7,1,1,0,0,17065,6.8,17586,220,48,-1813,-864,26.8,1706.5
4811021611,0,13,3,0,6,7,8,1,0,1,0,17335,7.0,17819,219,56,-1519,-1557,27.5,1733.5,13,1,1,7,6,9,1,1,0,0,18854,7.2,19376,240,68,1519,1557,30.8,1885.4
4809150398,1,15,1,0,6,8,2,1,1,0,0,17543,7.0,18233,211,47,519,307,25.8,1754.3,13,1,1,8,6,4,0,0,0,0,17024,6.8,17926,182,56,-519,-307,23.8,1702.4
4808130848,1,15,1,1,6,1,7,0,0,0,0,17513,7.0,18890,208,68,4108,3934,27.6,1751.3,11,2,0,1,6,0,1,1,0,0,13405,6.2,14956,194,47,-4108,-3934,24.1,1340.5
4806124263,0,11,0,0,4,3,2,0,0,0,0,16246,6.8,17792,238,56,-503,-1095,29.4,1624.6,11,1,1,3,4,2,1,1,0,0,16749,7.0,18887,232,63,503,1095,29.5,1674.9
4804273352,1,13,1,1,3,6,2,0,0,0,0,14678,6.6,16777,216,56,-1947,-2427,27.2,1467.8,12,1,0,6,3,3,0,0,0,0,16625,7.2,19204,210,55,1947,2427,26.5,1662.5
4802509001,0,9,1,1,4,6,3,0,0,0,0,16333,6.8,17011,193,53,-1589,-1719,24.6,1633.3,21,0,0,6,4,7,1,1,0,0,17922,7.0,18730,219,78,1589,1719,29.7,1792.2
4801556453,1,11,0,1,9,0,6,0,0,0,1,20136,7.4,20272,262,68,6780,3925,33.0,2013.6,11,0,0,0,9,0,0,0,0,0,13356,6.6,16347,217,48,-6780,-3925,26.5,1335.6
4799459639,1,13,2,0,3,2,3,0,0,0,0,16354,7.2,20109,260,72,1255,1843,33.2,1635.4,8,3,1,2,3,2,0,0,0,0,15099,7.2,18266,244,69,-1255,-1843,31.3,1509.9
4797618507,0,34,2,0,4,3,3,0,0,0,0,16023,6.8,17116,211,49,-81,490,26.0,1602.3,32,2,1,3,4,2,0,0,0,0,16104,6.4,16626,213,54,81,-490,26.7,1610.4
4857427107,1,12,1,0,11,10,10,0,0,0,0,18452,6.8,17466,191,56,-1071,1519,24.7,1845.2,84,1,1,10,11,13,1,1,0,0,19523,6.6,15947,191,39,1071,-1519,23.0,1952.3
4855350541,1,6,0,0,14,16,18,0,0,0,0,49550,12.0,55000,0,0,20100,22000,0.0,4955.0,0,0,1,10,8,9,0,0,0,0,29450,7.2,33000,0,0,-20100,-22000,0.0,2945.0
4855334949,1,4,0,1,15,21,20,0,0,0,0,47000,10.0,47500,0,0,17400,19000,0.0,4700.0,56,0,0,15,9,11,0,0,0,0,29600,6.0,28500,0,0,-17400,-19000,0.0,2960.0
4855299515,1,39,0,1,12,12,17,0,0,0,0,30600,9.0,40000,0,0,12000,16000,0.0,3060.0,0,0,0,8,8,5,0,0,0,0,18600,5.4,24000,2,0,-12000,-16000,0.2,1860.0
4855281904,1,34,0,1,17,12,22,0,0,0,0,62950,12.0,55000,5,0,26400,21000,0.5,6295.0,9,0,0,6,11,9,0,0,0,0,36550,7.4,34000,1,0,-26400,-21000,0.1,3655.0
4855139206,1,14,0,1,14,17,16,0,0,0,0,46300,10.0,47500,0,0,18100,19000,0.0,4630.0,0,0,0,10,7,8,0,0,0,0,28200,6.0,28500,0,0,-18100,-19000,0.0,2820.0
4853070898,1,0,0,1,20,15,21,0,0,0,0,64100,12.0,55000,0,0,26900,22000,0.0,6410.0,0,0,0,9,14,7,0,0,0,0,37200,7.2,33000,0,0,-26900,-22000,0.0,3720.0
4853041221,1,0,0,0,15,18,13,0,0,0,0,60956,12.0,55000,2,0,18506,22000,0.2,6095.6,2,0,1,13,10,12,0,0,0,0,42450,7.2,33000,0,0,-18506,-22000,0.0,4245.0
4846663931,1,21,1,0,13,4,11,0,0,0,0,22407,7.2,18718,236,43,6900,4223,27.9,2240.7,11,1,1,4,13,11,0,0,0,0,15507,6.0,14495,180,48,-6900,-4223,22.8,1550.7
4844388796,1,13,0,0,3,2,3,1,1,0,0,13990,7.2,18538,175,52,-1304,12,22.7,1399.0,12,0,1,2,3,1,0,0,0,0,15294,7.2,18526,223,56,1304,-12,27.9,1529.4
4844334003,0,11,1,0,7,3,7,0,0,0,0,15722,7.0,17837,166,36,1302,1844,20.2,1572.2,13,0,1,3,7,0,0,0,0,0,14420,6.2,15993,185,44,-1302,-1844,22.9,1442.0
4844294117,1,12,0,1,10,7,7,0,0,0,0,18168,7.0,18607,242,40,1174,1894,28.2,1816.8,8,0,0,7,10,6,0,0,0,0,16994,6.6,16713,212,52,-1174,-1894,26.4,1699.4
4844243243,0,102,1,1,3,1,1,1,1,0,0,15442,7.2,18401,211,52,915,1277,26.3,1544.2,9,0,0,1,3,1,0,0,0,0,14527,6.8,17124,221,64,-915,-1277,28.5,1452.7
4844183485,0,16,2,1,9,3,13,1,1,0,0,18372,6.8,17442,175,48,3875,423,22.3,1837.2,101,2,0,3,9,2,0,0,0,0,14497,6.6,17019,188,59,-3875,-423,24.7,1449.7
4842044837,0,14,0,0,2,8,3,1,0,1,0,13988,6.4,15694,186,54,-4473,-3181,24.0,1398.8,21,1,1,8,2,12,1,1,0,0,18461,7.2,18875,228,51,4473,3181,27.9,1846.1
4842009931,1,18,0,1,8,1,10,1,1,0,0,18157,7.2,19427,250,53,3551,2244,30.3,1815.7,9,0,0,1,8,1,0,0,0,0,14606,6.6,17183,226,56,-3551,-2244,28.2,1460.6
4841981718,0,10,0,0,4,4,2,0,0,0,0,14766,6.6,16904,199,56,-2396,-1757,25.5,1476.6,18,1,1,4,4,4,0,0,0,0,17162,7.0,18661,248,47,2396,1757,29.5,1716.2
4841961849,1,21,1,0,8,3,11,0,0,0,0,17009,6.8,17647,210,49,2416,1331,25.9,1700.9,8,1,1,2,7,2,0,0,0,0,14593,6.6,16316,233,40,-2416,-1331,27.3,1459.3
4841348861,0,15,1,0,5,8,2,0,0,0,0,15011,6.8,16545,163,52,-2733,-3489,21.5,1501.1,11,3,1,7,4,2,0,0,0,0,17744,7.2,20034,241,70,2733,3489,31.1,1774.4
4840743707,0,9,1,1,10,5,7,0,0,0,0,18457,6.6,17925,180,48,3123,1108,22.8,1845.7,13,0,0,5,10,2,0,0,0,0,15334,6.6,16817,181,52,-3123,-1108,23.3,1533.4
4857275395,0,53,24,0,6,6,4,0,0,0,0,17914,7.2,18596,208,60,998,1098,26.8,1791.4,41,2,1,6,6,8,0,0,0,0,16916,7.0,17498,224,49,-998,-1098,27.3,1691.6
4857159575,0,0,0,0,27,28,64,0,0,0,0,37178,11.2,40290,105,0,-2003,-3235,10.5,3717.8,88,0,1,28,27,73,0,0,0,0,39181,11.6,43525,120,0,2003,3235,12.0,3918.1
4857130666,1,0,0,0,32,26,89,0,0,0,1,40286,12.0,45675,117,0,2524,4928,11.7,4028.6,0,0,1,26,32,68,0,0,0,0,37762,11.0,40747,105,0,-2524,-4928,10.5,3776.2
4856097686,1,0,0,0,25,28,58,0,0,0,1,36991,11.2,40154,110,0,-615,-1144,11.0,3699.1,15,0,1,27,24,77,0,0,0,0,37606,11.2,41298,94,0,615,1144,9.4,3760.6
4856066508,0,0,1,0,20,31,49,0,0,0,2,36716,11.2,41021,105,0,-2722,-2306,10.5,3671.6,14,0,1,31,20,90,0,0,0,0,39438,11.6,43327,113,0,2722,2306,11.3,3943.8
4855154706,1,9,10,1,7,2,6,2,1,1,0,17463,7.2,19113,230,64,1852,1555,29.4,1746.3,34,1,0,2,7,0,0,0,0,0,15611,6.8,17558,240,56,-1852,-1555,29.6,1561.1
4855103383,0,15,1,1,7,0,7,1,1,0,0,17209,7.2,18674,238,60,3244,1588,29.8,1720.9,13,1,0,0,7,0,0,0,0,0,13965,6.8,17086,202,56,-3244,-1588,25.8,1396.5
4854735877,1,10,0,0,20,21,70,0,0,0,1,36462,11.0,39550,95,0,422,620,9.5,3646.2,59,0,1,21,20,44,0,0,0,0,36040,10.8,38930,74,0,-422,-620,7.4,3604.0
4854715413,0,0,0,1,24,21,75,0,0,0,0,35743,11.0,40362,97,0,-536,1875,9.7,3574.3,7,0,0,21,24,65,0,0,0,0,36279,10.6,38487,108,0,536,-1875,10.8,3627.9
4854680682,0,0,0,0,19,27,46,0,0,0,0,37315,11.0,39298,108,0,-1687,-2754,10.8,3731.5,0,0,1,27,19,66,0,0,0,0,39002,11.4,42052,124,0,1687,2754,12.4,3900.2
4852391863,0,0,0,1,17,19,37,0,0,0,1,38608,11.2,40494,129,0,2176,1803,12.9,3860.8,0,0,0,19,17,44,0,0,0,0,36432,11.0,38691,95,0,-2176,-1803,9.5,3643.2
4852372598,0,0,0,0,23,28,56,0,0,0,0,36935,11.4,41565,101,0,-711,-702,10.1,3693.5,0,0,1,28,23,65,0,0,0,0,37646,11.4,42267,108,0,711,702,10.8,3764.6
4852369780,0,38,0,1,12,20,33,0,0,0,2,34237,10.4,36264,82,0,-1694,-1428,8.2,3423.7,0,1,0,20,12,51,0,0,0,0,35931,10.8,37692,107,0,1694,1428,10.7,3593.1
4852357341,1,0,0,0,19,17,55,0,0,0,0,36800,10.8,37890,122,0,1711,-1806,12.2,3680.0,0,0,1,17,19,37,0,0,0,0,35089,11.0,39696,101,0,-1711,1806,10.1,3508.9
4852344409,0,1,0,1,25,28,64,0,0,0,2,39874,11.6,42033,115,0,65,100,11.5,3987.4,0,1,0,28,25,67,0,0,0,0,39809,11.6,41933,109,0,-65,-100,10.9,3980.9
4851475722,1,2,0,1,31,31,74,0,0,0,0,39023,11.6,44960,111,0,432,1518,11.1,3902.3,0,0,0,31,31,88,0,0,0,0,38591,11.8,43442,103,0,-432,-1518,10.3,3859.1
4850587072,1,0,0,1,37,24,105,0,0,0,1,40668,12.4,47967,115,0,3947,6549,11.5,4066.8,0,0,0,24,37,54,0,0,0,0,36721,11.2,41418,90,0,-3947,-6549,9.0,3672.1
4850416036,1,64,0,1,7,5,6,0,0,0,0,16448,6.6,17408,193,40,1747,2278,23.3,1644.8,103,1,0,5,7,6,0,0,0,0,14701,6.2,15130,170,36,-1747,-2278,20.6,1470.1
4850400232,1,120,2,1,4,8,0,1,0,1,0,16678,6.6,18038,191,52,-606,-492,24.3,1667.8,36,0,0,8,4,7,0,0,0,0,17284,7.0,18530,196,56,606,492,25.2,1728.4
4848342779,1,56,2,1,7,8,7,0,0,0,0,17066,7.2,18505,206,44,-146,-122,25.0,1706.6,19,2,0,8,7,1,1,0,1,0,17212,6.8,18627,203,48,146,122,25.1,1721.2
4853742775,0,14,0,1,3,2,3,1,1,0,0,16503,7.4,19626,248,76,2325,2186,32.4,1650.3,10,1,0,2,3,3,0,0,0,0,14178,6.8,17440,172,64,-2325,-2186,23.6,1417.8
4853686028,0,13,1,0,6,7,8,0,0,0,0,16766,6.8,17294,203,48,-1551,-1423,25.1,1676.6,67,4,1,7,6,5,2,1,1,0,18317,7.2,18717,228,72,1551,1423,30.0,1831.7
4853649891,1,13,10,0,4,7,2,1,1,0,0,15072,6.6,17161,191,54,-2101,-1259,24.5,1507.2,35,0,1,7,4,5,0,0,0,0,17173,7.4,18420,216,56,2101,1259,27.2,1717.3
4853614639,0,16,1,1,6,6,8,1,1,0,0,15482,7.0,17178,207,55,-2614,-1260,26.2,1548.2,15,1,0,6,6,7,1,0,1,0,18096,7.0,18438,260,55,2614,1260,31.5,1809.6
4853203230,1,0,0,1,21,17,18,0,0,0,0,48750,10.0,47500,0,0,20900,19000,0.0,4875.0,3,0,0,6,10,8,0,0,0,0,27850,6.0,28500,0,0,-20900,-19000,0.0,2785.0
4853195331,1,0,0,1,23,14,26,0,0,0,0,64543,12.8,61000,0,0,29093,25000,0.0,6454.3,10,0,0,7,16,6,0,0,0,0,35450,7.6,36000,0,0,-29093,-25000,0.0,3545.0
4853188203,1,0,0,1,14,21,24,0,0,0,0,77410,15.0,70000,0,0,35196,31000,0.0,7741.0,0,0,0,18,11,9,0,0,0,0,42214,8.2,39000,1,0,-35196,-31000,0.1,4221.4
4853177381,1,0,0,1,18,23,15,0,0,0,0,61650,12.8,61000,0,0,23400,25000,0.0,6165.0,0,0,0,13,8,16,0,0,0,0,38250,7.6,36000,0,0,-23400,-25000,0.0,3825.0
4853166188,1,6,0,1,24,24,21,0,0,0,0,47800,10.0,47500,2,0,18850,19000,0.2,4780.0,41,0,0,12,12,18,0,0,0,0,28950,6.0,28500,1,0,-18850,-19000,0.1,2895.0
4853151317,1,0,0,1,20,20,30,0,0,0,0,64830,13.0,62500,0,0,26876,25000,0.0,6483.0,0,0,0,14,14,8,0,0,0,0,37954,7.8,37500,0,0,-26876,-25000,0.0,3795.4
4853130303,1,352,0,1,16,16,15,0,0,0,0,46650,10.0,47500,0,0,17700,19000,0.0,4665.0,5,0,0,11,11,12,0,0,0,0,28950,6.0,28500,0,0,-17700,-19000,0.0,2895.0
4852626769,1,25,0,1,7,6,3,0,0,0,0,18399,7.2,18873,230,50,2654,919,28.0,1839.9,9,0,0,6,7,2,0,0,0,0,15745,6.8,17954,212,47,-2654,-919,25.9,1574.5
4852567572,1,15,1,0,4,6,7,0,0,0,0,15752,6.8,16908,197,47,-2498,-2720,24.4,1575.2,26,2,1,6,4,6,1,0,1,0,18250,7.4,19628,261,63,2498,2720,32.4,1825.0
4852532000,0,16,1,1,3,10,6,0,0,0,0,16411,6.8,17675,210,56,-2305,-644,26.6,1641.1,12,0,0,10,3,12,0,0,0,0,18716,6.8,18319,228,48,2305,644,27.6,1871.6
4852506262,0,8,2,0,7,4,6,0,0,0,0,17988,7.0,18628,213,56,1801,113,26.9,1798.8,80,0,1,4,7,2,0,0,0,0,16187,7.0,18515,210,72,-1801,-113,28.2,1618.7
4852099263,1,9,1,1,8,10,4,0,0,0,0,16417,6.8,17514,200,47,-1637,198,24.7,1641.7,12,2,0,10,8,9,0,0,0,0,18054,6.8,17316,191,52,1637,-198,24.3,1805.4
4852061687,1,18,5,1,7,3,8,0,0,0,0,18761,6.8,17943,251,47,1989,678,29.8,1876.1,30,3,0,3,7,5,0,0,0,0,16772,6.8,17265,220,56,-1989,-678,27.6,1677.2
4852043443,1,17,2,1,12,3,12,1,1,0,0,19903,6.8,17600,193,38,3819,1351,23.1,1990.3,12,1,0,3,12,3,0,0,0,0,16084,6.4,16249,207,42,-3819,-1351,24.9,1608.4
4852024406,0,17,2,1,6,8,8,1,1,0,0,16877,6.4,15988,205,52,-1843,-1264,25.7,1687.7,15,4,0,8,6,8,0,0,0,0,18720,6.6,17252,206,60,1843,1264,26.6,1872.0
4852935539,1,183,0,1,16,31,22,0,0,0,0,61650,13.0,62500,0,0,22700,25000,0.0,6165.0,0,0,0,20,5,17,0,0,0,0,38950,7.8,37500,0,0,-22700,-25000,0.0,3895.0
4851702135,1,10,0,0,5,3,2,1,1,0,0,16362,7.2,19558,240,52,1101,559,29.2,1636.2,18,0,1,3,5,2,0,0,0,0,15261,7.2,18999,212,68,-1101,-559,28.0,1526.1
4851666617,1,37,1,0,5,6,2,0,0,0,0,16589,6.8,17979,207,56,806,-363,26.3,1658.9,29,4,1,6,5,1,0,0,0,0,15783,7.2,18342,220,56,-806,363,27.6,1578.3
4850878098,0,12,2,1,5,5,6,0,0,0,0,16542,6.8,17724,226,48,-678,-1158,27.4,1654.2,11,1,0,5,5,4,1,0,1,0,17220,7.0,18882,198,52,678,1158,25.0,1722.0
4850841522,0,11,2,0,4,5,5,0,0,0,0,15720,7.0,18118,200,60,-246,694,26.0,1572.0,75,2,1,5,4,3,0,0,0,0,15966,6.8,17424,218,48,246,-694,26.6,1596.6
4848594031,1,34,1,1,8,6,6,0,0,0,0,17184,6.6,16656,207,44,379,-1275,25.1,1718.4,34,2,0,6,8,4,1,1,0,0,16805,7.0,17931,208,60,-379,1275,26.8,1680.5
4848556688,0,13,0,0,2,8,1,0,0,0,0,14656,6.4,15882,199,53,-3560,-4102,25.2,1465.6,12,0,1,8,2,4,0,0,0,0,18216,7.4,19984,218,62,3560,4102,28.0,1821.6
4848536536,0,16,1,0,2,4,2,0,0,0,0,14901,6.8,17314,220,39,-1774,-2262,25.9,1490.1,11,4,1,4,2,1,0,0,0,0,16675,7.2,19576,250,68,1774,2262,31.8,1667.5
4834370438,1,1,6,1,24,20,52,0,0,0,0,38906,11.2,41143,117,0,2682,97,11.7,3890.6,21,0,0,20,24,39,0,0,0,0,36224,11.0,41046,101,0,-2682,-97,10.1,3622.4
4831023353,0,20,1,1,4,6,2,0,0,0,0,16506,6.8,17656,220,52,165,-1738,27.2,1650.6,41,2,0,6,4,7,1,1,0,0,16341,7.4,19394,188,72,-165,1738,26.0,1634.1
4830986991,0,9,4,0,5,6,4,0,0,0,0,16471,7.0,17812,219,44,-603,-332,26.3,1647.1,14,1,1,6,5,3,0,0,0,0,17074,7.0,18144,217,68,603,332,28.5,1707.4
4830257998,0,0,0,1,30,29,100,0,0,0,0,38374,11.2,41987,108,0,990,1146,10.8,3837.4,0,0,0,29,30,73,0,0,0,0,37384,11.2,40841,105,0,-990,-1146,10.5,3738.4
4829267251,1,11,0,0,7,5,6,0,0,0,0,17099,6.6,17220,213,54,1460,-124,26.7,1709.9,17,2,1,5,7,7,1,1,0,0,15639,6.8,17344,187,50,-1460,124,23.7,1563.9
4828257893,0,22,1,0,21,19,44,0,0,0,1,34476,10.8,38139,92,58,-4948,-1934,15.0,3447.6,13,1,1,19,21,37,0,0,0,0,39424,11.0,40073,81,68,4948,1934,14.9,3942.4
4828226854,1,16,0,1,15,11,23,0,0,0,2,35857,10.4,37213,64,64,6623,5068,12.8,3585.7,13,0,0,11,15,20,0,0,0,0,29234,10.2,32145,88,51,-6623,-5068,13.9,2923.4
4828209734,0,12,3,0,6,30,9,0,0,0,2,31224,11.0,37236,101,43,-13171,-10718,14.4,3122.4,19,0,1,30,6,70,0,0,0,0,44395,12.4,47954,117,84,13171,10718,20.1,4439.5
4828200451,1,10,0,1,18,14,36,0,0,0,0,34255,10.4,37166,99,55,-6110,-3998,15.4,3425.5,18,1,0,13,17,24,0,0,0,0,40365,11.4,41164,102,72,6110,3998,17.4,4036.5
4814939261,0,76,1,0,7,6,4,0,0,0,0,17454,7.0,18583,224,56,387,-450,28.0,1745.4,8,0,1,6,7,2,0,0,0,0,17067,7.0,19033,232,51,-387,450,28.3,1706.7
4814916115,0,10,0,1,6,10,7,0,0,0,0,16705,6.8,17261,206,44,-2515,-1293,25.0,1670.5,16,1,0,10,6,12,1,0,1,0,19220,7.0,18554,196,75,2515,1293,27.1,1922.0
4796848049,0,8,1,1,3,7,2,0,0,0,0,15812,6.8,17672,200,60,-1822,-1796,26.0,1581.2,16,0,0,7,3,6,0,0,0,0,17634,7.2,19468,211,64,1822,1796,27.5,1763.4
4856369050,1,10,0,0,2,10,2,0,0,0,0,15402,6.8,17234,197,60,-3455,-2391,25.7,1540.2,195,1,1,10,2,6,1,1,0,0,18857,7.4,19625,226,63,3455,2391,28.9,1885.7
4853010954,0,14,3,0,7,7,13,1,1,0,0,17481,6.4,16030,208,50,187,-958,25.8,1748.1,14,1,1,7,7,11,0,0,0,0,17294,6.4,16988,238,48,-187,958,28.6,1729.4
4852945249,0,12,2,0,6,8,4,0,0,0,0,16811,6.8,17532,225,47,-1118,-1284,27.2,1681.1,14,4,1,8,6,6,1,1,0,0,17929,7.2,18816,260,56,1118,1284,31.6,1792.9
4847624382,0,70,0,0,5,5,3,1,0,1,0,18223,7.4,20218,236,72,-6,2127,30.8,1822.3,11,2,1,5,5,7,0,0,0,0,18229,6.8,18091,255,48,6,-2127,30.3,1822.9
4847599808,1,14,1,1,7,7,12,1,0,1,0,17489,6.6,17144,202,48,1081,-304,25.0,1748.9,11,0,0,7,7,6,0,0,0,0,16408,6.8,17448,174,44,-1081,304,21.8,1640.8
4833357682,0,53,3,0,2,2,3,0,0,0,0,16812,7.0,18401,230,72,1233,776,30.2,1681.2,12,1,1,2,2,1,0,0,0,0,15579,6.8,17625,233,63,-1233,-776,29.6,1557.9
4833004382,0,32,0,0,3,7,1,0,0,0,0,15160,6.8,18239,199,56,-859,1832,25.5,1516.0,45,0,1,7,3,6,0,0,0,0,16019,6.2,16407,167,55,859,-1832,22.2,1601.9
4832938285,1,12,0,0,8,2,8,1,1,0,0,17512,7.0,18280,222,55,2056,958,27.7,1751.2,120,0,1,2,8,2,0,0,0,0,15456,6.6,17322,238,44,-2056,-958,28.2,1545.6
4832900660,0,8,3,0,3,3,6,0,0,0,0,16343,7.0,18136,239,52,871,170,29.1,1634.3,11,1,1,3,3,1,0,0,0,0,15472,7.0,17966,230,60,-871,-170,29.0,1547.2
4831854948,1,18,1,0,11,7,11,0,0,0,0,18999,7.2,18211,198,54,1895,984,25.2,1899.9,224,3,1,7,11,5,0,0,0,0,17104,6.8,17227,194,44,-1895,-984,23.8,1710.4
4831844319,0,9,0,0,5,12,3,1,1,0,0,16362,6.6,17265,213,60,-4999,-1637,27.3,1636.2,15,0,1,12,5,14,0,0,0,0,21361,7.0,18902,246,53,4999,1637,29.9,2136.1
4831826052,1,12,1,1,6,2,7,2,1,1,0,17819,7.2,18764,239,47,2365,387,28.6,1781.9,14,0,0,2,6,1,0,0,0,0,15454,7.2,18377,234,66,-2365,-387,30.0,1545.4
4831806765,0,73,4,0,0,7,0,0,0,0,0,13552,6.4,16347,183,60,-4902,-3088,24.3,1355.2,14,4,1,7,0,8,0,0,0,0,18454,7.2,19435,258,64,4902,3088,32.2,1845.4
4831787015,0,114,3,0,5,6,4,0,0,0,0,16115,6.8,17124,204,60,-2727,-1418,26.4,1611.5,18,4,1,6,5,7,1,1,0,0,18842,6.8,18542,215,71,2727,1418,28.6,1884.2
4831771546,1,9,3,1,8,3,7,1,0,1,0,18242,7.2,19250,252,68,2977,1814,32.0,1824.2,14,0,0,3,8,2,1,1,0,0,15265,7.0,17436,255,48,-2977,-1814,30.3,1526.5
4831756103,0,16,3,1,3,5,5,0,0,0,0,15659,6.8,17094,223,60,-3017,-3293,28.3,1565.9,14,0,0,5,3,5,1,1,0,0,18676,7.2,20387,246,76,3017,3293,32.2,1867.6
4827864798,0,10,0,0,0,11,0,0,0,0,0,28630,10.2,35295,105,59,-6609,-5163,16.4,2863.0,10,0,1,11,0,23,0,0,0,0,35239,11.2,40458,88,68,6609,5163,15.6,3523.9
4827833432,1,37,1,1,9,15,20,0,0,0,0,33434,10.2,34641,102,55,1179,-3456,15.7,3343.4,8,3,0,15,9,32,0,0,0,0,32255,11.0,38097,86,63,-1179,3456,14.9,3225.5
4827803664,0,12,0,0,12,13,30,0,0,0,0,30643,10.4,35518,61,59,-2730,-3671,12.0,3064.3,17,0,1,13,12,25,0,0,0,0,33373,10.8,39189,90,60,2730,3671,15.0,3337.3
4827778349,1,19,1,0,6,11,8,0,0,0,0,30629,10.4,35203,78,63,1636,693,14.1,3062.9,13,0,1,11,6,13,0,0,0,0,28993,10.2,34510,82,54,-1636,-693,13.6,2899.3
4836265305,1,15,1,1,8,5,10,0,0,0,0,17574,7.0,18549,234,44,906,298,27.8,1757.4,78,0,0,5,8,4,1,1,0,0,16668,7.0,18251,229,52,-906,-298,28.1,1666.8
4824051032,1,10,0,1,7,4,7,1,1,0,0,17508,7.0,18350,222,59,1210,1164,28.1,1750.8,11,2,0,4,7,5,0,0,0,0,16298,6.8,17186,196,64,-1210,-1164,26.0,1629.8
4824017295,0,10,3,0,8,12,6,0,0,0,0,16193,6.4,15924,190,52,-2673,-1398,24.2,1619.3,14,0,1,12,8,13,1,1,0,0,18866,6.8,17322,219,60,2673,1398,27.9,1886.6
4823980448,0,13,1,1,4,3,2,1,0,1,0,17117,7.2,19930,229,76,1743,3063,30.5,1711.7,12,0,0,3,4,6,1,1,0,0,15374,6.6,16867,185,48,-1743,-3063,23.3,1537.4
4823542260,1,13,2,0,2,7,2,1,1,0,0,16040,6.8,17914,218,64,-1451,-776,28.2,1604.0,16,1,1,7,2,11,0,0,0,0,17491,7.2,18690,218,67,1451,776,28.5,1749.1
4822693175,1,16,0,1,7,9,6,1,1,0,0,17423,6.8,17079,173,57,-636,-521,23.0,1742.3,9,0,0,9,7,7,0,0,0,0,18059,6.8,17600,219,42,636,521,26.1,1805.9
4822657561,1,11,0,1,7,9,9,1,1,0,0,16942,6.8,17417,205,56,92,1248,26.1,1694.2,19,2,0,9,7,11,0,0,0,0,16850,6.4,16169,172,40,-92,-1248,21.2,1685.0
4822652746,1,28,4,1,6,1,5,1,0,1,0,17407,7.0,18331,230,49,2799,1336,27.9,1740.7,10,1,0,1,6,0,0,0,0,0,14608,6.6,16995,207,55,-2799,-1336,26.2,1460.8
4822631030,1,30,2,0,5,8,4,0,0,0,0,16408,6.8,17522,198,59,-816,-1222,25.7,1640.8,30,1,1,8,5,6,1,1,0,0,17224,7.0,18744,221,64,816,1222,28.5,1722.4
4822606195,1,15,0,1,1,3,2,1,0,1,0,16198,7.0,18492,236,59,-47,-957,29.5,1619.8,12,1,0,3,1,3,1,1,0,0,16245,7.2,19449,216,72,47,957,28.8,1624.5
4822322940,1,16,0,1,3,0,3,1,0,1,0,16808,7.2,19537,263,70,2257,909,33.3,1680.8,14,2,0,0,3,0,0,0,0,0,14551,7.2,18628,247,58,-2257,-909,30.5,1455.1
4822305937,1,14,0,0,10,9,9,1,1,0,0,18241,6.8,16663,201,52,-247,114,25.3,1824.1,10,1,1,9,10,6,0,0,0,0,18488,6.6,16549,183,52,247,-114,23.5,1848.8
4821843306,0,22,0,0,5,3,5,0,0,0,0,15100,6.6,16676,196,36,4,-382,23.2,1510.0,23,1,1,3,5,4,0,0,0,0,15096,6.8,17058,207,56,-4,382,26.3,1509.6
4821802390,1,13,0,1,11,5,12,0,0,0,0,18472,7.4,19122,234,56,2485,1302,29.0,1847.2,10,0,0,5,11,3,0,0,0,0,15987,6.8,17820,219,64,-2485,-1302,28.3,1598.7
4818756819,1,16,0,0,5,7,10,0,0,0,0,16175,6.6,16179,185,60,-2404,-2159,24.5,1617.5,77,0,1,7,5,7,1,0,1,0,18579,7.0,18338,249,56,2404,2159,30.5,1857.9
4817823011,0,17,2,0,4,7,5,0,0,0,0,16399,7.0,17806,226,61,-341,-351,28.7,1639.9,13,0,1,7,4,11,0,0,0,0,16740,7.0,18157,210,54,341,351,26.4,1674.0
4817791689,1,17,2,1,9,6,11,0,0,0,1,19197,6.8,17624,218,48,2731,467,26.6,1919.7,10,1,0,6,9,5,0,0,0,0,16466,6.8,17157,170,68,-2731,-467,23.8,1646.6
4817771056,1,19,6,0,3,3,3,1,1,0,0,15751,7.0,18025,223,56,-47,769,27.9,1575.1,11,1,1,3,3,4,0,0,0,0,15798,6.8,17256,222,56,47,-769,27.8,1579.8
4817743402,1,87,1,1,7,5,8,0,0,0,0,18012,7.0,18492,223,55,1632,606,27.8,1801.2,17,0,0,5,7,6,1,1,0,0,16380,6.8,17886,208,56,-1632,-606,26.4,1638.0
4803154996,0,15,2,1,14,10,23,1,0,1,0,19598,6.8,16585,193,60,1253,-66,25.3,1959.8,7,2,0,10,14,11,1,1,0,0,18345,6.6,16651,208,56,-1253,66,26.4,1834.5
4850911061,1,35,2,0,5,7,4,0,0,0,0,16504,6.8,17933,231,72,-329,-337,30.3,1650.4,38,2,1,7,5,4,1,1,0,0,16833,7.0,18270,208,64,329,337,27.2,1683.3
4849734086,1,16,3,1,8,3,8,0,0,0,0,20332,7.0,19024,257,57,6512,1220,31.4,2033.2,70,0,0,2,7,1,0,0,0,0,13820,6.8,17804,204,44,-6512,-1220,24.8,1382.0
4848692809,1,11,1,1,8,6,5,0,0,0,0,18776,7.0,17583,207,52,1815,-413,25.9,1877.6,13,1,0,6,8,5,1,1,0,0,16961,7.2,17996,217,68,-1815,413,28.5,1696.1
4846100612,1,16,1,0,4,7,7,0,0,0,0,16482,6.8,17088,233,52,-806,156,28.5,1648.2,17,3,1,7,4,10,0,0,0,0,17288,6.6,16932,228,59,806,-156,28.7,1728.8
4846074810,0,14,3,0,3,7,3,0,0,0,0,16239,6.4,15913,187,56,-1297,-1337,24.3,1623.9,13,2,1,7,3,5,1,1,0,0,17536,6.8,17250,236,52,1297,1337,28.8,1753.6
4843982890,0,13,1,0,8,3,7,1,1,0,0,18240,7.0,18214,246,52,2091,1022,29.8,1824.0,12,0,1,3,8,3,0,0,0,0,16149,6.8,17192,208,63,-2091,-1022,27.1,1614.9
4841478951,0,12,0,1,3,9,2,0,0,0,0,14776,6.6,16465,176,83,-2605,-1623,25.9,1477.6,18,2,0,9,3,7,0,0,0,0,17381,7.2,18088,223,52,2605,1623,27.5,1738.1
4837833195,1,14,1,1,8,4,11,1,1,0,0,18909,6.8,18171,246,52,1539,-933,29.8,1890.9,22,2,0,4,8,6,1,0,1,0,17370,6.8,19104,259,49,-1539,933,30.8,1737.0
4831062514,1,13,3,1,10,2,12,1,1,0,0,18291,6.8,16978,241,59,3475,717,30.0,1829.1,12,0,0,2,10,1,1,0,1,0,14816,6.6,16261,180,48,-3475,-717,22.8,1481.6
4831020592,0,25,0,0,3,11,4,0,0,0,0,13986,6.4,15864,193,52,-6192,-2744,24.5,1398.6,13,0,1,11,3,14,0,0,0,0,20178,7.2,18608,223,46,6192,2744,26.9,2017.8
4830999858,1,11,2,1,10,3,13,1,1,0,0,19279,7.0,18878,230,56,3683,1199,28.6,1927.9,14,0,0,2,9,2,0,0,0,0,15596,6.8,17679,229,52,-3683,-1199,28.1,1559.6
4830968298,0,14,2,0,7,5,5,0,0,0,0,16910,7.2,18685,218,59,343,118,27.7,1691.0,22,1,1,4,6,4,0,0,0,0,16567,7.0,18567,247,63,-343,-118,31.0,1656.7
4830284145,1,32,1,0,6,5,6,0,0,0,0,17555,7.0,17893,239,52,946,-82,29.1,1755.5,14,2,1,5,6,8,2,1,1,0,16609,6.8,17975,225,54,-946,82,27.9,1660.9
4828173156,0,33,2,1,5,7,5,0,0,0,0,17793,7.0,18208,243,50,248,712,29.3,1779.3,80,10,0,7,5,7,1,0,1,0,17545,6.8,17496,192,53,-248,-712,24.5,1754.5
4824690331,1,20,2,1,4,1,3,1,0,1,0,17248,6.8,17462,224,56,1887,166,28.0,1724.8,12,1,0,1,4,2,1,1,0,0,15361,6.6,17296,236,56,-1887,-166,29.2,1536.1
4824633542,1,17,2,1,4,0,6,1,1,0,0,16675,7.4,20376,254,56,2011,1471,31.0,1667.5,16,4,0,0,4,0,0,0,0,0,14664,7.2,18905,236,72,-2011,-1471,30.8,1466.4
4824597161,0,13,1,1,4,4,9,1,1,0,0,16270,7.2,19020,218,66,-939,392,28.4,1627.0,19,3,0,4,4,4,1,0,1,0,17209,7.0,18628,275,62,939,-392,33.7,1720.9
4823331153,1,13,1,1,2,2,1,0,0,0,0,15268,7.0,18413,257,56,1116,552,31.3,1526.8,16,0,0,1,1,0,0,0,0,0,14152,6.8,17861,237,54,-1116,-552,29.1,1415.2
4822314684,1,15,1,0,5,3,3,0,0,0,0,16945,7.2,19730,250,64,1376,1239,31.4,1694.5,9,3,1,3,5,4,0,0,0,0,15569,7.2,18491,229,56,-1376,-1239,28.5,1556.9
4821275500,0,13,2,0,0,6,0,0,0,0,0,14516,7.0,17620,241,67,-2562,-900,30.8,1451.6,15,2,1,6,0,13,2,1,1,0,17078,7.2,18520,255,56,2562,900,31.1,1707.8
4856314682,1,0,0,0,17,24,43,0,0,0,0,37013,11.0,39617,112,0,702,552,11.2,3701.3,0,0,1,24,17,62,0,0,0,0,36311,10.8,39065,106,0,-702,-552,10.6,3631.1
4856281664,1,0,0,0,34,24,104,0,0,0,1,41002,11.8,45528,111,0,3868,6020,11.1,4100.2,9,0,1,24,34,60,0,0,0,0,37134,11.2,39508,102,0,-3868,-6020,10.2,3713.4
4856247136,1,0,31,1,11,18,30,0,0,0,0,32143,10.0,33825,94,0,-3452,-5770,9.4,3214.3,22,0,0,18,11,40,0,0,0,0,35595,11.0,39595,114,0,3452,5770,11.4,3559.5
4855430459,1,13,1,1,6,8,8,1,1,0,0,16587,6.2,15539,183,41,1214,22,22.4,1658.7,27,0,0,8,6,10,0,0,0,0,15373,6.2,15517,153,50,-1214,-22,20.3,1537.3
4855380732,0,12,1,0,3,7,4,0,0,0,0,14434,6.8,17768,162,59,-3023,-1088,22.1,1443.4,10,1,1,7,3,4,2,1,1,0,17457,7.0,18856,230,52,3023,1088,28.2,1745.7
4855339003,0,13,1,1,3,4,1,0,0,0,0,15719,6.8,17845,231,55,-169,-96,28.6,1571.9,15,0,0,4,3,3,1,1,0,0,15888,7.2,17941,219,60,169,96,27.9,1588.8
4855258176,0,13,1,0,3,8,5,0,0,0,0,15952,6.8,18324,219,56,-1852,-487,27.5,1595.2,14,0,1,8,3,11,0,0,0,0,17804,7.0,18811,228,60,1852,487,28.8,1780.4
4855208288,0,11,1,0,7,12,6,1,0,1,0,17603,6.4,16362,190,47,-4818,-2907,23.7,1760.3,13,2,1,12,7,10,1,1,0,0,22421,7.2,19269,221,68,4818,2907,28.9,2242.1
4855179841,1,0,0,1,41,20,87,0,0,0,1,42469,12.2,47547,128,0,6128,7206,12.8,4246.9,0,0,0,20,41,33,0,0,0,0,36341,11.2,40341,75,0,-6128,-7206,7.5,3634.1
4855136544,1,0,0,1,31,32,78,0,0,0,2,41315,11.6,42402,113,0,736,-650,11.3,4131.5,0,0,0,32,31,92,0,0,0,0,40579,11.6,43052,104,0,-736,650,10.4,4057.9
4855107761,0,0,0,1,22,24,37,0,0,0,1,35022,11.0,40290,96,0,-1961,-1684,9.6,3502.2,0,0,0,24,22,55,0,0,0,0,36983,11.4,41974,122,0,1961,1684,12.2,3698.3
4854917204,1,19,0,1,20,16,16,0,0,0,0,46650,10.0,47500,0,0,19500,19000,0.0,4665.0,0,0,0,7,11,10,0,0,0,0,27150,6.0,28500,0,0,-19500,-19000,0.0,2715.0
4854888951,1,0,0,0,13,19,17,0,0,0,0,46650,10.0,47500,4,0,17175,19000,0.4,4665.0,0,0,1,13,7,12,0,0,0,0,29475,6.0,28500,7,0,-17175,-19000,0.7,2947.5
4854859774,1,0,0,0,12,20,13,0,0,0,0,62548,12.0,55000,0,0,23087,22000,0.0,6254.8,0,0,1,14,6,10,0,0,0,0,39461,7.2,33000,0,0,-23087,-22000,0.0,3946.1
4854829702,1,0,0,1,25,13,24,0,0,0,0,48059,10.0,47500,0,0,21558,19000,0.0,4805.9,4,0,0,5,17,7,0,0,0,0,26501,6.0,28500,4,0,-21558,-19000,0.4,2650.1
4854818755,1,5,0,0,17,12,14,0,0,0,0,47130,10.0,47500,2,0,20305,19000,0.2,4713.0,5,0,1,5,10,7,0,0,0,0,26825,6.0,28500,0,0,-20305,-19000,0.0,2682.5
4854268362,0,12,5,1,17,25,39,0,0,0,2,34753,10.4,36657,112,0,-4078,-3964,11.2,3475.3,31,0,0,25,17,76,0,0,0,0,38831,10.8,40621,113,0,4078,3964,11.3,3883.1
4854244392,1,9,0,1,19,13,56,0,0,0,1,36294,10.6,37107,112,0,3202,1919,11.2,3629.4,0,0,0,13,19,31,0,0,0,0,33092,10.2,35188,106,0,-3202,-1919,10.6,3309.2
4854211771,1,0,0,0,14,19,22,0,0,0,0,47000,10.0,47500,0,0,17400,19000,0.0,4700.0,0,0,1,16,11,7,0,0,0,0,29600,6.0,28500,0,0,-17400,-19000,0.0,2960.0
4854186258,1,1,0,0,15,17,16,0,0,0,0,47000,10.0,47500,0,0,18750,19000,0.0,4700.0,37,0,1,12,10,9,0,0,0,0,28250,6.0,28500,1,0,-18750,-19000,0.1,2825.0
4858362236,1,0,3,0,28,37,89,0,0,0,2,40323,11.8,43794,100,0,-1802,-1409,10.0,4032.3,24,0,1,37,28,97,0,0,0,0,42125,12.0,45203,103,0,1802,1409,10.3,4212.5
4858326658,0,0,0,0,21,22,59,0,0,0,0,35570,10.8,39752,83,0,-1795,-406,8.3,3557.0,89,0,1,22,21,41,0,0,0,0,37365,11.0,40158,123,0,1795,406,12.3,3736.5
4855299081,1,14,0,1,9,5,8,1,1,0,0,18596,7.2,18745,222,60,2309,2661,28.2,1859.6,18,3,0,5,9,10,0,0,0,0,16287,6.4,16084,190,59,-2309,-2661,24.9,1628.7
4855252721,0,14,1,0,8,9,8,1,1,0,0,16476,6.6,15853,172,48,-1519,-1355,22.0,1647.6,12,3,1,9,8,7,0,0,0,0,17995,6.8,17208,188,58,1519,1355,24.6,1799.5
4854007626,1,9,0,1,6,6,4,0,0,0,0,16469,6.8,17121,204,48,-1976,-1084,25.2,1646.9,11,1,0,6,6,4,0,0,0,0,18445,6.8,18205,214,48,1976,1084,26.2,1844.5
4853969124,1,12,1,1,10,8,8,1,0,1,0,19244,7.0,18906,217,51,1832,1474,26.8,1924.4,19,0,0,8,10,11,1,1,0,0,17412,6.8,17432,205,52,-1832,-1474,25.7,1741.2
4853932766,0,0,0,1,27,33,70,0,0,0,1,38314,11.2,40837,118,0,-1589,-4425,11.8,3831.4,0,0,0,33,27,95,0,0,0,0,39903,11.8,45262,103,0,1589,4425,10.3,3990.3
4851789633,1,34,0,1,6,6,2,0,0,0,0,17852,7.0,18379,220,68,990,1121,28.8,1785.2,13,5,0,6,6,6,0,0,0,0,16862,6.6,17258,208,48,-990,-1121,25.6,1686.2
4851736722,0,11,0,0,2,9,1,0,0,0,0,14486,6.6,16656,202,59,-4565,-2470,26.1,1448.6,20,1,1,9,2,12,0,0,0,0,19051,7.2,19126,230,64,4565,2470,29.4,1905.1
4851692633,0,10,1,0,1,8,0,0,0,0,0,13935,6.6,17559,212,56,-4384,-2029,26.8,1393.5,13,2,1,8,1,10,1,1,0,0,18319,7.6,19588,241,62,4384,2029,30.3,1831.9
4850875473,1,0,0,1,30,16,84,0,0,0,0,38394,11.6,42660,118,0,4613,5693,11.8,3839.4,0,0,0,16,30,35,0,0,0,0,33781,10.8,36967,104,0,-4613,-5693,10.4,3378.1
4850848622,1,14,1,1,9,7,14,0,0,0,0,18777,7.2,19155,221,62,2561,1487,28.3,1877.7,10,0,0,7,9,7,0,0,0,0,16216,6.8,17668,190,49,-2561,-1487,23.9,1621.6
4850824087,0,15,1,1,6,13,3,0,0,0,0,15982,6.6,16183,195,48,-3577,-1994,24.3,1598.2,11,2,0,13,6,9,1,1,0,0,19559,7.0,18177,184,55,3577,1994,23.9,1955.9
4847869894,0,11,3,1,9,8,8,0,0,0,0,17636,6.8,17459,199,43,436,-938,24.2,1763.6,10,3,0,8,9,5,1,0,1,0,17200,7.2,18397,195,64,-436,938,25.9,1720.0
4847054345,1,0,0,1,32,30,67,0,0,0,0,39781,12.0,44803,118,0,-153,-1678,11.8,3978.1,0,0,0,30,32,71,0,0,0,0,39934,12.0,46481,107,0,153,1678,10.7,3993.4
4847024422,0,0,0,0,32,37,84,0,0,0,2,40732,11.6,42779,112,0,-1062,-1870,11.2,4073.2,18,0,1,37,32,79,0,0,0,0,41794,11.6,44649,123,0,1062,1870,12.3,4179.4
4847005031,1,68,0,1,17,23,32,0,0,0,1,39130,11.4,41812,119,0,2411,4064,11.9,3913.0,0,0,0,23,17,73,0,0,0,0,36719,11.0,37748,92,0,-2411,-4064,9.2,3671.9
4846980960,1,30,0,1,33,24,91,0,0,0,0,41088,11.8,45180,118,0,3540,3268,11.8,4108.8,0,1,0,24,33,37,0,0,0,0,37548,11.4,41912,112,0,-3540,-3268,11.2,3754.8
4842124207,0,0,0,0,18,23,49,0,0,0,2,36686,11.0,38740,93,0,-421,-1340,9.3,3668.6,0,0,1,23,18,68,0,0,0,0,37107,11.2,40080,109,0,421,1340,10.9,3710.7
4858301152,1,13,0,1,14,6,14,0,0,0,0,21971,6.8,18086,225,48,5691,1792,27.3,2197.1,12,0,0,6,14,3,0,0,0,0,16280,6.4,16294,173,60,-5691,-1792,23.3,1628.0
4858216980,1,11,1,0,10,3,17,1,1,0,0,18890,7.2,19859,243,72,3918,3359,31.5,1889.0,13,2,1,3,10,3,0,0,0,0,14972,6.4,16500,222,56,-3918,-3359,27.8,1497.2
4858156345,0,8,0,0,5,16,5,0,0,0,0,16248,6.4,16405,211,51,-4195,-2543,26.2,1624.8,39,1,1,16,5,21,1,1,0,0,20443,7.2,18948,195,68,4195,2543,26.3,2044.3
4858109500,0,17,2,0,6,6,3,1,1,0,0,16358,7.0,17768,219,52,913,764,27.1,1635.8,9,0,1,6,6,6,1,0,1,0,15445,6.6,17004,183,47,-913,-764,23.0,1544.5
4858075424,1,10,0,1,7,5,15,1,1,0,0,17579,7.2,19025,238,67,1169,694,30.5,1757.9,85,0,0,5,7,6,0,0,0,0,16410,7.2,18331,244,52,-1169,-694,29.6,1641.0
4858043591,1,126,5,0,2,4,2,0,0,0,0,15483,7.0,18786,249,60,-726,802,30.9,1548.3,15,3,1,4,2,5,2,1,1,0,16209,6.8,17984,245,52,726,-802,29.7,1620.9
4858007669,1,164,3,1,7,2,7,1,1,0,0,17627,7.0,18654,223,60,2723,1803,28.3,1762.7,13,0,0,2,7,1,0,0,0,0,14904,6.6,16851,216,54,-2723,-1803,27.0,1490.4
4857990212,1,79,0,1,10,1,13,0,0,0,0,18180,6.8,17535,219,54,3382,1246,27.3,1818.0,11,0,0,1,10,3,1,1,0,0,14798,6.4,16289,158,61,-3382,-1246,21.9,1479.8
4857969761,0,18,1,0,4,9,7,0,0,0,0,16164,6.6,16622,191,56,-3252,-2262,24.7,1616.4,127,1,1,9,4,10,1,1,0,0,19416,7.2,18884,218,64,3252,2262,28.2,1941.6
4857932963,0,112,1,1,6,6,4,0,0,0,0,16317,7.0,17993,224,51,-292,-1023,27.5,1631.7,11,1,0,6,6,6,1,1,0,0,16609,7.0,19016,233,72,292,1023,30.5,1660.9
4857524574,1,0,0,0,11,20,13,0,0,0,0,49751,12.0,55000,0,0,17651,22000,0.0,4975.1,0,0,1,14,5,14,0,0,0,0,32100,7.2,33000,0,0,-17651,-22000,0.0,3210.0
4857502444,1,0,0,0,15,19,17,0,0,0,0,47145,10.0,47500,1,0,18130,17820,0.1,4714.5,0,0,1,14,10,9,0,0,0,0,29015,6.2,29680,1,0,-18130,-17820,0.1,2901.5
4857488862,1,20,0,1,16,22,9,0,0,0,0,60600,13.0,62500,0,0,21300,21000,0.0,6060.0,0,0,0,12,6,14,0,0,0,0,39300,8.6,41500,0,0,-21300,-21000,0.0,3930.0
4857464949,1,0,0,0,16,15,17,0,0,0,0,46300,10.0,47500,0,0,18800,17500,0.0,4630.0,0,0,1,9,10,5,0,0,0,0,27500,6.4,30000,0,0,-18800,-17500,0.0,2750.0
4857391217,1,8,1,1,9,5,11,0,0,0,0,17759,6.6,17830,238,56,2013,1446,29.4,1775.9,15,0,0,5,9,9,0,0,0,0,15746,6.6,16384,209,54,-2013,-1446,26.3,1574.6
4857346380,1,14,2,1,6,10,6,1,1,0,0,16901,6.6,16494,208,54,-1506,-2354,26.2,1690.1,12,2,0,10,6,5,0,0,0,0,18407,7.2,18848,218,62,1506,2354,28.0,1840.7
4857315368,0,30,0,1,6,8,3,0,0,0,0,16795,6.8,17583,228,55,-504,-392,28.3,1679.5,15,2,0,8,6,6,1,1,0,0,17299,7.0,17975,205,59,504,392,26.4,1729.9
4857274127,0,15,1,0,6,7,8,1,0,1,0,16254,6.8,17959,225,52,-2098,-841,27.7,1625.4,15,2,1,6,5,5,0,0,0,0,18352,7.2,18800,233,47,2098,841,28.0,1835.2
4857221374,0,14,3,1,9,2,14,2,1,1,0,17519,6.8,17535,186,44,2235,475,23.0,1751.9,15,1,0,2,9,3,0,0,0,0,15284,6.6,17060,210,60,-2235,-475,27.0,1528.4
4857056539,1,176,0,1,7,3,11,1,1,0,0,18132,7.0,18232,203,56,1770,-130,25.9,1813.2,9,0,0,3,7,1,0,0,0,0,16362,7.0,18362,221,64,-1770,130,28.5,1636.2
4857689133,0,19,3,0,4,4,3,0,0,0,0,16863,7.2,19197,250,76,941,1102,32.6,1686.3,13,3,1,4,4,3,2,1,1,0,15922,7.2,18095,229,60,-941,-1102,28.9,1592.2
4857679936,0,7,2,0,3,8,3,0,0,0,0,15124,6.8,16896,177,60,-4034,-1671,23.7,1512.4,195,1,1,8,3,9,1,1,0,0,19158,7.0,18567,249,52,4034,1671,30.1,1915.8
4857660505,0,13,1,0,3,4,2,1,0,1,0,14951,7.0,18078,216,64,-1268,789,28.0,1495.1,138,2,1,4,3,4,1,1,0,0,16219,6.8,17289,253,48,1268,-789,30.1,1621.9
4857502324,1,43,0,1,17,21,22,0,0,0,0,61625,12.0,55000,7,0,22695,22000,0.7,6162.5,0,0,0,14,10,12,0,0,0,0,38930,7.2,33000,4,0,-22695,-22000,0.4,3893.0
4857488070,1,0,0,0,19,14,19,0,0,0,0,63050,12.0,55000,0,0,27600,22000,0.0,6305.0,0,0,1,7,12,6,0,0,0,0,35450,7.2,33000,0,0,-27600,-22000,0.0,3545.0
4856538693,1,10,2,0,6,8,4,0,0,0,0,17162,7.0,17866,252,60,-1207,-976,31.2,1716.2,12,1,1,8,6,9,0,0,0,0,18369,7.2,18842,239,60,1207,976,29.9,1836.9
4856517564,0,80,1,0,6,7,10,0,0,0,0,15868,6.4,15024,166,46,-1858,-1325,21.2,1586.8,9,1,1,7,6,8,0,0,0,0,17726,6.6,16349,203,56,1858,1325,25.9,1772.6
4856478562,0,11,3,1,2,4,2,1,1,0,0,15468,7.0,17691,213,63,-1362,-1149,27.6,1546.8,12,1,0,4,2,5,1,0,1,0,16830,7.0,18840,222,64,1362,1149,28.6,1683.0
4855445818,0,0,0,0,23,20,67,0,0,0,0,38334,11.4,41027,103,0,2680,2673,10.3,3833.4,0,0,1,20,23,59,0,0,0,0,35654,10.8,38354,114,0,-2680,-2673,11.4,3565.4
4855412935,1,14,0,0,4,4,4,0,0,0,0,16117,7.2,18890,235,60,254,446,29.5,1611.7,10,0,1,4,4,3,1,1,0,0,15863,6.8,18444,224,48,-254,-446,27.2,1586.3
4855357735,1,9,0,0,7,8,6,0,0,0,0,17224,7.0,18201,202,51,-53,206,25.3,1722.4,14,1,1,8,7,4,0,0,0,0,17277,6.8,17995,203,40,53,-206,24.3,1727.7
4853183243,0,12,1,0,1,3,1,0,0,0,0,13687,6.8,17264,203,52,-3026,-1767,25.5,1368.7,71,1,1,3,1,2,0,0,0,0,16713,7.0,19031,237,60,3026,1767,29.7,1671.3
4853167770,1,11,3,1,4,3,6,0,0,0,0,16524,7.0,18590,255,72,1410,831,32.7,1652.4,15,2,0,3,4,1,1,1,0,0,15114,6.8,17759,225,63,-1410,-831,28.8,1511.4
4853136783,1,13,1,1,4,4,3,0,0,0,0,15963,6.8,17476,194,52,-1357,-1259,24.6,1596.3,15,2,0,4,4,6,0,0,0,0,17320,7.4,18735,217,60,1357,1259,27.7,1732.0
4853092856,1,12,1,1,2,2,4,1,0,1,0,15803,7.2,19026,258,66,789,676,32.4,1580.3,15,1,0,2,2,3,1,1,0,0,15014,7.0,18350,222,68,-789,-676,29.0,1501.4
4852127268,1,11,0,1,11,2,8,0,0,0,0,18211,7.0,18370,202,55,3225,1741,25.7,1821.1,12,4,0,2,11,5,0,0,0,0,14986,6.6,16629,224,51,-3225,-1741,27.5,1498.6
4852107788,1,9,0,0,3,7,3,0,0,0,0,16146,7.0,18200,201,44,-1172,-17,24.5,1614.6,27,1,1,7,3,7,0,0,0,0,17318,6.8,18217,198,63,1172,17,26.1,1731.8
4852085831,1,13,4,0,3,3,1,2,1,1,0,16821,7.0,18816,215,64,872,1391,27.9,1682.1,14,4,1,3,3,2,0,0,0,0,15949,6.8,17425,253,56,-872,-1391,30.9,1594.9
4850764701,0,12,1,0,4,5,2,0,0,0,0,15595,6.8,18138,227,52,-748,-237,27.9,1559.5,10,1,1,5,4,3,0,0,0,0,16343,7.0,18375,237,59,748,237,29.6,1634.3
4850729029,0,54,3,1,7,5,7,0,0,0,0,17465,7.2,18794,197,52,1071,210,24.9,1746.5,12,3,0,5,7,4,1,1,0,0,16394,7.0,18584,231,72,-1071,-210,30.3,1639.4
4858348372,0,21,3,1,2,1,2,1,1,0,0,16228,7.4,19727,279,80,1792,1950,35.9,1622.8,17,3,0,1,2,1,0,0,0,0,14436,6.8,17777,246,36,-1792,-1950,28.2,1443.6
4858297940,1,17,3,0,6,4,6,0,0,0,0,18813,7.0,19332,238,67,2440,-48,30.5,1881.3,70,3,1,4,6,0,1,0,1,0,16373,7.4,19380,238,63,-2440,48,30.1,1637.3
4858252302,0,12,2,0,3,10,5,0,0,0,0,14279,6.6,15828,193,55,-5363,-2547,24.8,1427.9,15,1,1,10,3,16,2,1,1,0,19642,7.0,18375,228,56,5363,2547,28.4,1964.2
4858209423,1,13,2,1,6,3,4,0,0,0,0,17048,7.0,18563,234,63,1428,774,29.7,1704.8,18,2,0,3,6,4,0,0,0,0,15620,7.0,17789,224,56,-1428,-774,28.0,1562.0
4858178942,1,27,17,0,5,4,13,1,1,0,0,16039,6.6,17148,200,52,112,-279,25.2,1603.9,50,3,1,4,5,5,0,0,0,0,15927,6.8,17427,215,55,-112,279,27.0,1592.7
4858145986,0,12,1,0,4,5,5,0,0,0,0,16389,6.8,17780,193,54,-1828,-1347,24.7,1638.9,14,2,1,5,4,3,1,1,0,0,18217,7.0,19127,230,69,1828,1347,29.9,1821.7
4857624174,0,14,2,0,5,4,3,0,0,0,0,17610,7.4,19346,253,68,1559,941,32.1,1761.0,11,2,1,4,5,2,0,0,0,0,16051,6.8,18405,242,59,-1559,-941,30.1,1605.1
4857596008,0,13,0,1,4,8,4,0,0,0,0,14908,6.8,17690,243,40,-3187,-875,28.3,1490.8,12,2,0,7,3,6,0,0,0,0,18095,7.2,18565,240,68,3187,875,30.8,1809.5
4857558041,1,14,2,0,6,3,4,0,0,0,0,17069,7.2,18803,237,63,1847,1503,30.0,1706.9,70,2,1,3,6,9,0,0,0,0,15222,6.8,17300,209,56,-1847,-1503,26.5,1522.2
4848072082,1,47,0,1,9,8,7,1,1,0,0,17639,6.8,17625,239,52,-945,-636,29.1,1763.9,14,1,0,7,8,10,0,0,0,0,18584,6.8,18261,221,52,945,636,27.3,1858.4
4847930426,1,30,1,1,6,3,6,0,0,0,0,18354,7.2,18730,254,60,2922,1357,31.4,1835.4,31,0,0,3,6,3,0,0,0,0,15432,6.6,17373,220,52,-2922,-1357,27.2,1543.2
4847901487,0,46,3,0,2,6,1,0,0,0,0,14967,7.0,18531,211,67,-3104,-1330,27.8,1496.7,12,1,1,6,2,3,1,1,0,0,18071,7.4,19861,243,68,3104,1330,31.1,1807.1
4847854960,0,20,0,1,6,7,7,0,0,0,0,16752,7.2,18082,204,67,-307,543,27.1,1675.2,18,5,0,7,6,6,0,0,0,0,17059,6.6,17539,224,44,307,-543,26.8,1705.9
4846310058,0,46,5,1,12,9,13,0,0,0,0,19175,7.2,19139,232,48,1736,2085,28.0,1917.5,14,0,0,8,11,9,0,0,0,0,17439,6.6,17054,211,48,-1736,-2085,25.9,1743.9
4846285545,1,54,2,1,3,3,2,1,1,0,0,16265,7.2,18885,231,72,668,862,30.3,1626.5,13,1,0,3,3,5,0,0,0,0,15597,7.2,18023,215,64,-668,-862,27.9,1559.7
4846270565,1,15,1,0,9,6,7,1,1,0,0,17160,7.0,17500,208,44,-1014,-1117,25.2,1716.0,9,2,1,6,9,7,0,0,0,0,18174,6.8,18617,254,64,1014,1117,31.8,1817.4
4846248484,0,51,1,1,5,2,8,0,0,0,0,16543,6.6,16582,187,63,-242,-1307,25.0,1654.3,12,3,0,2,5,4,1,1,0,0,16785,6.8,17889,227,52,242,1307,27.9,1678.5
4845413209,0,9,1,1,5,9,8,0,0,0,0,15206,6.6,16560,182,48,-2610,-2560,23.0,1520.6,13,1,0,9,5,6,0,0,0,0,17816,7.2,19120,212,56,2610,2560,26.8,1781.6
4845389600,0,10,1,1,4,11,4,0,0,0,0,16513,7.0,17819,233,48,-1715,-627,28.1,1651.3,6,1,0,11,4,16,0,0,0,0,18228,6.8,18446,223,48,1715,627,27.1,1822.8
4845371960,0,11,0,1,6,5,7,0,0,0,0,16099,6.8,16733,178,60,81,-1989,23.8,1609.9,10,0,0,5,6,2,0,0,0,0,16018,7.0,18722,221,59,-81,1989,28.0,1601.8
4856400556,1,3,0,0,27,39,54,0,0,0,0,39036,11.8,45084,114,0,-1253,-2072,11.4,3903.6,0,0,1,39,27,90,0,0,0,0,40289,12.0,47156,109,0,1253,2072,10.9,4028.9
4856382034,1,79,0,1,27,23,64,0,0,0,2,40136,11.4,43668,118,0,3619,2324,11.8,4013.6,0,0,0,23,27,33,0,0,0,0,36517,11.0,41344,87,0,-3619,-2324,8.7,3651.7
4856319056,1,0,1,0,27,19,70,0,0,0,0,39778,11.2,42083,107,0,3224,2331,10.7,3977.8,21,0,1,19,27,51,0,0,0,0,36554,10.8,39752,99,0,-3224,-2331,9.9,3655.4
4856241997,1,0,0,0,33,24,103,0,0,0,1,39967,11.6,43909,125,0,877,1921,12.5,3996.7,0,0,1,24,33,75,0,0,0,0,39090,11.2,41988,92,0,-877,-1921,9.2,3909.0
4856199351,1,37,0,1,24,20,66,0,0,0,2,38286,11.4,42129,108,0,832,2085,10.8,3828.6,23,2,0,20,24,56,0,0,0,0,37454,11.2,40044,105,0,-832,-2085,10.5,3745.4
4855696343,0,10,2,0,6,9,5,0,0,0,0,15428,6.6,16497,169,44,-3986,-2303,21.3,1542.8,13,1,1,9,6,12,0,0,0,0,19414,7.0,18800,231,48,3986,2303,27.9,1941.4
4855515321,1,0,0,1,25,32,59,0,0,0,1,39040,11.4,42745,117,0,1141,-2954,11.7,3904.0,15,0,0,32,25,74,0,0,0,0,37899,12.0,45699,94,0,-1141,2954,9.4,3789.9
4855505547,0,0,2,0,11,32,31,0,0,0,1,35553,10.6,38271,80,0,-5213,-6071,8.0,3555.3,22,0,1,32,11,89,0,0,0,0,40766,11.8,44342,134,0,5213,6071,13.4,4076.6
4855491284,1,0,7,1,17,15,44,0,0,0,1,35840,11.0,37484,132,0,1351,-1478,13.2,3584.0,22,0,0,15,17,33,0,0,0,0,34489,11.0,38962,94,0,-1351,1478,9.4,3448.9
4855456284,1,0,2,1,24,17,75,0,0,0,0,37058,10.8,40208,116,0,3153,3960,11.6,3705.8,13,0,0,17,24,32,0,0,0,0,33905,10.4,36248,94,0,-3153,-3960,9.4,3390.5
4855439297,1,0,0,0,31,22,87,0,0,0,2,40736,11.8,45145,112,0,4091,4654,11.2,4073.6,0,0,1,21,30,47,0,0,0,0,36645,11.0,40491,89,0,-4091,-4654,8.9,3664.5
4855412663,0,84,0,1,18,21,57,0,0,0,0,34629,10.8,37885,75,0,-314,-995,7.5,3462.9,0,5,0,21,18,54,0,0,0,0,34943,10.8,38880,96,0,314,995,9.6,3494.3
4855401743,1,14,0,0,12,16,30,0,0,0,1,34527,10.4,36269,116,0,769,1333,11.6,3452.7,20,0,1,16,12,36,0,0,0,0,33758,10.2,34936,102,0,-769,-1333,10.2,3375.8
4854360991,1,0,0,0,29,23,83,0,0,0,0,37446,11.2,41483,106,0,1373,2521,10.6,3744.6,3,0,1,23,29,65,0,0,0,0,36073,11.0,38962,99,0,-1373,-2521,9.9,3607.3
4854332459,0,0,0,0,10,20,24,0,0,0,0,34484,10.2,35501,97,0,-1380,-3945,9.7,3448.4,0,0,1,20,10,59,0,0,0,0,35864,10.8,39446,97,0,1380,3945,9.7,3586.4
4854325934,1,0,0,1,16,17,45,0,0,0,2,36975,10.6,36868,98,0,1147,-2608,9.8,3697.5,0,0,0,17,16,42,0,0,0,0,35828,11.0,39476,99,0,-1147,2608,9.9,3582.8
4853251396,0,1,0,1,23,35,61,0,0,0,0,36682,10.8,38664,101,0,-4981,-9543,10.1,3668.2,0,0,0,35,23,110,0,0,0,0,41663,12.2,48207,104,0,4981,9543,10.4,4166.3
4853234444,1,12,0,0,11,13,10,0,0,0,0,20692,7.2,18391,194,64,1843,622,25.8,2069.2,11,1,1,13,11,8,0,0,0,0,18849,6.6,17769,177,60,-1843,-622,23.7,1884.9
4853217048,1,10,0,0,3,6,1,0,0,0,0,15311,6.8,18426,192,64,-708,241,25.6,1531.1,12,1,1,6,3,4,1,1,0,0,16019,6.8,18185,184,56,708,-241,24.0,1601.9
4856678000,1,0,2,0,20,19,22,0,0,0,0,63484,12.0,55000,0,0,24765,22000,0.0,6348.4,29,2,1,11,12,8,0,0,0,0,38719,7.2,33000,8,0,-24765,-22000,0.8,3871.9
4856137512,1,12,1,1,7,4,7,0,0,0,0,17805,7.0,19517,235,72,2271,1308,30.7,1780.5,11,1,0,4,7,2,0,0,0,0,15534,7.0,18209,211,55,-2271,-1308,26.6,1553.4
4856096296,0,22,0,1,11,11,10,1,0,1,0,19907,7.2,18359,223,55,1711,1272,27.8,1990.7,62,1,0,11,11,10,0,0,0,0,18196,6.6,17087,203,44,-1711,-1272,24.7,1819.6
4856054118,1,60,2,1,6,3,6,1,1,0,0,17407,7.2,19026,264,63,1388,327,32.7,1740.7,33,3,0,3,6,3,0,0,0,0,16019,7.0,18699,235,60,-1388,-327,29.5,1601.9
4855971533,0,12,1,1,3,10,1,1,1,0,0,14477,6.4,15122,200,40,-4668,-3297,24.0,1447.7,178,3,0,10,3,9,1,0,1,0,19145,7.0,18419,227,48,4668,3297,27.5,1914.5
4855947161,1,16,5,1,8,3,9,0,0,0,0,17235,6.8,17333,203,52,1475,-492,25.5,1723.5,17,3,0,3,8,4,0,0,0,0,15760,6.8,17825,251,52,-1475,492,30.3,1576.0
4855866649,1,2,0,1,25,20,26,0,0,0,0,66200,12.0,55000,0,0,27008,22000,0.0,6620.0,13,0,0,10,15,8,0,0,0,0,39192,7.2,33000,1,0,-27008,-22000,0.1,3919.2
4855840078,1,12,3,0,7,9,6,1,1,0,0,19559,7.6,20367,261,76,2050,3806,33.7,1955.9,13,0,1,9,7,11,0,0,0,0,17509,6.8,16561,223,44,-2050,-3806,26.7,1750.9
4855812124,1,0,0,1,15,22,20,0,0,0,0,60950,12.6,59500,0,0,23400,22000,0.0,6095.0,0,0,0,14,7,11,0,0,0,0,37550,7.8,37500,0,0,-23400,-22000,0.0,3755.0
4855794151,1,12,1,1,8,2,6,1,1,0,0,19102,7.4,19374,228,64,5623,2632,29.2,1910.2,12,0,0,2,8,1,0,0,0,0,13479,6.6,16742,175,52,-5623,-2632,22.7,1347.9
4855755071,1,12,0,1,9,4,9,0,0,0,0,18721,6.8,17816,202,64,3477,1255,26.6,1872.1,8,1,0,4,9,4,1,1,0,0,15244,6.4,16561,184,56,-3477,-1255,24.0,1524.4
4855731089,1,15,2,1,11,4,9,0,0,0,0,19194,7.2,18681,212,72,2085,2691,28.4,1919.4,12,6,0,4,11,3,0,0,0,0,17109,6.4,15990,182,52,-2085,-2691,23.4,1710.9
4855707095,0,91,1,0,4,7,2,0,0,0,0,15176,6.4,16354,197,52,-3315,-1178,24.9,1517.6,46,0,1,7,4,9,0,0,0,0,18491,6.6,17532,204,55,3315,1178,25.9,1849.1
4854729586,1,0,0,1,19,19,17,0,0,0,0,64450,12.0,55000,0,0,26200,22000,0.0,6445.0,0,0,0,11,11,10,0,0,0,0,38250,7.2,33000,0,0,-26200,-22000,0.0,3825.0
4854724745,1,302,3,0,19,21,22,0,0,0,0,63920,12.0,55000,4,0,26953,22000,0.4,6392.0,0,2,1,12,10,7,0,0,0,0,36967,7.2,33000,2,0,-26953,-22000,0.2,3696.7
4854699291,1,12,0,1,4,2,3,0,0,0,0,16132,6.8,17868,235,51,88,-345,28.6,1613.2,8,0,0,2,4,3,1,1,0,0,16044,7.2,18213,241,72,-88,345,31.3,1604.4
4854656095,0,16,4,0,6,4,3,0,0,0,0,17505,7.0,17898,218,52,-840,-365,27.0,1750.5,16,3,1,4,6,7,1,1,0,0,18345,7.0,18263,223,70,840,365,29.3,1834.5
4854631580,0,15,13,0,2,7,4,0,0,0,0,14120,6.2,15476,190,48,-4568,-4409,23.8,1412.0,43,3,1,7,2,8,1,0,1,0,18688,7.2,19885,260,60,4568,4409,32.0,1868.8
4854599091,0,11,1,0,7,6,6,0,0,0,0,16360,6.6,16526,194,60,-1449,-1886,25.4,1636.0,13,3,1,6,7,7,1,1,0,0,17809,7.2,18412,208,59,1449,1886,26.7,1780.9
4854570738,1,22,3,0,5,4,4,0,0,0,0,15694,6.8,17821,222,56,-514,-294,27.8,1569.4,14,2,1,4,5,1,1,1,0,0,16208,7.0,18115,231,64,514,294,29.5,1620.8
4858095329,1,17,1,0,7,8,6,1,1,0,0,17168,6.8,16918,200,64,-1265,-858,26.4,1716.8,11,2,1,8,7,7,0,0,0,0,18433,6.8,17776,207,40,1265,858,24.7,1843.3
4858060094,1,20,2,1,12,9,14,0,0,0,0,19958,7.0,18167,213,44,2153,1273,25.7,1995.8,8,3,0,9,12,6,1,1,0,0,17805,6.6,16894,211,64,-2153,-1273,27.5,1780.5
4857558153,1,2,0,0,23,12,22,0,0,0,0,64505,12.0,55000,0,0,29745,22000,0.0,6450.5,19,0,1,3,14,4,0,0,0,0,34760,7.2,33000,0,0,-29745,-22000,0.0,3476.0
4857536596,1,216,0,0,14,23,14,0,0,0,0,44586,10.0,47500,0,0,15280,19000,0.0,4458.6,0,0,1,14,5,14,0,0,0,0,29306,6.0,28500,1,0,-15280,-19000,0.1,2930.6
4857501351,1,20,0,0,6,7,7,2,1,1,0,17299,6.6,17366,213,64,98,-383,27.7,1729.9,7,2,1,7,6,8,0,0,0,0,17201,7.0,17749,194,40,-98,383,23.4,1720.1
4857444583,0,13,2,0,5,10,9,0,0,0,0,15929,6.4,16037,215,47,-2384,-1669,26.2,1592.9,12,1,1,10,5,10,0,0,0,0,18313,6.8,17706,211,55,2384,1669,26.6,1831.3
4857379421,1,12,1,0,2,2,1,1,1,0,0,15211,7.0,18241,226,56,314,918,28.2,1521.1,9,0,1,2,2,2,0,0,0,0,14897,6.8,17323,211,60,-314,-918,27.1,1489.7
4857330741,1,12,2,0,6,4,6,0,0,0,0,16487,6.8,17498,216,47,581,254,26.3,1648.7,9,1,1,4,6,4,0,0,0,0,15906,6.8,17244,229,52,-581,-254,28.1,1590.6
4857281760,1,11,4,0,4,2,3,1,1,0,0,17258,7.2,19801,256,81,2986,3063,33.7,1725.8,17,2,1,2,4,2,0,0,0,0,14272,6.8,16738,213,44,-2986,-3063,25.7,1427.2
4857223351,1,11,8,1,6,4,11,0,0,0,0,16812,7.0,17652,228,48,700,-594,27.6,1681.2,33,1,0,4,6,6,2,1,1,0,16112,7.0,18246,229,72,-700,594,30.1,1611.2
4857064340,1,16,0,1,7,3,6,0,0,0,0,17233,7.0,17925,229,48,1147,-1330,27.7,1723.3,68,4,0,3,7,0,0,0,0,0,16086,7.2,19255,257,68,-1147,1330,32.5,1608.6
4857027231,1,17,1,0,5,8,4,1,0,1,0,16750,7.0,18054,224,68,-1459,-464,29.2,1675.0,12,2,1,8,5,6,1,1,0,0,18209,7.2,18518,251,60,1459,464,31.1,1820.9
4856982262,1,11,0,0,6,3,4,0,0,0,0,17171,7.2,18699,257,49,2715,2521,30.6,1717.1,47,0,1,3,6,2,0,0,0,0,14456,6.6,16178,205,51,-2715,-2521,25.6,1445.6
4856752384,0,16,1,0,9,5,9,0,0,0,0,17363,6.6,17183,191,36,109,-987,22.7,1736.3,11,7,1,5,9,5,0,0,0,0,17254,7.0,18170,212,43,-109,987,25.5,1725.4
4856740178,1,11,3,0,9,4,8,1,1,0,0,18173,6.8,18359,232,52,3152,2022,28.4,1817.3,126,1,1,4,9,6,0,0,0,0,15021,6.6,16337,199,52,-3152,-2022,25.1,1502.1
4856455855,0,10,3,1,4,5,3,0,0,0,0,15403,7.0,17966,191,51,-467,-454,24.2,1540.3,15,2,0,4,3,4,0,0,0,0,15870,7.0,18420,217,59,467,454,27.6,1587.0
4856415382,1,14,0,1,14,1,11,1,0,1,0,19927,7.2,19035,170,44,5910,2662,21.4,1992.7,69,1,0,1,14,1,0,0,0,0,14017,6.6,16373,181,59,-5910,-2662,24.0,1401.7
4856363611,0,13,0,0,2,12,2,1,1,0,0,14830,6.6,16880,184,60,-3126,-1493,24.4,1483.0,10,1,1,12,2,8,0,0,0,0,17956,7.2,18373,204,55,3126,1493,25.9,1795.6
4856320804,0,19,1,0,3,2,4,0,0,0,0,15210,6.6,17122,189,57,1012,-530,24.6,1521.0,9,3,1,2,3,1,0,0,0,0,14198,6.8,17652,196,48,-1012,530,24.4,1419.8
4830114204,1,18,0,0,5,7,3,1,0,1,0,17329,6.8,17845,195,56,-706,904,25.1,1732.9,13,0,1,7,5,5,1,1,0,0,18035,6.4,16941,200,44,706,-904,24.4,1803.5
4829768512,1,8,2,1,10,4,9,1,1,0,0,18886,6.8,17982,234,48,1951,-40,28.2,1888.6,14,0,0,4,10,4,0,0,0,0,16935,7.2,18022,214,64,-1951,40,27.8,1693.5
4829726329,0,13,0,1,5,8,3,0,0,0,0,17581,6.8,18044,251,62,666,1090,31.3,1758.1,14,1,0,8,5,6,0,0,0,0,16915,6.6,16954,207,48,-666,-1090,25.5,1691.5
4829699116,1,12,0,1,13,4,13,1,1,0,0,20148,7.0,18600,235,60,3723,2778,29.5,2014.8,18,1,0,4,13,4,0,0,0,0,16425,6.4,15822,201,56,-3723,-2778,25.7,1642.5
4829641794,0,13,6,1,7,7,7,0,0,0,0,17292,7.0,18204,235,44,25,384,27.9,1729.2,17,1,0,7,7,7,0,0,0,0,17267,7.0,17820,231,59,-25,-384,29.0,1726.7
4829602225,1,69,1,1,10,3,12,1,1,0,0,17287,6.4,16323,174,46,3100,453,22.0,1728.7,12,0,0,3,10,5,0,0,0,0,14187,6.4,15870,202,47,-3100,-453,24.9,1418.7
4829577886,1,11,1,0,10,6,9,0,0,0,0,17737,6.8,17004,177,64,1877,261,24.1,1773.7,12,1,1,6,10,4,0,0,0,0,15860,6.8,16743,194,48,-1877,-261,24.2,1586.0
4829490945,1,53,3,1,10,3,14,0,0,0,0,18235,7.0,18245,200,52,2285,477,25.2,1823.5,11,1,0,3,10,3,1,0,1,0,15950,6.6,17768,225,57,-2285,-477,28.2,1595.0
4829444559,1,14,1,1,4,3,4,1,1,0,0,17047,6.8,17379,199,60,1436,262,25.9,1704.7,12,0,0,3,4,3,0,0,0,0,15611,6.8,17117,213,52,-1436,-262,26.5,1561.1
4829417495,0,58,1,0,6,4,8,0,0,0,0,16335,6.8,17442,183,52,-1679,-261,23.5,1633.5,12,3,1,4,6,7,0,0,0,0,18014,6.8,17703,243,64,1679,261,30.7,1801.4
4829391622,1,37,1,1,11,5,14,1,1,0,0,20509,7.2,18898,263,52,4118,1986,31.5,2050.9,31,1,0,5,11,5,0,0,0,0,16391,6.4,16912,202,55,-4118,-1986,25.7,1639.1
4805095954,0,11,0,0,2,3,1,0,0,0,0,15538,6.8,17712,223,64,317,-475,28.7,1553.8,12,2,1,3,2,3,1,1,0,0,15221,7.0,18187,248,56,-317,475,30.4,1522.1
4805067374,1,11,3,0,9,3,10,2,1,1,0,19459,7.0,18727,222,59,4310,1229,28.1,1945.9,14,1,1,3,9,1,0,0,0,0,15149,6.8,17498,230,52,-4310,-1229,28.2,1514.9
4805046599,0,19,4,0,6,5,3,0,0,0,0,16107,6.6,16543,184,48,-1733,-1270,23.2,1610.7,12,1,1,5,6,5,1,1,0,0,17840,7.0,17813,202,84,1733,1270,28.6,1784.0
4805027399,1,23,0,1,5,2,2,1,1,0,0,16429,7.0,18255,221,64,1321,1131,28.5,1642.9,9,2,0,2,5,2,0,0,0,0,15108,6.6,17124,191,67,-1321,-1131,25.8,1510.8
4804294318,1,15,4,1,9,5,13,1,0,1,0,19640,7.2,19665,233,61,3804,3072,29.4,1964.0,13,0,0,5,9,7,0,0,0,0,15836,6.8,16593,159,55,-3804,-3072,21.4,1583.6
4804221609,0,12,4,1,8,6,6,0,0,0,0,16546,6.8,17305,218,48,-797,-267,26.6,1654.6,15,0,0,6,8,3,0,0,0,0,17343,6.8,17572,198,48,797,267,24.6,1734.3
4804194981,1,14,1,1,6,5,14,0,0,0,0,16614,7.0,17621,238,48,-1127,-1170,28.6,1661.4,12,1,0,5,6,5,0,0,0,0,17741,6.8,18791,267,50,1127,1170,31.7,1774.1
4804156307,1,23,2,1,5,3,11,0,0,0,0,16896,7.0,17172,255,51,918,-801,30.6,1689.6,15,3,0,3,5,2,2,1,1,0,15978,7.0,17973,224,68,-918,801,29.2,1597.8
4804129386,1,15,1,1,4,1,2,1,1,0,0,16523,6.8,17756,241,52,1732,78,29.3,1652.3,13,3,0,1,4,3,0,0,0,0,14791,6.8,17678,221,47,-1732,-78,26.8,1479.1
4851252029,1,46,1,0,8,9,15,0,0,0,0,17456,6.4,17105,215,51,223,343,26.6,1745.6,12,2,1,9,8,9,0,0,0,0,17233,6.4,16762,203,56,-223,-343,25.9,1723.3
4848279618,1,13,4,1,6,7,4,0,0,0,0,17780,7.0,18846,243,56,6,-2,29.9,1778.0,10,5,0,7,6,10,1,1,0,0,17774,7.4,18848,212,64,-6,2,27.6,1777.4
4848270573,1,14,0,1,8,5,9,1,1,0,0,17354,6.8,17220,187,65,2877,583,25.2,1735.4,8,2,0,4,7,2,0,0,0,0,14477,6.6,16637,172,46,-2877,-583,21.8,1447.7
4848261429,0,45,1,1,4,2,4,0,0,0,0,16843,7.0,18076,234,60,1547,261,29.4,1684.3,11,4,0,2,4,2,0,0,0,0,15296,6.8,17815,228,59,-1547,-261,28.7,1529.6
4846077737,1,14,9,1,12,4,11,1,0,1,0,18355,6.6,17316,182,47,725,-1073,22.9,1835.5,28,2,0,4,12,3,0,0,0,0,17630,7.2,18389,227,60,-725,1073,28.7,1763.0
4846027560,0,23,4,0,8,9,7,1,1,0,0,16913,6.8,17104,227,49,-4031,-2525,27.6,1691.3,15,0,1,9,8,8,0,0,0,0,20944,7.2,19629,218,64,4031,2525,28.2,2094.4
4842705529,1,19,1,1,12,3,14,0,0,0,0,19182,7.2,18227,216,60,4757,2210,27.6,1918.2,30,3,0,3,12,3,0,0,0,0,14425,6.4,16017,188,44,-4757,-2210,23.2,1442.5
4842692580,1,10,0,1,8,7,8,0,0,0,0,18262,6.8,17992,210,52,1104,743,26.2,1826.2,10,0,0,7,8,6,1,0,1,0,17158,6.6,17249,202,48,-1104,-743,25.0,1715.8
4842680260,0,14,1,0,4,10,0,0,0,0,0,14428,6.6,17002,192,46,-3064,-1188,23.8,1442.8,13,2,1,10,4,8,1,1,0,0,17492,7.2,18190,201,53,3064,1188,25.4,1749.2
4842669094,0,33,2,1,2,3,3,1,1,0,0,15272,7.0,17930,218,64,-1399,-1576,28.2,1527.2,32,2,0,3,2,3,0,0,0,0,16671,7.4,19506,246,64,1399,1576,31.0,1667.1
4842413687,0,14,1,0,5,9,7,0,0,0,0,16798,7.0,18088,210,60,-1682,-573,27.0,1679.8,21,4,1,9,5,9,2,1,1,0,18480,7.2,18661,213,60,1682,573,27.3,1848.0
4842381789,0,13,0,0,6,10,4,0,0,0,0,17340,6.8,17926,204,64,-1748,-1214,26.8,1734.0,18,3,1,10,6,10,0,0,0,0,19088,7.0,19140,219,44,1748,1214,26.3,1908.8
4836636771,1,131,2,0,2,7,0,0,0,0,0,15512,7.0,17797,214,62,-2603,-125,27.6,1551.2,13,3,1,7,2,8,2,1,1,0,18115,7.0,17922,210,62,2603,125,27.2,1811.5
4836606840,1,15,2,1,8,5,6,0,0,0,0,18750,6.8,18049,230,54,2338,834,28.4,1875.0,11,1,0,5,8,4,0,0,0,0,16412,7.0,17215,229,48,-2338,-834,27.7,1641.2
4827925343,1,16,1,1,16,7,15,0,0,0,0,21595,7.2,18586,192,59,4533,2233,25.1,2159.5,16,2,0,7,16,3,1,1,0,0,17062,6.6,16353,202,48,-4533,-2233,25.0,1706.2
4827697913,1,121,1,1,4,5,4,0,0,0,0,17090,6.8,17912,234,50,699,1117,28.4,1709.0,13,0,0,5,4,7,0,0,0,0,16391,6.6,16795,220,52,-699,-1117,27.2,1639.1
4827661063,0,11,2,0,9,5,9,1,1,0,0,17955,7.0,17450,216,50,1052,-57,26.6,1795.5,12,1,1,5,9,5,0,0,0,0,16903,6.6,17507,225,48,-1052,57,27.3,1690.3
4827630316,0,13,5,1,7,4,8,0,0,0,0,17114,6.8,17864,206,44,537,-402,25.0,1711.4,18,3,0,4,7,6,1,1,0,0,16577,7.0,18266,219,64,-537,402,28.3,1657.7
4823733297,1,9,0,0,11,2,9,0,0,0,0,17548,7.0,18127,228,56,2938,1947,28.4,1754.8,10,0,1,2,11,4,0,0,0,0,14610,6.4,16180,225,44,-2938,-1947,26.9,1461.0
4823683562,0,53,1,0,7,7,7,0,0,0,0,18233,7.0,18327,233,56,-1976,-1842,28.9,1823.3,78,1,1,7,7,6,0,0,0,0,20209,7.4,20169,210,48,1976,1842,25.8,2020.9
4857515896,1,4,0,0,7,5,2,1,1,0,0,15059,6.4,14714,78,60,1677,-221,13.8,1505.9,0,0,1,5,7,5,0,0,0,0,13382,6.2,14935,148,0,-1677,221,14.8,1338.2
4857498751,1,0,0,0,19,19,24,0,0,0,0,63050,13.0,62500,0,0,24800,25000,0.0,6305.0,0,0,1,13,13,8,0,0,0,0,38250,7.8,37500,0,0,-24800,-25000,0.0,3825.0
4857442567,0,15,2,1,7,7,7,0,0,0,0,18184,7.2,19450,231,68,1029,216,29.9,1818.4,10,0,0,7,7,9,1,0,1,0,17155,7.2,19234,221,60,-1029,-216,28.1,1715.5
4857398704,1,12,0,0,7,7,7,0,0,0,0,17438,7.0,17827,226,60,74,1085,28.6,1743.8,19,0,1,7,7,11,1,1,0,0,17364,6.6,16742,231,52,-74,-1085,28.3,1736.4
4856832075,1,11,0,0,6,7,3,0,0,0,0,16787,6.8,18147,191,60,-602,252,25.1,1678.7,9,1,1,7,6,12,1,1,0,0,17389,7.0,17895,210,52,602,-252,26.2,1738.9
4856813925,0,9,1,0,4,10,4,0,0,0,0,15568,6.6,17214,224,52,-2479,-1333,27.6,1556.8,18,2,1,10,4,9,1,1,0,0,18047,7.0,18547,204,51,2479,1333,25.5,1804.7
4856602746,0,13,1,0,10,8,11,1,0,1,0,18158,7.0,18565,234,63,425,142,29.7,1815.8,13,1,1,8,10,8,1,1,0,0,17733,7.2,18423,222,57,-425,-142,27.9,1773.3
4856577585,0,19,0,0,2,5,3,0,0,0,0,14434,6.2,15406,197,47,-2336,-3104,24.4,1443.4,13,0,1,5,2,6,0,0,0,0,16770,7.0,18510,237,60,2336,3104,29.7,1677.0
4856525877,1,32,2,1,21,14,22,0,0,0,0,47485,10.0,47500,5,0,20023,19000,0.5,4748.5,50,1,0,7,14,10,0,0,0,0,27462,6.0,28500,0,0,-20023,-19000,0.0,2746.2
4856505835,1,16,0,0,12,16,14,0,0,0,0,46030,10.0,47500,0,0,17864,19000,0.0,4603.0,0,0,1,11,7,8,0,0,0,0,28166,6.0,28500,1,0,-17864,-19000,0.1,2816.6
4854674377,0,18,0,1,4,7,3,0,0,0,0,15409,6.8,16783,197,51,-2627,-2216,24.8,1540.9,15,2,0,7,4,9,1,1,0,0,18036,7.0,18999,260,60,2627,2216,32.0,1803.6
4854649199,1,15,0,0,2,11,4,0,0,0,0,14815,6.8,16776,237,52,-4093,-1747,28.9,1481.5,13,6,1,11,2,15,1,1,0,0,18908,6.8,18523,264,47,4093,1747,31.1,1890.8
4854617698,0,12,0,1,4,8,4,0,0,0,0,15921,7.0,18205,244,47,-1916,-1029,29.1,1592.1,5,0,0,7,3,8,0,0,0,0,17837,7.2,19234,231,68,1916,1029,29.9,1783.7
4854156481,1,0,0,0,15,15,16,0,0,0,0,46650,10.0,47500,0,0,19500,19000,0.0,4665.0,4,0,1,9,9,9,0,0,0,0,27150,6.0,28500,0,0,-19500,-19000,0.0,2715.0
4854136144,1,14,0,1,20,22,15,0,0,0,0,61370,12.0,55000,0,0,22548,18000,0.0,6137.0,4,0,0,12,10,12,0,0,0,0,38822,8.0,37000,0,0,-22548,-18000,0.0,3882.2
4854104967,1,19,0,0,19,18,17,0,0,0,0,50133,10.0,47500,0,0,23333,19000,0.0,5013.3,0,0,1,8,9,7,0,0,0,0,26800,6.0,28500,0,0,-23333,-19000,0.0,2680.0
4854078766,1,15,0,1,18,16,14,0,0,0,0,47350,10.0,47500,0,0,19686,19000,0.0,4735.0,41,0,0,7,9,12,0,0,0,0,27664,6.0,28500,0,0,-19686,-19000,0.0,2766.4
4854049472,1,0,0,1,24,17,29,0,0,0,0,64800,12.4,57000,0,0,29000,24000,0.0,6480.0,0,0,0,8,15,6,0,0,0,0,35800,7.2,33000,0,0,-29000,-24000,0.0,3580.0
4853934922,1,5,0,0,17,19,19,0,0,0,0,60950,12.0,55000,0,0,23400,22000,0.0,6095.0,0,0,1,10,8,12,0,0,0,0,37550,7.2,33000,0,0,-23400,-22000,0.0,3755.0
4853908322,1,342,4,1,25,12,24,0,0,0,0,66962,12.0,55000,0,0,41014,22000,0.0,6696.2,30,1,0,5,18,6,0,0,0,0,25948,7.2,33000,5,0,-41014,-22000,0.5,2594.8
4856105693,1,0,0,1,21,16,18,0,0,0,0,62000,13.0,62500,0,0,24100,25000,0.0,6200.0,20,0,0,7,12,12,0,0,0,0,37900,7.8,37500,0,0,-24100,-25000,0.0,3790.0
4856082960,1,0,0,0,16,19,18,0,0,0,0,46300,10.0,47500,8,0,17400,19000,0.8,4630.0,0,0,1,13,10,9,0,0,0,0,28900,6.0,28500,1,0,-17400,-19000,0.1,2890.0
4856057826,1,0,0,0,19,13,17,0,0,0,0,51250,10.0,47500,2,0,24450,19000,0.2,5125.0,0,0,1,5,11,7,0,0,0,0,26800,6.0,28500,0,0,-24450,-19000,0.0,2680.0
4835192606,0,13,2,0,5,8,4,0,0,0,0,16674,6.8,17415,253,48,-1057,-1077,30.1,1667.4,12,2,1,8,5,10,1,1,0,0,17731,7.0,18492,232,64,1057,1077,29.6,1773.1
4835157761,0,8,0,0,4,8,0,0,0,0,0,15078,6.8,17808,200,44,-2203,-594,24.4,1507.8,13,0,1,8,4,3,0,0,0,0,17281,7.0,18402,208,72,2203,594,28.0,1728.1
4835100994,1,36,1,1,11,10,10,0,0,0,0,18914,7.0,17368,203,54,-394,-15,25.7,1891.4,11,14,0,9,10,6,0,0,0,0,19308,6.8,17383,205,36,394,15,24.1,1930.8
4827054933,1,12,1,0,5,3,6,0,0,0,0,16596,6.8,17949,202,72,1288,352,27.4,1659.6,12,0,1,3,5,1,1,1,0,0,15308,6.6,17597,200,64,-1288,-352,26.4,1530.8
4827040677,0,10,5,0,7,10,9,0,0,0,0,16904,6.4,16244,185,43,-2438,-1599,22.8,1690.4,50,0,1,9,6,7,0,0,0,0,19342,6.8,17843,211,76,2438,1599,28.7,1934.2
4824171270,0,13,0,0,1,2,0,0,0,0,0,15631,7.2,18813,246,57,-1142,-921,30.3,1563.1,10,0,1,2,1,3,0,0,0,0,16773,7.2,19734,241,78,1142,921,31.9,1677.3
4824151191,1,20,2,0,6,8,4,0,0,0,0,17899,7.2,19314,251,72,-126,1250,32.3,1789.9,10,1,1,8,6,8,1,1,0,0,18025,6.8,18064,249,52,126,-1250,30.1,1802.5
4811876379,0,17,1,1,4,3,5,0,0,0,0,16211,6.8,17469,230,47,295,-1133,27.7,1621.1,10,4,0,3,4,2,2,1,1,0,15916,7.0,18602,225,52,-295,1133,27.7,1591.6
4811858068,1,10,0,0,9,6,10,1,1,0,0,17873,7.0,17782,225,48,1011,372,27.3,1787.3,12,0,1,6,9,6,0,0,0,0,16862,7.0,17410,213,60,-1011,-372,27.3,1686.2
4811840371,1,12,0,0,3,3,2,1,1,0,0,17880,7.2,19123,276,69,1572,814,34.5,1788.0,11,1,1,3,3,3,0,0,0,0,16308,7.0,18309,236,62,-1572,-814,29.8,1630.8
4811822181,1,14,2,1,3,0,3,0,0,0,0,17041,7.2,18953,245,60,1958,35,30.5,1704.1,15,0,0,0,3,0,0,0,0,0,15083,7.0,18918,262,72,-1958,-35,33.4,1508.3
4811813939,0,14,2,1,8,7,8,0,0,0,0,16817,6.8,16858,207,44,-2149,-1500,25.1,1681.7,11,0,0,7,8,5,1,0,1,0,18966,7.0,18358,229,52,2149,1500,28.1,1896.6
4810975101,1,18,3,1,3,5,6,0,0,0,0,17011,7.2,19086,276,71,-52,34,34.7,1701.1,12,2,0,5,3,8,1,0,1,0,17063,7.2,19052,236,68,52,-34,30.4,1706.3
4810940233,0,15,2,0,4,8,4,0,0,0,0,14380,6.4,15219,203,33,-4444,-3656,23.6,1438.0,51,0,1,8,4,6,0,0,0,0,18824,7.4,18875,241,61,4444,3656,30.2,1882.4
4810920392,0,40,1,1,4,8,5,0,0,0,0,16104,7.0,17828,227,48,-2804,-1419,27.5,1610.4,47,1,0,8,4,14,0,0,0,0,18908,7.0,19247,235,67,2804,1419,30.2,1890.8
4810899010,1,82,0,0,7,5,7,0,0,0,0,18767,7.2,19762,215,62,1737,982,27.7,1876.7,13,2,1,5,7,4,0,0,0,0,17030,7.0,18780,216,60,-1737,-982,27.6,1703.0
4858371235,0,11,1,0,2,3,2,0,0,0,0,15188,6.8,18254,208,56,-258,-99,26.4,1518.8,9,1,1,3,2,3,0,0,0,0,15446,7.0,18353,188,76,258,99,26.4,1544.6
4858328858,1,0,0,0,19,14,19,0,0,0,0,62325,12.2,56000,5,0,24650,23000,0.5,6232.5,0,0,1,11,16,10,0,0,0,0,37675,7.2,33000,0,0,-24650,-23000,0.0,3767.5
4857923437,1,9,0,1,16,27,18,0,0,0,0,63350,12.0,55000,0,0,24750,22000,0.0,6335.0,0,0,0,19,8,17,0,0,0,0,38600,7.2,33000,0,0,-24750,-22000,0.0,3860.0
4857913459,1,0,0,1,19,21,19,0,0,0,0,64450,13.6,65000,0,0,26900,27500,0.0,6445.0,5,0,0,13,11,10,0,0,0,0,37550,7.8,37500,0,0,-26900,-27500,0.0,3755.0
4857319205,0,16,2,1,4,4,4,0,0,0,0,16289,7.0,17596,225,55,115,-467,28.0,1628.9,14,1,0,4,4,4,1,1,0,0,16174,6.8,18063,180,48,-115,467,22.8,1617.4
4857287213,1,14,3,1,8,4,10,1,0,1,0,18232,7.0,18078,231,60,2234,-208,29.1,1823.2,8,2,0,4,8,4,0,0,0,0,15998,7.0,18286,207,52,-2234,208,25.9,1599.8
4856896433,0,25,0,0,6,3,5,0,0,0,0,16042,6.6,17739,202,58,1354,446,26.0,1604.2,11,1,1,3,6,1,0,0,0,0,14688,6.8,17293,188,58,-1354,-446,24.6,1468.8
4856885034,0,12,2,0,5,5,3,0,0,0,0,16167,6.8,18153,197,60,-754,-1645,25.7,1616.7,10,2,1,5,5,3,1,1,0,0,16921,7.4,19798,236,64,754,1645,30.0,1692.1
4856822439,0,0,0,0,29,30,75,0,0,0,1,40710,11.6,44464,109,0,1050,-1320,10.9,4071.0,7,0,1,30,29,66,0,0,0,0,39660,12.0,45784,110,0,-1050,1320,11.0,3966.0
4856801744,0,0,0,0,15,15,36,0,0,0,0,33084,10.2,35160,89,0,-475,-1966,8.9,3308.4,0,0,1,15,15,40,0,0,0,0,33559,10.6,37126,94,0,475,1966,9.4,3355.9
4856580259,0,12,3,0,4,5,3,0,0,0,0,14817,6.8,17364,207,52,-2253,-1934,25.9,1481.7,12,1,1,5,4,3,0,0,0,0,17070,7.4,19298,239,72,2253,1934,31.1,1707.0
4856391537,1,0,2,1,26,21,80,0,0,0,1,40046,11.4,42298,123,0,4479,5050,12.3,4004.6,15,0,0,21,26,51,0,0,0,0,35567,10.8,37248,80,0,-4479,-5050,8.0,3556.7
4856348353,0,37,0,1,34,24,92,0,0,0,1,39742,11.8,43873,102,0,1027,727,10.2,3974.2,0,3,0,24,34,63,0,0,0,0,38715,11.8,43146,110,0,-1027,-727,11.0,3871.5
4856325111,0,1,16,1,28,32,64,0,0,0,1,38528,11.4,41948,108,0,-695,-1461,10.8,3852.8,48,0,0,32,28,80,0,0,0,0,39223,11.6,43409,121,0,695,1461,12.1,3922.3
4855061389,1,0,0,1,26,19,64,0,0,0,1,37312,10.8,40088,104,0,127,-33,10.4,3731.2,0,0,0,18,25,49,0,0,0,0,37185,11.0,40121,114,0,-127,33,11.4,3718.5
4855027397,1,0,0,0,16,17,42,0,0,0,1,34730,10.6,37309,106,0,-1725,-1130,10.6,3473.0,6,0,1,17,16,50,0,0,0,0,36455,10.8,38439,122,0,1725,1130,12.2,3645.5
4855003745,1,0,0,1,21,19,52,0,0,0,1,37924,11.2,39879,120,0,2513,2069,12.0,3792.4,111,0,0,19,21,53,0,0,0,0,35411,10.6,37810,92,0,-2513,-2069,9.2,3541.1
4854962978,0,0,0,1,25,24,50,0,0,0,0,37432,11.2,41049,111,0,-157,1424,11.1,3743.2,0,0,0,24,25,49,0,0,0,0,37589,11.0,39625,109,0,157,-1424,10.9,3758.9
4853761860,0,65,5,0,5,6,3,0,0,0,0,15315,6.8,17906,218,52,-314,125,27.0,1531.5,15,3,1,6,5,3,1,1,0,0,15629,6.8,17781,184,56,314,-125,24.0,1562.9
4853712493,0,14,3,1,4,4,2,0,0,0,0,15662,6.4,16857,219,40,4,-952,25.9,1566.2,16,1,0,4,4,5,1,1,0,0,15658,7.0,17809,226,56,-4,952,28.2,1565.8
4857538063,1,0,0,1,15,21,20,0,0,0,0,33793,9.0,40000,1,0,14593,16000,0.1,3379.3,0,0,0,15,9,9,0,0,0,0,19200,5.4,24000,0,0,-14593,-16000,0.0,1920.0
4857515466,1,202,0,0,14,15,15,0,0,0,0,61907,12.0,55000,9,0,23554,22000,0.9,6190.7,0,4,1,9,8,5,0,0,0,0,38353,7.2,33000,0,0,-23554,-22000,0.0,3835.3
4857497938,1,0,0,0,13,17,11,0,0,0,0,44900,10.0,47500,0,0,17400,19000,0.0,4490.0,0,0,1,10,6,12,0,0,0,0,27500,6.0,28500,0,0,-17400,-19000,0.0,2750.0
4857473390,1,5,0,1,18,18,19,0,0,0,0,53750,13.0,62500,0,0,16900,25000,0.0,5375.0,0,0,0,12,12,6,0,0,0,0,36850,7.8,37500,0,0,-16900,-25000,0.0,3685.0
4857453124,1,14,0,1,11,21,14,0,0,0,0,61148,12.0,55000,0,0,19748,22000,0.0,6114.8,0,0,0,16,6,12,0,0,0,0,41400,7.2,33000,0,0,-19748,-22000,0.0,4140.0
4857391616,0,9,0,1,2,6,2,0,0,0,0,16324,6.8,18002,190,48,-205,-39,23.8,1632.4,18,0,0,6,2,8,0,0,0,0,16529,7.0,18041,218,56,205,39,27.4,1652.9
4857351539,1,12,0,1,11,7,17,1,1,0,0,19573,6.8,17836,207,49,1770,928,25.6,1957.3,10,3,0,7,11,14,0,0,0,0,17803,6.8,16908,190,42,-1770,-928,23.2,1780.3
4857277385,1,17,2,0,4,4,2,0,0,0,0,16220,7.0,17966,222,44,273,1291,26.6,1622.0,9,4,1,4,4,11,1,1,0,0,15947,6.8,16675,227,44,-273,-1291,27.1,1594.7
4857215042,0,32,1,0,3,5,3,0,0,0,0,15377,7.0,17395,227,45,-1204,-524,27.2,1537.7,83,12,1,5,3,8,1,1,0,0,16581,7.0,17919,225,59,1204,524,28.4,1658.1
4856961770,1,16,3,1,3,5,3,1,1,0,0,16022,7.0,18106,246,60,192,41,30.6,1602.2,13,1,0,5,3,3,1,0,1,0,15830,7.0,18065,224,60,-192,-41,28.4,1583.0
4856917534,1,10,1,0,6,10,8,0,0,0,0,16931,7.0,17002,208,58,-774,-596,26.6,1693.1,35,1,1,10,6,18,0,0,0,0,17705,6.6,17598,172,53,774,596,22.5,1770.5
4856667555,1,17,2,0,6,3,2,0,0,0,0,15686,6.8,18113,235,40,770,-524,27.5,1568.6,8,1,1,3,6,1,0,0,0,0,14916,7.2,18637,220,72,-770,524,29.2,1491.6
4856658819,0,12,1,0,2,7,3,0,0,0,0,14608,6.8,16910,204,52,-3055,-2776,25.6,1460.8,12,1,1,7,2,3,1,1,0,0,17663,7.0,19686,234,73,3055,2776,30.7,1766.3
4856649032,1,0,0,0,21,17,60,0,0,0,1,36428,11.0,40468,113,0,640,3977,11.3,3642.8,0,0,1,17,21,39,0,0,0,0,35788,10.6,36491,99,0,-640,-3977,9.9,3578.8
4856634680,0,0,0,0,24,39,51,0,0,0,1,38688,11.6,43773,112,0,-2693,-2719,11.2,3868.8,31,0,1,39,24,121,0,0,0,0,41381,12.2,46492,104,0,2693,2719,10.4,4138.1
4855925798,0,13,1,0,5,10,5,0,0,0,0,15836,6.4,15991,165,52,-3654,-2352,21.7,1583.6,11,2,1,10,5,12,1,1,0,0,19490,7.2,18343,192,55,3654,2352,24.7,1949.0
4855858035,0,15,1,0,8,6,15,0,0,0,0,17460,6.6,16821,212,47,755,-605,25.9,1746.0,12,2,1,6,8,9,0,0,0,0,16705,6.6,17426,215,52,-755,605,26.7,1670.5
4855823247,1,12,4,0,5,8,9,1,1,0,0,16204,6.8,17111,235,59,-2324,-494,29.4,1620.4,10,4,1,8,5,19,0,0,0,0,18528,6.8,17605,227,44,2324,494,27.1,1852.8
4855162483,0,12,0,1,10,11,11,1,1,0,0,16165,6.4,15584,145,44,-4789,-1771,18.9,1616.5,14,0,0,11,10,13,0,0,0,0,20954,6.8,17355,204,44,4789,1771,24.8,2095.4
4855118352,1,34,0,1,36,35,94,0,0,0,1,42915,11.8,46811,116,0,2957,1180,11.6,4291.5,34,0,0,35,36,70,0,0,0,0,39958,12.0,45631,102,0,-2957,-1180,10.2,3995.8
4858199295,1,0,0,1,17,12,14,0,0,0,0,33400,9.0,40000,0,0,14200,16000,0.0,3340.0,0,0,0,6,11,7,0,0,0,0,19200,5.4,24000,0,0,-14200,-16000,0.0,1920.0
4858173276,1,26,0,1,22,12,14,0,0,0,0,46650,10.0,47500,0,0,18800,19000,0.0,4665.0,1,0,0,4,14,10,0,0,0,0,27850,6.0,28500,0,0,-18800,-19000,0.0,2785.0
4857504145,1,0,0,1,23,11,18,0,0,0,0,49070,10.0,47500,0,0,22270,17820,0.0,4907.0,0,0,0,3,15,8,0,0,0,0,26800,6.2,29680,0,0,-22270,-17820,0.0,2680.0
4857481370,1,15,0,1,26,15,22,0,0,0,0,65500,13.0,62500,0,0,28300,28000,0.0,6550.0,4,0,0,4,15,7,0,0,0,0,37200,7.4,34500,0,0,-28300,-28000,0.0,3720.0
4857423095,1,11,1,1,4,5,4,0,0,0,0,17724,7.2,18814,239,68,1331,1366,30.7,1772.4,11,1,0,5,4,7,1,1,0,0,16393,6.8,17448,234,52,-1331,-1366,28.6,1639.3
4856920471,1,20,1,0,7,2,11,0,0,0,0,17839,7.4,19204,213,59,2996,1580,27.2,1783.9,14,1,1,2,7,2,0,0,0,0,14843,6.8,17624,196,48,-2996,-1580,24.4,1484.3
4856899419,0,15,2,0,6,5,7,0,0,0,0,16580,6.4,16523,194,50,358,46,24.4,1658.0,11,4,1,5,6,3,1,1,0,0,16222,6.6,16477,200,41,-358,-46,24.1,1622.2
4856401808,1,0,0,1,15,23,19,0,0,0,0,62055,12.0,55000,1,0,22730,22000,0.1,6205.5,0,0,0,14,6,11,0,0,0,0,39325,7.2,33000,0,0,-22730,-22000,0.0,3932.5
4856376225,1,27,3,0,14,14,16,0,0,0,0,61015,12.0,55000,2,0,23551,22000,0.2,6101.5,0,1,1,11,11,8,0,0,0,0,37464,7.2,33000,0,0,-23551,-22000,0.0,3746.4
4856350096,1,12,0,1,18,19,13,0,0,0,0,61650,12.0,55000,0,0,24100,22000,0.0,6165.0,0,0,0,13,12,13,0,0,0,0,37550,7.2,33000,0,0,-24100,-22000,0.0,3755.0
4856320555,1,0,0,1,19,22,16,0,0,0,0,63400,12.0,55000,0,1,24800,22000,0.1,6340.0,19,0,0,12,9,13,0,0,0,0,38600,7.2,33000,0,0,-24800,-22000,0.0,3860.0
4856292087,1,14,11,1,7,1,4,0,0,0,0,17553,7.4,20360,241,56,3082,3165,29.7,1755.3,34,2,0,1,7,1,0,0,0,0,14471,6.8,17195,216,40,-3082,-3165,25.6,1447.1
4856210382,1,19,3,1,10,4,8,0,0,0,0,18013,6.6,17598,194,44,2746,434,23.8,1801.3,12,1,0,4,10,3,0,0,0,0,15267,6.6,17164,170,47,-2746,-434,21.7,1526.7
4856093744,0,0,0,1,28,33,70,0,0,0,0,38474,11.8,44381,106,0,-1961,-1395,10.6,3847.4,0,0,0,33,28,76,0,0,0,0,40435,12.0,45776,107,0,1961,1395,10.7,4043.5
4856060988,1,49,0,1,24,20,64,0,0,0,0,37522,11.2,40891,97,0,901,1514,9.7,3752.2,0,3,0,20,24,57,0,0,0,0,36621,11.0,39377,107,0,-901,-1514,10.7,3662.1
4856027648,0,1,0,0,26,20,69,0,0,0,1,39500,11.8,44513,97,0,2455,4057,9.7,3950.0,37,0,1,20,26,41,0,0,0,0,37045,11.0,40456,98,0,-2455,-4057,9.8,3704.5
4855985817,0,23,1,0,7,7,10,0,0,0,0,16933,6.8,16611,206,56,-92,19,26.2,1693.3,12,0,1,7,7,6,0,0,0,0,17025,6.8,16592,192,52,92,-19,24.4,1702.5
4855953598,0,50,1,1,5,15,8,0,0,0,0,15096,6.4,15830,178,52,-5311,-3119,23.0,1509.6,20,1,0,15,5,15,0,0,0,0,20407,7.0,18949,220,64,5311,3119,28.4,2040.7
4855929353,0,10,1,0,1,9,0,0,0,0,0,14553,6.6,17452,216,48,-3637,-1629,26.4,1455.3,28,1,1,9,1,9,0,0,0,0,18190,7.0,19081,224,50,3637,1629,27.4,1819.0
4855357679,1,17,0,0,5,3,1,0,0,0,0,17039,7.8,20810,246,64,1997,3065,31.0,1703.9,12,3,1,3,5,1,0,0,0,0,15042,7.0,17745,241,56,-1997,-3065,29.7,1504.2
4846407949,0,12,1,1,8,13,10,0,0,0,0,16736,6.4,15647,171,40,-2212,-3097,21.1,1673.6,20,4,0,13,8,8,0,0,0,0,18948,7.2,18744,225,57,2212,3097,28.2,1894.8
4846391307,1,16,0,1,10,7,11,1,1,0,0,18972,7.0,18436,241,55,2192,660,29.6,1897.2,15,1,0,6,9,4,0,0,0,0,16780,7.0,17776,213,49,-2192,-660,26.2,1678.0
4843445485,1,14,1,0,7,5,9,0,0,0,0,19019,7.4,19511,249,59,1968,1235,30.8,1901.9,15,1,1,5,7,4,0,0,0,0,17051,7.2,18276,222,56,-1968,-1235,27.8,1705.1
4843375370,0,14,2,0,11,5,6,1,1,0,0,17898,6.8,17852,199,52,917,264,25.1,1789.8,21,3,1,5,11,3,0,0,0,0,16981,7.0,17588,207,53,-917,-264,26.0,1698.1
4843327567,1,10,3,1,10,9,11,2,1,1,0,20264,7.0,18199,213,48,359,-147,26.1,2026.4,24,0,0,9,10,9,0,0,0,0,19905,7.0,18346,193,60,-359,147,25.3,1990.5
4843287353,1,9,1,0,8,7,6,0,0,0,0,16951,7.2,18653,196,64,-138,511,26.0,1695.1,9,0,1,7,8,5,1,0,1,0,17089,6.8,18142,230,43,138,-511,27.3,1708.9
4767949719,1,22,1,0,4,1,4,2,1,1,0,16201,6.6,17852,213,63,873,1066,27.6,1620.1,11,3,1,1,4,1,0,0,0,0,15328,6.8,16786,229,55,-873,-1066,28.4,1532.8
4766674933,0,15,1,0,2,5,0,1,0,1,0,14486,6.6,16665,198,55,-3294,-2594,25.3,1448.6,14,3,1,5,2,4,1,1,0,0,17780,7.0,19259,245,72,3294,2594,31.7,1778.0
4766653686,1,56,3,1,7,3,10,0,0,0,0,17334,7.0,17966,208,57,1683,-160,26.5,1733.4,12,0,0,3,7,1,0,0,0,0,15651,7.0,18126,212,64,-1683,160,27.6,1565.1
4759886662,1,29,4,1,7,2,4,0,0,0,0,19261,7.4,20185,259,55,3800,3099,31.4,1926.1,14,1,0,2,7,2,1,1,0,0,15461,7.0,17086,206,51,-3800,-3099,25.7,1546.1
4759870684,1,13,0,1,3,1,1,0,0,0,0,15955,7.2,18851,230,64,1478,1979,29.4,1595.5,12,0,0,1,3,1,0,0,0,0,14477,6.4,16872,218,52,-1478,-1979,27.0,1447.7
4759837241,1,11,4,1,7,2,7,0,0,0,0,16634,6.8,17815,201,60,1182,538,26.1,1663.4,16,2,0,2,7,1,1,1,0,0,15452,6.8,17277,209,68,-1182,-538,27.7,1545.2
4759804395,1,17,1,0,10,8,9,0,0,0,0,19805,6.8,18392,220,59,1907,536,27.9,1980.5,15,0,1,8,10,12,1,1,0,0,17898,7.0,17856,209,60,-1907,-536,26.9,1789.8
4759767649,0,13,2,1,1,12,2,0,0,0,0,15113,6.8,16807,217,60,-6401,-3405,27.7,1511.3,9,4,0,12,1,16,0,0,0,0,21514,7.4,20212,255,67,6401,3405,32.2,2151.4
4759732051,0,13,0,0,6,11,3,0,0,0,0,15307,6.6,16825,195,40,-3475,-1410,23.5,1530.7,21,0,1,11,6,9,1,1,0,0,18782,6.8,18235,232,52,3475,1410,28.4,1878.2
4759709875,1,17,4,1,12,5,17,0,0,0,0,18509,7.0,17360,201,42,1494,1832,24.3,1850.9,16,1,0,5,12,9,0,0,0,0,17015,6.4,15528,197,48,-1494,-1832,24.5,1701.5
4759348049,0,15,4,0,1,9,1,0,0,0,0,13422,6.2,15509,196,48,-7694,-5172,24.4,1342.2,13,1,1,9,1,6,0,0,0,0,21116,7.4,20681,257,48,7694,5172,30.5,2111.6
4759332150,0,12,3,1,4,6,2,0,0,0,0,15644,6.0,15800,195,40,-2721,-2545,23.5,1564.4,11,2,0,6,4,6,1,1,0,0,18365,7.0,18345,260,52,2721,2545,31.2,1836.5
4755611516,1,12,2,1,9,1,12,0,0,0,0,19738,7.6,20932,251,84,5223,3733,33.5,1973.8,19,4,0,1,9,0,0,0,0,0,14515,6.8,17199,227,56,-5223,-3733,28.3,1451.5
4858252302,0,12,2,0,3,10,5,0,0,0,0,14279,6.6,15828,193,55,-5363,-2547,24.8,1427.9,15,1,1,10,3,16,2,1,1,0,19642,7.0,18375,228,56,5363,2547,28.4,1964.2
4858197497,1,13,1,1,8,6,6,0,0,0,0,18134,7.0,18162,230,52,-203,25,28.2,1813.4,11,3,0,6,8,5,0,0,0,0,18337,7.2,18137,246,51,203,-25,29.7,1833.7
4858155308,1,18,0,0,8,6,13,0,0,0,0,17940,6.8,17442,189,52,1603,1141,24.1,1794.0,14,0,1,6,8,4,1,1,0,0,16337,6.6,16301,173,65,-1603,-1141,23.8,1633.7
4858127265,1,10,2,1,7,5,8,1,1,0,0,17861,6.8,17073,224,52,1589,1559,27.6,1786.1,7,5,0,5,7,3,0,0,0,0,16272,6.4,15514,162,52,-1589,-1559,21.4,1627.2
4856300627,1,3,0,0,23,17,22,0,0,0,0,48678,10.0,47500,0,0,21518,19000,0.0,4867.8,0,0,1,7,13,6,0,0,0,0,27160,6.0,28500,0,0,-21518,-19000,0.0,2716.0
4853571722,1,10,2,0,22,19,21,0,0,0,0,48120,10.0,47500,3,0,20260,19000,0.3,4812.0,20,1,1,8,11,10,0,0,0,0,27860,6.0,28500,1,0,-20260,-19000,0.1,2786.0
4853553569,1,0,0,0,21,15,26,0,0,0,0,66260,13.0,62500,0,0,30445,28000,0.0,6626.0,0,0,1,10,16,5,0,0,0,0,35815,7.4,34500,0,0,-30445,-28000,0.0,3581.5
4853541960,1,3,0,0,21,14,17,0,0,0,0,53400,12.0,55000,0,0,17600,22000,0.0,5340.0,0,0,1,4,11,6,0,0,0,0,35800,7.2,33000,0,0,-17600,-22000,0.0,3580.0
4853529753,1,4,0,0,20,18,20,0,0,0,0,62706,12.0,55000,0,0,25503,22000,0.0,6270.6,0,0,1,11,13,9,0,0,0,0,37203,7.2,33000,0,0,-25503,-22000,0.0,3720.3
4853510274,1,19,0,1,18,16,21,0,0,0,0,62000,12.0,55000,0,0,25490,22000,0.0,6200.0,0,1,0,9,11,7,0,0,0,0,36510,7.2,33000,1,0,-25490,-22000,0.1,3651.0
4853470862,0,184,2,1,6,10,3,0,0,0,0,17042,6.8,17692,211,63,-1728,-217,27.4,1704.2,12,4,0,10,6,8,0,0,0,0,18770,7.2,17909,250,40,1728,217,29.0,1877.0
4852608411,1,6,0,0,17,13,16,0,0,0,0,46300,10.0,47500,0,0,18800,19000,0.0,4630.0,5,0,1,11,15,9,0,0,0,0,27500,6.0,28500,0,0,-18800,-19000,0.0,2750.0
4852595816,1,0,0,1,22,16,23,0,0,0,0,49450,10.0,47500,0,0,20900,19000,0.0,4945.0,5,0,0,8,14,9,0,0,0,0,28550,6.0,28500,0,0,-20900,-19000,0.0,2855.0
4852571947,1,0,0,1,15,17,23,0,0,0,0,47350,10.0,47500,0,0,18100,19000,0.0,4735.0,0,0,0,13,11,6,0,0,0,0,29250,6.0,28500,0,0,-18100,-19000,0.0,2925.0
4852536036,1,20,0,1,16,20,16,0,0,0,0,60600,12.0,55000,0,0,22700,22000,0.0,6060.0,0,0,0,11,7,12,0,0,0,0,37900,7.2,33000,0,0,-22700,-22000,0.0,3790.0
4852509418,1,0,0,1,15,10,15,0,0,0,0,34780,10.0,47500,2,0,15500,19000,0.2,3478.0,0,0,0,5,10,4,0,0,0,0,19280,6.0,28500,0,0,-15500,-19000,0.0,1928.0
4852494678,1,0,0,0,16,21,18,0,0,0,0,62700,12.0,55000,0,0,24800,22000,0.0,6270.0,4,0,1,15,10,13,0,0,0,0,37900,7.2,33000,0,0,-24800,-22000,0.0,3790.0
4852484777,1,0,0,1,19,14,22,0,0,0,0,47555,10.0,47500,7,0,18930,19000,0.7,4755.5,0,0,0,11,16,10,0,0,0,0,28625,6.0,28500,6,0,-18930,-19000,0.6,2862.5
4852462582,1,0,0,1,10,20,13,0,0,0,0,59675,12.0,55000,1,0,21365,22000,0.1,5967.5,0,0,0,14,4,12,0,0,0,0,38310,7.2,33000,0,0,-21365,-22000,0.0,3831.0
4849711251,1,13,2,1,3,2,2,0,0,0,0,15207,7.2,18521,221,68,-628,-552,28.9,1520.7,18,2,0,2,3,2,0,0,0,0,15835,7.2,19073,243,55,628,552,29.8,1583.5
4851600626,1,11,2,1,10,5,9,0,0,0,0,19864,7.4,18778,228,58,3549,1755,28.6,1986.4,12,0,0,5,10,4,0,0,0,0,16315,6.6,17023,228,42,-3549,-1755,27.0,1631.5
4851565854,1,10,0,1,4,6,0,0,0,0,0,16127,7.2,19174,249,68,-1393,-252,31.7,1612.7,14,1,0,6,4,5,0,0,0,0,17520,7.4,19426,248,56,1393,252,30.4,1752.0
4851523007,0,51,0,0,2,5,2,1,0,1,0,15118,7.0,17923,243,48,-1687,102,29.1,1511.8,12,2,1,5,2,6,1,1,0,0,16805,7.0,17821,254,59,1687,-102,31.3,1680.5
4846643321,0,15,1,0,2,6,2,2,1,1,0,15221,6.8,17350,211,48,-1742,94,25.9,1522.1,13,0,1,6,2,7,0,0,0,0,16963,6.6,17256,227,52,1742,-94,27.9,1696.3
4846627119,0,12,1,1,6,9,6,0,0,0,0,15731,6.0,14949,224,48,-1799,-3719,27.2,1573.1,19,0,0,7,4,4,0,0,0,0,17530,7.0,18668,247,64,1799,3719,31.1,1753.0
4833996659,0,0,23,0,17,33,46,0,0,0,2,36109,10.6,37921,98,0,-5999,-6892,9.8,3610.9,24,0,1,33,17,85,0,0,0,0,42108,11.8,44813,104,0,5999,6892,10.4,4210.8
4833219237,0,13,2,0,1,4,0,1,1,0,0,13563,6.8,17596,200,64,-2758,-717,26.4,1356.3,11,1,1,4,1,3,0,0,0,0,16321,7.0,18313,228,56,2758,717,28.4,1632.1
4832274986,1,31,3,1,7,5,5,1,0,1,0,15668,6.8,17285,192,56,-300,819,24.8,1566.8,23,1,0,5,7,4,0,0,0,0,15968,6.6,16466,172,44,300,-819,21.6,1596.8
4832226944,1,12,2,1,5,8,6,0,0,0,0,16011,6.8,17616,193,60,-1491,-827,25.3,1601.1,15,1,0,8,5,9,0,0,0,0,17502,7.0,18443,204,48,1491,827,25.2,1750.2
4829797587,1,17,1,0,12,10,6,0,0,0,0,20316,7.0,18891,223,43,3456,2942,26.6,2031.6,13,0,1,10,12,4,1,1,0,0,16860,6.4,15949,177,40,-3456,-2942,21.7,1686.0
4826358673,0,15,4,0,4,3,4,1,1,0,0,17235,7.0,18134,225,56,935,-645,28.1,1723.5,15,2,1,3,4,3,0,0,0,0,16300,7.0,18779,225,48,-935,645,27.3,1630.0
4823565194,0,12,1,1,5,7,7,1,0,1,0,17050,7.0,17587,247,59,-202,528,30.6,1705.0,14,0,0,7,5,13,1,1,0,0,17252,6.6,17059,211,56,202,-528,26.7,1725.2
4823088783,1,11,0,0,6,9,7,0,0,0,0,16088,6.6,16469,176,56,-2191,94,23.2,1608.8,10,0,1,9,6,11,0,0,0,0,18279,6.6,16375,192,49,2191,-94,24.1,1827.9
4823046116,0,13,0,1,5,3,4,1,0,1,0,16422,7.2,18589,225,72,1426,1132,29.7,1642.2,10,1,0,3,5,3,0,0,0,0,14996,7.0,17457,228,44,-1426,-1132,27.2,1499.6
4822985709,0,17,1,1,6,5,4,0,0,0,0,17690,6.8,18092,216,54,2236,1769,27.0,1769.0,8,2,0,5,6,2,0,0,0,0,15454,6.4,16323,149,49,-2236,-1769,19.8,1545.4
4818265916,0,79,1,1,6,7,4,0,0,0,0,16181,7.0,18260,232,52,-917,580,28.4,1618.1,19,1,0,6,5,12,1,1,0,0,17098,7.0,17680,219,47,917,-580,26.6,1709.8
4816475827,1,11,3,0,8,6,7,1,1,0,0,16601,7.0,18134,219,48,-198,23,26.7,1660.1,15,1,1,6,8,4,0,0,0,0,16799,7.0,18111,231,53,198,-23,28.4,1679.9
4816438485,1,11,1,0,2,6,1,0,0,0,0,15438,6.8,17601,239,44,-1870,-1633,28.3,1543.8,10,1,1,6,2,5,0,0,0,0,17308,7.4,19234,218,72,1870,1633,29.0,1730.8
4814025604,0,25,0,1,4,22,5,0,0,0,2,25884,10.4,34946,69,53,-15264,-12455,12.2,2588.4,13,1,0,22,4,32,0,0,0,0,41148,12.0,47401,127,77,15264,12455,20.4,4114.8
4805494940,0,8,1,0,2,6,0,0,0,0,0,14913,7.0,17737,216,63,-2411,-32,27.9,1491.3,10,0,1,6,2,5,0,0,0,0,17324,7.0,17769,217,56,2411,32,27.3,1732.4
4853366790,1,17,0,1,28,21,77,0,0,0,1,38779,11.4,43037,129,0,2492,4165,12.9,3877.9,0,0,0,21,28,59,0,0,0,0,36287,10.8,38872,97,0,-2492,-4165,9.7,3628.7
4853345168,1,0,0,1,32,34,75,0,0,0,2,37710,11.6,42838,81,0,-2718,-3295,8.1,3771.0,0,0,0,34,32,92,0,0,0,0,40428,11.8,46133,114,0,2718,3295,11.4,4042.8
4853310636,1,0,0,1,14,22,29,0,0,0,0,34681,10.4,36778,106,0,-693,-1673,10.6,3468.1,2,0,0,22,14,63,0,0,0,0,35374,11.0,38451,105,0,693,1673,10.5,3537.4
4853304496,1,25,2,1,5,2,6,1,1,0,0,16162,6.8,17256,188,55,1791,656,24.3,1616.2,17,2,0,2,5,2,0,0,0,0,14371,6.4,16600,217,41,-1791,-656,25.8,1437.1
4853285712,1,8,1,1,6,7,5,0,0,0,0,16144,6.6,16700,204,48,-1900,-1053,25.2,1614.4,13,0,0,6,5,3,1,1,0,0,18044,6.6,17753,202,44,1900,1053,24.6,1804.4
4853021459,1,15,1,0,6,5,8,1,1,0,0,17635,7.0,17515,213,60,2250,629,27.3,1763.5,12,4,1,5,6,2,0,0,0,0,15385,6.6,16886,218,44,-2250,-629,26.2,1538.5
4852966404,1,11,1,1,3,4,2,0,0,0,0,15828,7.0,17835,224,59,-642,-1381,28.3,1582.8,34,1,0,4,3,7,0,0,0,0,16470,7.4,19216,246,72,642,1381,31.8,1647.0
4852915730,1,13,1,1,8,5,8,1,0,1,0,17647,7.2,18985,221,60,1888,920,28.1,1764.7,10,0,0,5,8,4,0,0,0,0,15759,6.8,18065,230,52,-1888,-920,28.2,1575.9
4852310565,0,13,2,1,5,7,2,1,1,0,0,15623,7.0,17961,221,59,-1885,470,28.0,1562.3,14,3,0,7,5,9,0,0,0,0,17508,6.8,17491,214,48,1885,-470,26.2,1750.8
4852294607,0,14,0,0,3,7,1,1,0,1,0,14590,6.6,16895,203,52,-3708,-1906,25.5,1459.0,20,1,1,7,3,7,0,0,0,0,18298,7.0,18801,232,70,3708,1906,30.2,1829.8
4851862505,0,25,2,0,6,10,6,0,0,0,0,17363,6.8,17779,202,66,-750,-603,26.8,1736.3,17,2,1,10,6,18,1,1,0,0,18113,7.0,18382,216,54,750,603,27.0,1811.3
4851828161,1,14,3,1,7,4,6,1,1,0,0,17764,7.0,18110,246,44,1248,-10,29.0,1776.4,12,1,0,4,7,5,0,0,0,0,16516,7.2,18120,224,56,-1248,10,28.0,1651.6
4851252167,1,18,0,1,30,39,64,0,0,0,0,39065,11.6,43152,100,0,-3302,-4090,10.0,3906.5,0,0,0,39,30,95,0,0,0,0,42367,12.2,47242,110,0,3302,4090,11.0,4236.7
4851246366,0,86,0,0,29,26,70,0,0,0,0,37324,11.6,42774,99,0,-605,1618,9.9,3732.4,0,4,1,26,29,64,0,0,0,0,37929,11.2,41156,104,0,605,-1618,10.4,3792.9
4851235711,1,0,0,1,16,24,36,0,0,0,2,33740,10.2,35803,100,0,-4308,-4118,10.0,3374.0,0,0,0,24,16,64,0,0,0,0,38048,11.2,39921,124,0,4308,4118,12.4,3804.8
4850522642,0,15,1,0,8,5,9,0,0,0,0,17030,6.4,16073,204,38,112,-1716,24.2,1703.0,21,1,1,5,8,3,1,1,0,0,16918,6.6,17789,216,64,-112,1716,28.0,1691.8
4850234251,1,0,0,1,25,22,63,0,0,0,0,36822,11.0,40098,98,0,-2,-568,9.8,3682.2,0,0,0,22,25,45,0,0,0,0,36824,11.0,40666,116,0,2,568,11.6,3682.4
4850225262,0,0,4,1,24,32,50,0,0,0,0,39364,11.2,40777,109,0,-255,-3158,10.9,3936.4,13,0,0,32,24,71,0,0,0,0,39619,11.8,43935,102,0,255,3158,10.2,3961.9
4850215096,0,0,0,0,21,33,43,0,0,0,2,36657,11.2,40753,94,0,-2777,-2140,9.4,3665.7,3,0,1,33,21,102,0,0,0,0,39434,11.4,42893,125,0,2777,2140,12.5,3943.4
4850198351,1,0,0,1,38,24,95,0,0,0,1,41739,12.0,45501,114,0,3618,3444,11.4,4173.9,0,0,0,24,38,56,0,0,0,0,38121,11.6,42057,100,0,-3618,-3444,10.0,3812.1
4849351752,1,11,1,0,8,7,6,0,0,0,0,18486,7.2,19068,217,57,1619,1281,27.4,1848.6,15,1,1,7,8,3,0,0,0,0,16867,6.8,17787,204,46,-1619,-1281,25.0,1686.7
4849343903,1,13,1,1,12,4,7,0,0,0,0,18519,7.0,18353,226,59,5920,1224,28.5,1851.9,7,2,0,3,11,0,1,1,0,0,12599,6.4,17129,168,24,-5920,-1224,19.2,1259.9
4849319660,0,12,0,0,0,4,0,0,0,0,0,12930,6.8,16450,179,44,-2559,-2120,22.3,1293.0,9,0,1,4,0,1,1,1,0,0,15489,7.0,18570,209,60,2559,2120,26.9,1548.9
4846374402,0,8,1,0,1,12,1,0,0,0,0,14310,6.8,16978,172,48,-6284,-2552,22.0,1431.0,15,0,1,12,1,15,0,0,0,0,20594,7.2,19530,242,52,6284,2552,29.4,2059.4
4846330398,0,10,0,1,7,7,7,1,0,1,0,15951,6.8,17147,141,68,-1819,-507,20.9,1595.1,12,1,0,7,7,7,0,0,0,0,17770,7.0,17654,197,58,1819,507,25.5,1777.0
4846319246,1,36,2,1,9,8,11,0,0,0,0,17957,6.6,16437,173,44,540,-1092,21.7,1795.7,17,2,0,8,9,4,0,0,0,0,17417,6.8,17529,222,44,-540,1092,26.6,1741.7
4846305157,1,52,2,0,3,6,1,2,1,1,0,15431,7.0,18680,193,68,-1632,-77,26.1,1543.1,11,0,1,6,3,3,0,0,0,0,17063,7.2,18757,242,48,1632,77,29.0,1706.3
4845303830,0,17,2,1,4,4,3,0,0,0,0,15219,7.0,17376,215,48,-879,-219,26.3,1521.9,16,5,0,4,4,4,0,0,0,0,16098,7.0,17595,205,60,879,219,26.5,1609.8
4844566391,1,17,1,1,8,5,6,0,0,0,0,19357,7.2,19030,221,48,2922,2545,26.9,1935.7,25,2,0,5,8,6,0,0,0,0,16435,6.6,16485,186,57,-2922,-2545,24.3,1643.5
4844386571,1,17,2,0,1,5,1,0,0,0,0,15367,7.2,17906,186,59,-991,688,24.5,1536.7,14,0,1,5,1,7,0,0,0,0,16358,6.8,17218,245,36,991,-688,28.1,1635.8
4844339355,1,11,4,0,8,5,7,1,1,0,0,17606,7.0,18354,195,40,1591,2034,23.5,1760.6,15,0,1,5,8,5,0,0,0,0,16015,6.6,16320,189,40,-1591,-2034,22.9,1601.5
4844299814,1,10,4,0,6,9,6,0,0,0,0,17855,6.8,17606,224,44,196,-140,26.8,1785.5,14,1,1,9,6,5,2,1,1,0,17659,6.8,17746,186,48,-196,140,23.4,1765.9
4844265763,0,16,1,0,2,8,2,0,0,0,0,15085,6.6,16514,199,44,-3274,-2287,24.3,1508.5,12,4,1,8,2,9,1,1,0,0,18359,7.2,18801,238,52,3274,2287,29.0,1835.9
4844203061,1,11,0,1,10,3,11,1,1,0,0,17597,6.8,18022,197,64,1728,400,26.1,1759.7,8,0,0,3,10,3,0,0,0,0,15869,6.6,17622,205,56,-1728,-400,26.1,1586.9
4843516840,0,15,4,0,1,8,1,0,0,0,0,12900,6.2,15125,185,32,-3838,-2269,21.7,1290.0,13,4,1,8,1,7,1,1,0,0,16738,7.0,17394,209,52,3838,2269,26.1,1673.8
4838348529,0,10,1,0,3,12,2,0,0,0,0,15221,6.4,15995,189,40,-4239,-3354,22.9,1522.1,10,1,1,12,3,12,0,0,0,0,19460,7.0,19349,236,51,4239,3354,28.7,1946.0
4838317260,1,16,5,1,12,5,10,1,1,0,0,18950,7.0,18337,198,48,3052,842,24.6,1895.0,13,1,0,5,12,3,0,0,0,0,15898,6.6,17495,183,48,-3052,-842,23.1,1589.8
4837402225,1,13,1,0,5,1,4,1,1,0,0,16787,7.0,18749,223,64,2429,463,28.7,1678.7,11,1,1,1,5,0,0,0,0,0,14358,7.2,18286,224,52,-2429,-463,27.6,1435.8
4858329558,0,71,1,1,7,4,3,1,1,0,0,16917,7.2,18613,224,44,750,1332,26.8,1691.7,9,1,0,4,7,4,0,0,0,0,16167,6.6,17281,219,43,-750,-1332,26.2,1616.7
4858312874,1,98,3,0,19,17,18,0,0,0,0,47981,10.0,47500,9,0,20431,19000,0.9,4798.1,0,1,1,9,11,8,0,0,0,0,27550,6.0,28500,0,0,-20431,-19000,0.0,2755.0
4858285813,1,0,0,1,15,18,14,0,0,0,0,46635,10.0,47500,2,0,18065,19000,0.2,4663.5,0,0,0,12,9,15,0,0,0,0,28570,6.0,28500,0,0,-18065,-19000,0.0,2857.0
4858263969,1,18,1,0,21,17,21,0,0,0,0,63060,12.0,55000,1,0,25510,22000,0.1,6306.0,0,0,1,9,13,9,0,0,0,0,37550,7.2,33000,0,0,-25510,-22000,0.0,3755.0
4858231854,1,0,0,0,10,20,16,0,0,0,0,60950,12.0,55000,0,0,23400,22000,0.0,6095.0,0,0,1,17,7,9,0,0,0,0,37550,7.2,33000,0,0,-23400,-22000,0.0,3755.0
4858203330,1,0,7,1,14,14,9,0,0,0,0,44620,10.0,47500,0,0,15860,19000,0.0,4462.0,33,0,0,7,7,11,0,0,0,0,28760,6.0,28500,6,0,-15860,-19000,0.6,2876.0
4858166519,0,0,0,1,29,20,89,0,0,0,0,37576,11.4,42235,104,0,2052,2795,10.4,3757.6,168,0,0,20,29,31,0,0,0,0,35524,11.0,39440,102,0,-2052,-2795,10.2,3552.4
4858145491,1,0,0,1,26,13,75,0,0,0,1,38372,11.0,39996,124,0,4036,3906,12.4,3837.2,0,0,0,13,26,32,0,0,0,0,34336,10.2,36090,91,0,-4036,-3906,9.1,3433.6
4858128094,1,13,6,0,24,17,73,0,0,0,1,38528,11.4,42414,86,0,2872,4249,8.6,3852.8,30,0,1,17,24,42,0,0,0,0,35656,11.0,38165,90,0,-2872,-4249,9.0,3565.6
4858104458,1,358,0,0,14,25,16,0,0,0,0,60250,12.0,55025,0,0,21300,22025,0.0,6025.0,0,0,1,15,4,17,0,0,0,0,38950,7.2,33000,0,0,-21300,-22025,0.0,3895.0
4858088965,1,0,0,1,19,11,20,0,0,0,0,47000,10.0,47500,0,0,20200,19000,0.0,4700.0,5,0,0,7,15,5,0,0,0,0,26800,6.0,28500,0,0,-20200,-19000,0.0,2680.0
4857144818,0,9,1,0,1,5,0,0,0,0,0,14711,6.8,17652,201,44,-1553,-505,24.5,1471.1,12,0,1,5,1,6,0,0,0,0,16264,7.0,18157,179,67,1553,505,24.6,1626.4
4857100724,1,19,1,1,15,18,14,0,0,0,0,46310,10.0,47500,1,0,17410,19000,0.1,4631.0,24,0,0,12,9,13,0,0,0,0,28900,6.0,28500,0,0,-17410,-19000,0.0,2890.0
4857088809,1,0,0,1,24,14,23,0,0,0,0,64450,12.2,56000,0,0,28300,23000,0.0,6445.0,0,0,0,4,14,9,0,0,0,0,36150,7.2,33000,0,0,-28300,-23000,0.0,3615.0
4856883684,1,11,0,1,5,7,1,1,0,1,0,16584,7.4,19027,241,61,-1413,1485,30.2,1658.4,12,0,0,7,5,7,0,0,0,0,17997,6.8,17542,226,50,1413,-1485,27.6,1799.7
4856479170,0,12,2,1,4,9,7,0,0,0,0,15454,6.4,16279,206,36,-3295,-3581,24.2,1545.4,15,1,0,9,4,6,0,0,0,0,18749,7.4,19860,229,72,3295,3581,30.1,1874.9
4856439635,0,141,5,0,3,4,1,0,0,0,0,15656,7.0,18251,201,60,-1576,319,26.1,1565.6,19,5,1,4,3,4,0,0,0,0,17232,6.8,17932,244,52,1576,-319,29.6,1723.2
4856347439,0,17,1,1,3,5,1,2,1,1,0,15152,7.0,18549,235,48,-1688,-555,28.3,1515.2,13,3,0,5,3,7,0,0,0,0,16840,7.2,19104,217,63,1688,555,28.0,1684.0
4856314390,1,19,3,0,4,7,3,0,0,0,0,15485,6.8,17634,216,60,-1581,-411,27.6,1548.5,13,2,1,7,4,4,1,1,0,0,17066,7.2,18045,177,56,1581,411,23.3,1706.6
4856285019,1,0,0,1,23,16,23,0,0,0,0,67200,12.0,55000,6,0,30700,22000,0.6,6720.0,0,0,0,8,15,9,0,0,0,0,36500,7.2,33000,0,0,-30700,-22000,0.0,3650.0
4832549768,1,12,0,1,4,5,4,2,1,1,0,17000,6.8,17453,220,56,63,-337,27.6,1700.0,18,1,0,5,4,5,0,0,0,0,16937,6.8,17790,224,63,-63,337,28.7,1693.7
4822321364,0,10,1,1,5,8,6,0,0,0,0,16548,7.0,17548,222,64,-1693,-477,28.6,1654.8,30,0,0,8,5,9,0,0,0,0,18241,6.8,18025,230,60,1693,477,29.0,1824.1
4821215808,1,10,2,1,7,8,5,0,0,0,0,17022,7.2,18401,231,59,-332,-836,29.0,1702.2,14,1,0,7,6,6,2,1,1,0,17354,7.2,19237,265,52,332,836,31.7,1735.4
4821175317,1,14,0,0,6,8,6,0,0,0,0,16551,6.8,18034,189,59,-1794,-1242,24.8,1655.1,12,2,1,8,6,6,0,0,0,0,18345,7.2,19276,266,64,1794,1242,33.0,1834.5
4813998464,0,10,2,0,9,5,7,0,0,0,0,18212,7.0,17332,208,48,2095,1174,25.6,1821.2,194,2,1,5,9,4,1,1,0,0,16117,6.4,16158,212,56,-2095,-1174,26.8,1611.7
4812103710,0,8,1,1,5,11,7,0,0,0,0,16576,6.6,16939,196,52,-3891,-2536,24.8,1657.6,12,1,0,11,5,12,0,0,0,0,20467,7.4,19475,230,72,3891,2536,30.2,2046.7
4810410116,1,16,1,1,6,2,8,1,1,0,0,17167,7.2,18840,249,66,1894,711,31.5,1716.7,10,0,0,2,6,4,0,0,0,0,15273,6.8,18129,255,48,-1894,-711,30.3,1527.3
4810355733,0,13,1,0,3,6,2,1,1,0,0,16258,7.2,18349,245,56,-583,244,30.1,1625.8,12,1,1,6,3,9,0,0,0,0,16841,6.8,18105,230,56,583,-244,28.6,1684.1
4808686685,0,10,2,1,4,14,3,0,0,0,0,16922,6.4,16379,193,43,-4154,-1269,23.6,1692.2,22,2,0,14,4,24,0,0,0,0,21076,6.8,17648,197,55,4154,1269,25.2,2107.6
4808630354,1,14,3,1,11,6,15,1,1,0,0,20516,6.8,18555,271,52,2089,709,32.3,2051.6,18,2,0,6,11,9,1,0,1,0,18427,6.8,17846,206,72,-2089,-709,27.8,1842.7
4806727350,0,26,2,0,8,8,8,0,0,0,0,19348,7.0,17968,242,56,2055,877,29.8,1934.8,9,1,1,8,8,7,0,0,0,0,17293,6.8,17091,199,48,-2055,-877,24.7,1729.3
4804702169,1,13,1,1,10,13,6,0,0,0,0,17732,6.6,17910,213,56,-499,1052,26.9,1773.2,17,2,0,12,9,15,0,0,0,0,18231,6.6,16858,208,49,499,-1052,25.7,1823.1
4801125441,0,14,2,1,6,5,4,0,0,0,0,16751,6.8,17757,227,54,934,1117,28.1,1675.1,24,2,0,5,6,6,0,0,0,0,15817,6.8,16640,208,48,-934,-1117,25.6,1581.7
4801114027,0,33,3,0,3,6,4,0,0,0,0,16412,6.6,17562,193,59,-669,-511,25.2,1641.2,13,0,1,6,3,5,1,1,0,0,17081,6.6,18073,248,64,669,511,31.2,1708.1
4801103863,0,11,1,0,3,5,3,0,0,0,1,14858,6.8,17510,197,56,-3267,-1345,25.3,1485.8,23,1,1,5,3,6,1,1,0,0,18125,7.2,18855,221,59,3267,1345,28.0,1812.5
4801086813,1,15,2,0,7,3,6,0,0,0,0,16301,6.6,16598,222,44,-416,-526,26.6,1630.1,13,2,1,3,7,1,0,0,0,0,16717,6.6,17124,237,48,416,526,28.5,1671.7
4801066650,0,12,1,1,1,7,2,1,1,0,0,14525,6.8,17181,207,62,-2734,-944,26.9,1452.5,26,0,0,7,1,6,0,0,0,0,17259,7.0,18125,226,52,2734,944,27.8,1725.9
4800052736,1,14,5,1,9,4,9,0,0,0,0,20388,7.2,18965,249,66,4856,1507,31.5,2038.8,15,3,0,4,9,4,0,0,0,0,15532,6.6,17458,210,48,-4856,-1507,25.8,1553.2
4794455329,1,15,4,1,14,8,15,0,0,0,0,20572,7.0,17839,204,53,3804,2455,25.7,2057.2,11,1,0,8,14,9,0,0,0,0,16768,6.4,15384,165,42,-3804,-2455,20.7,1676.8
4856234733,1,0,0,0,20,26,57,0,0,0,2,39216,11.2,40052,105,0,724,-2787,10.5,3921.6,0,0,1,26,20,65,0,0,0,0,38492,11.6,42839,97,0,-724,2787,9.7,3849.2
4856202242,1,0,0,1,34,31,67,0,0,0,2,42129,12.2,47253,127,0,3912,3662,12.7,4212.9,0,0,0,31,34,87,0,0,0,0,38217,11.6,43591,86,0,-3912,-3662,8.6,3821.7
4856162405,1,0,0,0,30,23,77,0,0,0,1,40901,11.8,45847,121,0,5721,6732,12.1,4090.1,0,0,1,23,30,43,0,0,0,0,35180,10.8,39115,81,0,-5721,-6732,8.1,3518.0
4855953290,1,0,0,1,18,21,10,0,0,0,0,60600,12.0,55000,0,0,22700,22000,0.0,6060.0,0,0,0,9,6,17,0,0,0,0,37900,7.2,33000,0,0,-22700,-22000,0.0,3790.0
4855933389,1,0,0,1,12,20,15,0,0,0,0,59550,12.0,55000,0,0,21300,22000,0.0,5955.0,0,0,0,13,5,11,0,0,0,0,38250,7.2,33000,0,0,-21300,-22000,0.0,3825.0
4855912742,1,76,0,1,22,13,20,0,0,0,0,50575,10.0,47500,0,0,23045,19000,0.0,5057.5,0,0,0,6,15,6,0,0,0,0,27530,6.0,28500,0,0,-23045,-19000,0.0,2753.0
4855890902,1,0,0,1,20,14,20,0,0,0,0,48412,10.0,47500,4,0,20518,19000,0.4,4841.2,0,0,0,8,14,5,0,0,0,0,27894,6.0,28500,0,0,-20518,-19000,0.0,2789.4
4855871985,1,0,0,1,19,16,17,0,0,0,0,49100,10.0,47500,0,0,21432,19000,0.0,4910.0,0,0,0,7,10,8,0,0,0,0,27668,6.0,28500,0,0,-21432,-19000,0.0,2766.8
4847452171,0,9,0,0,8,8,5,1,0,1,0,18362,7.2,18665,230,62,-329,464,29.2,1836.2,25,2,1,8,8,9,1,1,0,0,18691,7.0,18201,200,60,329,-464,26.0,1869.1
4846887547,0,15,1,0,8,8,6,1,1,0,0,20065,7.0,18468,230,50,2380,1454,28.0,2006.5,14,1,1,8,8,8,0,0,0,0,17685,6.6,17014,211,53,-2380,-1454,26.4,1768.5
4846659478,1,14,0,1,6,4,3,0,0,0,0,16304,6.8,18083,182,53,990,977,23.5,1630.4,11,0,0,4,6,3,0,0,0,0,15314,6.8,17106,205,59,-990,-977,26.4,1531.4
4841115576,0,14,1,0,4,8,2,1,0,1,0,16543,6.8,18145,248,51,-2546,-260,29.9,1654.3,9,0,1,8,4,8,1,1,0,0,19089,7.0,18405,231,56,2546,260,28.7,1908.9
4841086624,0,10,0,1,6,15,5,0,0,0,0,16395,6.6,16459,203,43,-4041,-1115,24.6,1639.5,22,0,0,15,6,19,1,1,0,0,20436,6.8,17574,189,40,4041,1115,22.9,2043.6
4841061908,0,14,4,1,5,7,7,0,0,0,0,17846,6.8,17731,232,67,663,1069,29.9,1784.6,30,6,0,7,5,5,1,1,0,0,17183,6.6,16662,219,45,-663,-1069,26.4,1718.3
4841006231,0,17,2,1,5,4,7,0,0,0,0,16479,6.8,17452,231,56,389,-1561,28.7,1647.9,11,1,0,4,5,3,1,1,0,0,16090,7.0,19013,227,75,-389,1561,30.2,1609.0
4840775362,0,13,1,1,2,2,6,2,1,1,0,16969,7.0,18282,234,56,2377,1564,29.0,1696.9,10,2,0,2,2,2,0,0,0,0,14592,6.8,16718,205,50,-2377,-1564,25.5,1459.2
4839789884,1,25,2,1,7,1,10,1,1,0,1,20086,7.0,18801,227,62,7388,4031,28.9,2008.6,10,0,0,1,7,3,0,0,0,0,12698,6.2,14770,165,48,-7388,-4031,21.3,1269.8
4839762971,1,9,1,1,5,5,5,1,0,1,0,16895,6.8,18231,232,64,-964,1020,29.6,1689.5,10,0,0,5,5,7,1,1,0,0,17859,6.8,17211,206,52,964,-1020,25.8,1785.9
4837741304,0,12,1,0,6,6,7,0,0,0,0,18729,7.0,18656,238,51,1318,2144,28.9,1872.9,72,1,1,6,6,6,0,0,0,0,17411,6.6,16512,179,39,-1318,-2144,21.8,1741.1
4837673289,1,16,2,0,15,9,18,1,1,0,0,21992,7.0,19039,243,48,3167,2341,29.1,2199.2,18,1,1,9,15,13,1,0,1,0,18825,6.8,16698,205,56,-3167,-2341,26.1,1882.5
4836118781,1,17,2,1,3,1,5,1,1,0,0,15614,6.8,17449,203,60,551,-750,26.3,1561.4,13,0,0,1,3,0,1,0,1,0,15063,6.8,18199,223,43,-551,750,26.6,1506.3
4836083215,1,13,2,0,10,4,6,0,0,0,0,18044,6.8,17892,246,45,2155,1634,29.1,1804.4,13,1,1,4,10,5,0,0,0,0,15889,6.6,16258,236,42,-2155,-1634,27.8,1588.9
4834320631,0,13,2,1,4,5,9,0,0,0,0,15950,6.6,16801,204,60,-2175,-595,26.4,1595.0,12,1,0,5,4,6,1,1,0,0,18125,6.6,17396,232,56,2175,595,28.8,1812.5
4834295583,0,14,4,0,6,10,6,0,0,0,0,17125,6.6,16261,211,64,-2500,-1419,27.5,1712.5,22,4,1,10,6,11,1,1,0,0,19625,7.0,17680,223,47,2500,1419,27.0,1962.5
4834273570,0,19,19,1,6,6,2,0,0,0,0,16130,7.0,17266,192,77,-62,-969,26.9,1613.0,42,3,0,6,6,9,2,1,1,0,16192,7.2,18235,205,58,62,969,26.3,1619.2
4834227111,1,12,2,0,5,7,4,0,0,0,0,16055,6.8,17745,231,55,-734,166,28.6,1605.5,16,3,1,7,5,4,0,0,0,0,16789,6.8,17579,196,52,734,-166,24.8,1678.9
4834177753,0,12,0,1,2,2,2,1,1,0,0,14603,6.8,17322,214,58,-669,-962,27.2,1460.3,14,2,0,2,2,2,1,0,1,0,15272,7.2,18284,213,66,669,962,27.9,1527.2
4834129390,0,18,0,1,7,7,7,0,0,0,0,16623,6.8,17614,220,48,-728,-454,26.8,1662.3,13,2,0,7,7,9,0,0,0,0,17351,7.0,18068,222,64,728,454,28.6,1735.1
4833327062,1,17,1,1,3,4,6,0,0,0,0,15452,6.8,17308,243,54,-762,-695,29.7,1545.2,20,0,0,4,3,4,1,1,0,0,16214,6.8,18003,225,61,762,695,28.6,1621.4
4829393885,0,8,3,1,3,9,2,0,0,0,0,15301,7.0,17692,230,56,-3693,-1922,28.6,1530.1,15,1,0,9,3,7,2,1,1,0,18994,7.4,19614,232,61,3693,1922,29.3,1899.4
4829363674,0,9,2,0,2,9,3,1,1,0,0,14639,6.6,17070,205,52,-4278,-2148,25.7,1463.9,14,1,1,9,2,11,0,0,0,0,18917,7.4,19218,235,60,4278,2148,29.5,1891.7
4829347708,1,16,1,1,10,2,10,0,0,0,0,19619,7.2,19320,236,48,5386,3311,28.4,1961.9,10,0,0,2,10,2,1,0,1,0,14233,6.4,16009,200,48,-5386,-3311,24.8,1423.3
4829335143,1,15,3,1,6,2,5,0,0,0,0,16879,7.0,18409,238,52,3405,1789,29.0,1687.9,13,1,0,2,6,0,0,0,0,0,13474,6.6,16620,203,60,-3405,-1789,26.3,1347.4
4829319141,0,13,2,0,5,8,3,0,0,0,0,14810,6.4,15899,164,64,-2992,-2573,22.8,1481.0,17,1,1,8,5,4,1,1,0,0,17802,7.0,18472,232,60,2992,2573,29.2,1780.2
4825969127,0,14,0,1,8,5,9,1,1,0,0,18446,7.2,18807,233,52,553,-399,28.5,1844.6,13,2,0,5,8,7,0,0,0,0,17893,7.2,19206,211,60,-553,399,27.1,1789.3
4767409833,0,13,3,0,3,3,2,0,0,0,0,14673,6.6,16633,188,56,-3534,-2558,24.4,1467.3,17,1,1,3,3,3,2,1,1,0,18207,7.2,19191,245,80,3534,2558,32.5,1820.7
4767388065,1,16,1,1,8,7,11,0,0,0,0,18025,6.8,16632,184,44,1613,234,22.8,1802.5,13,2,0,7,8,6,0,0,0,0,16412,6.4,16398,208,48,-1613,-234,25.6,1641.2
4767358640,1,15,2,0,7,12,8,0,0,0,0,17217,6.8,17445,181,72,-1743,-224,25.3,1721.7,13,1,1,12,7,12,0,0,0,0,18960,6.6,17669,238,51,1743,224,28.9,1896.0
4767345825,0,14,0,0,4,1,5,0,0,0,0,15776,7.0,18528,205,60,-940,-716,26.5,1577.6,75,1,1,1,4,1,1,1,0,0,16716,7.4,19244,249,64,940,716,31.3,1671.6
4857952654,1,20,1,1,13,5,15,0,0,0,0,20512,7.2,19024,224,54,4569,1356,27.8,2051.2,12,2,0,5,13,6,0,0,0,0,15943,6.8,17668,217,60,-4569,-1356,27.7,1594.3
4857446240,1,12,0,1,6,3,4,2,1,1,0,17233,7.4,19868,225,76,2119,2455,30.1,1723.3,13,0,0,3,6,1,0,0,0,0,15114,6.8,17413,219,60,-2119,-2455,27.9,1511.4
4856923972,0,11,0,1,10,7,18,0,0,0,0,18625,6.8,18132,185,48,1664,-7,23.3,1862.5,13,1,0,7,10,8,0,0,0,0,16961,7.0,18139,208,52,-1664,7,26.0,1696.1
4856499747,0,13,0,0,0,6,0,0,0,0,0,14890,6.8,17446,226,52,-1769,-1897,27.8,1489.0,18,1,1,6,0,3,2,1,1,0,16659,7.2,19343,227,59,1769,1897,28.6,1665.9
4855668492,0,11,0,1,4,3,7,1,0,1,0,16767,7.0,18880,218,76,1536,602,29.4,1676.7,17,0,0,3,4,3,0,0,0,0,15231,6.8,18278,221,76,-1536,-602,29.7,1523.1
4855602564,1,14,1,1,3,6,5,1,0,1,0,15647,6.6,16946,224,52,-1357,-1151,27.6,1564.7,23,1,0,6,3,5,0,0,0,0,17004,6.8,18097,261,52,1357,1151,31.3,1700.4
4855594407,1,16,0,0,7,5,4,1,1,0,0,17468,7.0,18657,240,63,1678,1454,30.3,1746.8,13,2,1,5,7,4,0,0,0,0,15790,6.6,17203,233,48,-1678,-1454,28.1,1579.0
4855562383,0,14,0,0,7,7,5,0,0,0,0,16316,6.8,16909,208,50,-2134,-424,25.8,1631.6,12,0,1,7,7,7,0,0,0,0,18450,6.8,17333,213,54,2134,424,26.7,1845.0
4849134464,0,17,1,0,12,15,12,0,0,0,0,20101,6.4,16090,151,43,-1439,-2046,19.4,2010.1,14,2,1,15,12,11,0,0,0,0,21540,7.0,18136,211,44,1439,2046,25.5,2154.0
4849094930,0,13,2,0,8,6,7,1,0,1,0,17802,6.6,17337,197,40,1267,-361,23.7,1780.2,20,1,1,6,8,4,0,0,0,0,16535,6.8,17698,233,52,-1267,361,28.5,1653.5
4849050565,0,19,1,1,5,4,7,0,0,0,0,17318,7.2,17883,224,52,518,513,27.6,1731.8,14,4,0,4,5,5,1,1,0,0,16800,6.8,17370,218,56,-518,-513,27.4,1680.0
4848044639,0,16,1,1,2,4,4,1,1,0,0,15004,6.8,16975,205,49,-2825,-2754,25.4,1500.4,13,1,0,4,2,6,0,0,0,0,17829,7.2,19729,257,64,2825,2754,32.1,1782.9
4847806248,0,69,0,0,28,26,95,0,0,0,0,36988,11.2,40974,113,0,192,-1280,11.3,3698.8,33,0,1,26,28,61,0,0,0,0,36796,11.4,42254,100,0,-192,1280,10.0,3679.6
4846157953,1,10,1,1,8,8,7,0,0,0,0,19961,7.2,19665,255,58,2514,2968,31.3,1996.1,17,1,0,8,8,9,1,1,0,0,17447,7.0,16697,205,44,-2514,-2968,24.9,1744.7
4845953849,1,8,0,0,1,2,1,0,0,0,0,14876,6.8,18444,246,52,43,-171,29.8,1487.6,12,0,1,2,1,0,1,1,0,0,14833,7.0,18615,231,64,-43,171,29.5,1483.3
4845744291,1,35,5,1,10,3,8,1,0,1,0,20543,7.2,19886,207,62,5323,3171,26.9,2054.3,17,1,0,3,10,0,0,0,0,0,15220,6.6,16715,192,60,-5323,-3171,25.2,1522.0
4845703696,1,15,4,0,6,6,7,0,0,0,0,17372,7.0,17645,208,52,140,508,26.0,1737.2,17,3,1,6,6,8,0,0,0,0,17232,6.8,17137,213,44,-140,-508,25.7,1723.2
4845690093,1,7,4,0,4,4,4,0,0,0,0,16566,7.0,18813,214,64,529,2234,27.8,1656.6,13,1,1,4,4,2,0,0,0,0,16037,6.6,16579,185,56,-529,-2234,24.1,1603.7
4845670907,1,10,1,0,9,4,8,0,0,0,0,18320,7.0,18797,218,64,723,797,28.2,1832.0,25,0,1,4,9,5,0,0,0,0,17597,6.8,18000,206,60,-723,-797,26.6,1759.7
4857496221,0,14,1,1,7,7,7,1,1,0,0,17269,6.6,16175,155,48,595,-22,20.3,1726.9,15,1,0,7,7,8,1,0,1,0,16674,6.6,16197,181,44,-595,22,22.5,1667.4
4857450569,1,60,2,0,5,4,6,0,0,0,0,15894,7.0,17732,191,36,574,-419,22.7,1589.4,12,3,1,4,5,1,0,0,0,0,15320,7.0,18151,223,52,-574,419,27.5,1532.0
4857412628,0,12,1,0,4,5,2,0,0,0,0,14184,6.4,16116,164,48,-1116,-385,21.2,1418.4,16,2,1,5,4,2,0,0,0,0,15300,6.6,16501,184,48,1116,385,23.2,1530.0
4856274423,1,0,0,1,31,24,88,0,0,0,2,40915,11.6,43269,120,0,3572,2621,12.0,4091.5,8,0,0,24,31,62,0,0,0,0,37343,11.2,40648,106,0,-3572,-2621,10.6,3734.3
4856238289,1,0,0,1,22,15,64,0,0,0,2,37865,11.0,38611,112,0,3509,3475,11.2,3786.5,0,0,0,15,22,39,0,0,0,0,34356,10.2,35136,117,0,-3509,-3475,11.7,3435.6
4856193041,0,0,0,1,24,29,48,0,0,0,1,37115,10.8,39646,108,0,-1631,-2951,10.8,3711.5,0,0,0,29,24,79,0,0,0,0,38746,11.2,42597,112,0,1631,2951,11.2,3874.6
4856144784,1,25,3,0,16,15,26,0,0,0,0,62215,12.0,55000,8,0,25015,22000,0.8,6221.5,2,0,1,11,12,5,0,0,0,0,37200,7.2,33000,0,0,-25015,-22000,0.0,3720.0
4855130507,1,13,1,0,3,8,1,0,0,0,0,14771,7.0,17321,231,44,-2300,-772,27.5,1477.1,52,2,1,8,3,6,1,1,0,0,17071,7.0,18093,226,52,2300,772,27.8,1707.1
4855103114,1,0,0,1,27,22,63,0,0,0,0,37382,11.0,38341,105,0,1592,859,10.5,3738.2,21,0,0,22,27,55,0,0,0,0,35790,10.6,37482,105,0,-1592,-859,10.5,3579.0
4855069663,1,0,0,0,20,18,52,0,0,0,1,36322,10.8,37950,112,0,925,-672,11.2,3632.2,0,0,1,18,20,48,0,0,0,0,35397,10.8,38622,105,0,-925,672,10.5,3539.7
4855046366,0,0,0,0,18,29,40,0,0,0,2,35639,10.8,37308,117,0,-4569,-6375,11.7,3563.9,0,0,1,29,18,80,0,0,0,0,40208,11.6,43683,110,0,4569,6375,11.0,4020.8
4855016825,0,269,0,0,28,43,58,0,0,0,1,38432,11.2,41755,112,0,-6854,-8135,11.2,3843.2,37,0,1,43,28,110,0,0,0,0,45286,12.6,49890,119,0,6854,8135,11.9,4528.6
4853239149,1,0,0,1,19,16,18,0,0,0,0,47406,10.2,48680,0,0,19488,19000,0.0,4740.6,0,0,0,9,12,9,0,0,0,0,27918,6.2,29680,0,0,-19488,-19000,0.0,2791.8
4853230437,1,14,0,0,15,18,9,0,0,0,0,47000,10.0,47500,0,0,18100,19000,0.0,4700.0,6,0,1,13,10,15,0,0,0,0,28900,6.0,28500,0,0,-18100,-19000,0.0,2890.0
4853222588,1,26,1,1,17,21,17,0,0,0,0,50555,12.0,55000,4,0,18625,22000,0.4,5055.5,7,0,0,13,9,15,0,0,0,0,31930,7.2,33000,3,0,-18625,-22000,0.3,3193.0
4853217283,1,34,1,1,19,14,17,0,0,0,0,62830,12.2,56000,5,0,26305,23000,0.5,6283.0,0,0,0,6,11,8,0,0,0,0,36525,7.2,33000,1,0,-26305,-23000,0.1,3652.5
4853213820,1,1,0,1,19,18,25,0,0,0,0,63537,13.0,62500,0,0,24387,25000,0.0,6353.7,1,0,0,13,14,9,0,0,0,0,39150,7.8,37500,0,0,-24387,-25000,0.0,3915.0
4853196638,1,0,0,1,22,11,21,0,0,0,0,47350,10.2,48680,0,0,20200,20180,0.0,4735.0,0,0,0,6,17,6,0,0,0,0,27150,6.0,28500,0,0,-20200,-20180,0.0,2715.0
4853172705,0,10,2,0,7,13,4,0,0,0,0,16461,6.8,17675,165,52,-1685,-484,21.7,1646.1,19,0,1,13,7,9,0,0,0,0,18146,6.8,18159,194,52,1685,484,24.6,1814.6
4853149134,1,9,1,1,12,6,11,1,1,0,1,20349,7.2,18922,220,53,4293,1132,27.3,2034.9,13,0,0,6,12,2,0,0,0,0,16056,6.8,17790,193,52,-4293,-1132,24.5,1605.6
4858373670,1,11,2,0,6,8,5,0,0,0,0,16903,7.2,18687,208,64,8,-376,27.2,1690.3,13,2,1,8,6,4,1,1,0,0,16895,7.2,19063,204,64,-8,376,26.8,1689.5
4858322099,0,17,1,0,5,7,4,1,1,0,0,14887,6.8,16563,192,48,-1443,-789,24.0,1488.7,13,1,1,7,5,12,0,0,0,0,16330,6.4,17352,195,40,1443,789,23.5,1633.0
4858262119,0,13,1,1,2,8,2,0,0,0,0,15218,6.6,16724,244,56,-1835,-607,30.0,1521.8,17,2,0,8,2,11,1,1,0,0,17053,6.8,17331,226,48,1835,607,27.4,1705.3
4858225883,1,13,1,1,7,8,6,1,1,0,0,17207,7.0,18281,204,68,879,1963,27.2,1720.7,12,2,0,8,7,10,0,0,0,0,16328,6.4,16318,191,50,-879,-1963,24.1,1632.8
4857321109,0,17,0,0,11,7,14,1,0,1,0,18340,6.6,16895,186,52,1622,646,23.8,1834.0,14,2,1,7,11,8,0,0,0,0,16718,6.4,16249,187,52,-1622,-646,23.9,1671.8
4857252280,0,17,2,1,6,3,9,0,0,0,0,16149,6.8,16948,208,44,-29,-2724,25.2,1614.9,80,5,0,3,6,1,1,1,0,0,16178,7.4,19672,220,56,29,2724,27.6,1617.8
4857198748,0,11,1,0,10,10,4,0,0,0,0,18023,7.4,18971,196,63,-84,865,25.9,1802.3,14,1,1,10,10,8,1,1,0,0,18107,6.8,18106,178,52,84,-865,23.0,1810.7
4857053894,1,14,0,0,4,8,3,1,1,0,0,16380,6.6,17242,205,44,-983,465,24.9,1638.0,35,0,1,8,4,11,0,0,0,0,17363,6.4,16777,232,40,983,-465,27.2,1736.3
4857014212,0,34,1,1,4,3,5,0,0,0,0,15819,6.8,17141,207,55,941,132,26.2,1581.9,30,0,0,3,4,2,1,1,0,0,14878,6.8,17009,196,43,-941,-132,23.9,1487.8
4856984962,0,12,1,1,5,4,5,1,1,0,0,15892,6.8,17917,204,56,55,-405,26.0,1589.2,12,3,0,4,5,2,1,0,1,0,15837,7.0,18322,213,64,-55,405,27.7,1583.7
4856966750,0,17,2,1,2,5,0,0,0,0,0,14413,7.0,18541,238,48,-2708,-1611,28.6,1441.3,16,1,0,5,2,2,1,1,0,0,17121,7.4,20152,256,83,2708,1611,33.9,1712.1
4856899625,0,0,0,0,39,35,98,0,0,0,0,39192,12.0,46069,99,0,-2007,-2448,9.9,3919.2,0,0,1,35,39,75,0,0,0,0,41199,12.4,48517,96,0,2007,2448,9.6,4119.9
4855893890,0,17,2,0,5,10,4,0,0,0,0,15950,6.8,17799,180,48,-2055,254,22.8,1595.0,16,1,1,10,5,19,0,0,0,0,18005,6.8,17545,167,60,2055,-254,22.7,1800.5
4855852546,1,13,0,1,11,7,9,1,1,0,0,18832,6.6,17271,236,44,2143,-511,28.0,1883.2,20,2,0,7,11,7,0,0,0,0,16689,6.8,17782,173,48,-2143,511,22.1,1668.9
4855288337,0,16,2,0,3,5,3,1,1,0,0,14264,6.4,15666,165,44,-3137,-1137,20.9,1426.4,12,1,1,5,3,4,0,0,0,0,17401,6.4,16803,230,24,3137,1137,25.4,1740.1
4855239445,1,13,2,1,4,3,1,1,1,0,0,16705,7.0,18492,224,68,1213,475,29.2,1670.5,15,1,0,3,4,3,0,0,0,0,15492,6.8,18017,210,48,-1213,-475,25.8,1549.2
4855187880,0,13,2,0,4,7,6,0,0,0,0,13931,6.4,16106,117,56,-3107,-2169,17.3,1393.1,8,0,1,7,4,8,0,0,0,0,17038,6.8,18275,211,54,3107,2169,26.5,1703.8
4855122126,0,54,1,0,6,4,5,0,0,0,0,15588,6.6,17202,180,44,-1057,-282,22.4,1558.8,8,1,1,4,6,5,0,0,0,0,16645,6.8,17484,219,44,1057,282,26.3,1664.5
4854041202,1,12,1,1,4,1,5,0,0,0,0,17477,7.0,18411,227,48,2887,592,27.5,1747.7,13,2,0,1,4,1,0,0,0,0,14590,6.8,17819,212,48,-2887,-592,26.0,1459.0
4842305776,0,12,0,0,5,7,2,1,1,0,0,16110,6.8,17586,213,55,351,292,26.8,1611.0,8,0,1,7,5,8,0,0,0,0,15759,7.0,17294,183,36,-351,-292,21.9,1575.9
4842253875,0,17,0,0,3,7,0,0,0,0,0,14886,6.8,18164,197,57,-1138,466,25.4,1488.6,8,3,1,7,3,8,0,0,0,0,16024,7.0,17698,196,56,1138,-466,25.2,1602.4
4834666513,0,17,2,0,5,7,4,0,0,0,0,16709,7.2,18952,202,72,-1008,-924,27.4,1670.9,11,3,1,7,5,5,1,1,0,0,17717,7.2,19876,225,72,1008,924,29.7,1771.7
4834087250,1,14,2,1,4,1,4,1,0,1,0,16594,7.4,19343,263,58,2617,553,32.1,1659.4,14,1,0,1,4,0,0,0,0,0,13977,7.0,18790,207,65,-2617,-553,27.2,1397.7
4834036221,0,12,0,1,6,7,6,0,0,0,0,16952,6.8,17327,210,47,-1799,-1763,25.7,1695.2,11,0,0,7,6,6,0,0,0,0,18751,7.2,19090,245,72,1799,1763,31.7,1875.1
4823859877,0,12,1,1,4,3,4,1,1,0,0,16780,6.8,18104,231,52,1077,-166,28.3,1678.0,16,1,0,3,4,1,0,0,0,0,15703,7.2,18270,225,67,-1077,166,29.2,1570.3
4823777081,0,55,1,1,4,3,3,0,0,0,0,16866,7.4,19839,246,60,789,-11,30.6,1686.6,12,3,0,3,4,3,2,1,1,0,16077,7.4,19850,255,68,-789,11,32.3,1607.7
4823721490,0,11,0,0,9,7,12,0,0,0,0,16525,6.4,15264,178,30,-913,-2269,20.8,1652.5,14,1,1,7,9,5,0,0,0,0,17438,6.8,17533,234,38,913,2269,27.2,1743.8
4823599519,1,11,2,1,6,2,5,1,0,1,0,17728,7.4,19480,246,68,2033,1935,31.4,1772.8,17,1,0,2,6,4,0,0,0,0,15695,6.6,17545,231,52,-2033,-1935,28.3,1569.5
4823533447,0,19,1,1,3,3,8,0,0,0,0,17684,7.2,19543,229,71,1178,1108,30.0,1768.4,19,3,0,3,3,1,0,0,0,0,16506,7.0,18435,253,52,-1178,-1108,30.5,1650.6
4822906067,0,16,0,0,4,6,4,0,0,0,0,15862,7.0,17547,228,48,-1343,30,27.6,1586.2,11,1,1,6,4,12,1,1,0,0,17205,6.8,17517,202,40,1343,-30,24.2,1720.5
4822838632,0,9,2,0,7,8,6,0,0,0,0,17846,7.0,18674,234,62,-35,1460,29.6,1784.6,10,2,1,8,7,10,1,1,0,0,17881,6.8,17214,228,53,35,-1460,28.1,1788.1
4821634881,1,14,3,0,7,2,10,0,0,0,0,16759,7.0,17887,219,46,2047,1481,26.5,1675.9,10,0,1,2,7,2,0,0,0,0,14712,6.6,16406,211,56,-2047,-1481,26.7,1471.2
4821580284,0,10,2,1,9,7,7,1,0,1,0,19049,7.0,17570,205,56,211,-630,26.1,1904.9,21,2,0,7,9,5,0,0,0,0,18838,7.0,18200,201,52,-211,630,25.3,1883.8
4821034559,1,13,2,1,7,6,8,1,1,0,0,17253,7.0,18123,233,48,403,-51,28.1,1725.3,14,0,0,6,7,4,0,0,0,0,16850,7.2,18174,230,60,-403,51,29.0,1685.0
4820989827,0,15,0,0,4,8,3,0,0,0,0,16255,7.0,17783,215,73,-2386,-707,28.8,1625.5,12,1,1,8,4,14,1,1,0,0,18641,7.2,18490,227,60,2386,707,28.7,1864.1
4812097635,1,14,1,0,7,3,7,0,0,0,0,17706,6.8,17967,214,64,1712,1709,27.8,1770.6,14,1,1,3,7,6,1,1,0,0,15994,6.6,16258,217,56,-1712,-1709,27.3,1599.4
4812014810,1,18,1,1,10,7,8,1,1,0,0,19492,7.4,19635,239,68,1856,2094,30.7,1949.2,12,1,0,7,10,10,0,0,0,0,17636,6.8,17541,209,52,-1856,-2094,26.1,1763.6
4811278887,1,14,0,0,4,4,5,0,0,0,0,16435,6.8,18360,204,72,-1387,-923,27.6,1643.5,16,2,1,4,4,1,2,1,1,0,17822,7.4,19283,240,56,1387,923,29.6,1782.2
4858147429,0,51,3,1,4,4,3,0,0,0,0,17215,7.0,18470,226,52,1256,91,27.8,1721.5,9,0,0,4,4,3,0,0,0,0,15959,6.8,18379,205,60,-1256,-91,26.5,1595.9
4858108152,1,17,2,1,7,1,4,1,1,0,0,16550,6.8,17696,192,44,2579,739,23.6,1655.0,11,3,0,0,6,0,0,0,0,0,13971,6.8,16957,184,56,-2579,-739,24.0,1397.1
4857402169,1,0,0,0,16,21,19,0,0,0,0,47750,10.0,47500,1,0,18800,19000,0.1,4775.0,0,0,1,13,8,9,0,0,0,0,28950,6.0,28500,1,0,-18800,-19000,0.1,2895.0
4857372584,1,0,0,1,23,18,26,0,0,0,0,49450,10.0,47500,0,0,22300,19000,0.0,4945.0,0,0,0,9,14,5,0,0,0,0,27150,6.0,28500,0,0,-22300,-19000,0.0,2715.0
4857348987,1,0,0,0,18,20,23,0,0,0,0,63050,12.0,55000,0,0,24100,22000,0.0,6305.0,1,0,1,13,11,8,0,0,0,0,38950,7.2,33000,0,0,-24100,-22000,0.0,3895.0
4857318820,1,25,4,1,9,17,9,0,0,0,0,44814,10.0,47500,2,0,16832,19000,0.2,4481.4,86,1,0,13,5,10,0,0,0,0,27982,6.0,28500,1,0,-16832,-19000,0.1,2798.2
4855764225,1,14,0,1,6,6,6,0,0,0,0,17074,7.0,18565,222,56,831,1374,27.8,1707.4,9,1,0,6,6,4,1,1,0,0,16243,6.8,17191,183,52,-831,-1374,23.5,1624.3
4855728664,0,50,2,1,3,3,1,0,0,0,0,15444,6.8,18413,217,48,237,721,26.5,1544.4,12,4,0,3,3,2,0,0,0,0,15207,7.0,17692,192,59,-237,-721,25.1,1520.7
4854838315,0,13,1,0,4,8,4,1,1,0,0,16805,7.0,17859,225,64,-1033,-74,28.9,1680.5,9,0,1,8,4,11,1,0,1,0,17838,6.8,17933,243,52,1033,74,29.5,1783.8
4854797226,0,22,1,0,4,10,2,0,0,0,0,16049,6.6,16609,188,56,-1783,-894,24.4,1604.9,14,0,1,10,4,9,0,0,0,0,17832,7.0,17503,210,52,1783,894,26.2,1783.2
4854771781,1,0,0,1,21,17,16,0,0,0,0,64100,12.0,55000,0,1,26900,22000,0.1,6410.0,0,0,0,7,11,13,0,0,0,0,37200,7.2,33000,0,0,-26900,-22000,0.0,3720.0
4849911576,1,52,3,1,5,3,4,0,0,0,0,15879,6.6,16691,199,47,516,-879,24.6,1587.9,12,0,0,3,5,2,0,0,0,0,15363,6.6,17570,207,56,-516,879,26.3,1536.3
4849887785,1,11,2,0,5,3,6,0,0,0,0,17015,7.0,17595,227,42,1613,635,26.9,1701.5,11,1,1,3,5,3,0,0,0,0,15402,6.6,16960,235,54,-1613,-635,28.9,1540.2
4849848217,1,10,2,0,7,4,4,1,1,0,0,17498,7.2,18242,226,53,1351,3086,27.9,1749.8,15,0,1,4,7,6,0,0,0,0,16147,6.2,15156,187,42,-1351,-3086,22.9,1614.7
4849810789,0,19,1,1,4,4,4,0,0,0,0,15684,6.6,17046,208,52,-2018,-2071,26.0,1568.4,15,0,0,4,4,6,0,0,0,0,17702,7.0,19117,221,64,2018,2071,28.5,1770.2
4848883529,0,11,8,1,5,5,7,0,0,0,0,16337,6.6,16104,219,40,378,-1200,25.9,1633.7,30,0,0,5,5,7,1,0,1,0,15959,6.8,17304,169,60,-378,1200,22.9,1595.9
4848818648,0,9,1,0,2,9,3,0,0,0,0,16198,6.8,17740,257,47,-3405,-1056,30.4,1619.8,15,1,1,9,2,11,0,0,0,0,19603,7.0,18796,226,52,3405,1056,27.8,1960.3
4847554975,1,122,2,0,7,5,11,0,0,0,0,17756,6.8,17741,182,27,591,163,20.9,1775.6,11,1,1,5,7,7,0,0,0,0,17165,7.0,17578,212,60,-591,-163,27.2,1716.5
4847529974,1,46,3,1,5,4,4,0,0,0,0,16707,7.0,17943,187,56,495,-471,24.3,1670.7,11,2,0,4,5,3,1,1,0,0,16212,7.0,18414,192,63,-495,471,25.5,1621.2
4858007669,1,164,3,1,7,2,7,1,1,0,0,17627,7.0,18654,223,60,2723,1803,28.3,1762.7,13,0,0,2,7,1,0,0,0,0,14904,6.6,16851,216,54,-2723,-1803,27.0,1490.4
4857963540,0,14,2,1,5,8,6,0,0,0,0,15613,6.4,15917,191,64,-2659,-1461,25.5,1561.3,12,5,0,8,5,12,1,1,0,0,18272,6.8,17378,200,57,2659,1461,25.7,1827.2
4857212598,0,141,1,1,6,5,5,1,1,0,0,16515,7.2,18974,221,64,505,325,28.5,1651.5,12,0,0,5,6,3,0,0,0,0,16010,7.0,18649,211,68,-505,-325,27.9,1601.0
4857172162,1,12,1,1,7,3,8,1,1,0,0,17753,7.2,18692,218,64,1225,424,28.2,1775.3,13,2,0,3,7,4,1,0,1,0,16528,7.0,18268,232,64,-1225,-424,29.6,1652.8
4857136576,1,14,1,1,2,1,2,0,0,0,0,15899,7.4,18830,255,60,496,-583,31.5,1589.9,16,1,0,1,2,0,1,1,0,0,15403,7.4,19413,255,68,-496,583,32.3,1540.3
4856982572,1,9,3,1,5,7,4,0,0,0,0,16254,6.8,17691,238,63,-375,-1505,30.1,1625.4,15,3,0,7,5,7,0,0,0,0,16629,7.2,19196,225,64,375,1505,28.9,1662.9
4856184917,0,45,1,1,11,10,18,1,1,0,0,18346,6.8,17687,194,40,-1423,-1540,23.4,1834.6,33,2,0,10,11,12,0,0,0,0,19769,7.2,19227,239,56,1423,1540,29.5,1976.9
4856150309,1,0,0,1,21,18,19,0,0,0,0,63490,12.0,55000,0,0,25590,22000,0.0,6349.0,0,0,0,9,12,13,0,0,0,0,37900,7.2,33000,0,0,-25590,-22000,0.0,3790.0
4856127007,1,0,0,1,16,10,24,0,0,0,0,62700,12.0,55000,0,0,27600,22000,0.0,6270.0,0,0,0,6,12,2,0,0,0,0,35100,7.2,33000,0,0,-27600,-22000,0.0,3510.0
4856092796,1,24,0,1,18,20,20,0,0,0,0,62352,12.4,58000,5,0,23265,22000,0.5,6235.2,0,0,0,14,12,14,0,0,0,0,39087,7.6,36000,0,0,-23265,-22000,0.0,3908.7
4856060666,1,0,0,0,24,20,26,0,0,0,0,65989,13.0,62500,3,0,28309,25000,0.3,6598.9,0,0,1,14,18,10,0,0,0,0,37680,7.8,37500,2,0,-28309,-25000,0.2,3768.0
4855996626,1,18,0,1,13,5,16,1,1,0,0,19797,7.0,18196,219,52,2372,1715,27.1,1979.7,17,4,0,5,13,6,0,0,0,0,17425,6.6,16481,200,56,-2372,-1715,25.6,1742.5
4855415134,0,79,2,0,7,9,9,0,0,0,0,16522,6.6,16489,159,57,-1986,-948,21.6,1652.2,15,1,1,9,7,2,1,1,0,0,18508,7.0,17437,211,46,1986,948,25.7,1850.8
4855374951,1,14,1,0,10,7,16,1,1,0,0,18228,6.8,17690,216,48,881,-170,26.4,1822.8,9,0,1,7,10,3,0,0,0,0,17347,7.0,17860,185,56,-881,170,24.1,1734.7
4855333158,1,11,1,0,3,2,0,0,0,0,0,15637,7.0,18173,220,52,882,1316,27.2,1563.7,74,3,1,2,3,4,1,1,0,0,14755,6.8,16857,204,66,-882,-1316,27.0,1475.5
4854921581,1,0,0,1,24,22,24,0,0,0,0,66200,12.8,61000,0,0,26200,25000,0.0,6620.0,0,0,0,13,15,12,0,0,0,0,40000,7.6,36000,0,0,-26200,-25000,0.0,4000.0
4854904263,1,0,0,1,22,19,21,0,0,0,0,57400,12.0,55000,0,0,21590,22000,0.0,5740.0,0,0,0,8,11,6,0,0,0,0,35810,7.2,33000,0,1,-21590,-22000,0.1,3581.0
4854885376,1,0,0,1,26,18,23,0,0,0,0,74040,14.2,67000,0,0,27840,25000,0.0,7404.0,0,0,0,8,16,11,0,0,0,0,46200,9.0,42000,0,0,-27840,-25000,0.0,4620.0
4854691897,1,12,1,1,10,8,10,1,1,0,0,18570,6.8,18223,202,72,1299,706,27.4,1857.0,17,0,0,8,10,12,0,0,0,0,17271,6.6,17517,227,40,-1299,-706,26.7,1727.1
4854589970,1,14,1,1,7,2,6,0,0,0,0,17618,7.0,18855,220,69,2171,1634,28.9,1761.8,14,2,0,2,7,2,0,0,0,0,15447,6.6,17221,234,59,-2171,-1634,29.3,1544.7
4856462893,0,17,1,0,5,7,7,0,0,0,0,16097,7.0,17619,220,67,-2148,-1004,28.7,1609.7,18,1,1,7,5,10,0,0,0,0,18245,7.0,18623,253,66,2148,1004,31.9,1824.5
4856419771,0,9,6,1,5,5,9,1,1,0,0,17162,6.8,17198,235,47,310,245,28.2,1716.2,15,0,0,5,5,5,0,0,0,0,16852,7.0,16953,217,60,-310,-245,27.7,1685.2
4856382258,0,12,0,0,4,8,4,0,0,0,0,16515,6.8,17427,234,52,-2375,-1405,28.6,1651.5,12,0,1,8,4,9,1,0,1,0,18890,7.2,18832,228,72,2375,1405,30.0,1889.0
4854191936,1,14,3,0,7,5,7,0,0,0,0,16284,6.6,16789,188,64,544,-101,25.2,1628.4,13,0,1,5,7,6,1,0,1,0,15740,6.8,16890,215,48,-544,101,26.3,1574.0
4850006732,1,95,1,0,5,4,5,0,0,0,0,16324,7.0,19009,195,68,-1027,390,26.3,1632.4,35,2,1,4,5,6,0,0,0,0,17351,7.0,18619,244,56,1027,-390,30.0,1735.1
4849977586,0,18,3,0,5,5,5,0,0,0,0,16970,6.8,17623,230,63,-1352,-268,29.3,1697.0,16,0,1,5,5,8,0,0,0,0,18322,6.8,17891,241,47,1352,268,28.8,1832.2
4849215658,1,55,1,1,2,3,3,0,0,0,0,16168,6.4,16454,212,56,-1171,-2207,26.8,1616.8,18,0,0,3,2,2,1,1,0,0,17339,7.0,18661,190,72,1171,2207,26.2,1733.9
4849194393,1,59,1,1,8,5,8,0,0,0,0,19751,7.4,19143,212,56,3014,1647,26.8,1975.1,9,3,0,5,8,5,0,0,0,0,16737,6.8,17496,229,52,-3014,-1647,28.1,1673.7
4849161842,0,17,2,0,3,9,2,1,1,0,0,15643,7.0,17680,205,56,-1916,-90,26.1,1564.3,28,3,1,9,3,7,0,0,0,0,17559,6.8,17770,223,64,1916,90,28.7,1755.9
4849120504,1,14,2,1,7,3,5,2,1,1,0,17531,7.0,18554,219,70,1826,491,28.9,1753.1,11,2,0,3,7,0,0,0,0,0,15705,7.0,18063,232,63,-1826,-491,29.5,1570.5
4849087361,1,13,2,1,7,3,8,1,1,0,0,17813,7.0,18292,206,60,2060,53,26.6,1781.3,11,0,0,3,7,4,1,0,1,0,15753,7.0,18239,200,64,-2060,-53,26.4,1575.3
4772398706,1,17,2,1,3,1,2,2,1,1,0,16323,7.2,19284,242,64,865,1679,30.6,1632.3,15,1,0,1,3,1,0,0,0,0,15458,6.8,17605,253,44,-865,-1679,29.7,1545.8
4724765012,0,15,1,0,5,7,3,0,0,0,0,16838,7.2,19248,247,64,-1782,-91,31.1,1683.8,14,6,1,7,5,7,1,1,0,0,18620,7.2,19339,251,72,1782,91,32.3,1862.0
4724709227,1,14,2,0,7,9,4,0,0,0,0,16283,6.4,16543,219,20,-2861,-2128,23.9,1628.3,16,1,1,9,7,5,0,0,0,0,19144,7.2,18671,210,67,2861,2128,27.7,1914.4
4724652389,1,13,12,1,7,1,5,1,1,0,0,18843,6.8,18053,259,44,3441,731,30.3,1884.3,41,1,0,1,7,2,0,0,0,0,15402,6.6,17322,201,60,-3441,-731,26.1,1540.2
4723604775,1,45,5,0,6,3,6,1,0,1,0,18955,7.2,19742,242,47,3751,1862,28.9,1895.5,20,2,1,3,6,2,1,1,0,0,15204,6.8,17880,216,71,-3751,-1862,28.7,1520.4
4723578776,1,20,2,1,4,2,8,2,1,1,0,16891,7.0,19308,247,72,1989,1661,31.9,1689.1,15,6,0,2,4,2,0,0,0,0,14902,7.0,17647,225,62,-1989,-1661,28.7,1490.2
4723525176,0,13,2,1,5,3,4,0,0,0,0,17346,6.8,18718,241,53,1290,-615,29.4,1734.6,13,1,0,3,5,4,0,0,0,0,16056,7.0,19333,245,62,-1290,615,30.7,1605.6
4721118389,1,0,0,0,17,22,16,0,0,0,0,61318,12.8,61000,0,0,22718,25000,0.0,6131.8,0,0,1,13,8,18,0,0,0,0,38600,7.6,36000,0,0,-22718,-25000,0.0,3860.0
4721118799,1,64,0,0,21,15,22,0,0,0,0,65386,13.0,62500,0,0,29936,28000,0.0,6538.6,0,0,1,7,13,6,0,0,0,0,35450,7.4,34500,0,0,-29936,-28000,0.0,3545.0
4853005423,1,11,1,0,6,11,6,0,0,0,0,17700,6.8,16624,218,40,325,-935,25.8,1770.0,12,3,1,11,6,6,1,1,0,0,17375,7.0,17559,189,64,-325,935,25.3,1737.5
4852980884,0,13,4,0,2,4,0,1,1,0,0,14709,7.0,18615,247,60,-1252,-491,30.7,1470.9,13,3,1,4,2,6,1,0,1,0,15961,7.2,19106,212,76,1252,491,28.8,1596.1
4852948806,1,16,2,1,11,5,12,1,1,0,0,17886,6.6,17007,170,44,2289,957,21.4,1788.6,10,3,0,5,11,1,0,0,0,0,15597,6.4,16050,175,47,-2289,-957,22.2,1559.7
4852918092,0,78,3,0,4,3,1,1,1,0,0,16100,7.2,18172,237,52,-267,917,28.9,1610.0,15,1,1,3,4,4,0,0,0,0,16367,6.8,17255,213,50,267,-917,26.3,1636.7
4845449447,1,52,5,1,5,4,10,0,0,0,0,16739,6.6,16821,215,60,-1063,-2927,27.5,1673.9,11,2,0,4,5,3,1,1,0,0,17802,7.4,19748,252,72,1063,2927,32.4,1780.2
4831319648,1,34,3,1,7,3,5,0,0,0,0,16162,7.0,18376,213,45,1337,-113,25.8,1616.2,33,1,0,3,7,2,1,1,0,0,14825,7.0,18489,227,42,-1337,113,26.9,1482.5
4830295244,1,18,2,1,7,6,8,0,0,0,0,19471,7.0,18752,240,63,2561,1342,30.3,1947.1,16,0,0,6,7,5,0,0,0,0,16910,6.8,17410,212,49,-2561,-1342,26.1,1691.0
4830268988,1,15,1,1,2,2,5,1,0,1,0,16952,7.0,18114,239,64,1186,187,30.3,1695.2,16,2,0,2,2,1,0,0,0,0,15766,7.0,17927,215,54,-1186,-187,26.9,1576.6
4829516344,0,11,3,0,5,10,4,0,0,0,0,15338,6.6,17073,224,37,-3158,-1735,26.1,1533.8,13,0,1,10,5,10,1,1,0,0,18496,7.0,18808,232,42,3158,1735,27.4,1849.6
4829470850,0,18,2,1,4,7,8,0,0,0,0,16465,6.8,16826,223,48,-1598,-1757,27.1,1646.5,13,0,0,7,4,7,0,0,0,0,18063,7.4,18583,231,55,1598,1757,28.6,1806.3
4827322562,1,10,2,0,3,4,2,0,0,0,0,15879,6.8,17218,176,52,-701,-116,22.8,1587.9,9,1,1,4,3,8,1,1,0,0,16580,7.0,17334,194,64,701,116,25.8,1658.0
4826913871,0,35,0,0,21,35,42,0,0,0,1,35611,10.8,38767,93,0,-6469,-6282,9.3,3561.1,0,0,1,35,21,102,0,0,0,0,42080,12.0,45049,110,0,6469,6282,11.0,4208.0
4826895245,1,0,2,0,20,22,40,0,0,0,1,37704,11.0,40462,104,0,1731,1966,10.4,3770.4,5,0,1,21,19,55,0,0,0,0,35973,10.8,38496,88,0,-1731,-1966,8.8,3597.3
4824099931,1,12,0,0,5,2,3,1,0,1,0,15842,6.6,17336,191,60,1590,11,25.1,1584.2,14,1,1,2,5,0,1,1,0,0,14252,6.8,17325,189,54,-1590,-11,24.3,1425.2
4824081197,1,13,0,1,8,4,14,1,1,0,0,18642,6.6,18312,178,52,3251,1846,23.0,1864.2,10,3,0,4,8,4,0,0,0,0,15391,6.4,16466,177,54,-3251,-1846,23.1,1539.1
4824056586,1,6,1,0,22,19,45,0,0,0,0,35158,10.8,38421,108,0,1089,828,10.8,3515.8,5,0,1,18,21,51,0,0,0,0,34069,10.8,37593,96,0,-1089,-828,9.6,3406.9
4822175984,1,9,2,1,4,1,0,0,0,0,0,16434,7.2,19395,233,60,2287,1417,29.3,1643.4,10,0,0,1,4,1,0,0,0,0,14147,7.0,17978,207,44,-2287,-1417,25.1,1414.7
4822154856,0,0,0,0,21,22,55,0,0,0,0,34972,11.0,37480,94,0,-2448,-3463,9.4,3497.2,0,0,1,22,21,52,0,0,0,0,37420,11.0,40943,116,0,2448,3463,11.6,3742.0
4822134543,1,0,0,0,23,26,44,0,0,0,1,37742,11.0,39780,124,0,1809,-1,12.4,3774.2,0,0,1,26,23,65,0,0,0,0,35933,11.0,39781,88,0,-1809,1,8.8,3593.3
4822111264,1,0,0,1,26,24,71,0,0,0,0,37859,11.4,41848,106,0,-72,116,10.6,3785.9,216,0,0,24,26,66,0,0,0,0,37931,11.6,41732,114,0,72,-116,11.4,3793.1
4851257647,1,37,1,0,6,5,8,0,0,0,0,16690,7.0,17937,207,63,597,507,27.0,1669.0,30,3,1,5,6,5,0,0,0,0,16093,7.0,17430,201,52,-597,-507,25.3,1609.3
4851253819,0,14,1,0,4,5,4,0,0,0,0,16044,6.8,17248,185,52,-971,-1168,23.7,1604.4,15,3,1,5,4,3,1,1,0,0,17015,7.0,18416,226,60,971,1168,28.6,1701.5
4851238871,1,13,2,0,2,3,3,1,1,0,0,15628,7.0,17576,241,66,-167,366,30.7,1562.8,21,1,1,3,2,3,0,0,0,0,15795,6.8,17210,213,48,167,-366,26.1,1579.5
4850736522,0,16,2,0,6,6,7,0,0,0,0,16251,6.8,17219,209,56,-2574,-1996,26.5,1625.1,84,3,1,6,6,10,1,1,0,0,18825,7.4,19215,260,68,2574,1996,32.8,1882.5
4850609982,1,10,0,0,6,4,7,0,0,0,0,16611,6.6,17334,224,44,73,-296,26.8,1661.1,13,2,1,4,6,5,0,0,0,0,16538,6.8,17630,220,56,-73,296,27.6,1653.8
4843090216,1,50,1,0,6,4,6,0,0,0,0,17061,7.4,19236,206,67,1701,2357,27.3,1706.1,11,2,1,4,6,4,0,0,0,0,15360,6.6,16879,210,36,-1701,-2357,24.6,1536.0
4843060335,1,14,3,0,5,8,6,1,1,0,0,16479,6.8,16818,219,64,-718,-123,28.3,1647.9,14,1,1,8,5,13,0,0,0,0,17197,6.8,16941,184,60,718,123,24.4,1719.7
4843031637,0,12,2,0,3,8,2,1,1,0,0,13972,6.6,15662,177,40,-4616,-3047,21.7,1397.2,72,0,1,8,3,6,0,0,0,0,18588,7.2,18709,199,61,4616,3047,26.0,1858.8
4829413870,1,12,0,1,5,8,3,0,0,0,0,16144,6.8,18196,206,60,-2492,-458,26.6,1614.4,11,0,0,8,5,14,0,0,0,0,18636,7.2,18654,222,72,2492,458,29.4,1863.6
4829318875,0,14,0,0,3,1,1,1,0,1,0,15474,7.0,19238,228,72,759,1518,30.0,1547.4,19,2,1,1,3,1,1,1,0,0,14715,6.8,17720,236,60,-759,-1518,29.6,1471.5
4829290487,0,54,2,0,2,2,3,1,1,0,0,16053,7.4,19323,236,67,-572,-721,30.3,1605.3,12,1,1,2,2,2,0,0,0,0,16625,7.4,20044,242,72,572,721,31.4,1662.5
4824621045,1,12,1,1,5,3,7,0,0,0,0,17465,6.8,17893,229,47,1822,-402,27.6,1746.5,9,3,0,3,5,2,0,0,0,0,15643,6.8,18295,258,60,-1822,402,31.8,1564.3
4816905561,1,30,0,0,8,4,8,0,0,0,0,18494,7.2,18776,240,66,1865,1506,30.6,1849.4,20,0,1,4,8,6,0,0,0,0,16629,6.8,17270,204,54,-1865,-1506,25.8,1662.9
4816887294,1,16,3,0,12,9,13,1,0,1,0,20811,7.2,19129,231,56,2142,1838,28.7,2081.1,28,0,1,9,12,6,0,0,0,0,18669,6.8,17291,196,52,-2142,-1838,24.8,1866.9
4816868675,0,101,3,0,2,12,3,0,0,0,0,14143,6.2,15524,209,52,-7311,-4055,26.1,1414.3,17,2,1,12,2,14,0,0,0,0,21454,7.4,19579,254,60,7311,4055,31.4,2145.4
4816820295,0,18,2,1,4,2,3,0,0,0,0,16828,7.0,18903,252,60,1331,80,31.2,1682.8,11,1,0,2,4,3,1,1,0,0,15497,6.8,18823,232,64,-1331,-80,29.6,1549.7
4812014258,1,29,0,1,25,10,51,0,0,0,0,37908,11.8,45554,95,67,1550,4142,16.2,3790.8,10,0,0,10,25,27,0,0,0,0,36358,11.4,41412,83,67,-1550,-4142,15.0,3635.8
4805263459,0,18,1,1,5,9,8,0,0,0,0,16178,6.6,16700,215,56,-1934,-1753,27.1,1617.8,11,1,0,9,5,7,1,1,0,0,18112,7.0,18453,231,64,1934,1753,29.5,1811.2
4805233063,1,9,3,1,9,7,12,0,0,0,0,18770,7.0,18385,231,68,2116,1670,29.9,1877.0,12,1,0,7,9,5,0,0,0,0,16654,6.6,16715,222,44,-2116,-1670,26.6,1665.4
4805074338,1,16,5,0,7,7,6,0,0,0,0,16606,7.0,17774,191,52,-2000,-1344,24.3,1660.6,15,2,1,7,7,9,0,0,0,0,18606,7.2,19118,242,60,2000,1344,30.2,1860.6
4855123532,0,0,32,0,15,22,33,0,0,0,1,34838,10.6,37532,104,0,-1826,-1783,10.4,3483.8,27,0,1,22,15,57,0,0,0,0,36664,11.0,39315,125,0,1826,1783,12.5,3666.4
4855092093,1,14,0,1,19,15,53,0,0,0,1,35674,11.0,39410,123,0,948,1332,12.3,3567.4,0,4,0,15,19,23,0,0,0,0,34726,10.6,38078,102,0,-948,-1332,10.2,3472.6
4855065968,0,1,0,0,21,30,52,0,0,0,1,36508,11.0,39809,106,0,-1441,-1664,10.6,3650.8,29,0,1,30,21,96,0,0,0,0,37949,11.2,41473,109,0,1441,1664,10.9,3794.9
4854849965,1,25,0,1,21,18,15,0,0,0,0,45600,10.0,47500,0,0,13600,19000,0.0,4560.0,0,0,0,9,12,13,0,0,0,0,32000,6.0,28500,0,0,-13600,-19000,0.0,3200.0
4854815435,1,0,0,1,19,18,20,0,0,0,0,48750,10.0,47500,6,0,20200,19000,0.6,4875.0,4,0,0,13,14,9,0,0,0,0,28550,6.0,28500,0,0,-20200,-19000,0.0,2855.0
4854796186,1,20,0,1,17,17,20,0,0,0,0,61698,12.0,55000,0,0,24148,21000,0.0,6169.8,0,0,0,12,12,8,0,0,0,0,37550,7.4,34000,0,0,-24148,-21000,0.0,3755.0
4854775932,1,640,0,1,20,10,17,0,0,0,0,48142,10.0,47701,1,0,20970,19201,0.1,4814.2,2,0,0,4,14,7,0,0,0,0,27172,6.0,28500,0,0,-20970,-19201,0.0,2717.2
4854755947,1,0,0,0,16,21,23,0,0,0,0,62000,12.0,55000,0,0,24800,22000,0.0,6200.0,0,0,1,14,9,9,0,0,0,0,37200,7.2,33000,0,0,-24800,-22000,0.0,3720.0
4854737982,1,0,0,1,22,15,20,0,0,0,0,48750,10.0,47500,0,0,19500,19000,0.0,4875.0,0,0,0,8,15,9,0,0,0,0,29250,6.0,28500,0,0,-19500,-19000,0.0,2925.0
4854709228,1,0,0,1,14,11,16,0,0,0,0,47150,10.0,47500,0,0,20700,19000,0.0,4715.0,0,0,0,7,10,3,0,0,0,0,26450,6.0,28500,0,0,-20700,-19000,0.0,2645.0
4854687221,1,0,0,1,20,15,24,0,0,0,0,47800,10.0,47500,2,0,20255,19000,0.2,4780.0,5,0,0,9,14,6,0,0,0,0,27545,6.0,28500,1,0,-20255,-19000,0.1,2754.5
4854673033,1,2,0,1,19,21,18,0,0,0,0,48800,10.0,47500,1,0,20200,19000,0.1,4880.0,0,0,0,14,12,11,0,0,0,0,28600,6.0,28500,1,0,-20200,-19000,0.1,2860.0
4854655767,1,59,0,1,17,17,18,0,0,0,0,62350,12.2,56000,0,0,24800,23000,0.0,6235.0,24,0,0,14,14,12,0,0,0,0,37550,7.2,33000,0,0,-24800,-23000,0.0,3755.0
4846617241,1,15,1,0,0,6,0,0,0,0,0,13200,6.2,14735,164,42,-3544,-3033,20.6,1320.0,15,0,1,6,0,4,0,0,0,0,16744,6.8,17768,206,57,3544,3033,26.3,1674.4
4843483584,1,10,1,1,10,5,7,0,0,0,0,17880,6.8,17595,213,39,3037,547,25.2,1788.0,15,1,0,5,10,3,0,0,0,0,14843,6.6,17048,183,61,-3037,-547,24.4,1484.3
4843449746,0,0,0,0,16,21,37,0,0,0,1,34343,10.6,36843,84,0,-2820,-694,8.4,3434.3,12,0,1,21,16,60,0,0,0,0,37163,10.8,37537,105,0,2820,694,10.5,3716.3
4842440265,1,10,1,1,5,6,1,0,0,0,0,16309,7.4,19391,201,72,156,1956,27.3,1630.9,13,0,0,6,5,5,2,1,1,0,16153,6.6,17435,220,56,-156,-1956,27.6,1615.3
4842225049,0,10,3,1,3,3,0,2,1,1,0,15765,7.0,18508,252,64,164,-54,31.6,1576.5,13,0,0,3,3,4,0,0,0,0,15601,7.2,18562,232,52,-164,54,28.4,1560.1
4842193673,0,10,3,1,2,5,1,0,0,0,0,14923,6.8,18038,229,66,-1770,837,29.5,1492.3,21,1,0,5,2,11,1,1,0,0,16693,6.8,17201,211,53,1770,-837,26.4,1669.3
4847978162,0,11,2,0,2,4,2,0,0,0,0,15654,7.2,18714,219,68,-2316,-1381,28.7,1565.4,15,2,1,4,2,4,1,1,0,0,17970,7.2,20095,250,72,2316,1381,32.2,1797.0
4835552664,0,13,3,0,3,3,2,0,0,0,0,15161,7.0,18124,216,64,-1772,-451,28.0,1516.1,13,4,1,3,3,3,2,1,1,0,16933,7.0,18575,253,68,1772,451,32.1,1693.3
4834807528,0,12,1,0,7,8,9,0,0,0,0,17923,7.0,18286,225,62,-1195,-604,28.7,1792.3,12,2,1,8,7,11,2,1,1,0,19118,7.2,18890,248,52,1195,604,30.0,1911.8
4830404202,1,10,2,0,6,10,8,0,0,0,0,17396,6.6,17590,224,51,-1531,30,27.5,1739.6,27,1,1,10,6,17,0,0,0,0,18927,6.8,17560,197,48,1531,-30,24.5,1892.7
4829495693,1,16,2,0,9,2,9,0,0,0,0,19550,7.4,19968,273,64,5018,2752,33.7,1955.0,14,0,1,2,9,5,0,0,0,0,14532,6.8,17216,203,51,-5018,-2752,25.4,1453.2
4828153706,1,11,3,0,5,5,6,0,0,0,0,18336,6.8,17510,240,48,1719,-552,28.8,1833.6,20,4,1,5,5,3,0,0,0,0,16617,7.0,18062,248,52,-1719,552,30.0,1661.7
4821007862,0,13,0,0,4,5,3,0,0,0,0,16476,6.8,17791,223,48,-835,-616,27.1,1647.6,17,2,1,5,4,6,1,1,0,0,17311,7.0,18407,242,60,835,616,30.2,1731.1
4813812633,0,30,1,0,2,3,3,1,1,0,0,15624,6.8,17895,246,60,-784,-1228,30.6,1562.4,31,1,1,3,2,1,1,0,1,0,16408,7.4,19123,226,60,784,1228,28.6,1640.8
4806429952,0,17,1,0,5,4,5,0,0,0,0,16710,6.6,17548,220,52,93,-388,27.2,1671.0,14,2,1,4,5,5,0,0,0,0,16617,7.0,17936,230,56,-93,388,28.6,1661.7
4799693529,1,17,2,1,5,4,2,1,1,0,0,16655,7.2,18591,253,48,831,663,30.1,1665.5,14,1,0,4,5,4,0,0,0,0,15824,7.0,17928,213,68,-831,-663,28.1,1582.4
4799650443,0,12,0,0,3,6,3,0,0,0,0,14704,6.4,15966,187,64,-2713,-2775,25.1,1470.4,16,0,1,6,3,1,0,0,0,0,17417,7.2,18741,256,52,2713,2775,30.8,1741.7
4793025841,0,15,2,0,3,6,1,0,0,0,0,14715,6.4,16741,225,45,-2946,-2604,27.0,1471.5,15,4,1,6,3,6,1,1,0,0,17661,7.4,19345,260,67,2946,2604,32.7,1766.1
4786927508,0,21,1,0,6,14,5,0,0,0,0,16256,6.4,15099,168,43,-5978,-4059,21.1,1625.6,17,2,1,14,6,13,1,1,0,0,22234,7.2,19158,213,60,5978,4059,27.3,2223.4
4778489240,0,19,4,0,2,3,3,0,0,0,0,14679,6.6,16148,214,52,-2837,-2902,26.6,1467.9,15,7,1,3,2,3,1,1,0,0,17516,7.2,19050,218,76,2837,2902,29.4,1751.6
4774739918,1,9,1,1,9,5,5,1,1,0,0,17986,7.0,18776,236,72,767,1150,30.8,1798.6,14,0,0,5,9,5,0,0,0,0,17219,6.8,17626,214,72,-767,-1150,28.6,1721.9
4768209125,0,11,2,1,6,8,4,0,0,0,0,16340,6.6,16377,174,62,-564,-392,23.6,1634.0,17,2,0,8,6,4,1,1,0,0,16904,6.8,16769,222,48,564,392,27.0,1690.4
4768128647,1,13,4,1,4,6,3,0,0,0,0,16028,7.2,19084,247,64,-230,1128,31.1,1602.8,17,3,0,6,4,5,1,1,0,0,16258,7.0,17956,237,52,230,-1128,28.9,1625.8
4768088611,0,16,1,0,2,2,2,0,0,0,0,15778,7.0,18087,235,49,832,857,28.4,1577.8,16,1,1,2,2,2,1,1,0,0,14946,6.8,17230,212,58,-832,-857,27.0,1494.6
4768046923,0,10,1,0,5,8,1,1,0,1,0,16216,6.6,17208,220,60,-1722,-341,28.0,1621.6,10,1,1,8,5,12,1,1,0,0,17938,6.8,17549,219,68,1722,341,28.7,1793.8
4768012944,1,14,3,1,11,2,8,0,0,0,0,21566,7.0,18694,248,32,5717,2256,28.0,2156.6,11,2,0,2,11,1,0,0,0,0,15849,6.4,16438,194,52,-5717,-2256,24.6,1584.9
4853649891,1,13,10,0,4,7,2,1,1,0,0,15072,6.6,17161,191,54,-2101,-1259,24.5,1507.2,35,0,1,7,4,5,0,0,0,0,17173,7.4,18420,216,56,2101,1259,27.2,1717.3
4853610074,1,135,1,0,5,6,4,0,0,0,0,17348,7.2,18801,209,72,575,1363,28.1,1734.8,11,0,1,6,5,8,0,0,0,0,16773,6.6,17438,229,60,-575,-1363,28.9,1677.3
4848051762,1,12,2,0,12,8,10,1,1,0,0,20205,7.0,18505,222,48,1279,2059,27.0,2020.5,35,0,1,8,12,11,1,0,1,0,18926,6.8,16446,195,51,-1279,-2059,24.6,1892.6
4848015905,1,23,1,1,11,5,15,1,1,0,0,18988,7.2,18695,222,52,2218,1860,27.4,1898.8,15,3,0,5,11,5,0,0,0,0,16770,6.6,16835,207,56,-2218,-1860,26.3,1677.0
4845768741,0,14,2,1,4,3,1,1,0,1,0,16681,7.2,19137,237,49,1135,-61,28.6,1668.1,11,1,0,3,4,5,0,0,0,0,15546,7.2,19198,230,53,-1135,61,28.3,1554.6
4845734645,0,12,2,0,1,9,2,0,0,0,0,13504,6.4,16425,197,40,-6142,-4809,23.7,1350.4,15,0,1,9,1,7,0,0,0,0,19646,7.6,21234,217,68,6142,4809,28.5,1964.6
4820813047,0,15,1,0,5,5,4,0,0,0,0,16054,7.0,17799,247,44,-425,-1176,29.1,1605.4,14,1,1,5,5,3,2,1,1,0,16479,7.0,18975,244,67,425,1176,31.1,1647.9
4820752815,0,16,2,0,4,6,5,0,0,0,0,16007,7.2,18625,217,55,-1151,953,27.2,1600.7,13,4,1,6,4,13,1,1,0,0,17158,7.0,17672,222,60,1151,-953,28.2,1715.8
4817660426,1,17,2,1,10,2,10,0,0,0,0,19427,7.2,19553,239,52,3993,1481,29.1,1942.7,14,0,0,2,10,3,1,1,0,0,15434,7.0,18072,231,72,-3993,-1481,30.3,1543.4
4812273578,1,13,0,0,7,5,9,0,0,0,0,17350,6.8,18050,229,44,-829,-548,27.3,1735.0,13,1,1,5,7,2,1,1,0,0,18179,7.0,18598,249,51,829,548,30.0,1817.9
4811991382,1,12,0,1,5,4,9,0,0,0,0,18289,7.2,18573,237,52,1781,-56,28.9,1828.9,13,1,0,4,5,3,0,0,0,0,16508,7.2,18629,238,68,-1781,56,30.6,1650.8
4809540944,0,15,1,0,4,6,4,0,0,0,0,15212,7.2,18335,187,52,-2937,-241,23.9,1521.2,13,1,1,6,4,4,1,1,0,0,18149,7.0,18576,239,56,2937,241,29.5,1814.9
4809505738,0,13,4,1,4,4,4,1,0,1,0,16108,7.0,18087,232,64,-1080,-1596,29.6,1610.8,12,3,0,4,4,2,1,1,0,0,17188,7.0,19683,232,68,1080,1596,30.0,1718.8
4806177169,0,12,0,0,8,5,9,0,0,0,0,16158,6.8,17194,177,55,302,-980,23.2,1615.8,10,1,1,5,8,2,0,0,0,0,15856,6.8,18174,230,54,-302,980,28.4,1585.6
4792346305,0,13,0,0,4,10,4,1,0,1,0,16090,6.8,17027,197,48,-2402,-1589,24.5,1609.0,9,2,1,10,4,10,0,0,0,0,18492,7.0,18616,223,52,2402,1589,27.5,1849.2
4788965105,1,13,4,1,4,5,8,0,0,0,0,16140,6.6,17057,224,52,-1083,-1322,27.6,1614.0,12,0,0,5,4,8,1,1,0,0,17223,7.0,18379,231,68,1083,1322,29.9,1722.3
4788929770,1,24,1,0,7,5,8,0,0,0,0,17319,7.0,18266,223,58,1602,77,28.1,1731.9,12,0,1,5,7,4,1,1,0,0,15717,7.0,18189,216,60,-1602,-77,27.6,1571.7
4788877345,1,8,2,1,5,8,4,0,0,0,0,16578,6.6,16561,221,52,-1316,-2445,27.3,1657.8,20,1,0,8,5,6,1,1,0,0,17894,7.2,19006,226,63,1316,2445,28.9,1789.4
4787988016,1,12,0,0,7,13,5,0,0,0,0,18130,7.2,19235,263,63,-1145,1543,32.6,1813.0,14,1,1,13,7,23,0,0,0,0,19275,7.0,17692,206,56,1145,-1543,26.2,1927.5
4857211035,1,1,0,0,37,24,97,0,0,0,0,40614,12.2,47763,110,0,5125,7695,11.0,4061.4,133,0,1,24,37,43,0,0,0,0,35489,11.0,40068,88,0,-5125,-7695,8.8,3548.9
4857109466,1,0,0,0,24,12,65,0,0,0,0,36117,11.0,40103,123,0,2364,4215,12.3,3611.7,0,0,1,12,24,27,0,0,0,0,33753,10.2,35888,110,0,-2364,-4215,11.0,3375.3
4857018813,1,0,0,1,27,19,22,0,0,0,0,65550,12.8,61000,1,0,29050,25000,0.1,6555.0,6,0,0,6,14,11,0,0,0,0,36500,7.6,36000,0,0,-29050,-25000,0.0,3650.0
4856999031,1,1,0,0,13,15,12,0,0,0,0,45652,10.2,48680,0,0,17452,20180,0.0,4565.2,7,0,1,12,10,13,0,0,0,0,28200,6.0,28500,0,0,-17452,-20180,0.0,2820.0
4856977517,1,3,0,1,22,14,19,0,0,0,0,64800,12.0,55000,0,0,27600,22000,0.0,6480.0,0,0,0,7,15,13,0,0,0,0,37200,7.2,33000,0,0,-27600,-22000,0.0,3720.0
4856965882,1,86,0,0,15,20,19,0,0,0,0,48089,10.0,47500,0,0,19488,19000,0.0,4808.9,0,0,1,16,11,11,0,0,0,0,28601,6.0,28500,0,0,-19488,-19000,0.0,2860.1
4856944440,1,0,0,1,14,14,13,0,0,0,0,47600,10.2,48680,0,0,20100,18680,0.0,4760.0,0,0,0,10,10,6,0,0,0,0,27500,6.4,30000,0,0,-20100,-18680,0.0,2750.0
4856935082,1,0,0,1,19,15,25,0,0,0,0,63050,12.2,56000,0,0,26900,23000,0.0,6305.0,5,0,0,9,13,5,0,0,0,0,36150,7.2,33000,0,0,-26900,-23000,0.0,3615.0
4856914626,1,0,0,1,22,16,19,0,0,0,0,48050,10.2,48680,0,0,20200,20180,0.0,4805.0,0,0,0,7,13,10,0,0,0,0,27850,6.0,28500,0,0,-20200,-20180,0.0,2785.0
4856908360,1,6,0,1,13,25,19,0,0,0,0,60600,12.0,55000,0,0,22000,22000,0.0,6060.0,0,0,0,18,6,13,0,0,0,0,38600,7.2,33000,0,0,-22000,-22000,0.0,3860.0
4856871697,1,0,0,1,24,26,54,0,0,0,0,36007,11.0,39337,99,0,-2316,-3800,9.9,3600.7,1,0,0,26,24,66,0,0,0,0,38323,11.4,43137,121,0,2316,3800,12.1,3832.3
4856342955,0,0,0,1,20,17,54,0,0,0,1,34361,10.4,36783,93,0,-607,-83,9.3,3436.1,2,0,0,17,20,48,0,0,0,0,34968,10.6,36866,106,0,607,83,10.6,3496.8
4856204309,1,0,0,1,23,37,50,0,0,0,1,37928,11.0,39197,100,0,-4039,-7365,10.0,3792.8,0,0,0,37,23,94,0,0,0,0,41967,11.8,46562,107,0,4039,7365,10.7,4196.7
4856010000,0,11,1,0,20,42,40,0,0,0,2,37895,11.8,43782,80,0,-5275,-2386,8.0,3789.5,21,0,1,42,20,125,0,0,0,0,43170,12.0,46168,105,0,5275,2386,10.5,4317.0
4855860420,0,14,1,0,5,5,5,0,0,0,0,16867,7.4,19162,239,72,-44,365,31.1,1686.7,9,2,1,5,5,8,1,1,0,0,16911,7.2,18797,238,68,44,-365,30.6,1691.1
4855822758,1,12,2,0,4,7,3,0,0,0,0,16168,6.8,17906,196,66,-2683,-1139,26.2,1616.8,13,2,1,7,4,4,0,0,0,0,18851,7.4,19045,224,52,2683,1139,27.6,1885.1
4855781737,0,23,0,1,19,16,46,0,0,0,1,34650,10.2,35445,90,0,-2298,-3842,9.0,3465.0,0,0,0,16,19,39,0,0,0,0,36948,11.0,39287,106,0,2298,3842,10.6,3694.8
4855759602,1,1,0,1,29,17,75,0,0,0,1,38993,11.2,41493,124,0,2682,2083,12.4,3899.3,44,0,0,17,29,46,0,0,0,0,36311,11.0,39410,100,0,-2682,-2083,10.0,3631.1
4855730881,0,0,1,0,29,22,57,0,0,0,0,38377,12.0,44166,113,0,2055,4974,11.3,3837.7,21,0,1,22,29,55,0,0,0,0,36322,10.8,39192,104,0,-2055,-4974,10.4,3632.2
4854936661,1,0,0,1,19,20,24,0,0,0,0,62255,12.8,61000,3,0,24250,25000,0.3,6225.5,0,0,0,14,13,9,0,0,0,0,38005,7.6,36000,3,0,-24250,-25000,0.3,3800.5
4849790181,1,82,15,1,9,10,7,0,0,0,0,17851,6.4,16392,184,47,-1436,-1510,23.1,1785.1,32,1,0,10,9,9,1,1,0,0,19287,7.0,17902,208,44,1436,1510,25.2,1928.7
4840034162,1,12,0,0,6,6,5,1,1,0,0,16341,6.8,18004,209,49,-1319,-753,25.8,1634.1,77,0,1,5,5,5,0,0,0,0,17660,7.0,18757,221,54,1319,753,27.5,1766.0
4839771146,1,74,1,1,3,6,2,1,1,0,0,16255,7.2,18295,223,56,-1199,-600,27.9,1625.5,10,3,0,6,3,10,0,0,0,0,17454,7.0,18895,241,67,1199,600,30.8,1745.4
4839207206,0,71,1,0,3,7,2,0,0,0,0,15469,6.2,16292,202,56,-1781,-1658,25.8,1546.9,12,0,1,7,3,6,1,1,0,0,17250,7.0,17950,203,56,1781,1658,25.9,1725.0
4838996216,0,13,0,0,3,5,1,0,0,0,0,15843,7.0,18181,227,64,-1077,321,29.1,1584.3,79,1,1,5,3,4,0,0,0,0,16920,6.8,17860,228,60,1077,-321,28.8,1692.0
4825823117,1,105,0,1,18,14,30,0,0,0,0,35582,11.4,42347,77,63,2922,5868,14.0,3558.2,13,0,0,14,18,29,0,0,0,0,32660,10.4,36479,77,51,-2922,-5868,12.8,3266.0
4825791766,1,37,1,1,9,10,13,0,0,0,0,32106,10.4,35632,111,41,2153,-210,15.2,3210.6,100,0,0,10,9,11,0,0,0,0,29953,10.6,35842,75,64,-2153,210,13.9,2995.3
4825768466,0,218,0,0,8,16,18,0,0,0,0,30129,11.0,38583,84,59,-9176,-5414,14.3,3012.9,9,1,1,15,7,37,0,0,0,0,39305,11.8,43997,107,83,9176,5414,19.0,3930.5
4823672912,1,12,2,0,5,6,7,1,1,0,0,16580,6.6,17705,212,50,345,443,26.2,1658.0,14,3,1,6,5,5,0,0,0,0,16235,6.6,17262,214,52,-345,-443,26.6,1623.5
4823636564,0,72,1,0,5,7,3,1,1,0,0,15657,6.6,16494,203,56,-1766,-1224,25.9,1565.7,7,2,1,7,5,13,0,0,0,0,17423,7.0,17718,203,51,1766,1224,25.4,1742.3
4822768746,0,11,2,1,4,7,2,0,0,0,0,15255,6.6,17784,223,48,-2383,-1532,27.1,1525.5,79,0,0,7,4,4,1,1,0,0,17638,7.0,19316,233,56,2383,1532,28.9,1763.8
4822723638,1,65,2,0,4,5,3,0,0,0,0,16184,7.2,18332,235,64,-1315,628,29.9,1618.4,12,1,1,5,4,7,1,1,0,0,17499,6.8,17704,210,48,1315,-628,25.8,1749.9
4822144409,1,3,0,0,25,23,68,0,0,0,1,39153,11.8,44002,119,0,2654,4259,11.9,3915.3,13,0,1,23,25,50,0,0,0,0,36499,11.0,39743,99,0,-2654,-4259,9.9,3649.9
4822121631,1,18,0,0,20,17,45,0,0,0,2,36436,10.8,38620,105,0,1559,1573,10.5,3643.6,0,5,1,17,20,42,0,0,0,0,34877,10.8,37047,105,0,-1559,-1573,10.5,3487.7
4822096452,1,12,0,0,11,19,20,0,0,0,2,37971,11.0,39504,96,71,2499,-1587,16.7,3797.1,103,2,1,19,11,41,0,0,0,0,35472,11.2,41091,99,59,-2499,1587,15.8,3547.2
4822072425,0,17,0,0,13,25,22,0,0,0,0,32319,11.0,38148,71,59,-8932,-7745,13.0,3231.9,102,1,1,25,13,59,0,0,0,0,41251,12.0,45893,96,79,8932,7745,17.5,4125.1
4820591403,1,168,0,1,23,12,72,0,0,0,0,36814,11.4,42113,102,58,3257,8567,16.0,3681.4,10,0,0,11,22,26,0,0,0,0,33557,10.2,33546,73,59,-3257,-8567,13.2,3355.7
4820578776,0,14,1,0,20,19,41,0,0,0,1,31016,10.4,34202,58,43,-3468,-1447,10.1,3101.6,110,1,1,19,20,41,0,0,0,0,34484,10.2,35649,74,51,3468,1447,12.5,3448.4
4857847016,0,11,0,1,11,3,10,0,0,0,0,18570,6.8,17856,192,57,1604,327,24.9,1857.0,11,2,0,3,11,1,0,0,0,0,16966,6.8,17529,216,66,-1604,-327,28.2,1696.6
4857804924,1,10,3,1,12,5,10,1,1,0,0,20491,7.2,19057,211,60,3639,2554,27.1,2049.1,11,1,0,5,12,3,0,0,0,0,16852,6.4,16503,187,52,-3639,-2554,23.9,1685.2
4856892382,1,9,0,1,5,4,3,0,0,0,0,16951,7.2,18685,256,60,721,711,31.6,1695.1,12,1,0,4,5,4,0,0,0,0,16230,7.0,17974,239,67,-721,-711,30.6,1623.0
4856870757,1,8,2,1,8,5,5,1,1,0,0,18665,7.4,19601,235,64,3467,2510,29.9,1866.5,16,1,0,5,8,5,0,0,0,0,15198,6.8,17091,184,44,-3467,-2510,22.8,1519.8
4856853018,1,13,4,0,4,6,4,1,1,0,0,16859,7.0,18199,223,48,667,1653,27.1,1685.9,10,2,1,6,4,5,0,0,0,0,16192,6.6,16546,217,48,-667,-1653,26.5,1619.2
4853479943,0,41,2,0,5,8,9,0,0,0,0,16456,6.6,17164,195,52,-3560,-2201,24.7,1645.6,8,1,1,8,5,19,1,1,0,0,20016,7.2,19365,248,76,3560,2201,32.4,2001.6
4853440477,1,18,14,0,6,8,3,0,0,0,0,16292,6.8,17579,226,54,-1485,857,28.0,1629.2,31,2,1,8,6,7,0,0,0,0,17777,6.8,16722,209,46,1485,-857,25.5,1777.7
4853424429,0,12,3,1,5,5,8,0,0,0,0,16605,6.8,16821,206,52,-1597,-1277,25.8,1660.5,13,3,0,5,5,7,0,0,0,0,18202,7.2,18098,234,52,1597,1277,28.6,1820.2
4851307408,0,12,10,0,5,2,3,0,0,0,0,15326,6.8,17718,214,48,702,827,26.2,1532.6,35,2,1,2,5,2,1,1,0,0,14624,6.8,16891,215,60,-702,-827,27.5,1462.4
4851288248,0,15,3,0,5,8,8,0,0,0,0,16691,6.8,17783,234,44,-652,-255,27.8,1669.1,14,2,1,8,5,6,0,0,0,0,17343,7.0,18038,234,64,652,255,29.8,1734.3
4850741493,0,15,1,1,6,3,8,1,1,0,0,18530,6.8,18071,241,66,3152,-178,30.7,1853.0,17,1,0,3,6,8,1,0,1,0,15378,7.0,18249,226,69,-3152,178,29.5,1537.8
4850712404,0,12,3,0,2,10,2,0,0,0,0,14197,6.6,17031,211,56,-5173,-3454,26.7,1419.7,12,1,1,10,2,9,1,1,0,0,19370,7.4,20485,252,71,5173,3454,32.3,1937.0
4850577300,0,9,2,0,8,9,8,0,0,0,0,17358,6.6,16707,188,52,-742,-1235,24.0,1735.8,14,4,1,9,8,10,1,1,0,0,18100,6.8,17942,227,50,742,1235,27.7,1810.0
4850551455,0,15,3,0,6,11,5,1,1,0,0,17451,6.6,17135,202,55,-1640,-542,25.7,1745.1,14,2,1,11,6,10,0,0,0,0,19091,7.0,17677,211,61,1640,542,27.2,1909.1
4850527434,0,18,2,0,1,5,1,0,0,0,0,15075,7.2,18525,240,63,-3302,-323,30.3,1507.5,17,3,1,5,1,4,0,0,0,0,18377,7.2,18848,264,49,3302,323,31.3,1837.7
4850491571,1,11,1,0,4,7,2,0,0,0,0,16646,7.0,17463,209,64,-1213,-515,27.3,1664.6,11,1,1,7,4,8,0,0,0,0,17859,7.0,17978,220,64,1213,515,28.4,1785.9
4850429007,0,12,1,0,6,7,7,0,0,0,0,16506,6.8,17027,208,62,-1673,-1351,27.0,1650.6,14,2,1,7,6,13,1,1,0,0,18179,7.0,18378,241,64,1673,1351,30.5,1817.9
4849697299,0,15,4,0,5,7,7,1,1,0,0,18051,7.0,18522,193,59,186,624,25.2,1805.1,25,1,1,7,5,4,0,0,0,0,17865,7.0,17898,208,64,-186,-624,27.2,1786.5
4849666908,0,9,0,0,8,15,7,0,0,0,0,18309,6.4,16503,171,47,-2360,-1774,21.8,1830.9,14,1,1,15,8,13,2,1,1,0,20669,7.0,18277,206,54,2360,1774,26.0,2066.9
4857514181,1,3,0,1,16,17,18,0,0,0,0,47060,10.0,47500,0,0,18797,19000,0.0,4706.0,17,0,0,12,11,8,0,0,0,0,28263,6.0,28500,0,0,-18797,-19000,0.0,2826.3
4857494337,1,13,0,1,19,21,18,0,0,0,0,48110,10.0,47500,0,0,19538,19000,0.0,4811.0,0,0,0,13,11,9,0,0,0,0,28572,6.0,28500,0,0,-19538,-19000,0.0,2857.2
4857469577,1,26,0,1,17,20,20,0,0,0,0,62000,12.0,55000,0,0,24100,22000,0.0,6200.0,0,0,0,12,9,10,0,0,0,0,37900,7.2,33000,0,0,-24100,-22000,0.0,3790.0
4857453946,1,0,0,1,18,14,18,0,0,0,0,46719,10.0,47500,0,0,19512,19000,0.0,4671.9,0,0,0,6,10,8,0,0,0,0,27207,6.0,28500,0,0,-19512,-19000,0.0,2720.7
4855853497,1,0,0,1,24,16,63,0,0,0,1,38222,11.4,41471,119,0,4415,5075,11.9,3822.2,0,0,0,16,24,40,0,0,0,0,33807,10.4,36396,75,0,-4415,-5075,7.5,3380.7
4855837271,1,0,0,1,31,25,78,0,0,0,0,38750,11.8,44176,99,0,1423,1756,9.9,3875.0,0,0,0,25,31,69,0,0,0,0,37327,11.2,42420,92,0,-1423,-1756,9.2,3732.7
4855809677,1,68,0,1,26,17,67,0,0,0,0,37015,11.6,43009,82,0,1516,5316,8.2,3701.5,0,0,0,17,26,44,0,0,0,0,35499,10.8,37693,104,0,-1516,-5316,10.4,3549.9
4855795851,0,0,0,1,19,29,49,0,0,0,1,35814,10.6,36584,104,0,-4524,-5664,10.4,3581.4,0,0,0,29,19,74,0,0,0,0,40338,11.6,42248,118,0,4524,5664,11.8,4033.8
4855768408,1,5,0,1,19,20,48,0,0,0,1,36979,11.0,39934,116,0,-371,1857,11.6,3697.9,0,4,0,20,19,49,0,0,0,0,37350,10.6,38077,106,0,371,-1857,10.6,3735.0
4855741474,0,1,0,1,28,26,74,0,0,0,2,38797,11.2,41396,111,0,1169,1391,11.1,3879.7,0,1,0,26,28,66,0,0,0,0,37628,10.8,40005,103,0,-1169,-1391,10.3,3762.8
4852746497,1,26,4,1,15,14,17,0,0,0,0,45845,10.2,48680,7,0,17530,20180,0.7,4584.5,0,3,0,9,10,8,0,0,0,0,28315,6.0,28500,3,0,-17530,-20180,0.3,2831.5
4852723105,1,0,0,1,16,11,25,0,0,0,0,62350,12.0,55000,0,0,26200,21000,0.0,6235.0,0,0,0,8,13,2,0,0,0,0,36150,7.4,34000,0,0,-26200,-21000,0.0,3615.0
4847244602,1,0,0,1,38,22,65,0,0,0,2,45021,12.4,48908,124,0,7372,7695,12.4,4502.1,0,0,0,22,38,42,0,0,0,0,37649,11.2,41213,98,0,-7372,-7695,9.8,3764.9
4847235743,1,15,3,1,35,27,99,0,0,0,2,41518,12.0,45565,115,0,1637,2417,11.5,4151.8,10,0,0,27,35,70,0,0,0,0,39881,11.6,43148,123,0,-1637,-2417,12.3,3988.1
4847223934,1,0,0,1,27,23,56,0,0,0,1,38768,11.4,43089,117,0,957,-296,11.7,3876.8,0,0,0,23,27,58,0,0,0,0,37811,11.6,43385,107,0,-957,296,10.7,3781.1
4847200557,0,7,0,0,22,23,55,0,0,0,0,37347,11.4,41926,108,0,655,-557,10.8,3734.7,0,0,1,23,22,60,0,0,0,0,36692,11.4,42483,113,0,-655,557,11.3,3669.2
4839403788,0,8,2,0,4,14,3,0,0,0,0,15744,6.8,17133,212,60,-5279,-3669,27.2,1574.4,12,1,1,14,4,12,2,1,1,0,21023,7.6,20802,222,64,5279,3669,28.6,2102.3
4839366200,0,13,2,1,6,5,8,0,0,0,0,17095,7.0,18370,239,52,-348,-734,29.1,1709.5,20,1,0,5,6,5,0,0,0,0,17443,7.0,19104,253,62,348,734,31.5,1744.3
4829566346,1,0,0,0,31,31,84,0,0,0,1,40562,12.0,45646,115,0,-1609,584,11.5,4056.2,12,0,1,31,31,66,0,0,0,0,42171,11.6,45062,106,0,1609,-584,10.6,4217.1
4829545963,1,27,0,1,37,39,97,0,0,0,1,42571,12.4,48570,126,0,1950,1401,12.6,4257.1,0,0,0,39,37,114,0,0,0,0,40621,12.0,47169,92,0,-1950,-1401,9.2,4062.1
4858390326,1,14,2,1,5,7,5,0,0,0,0,17833,7.0,17760,202,56,283,-469,25.8,1783.3,13,2,0,7,5,5,0,0,0,0,17550,6.8,18229,218,64,-283,469,28.2,1755.0
4858353952,0,13,2,1,4,6,2,0,0,0,0,16287,7.0,18404,212,84,-1864,243,29.6,1628.7,10,2,0,6,4,6,1,1,0,0,18151,7.0,18161,202,47,1864,-243,24.9,1815.1
4857955424,0,11,0,0,2,6,0,1,0,1,0,14892,7.2,18674,223,64,-2639,-251,28.7,1489.2,23,1,1,6,2,9,1,1,0,0,17531,7.0,18925,221,68,2639,251,28.9,1753.1
4857932078,0,11,2,1,4,10,4,0,0,0,0,16287,6.6,17312,235,46,-2256,-1581,28.1,1628.7,14,1,0,10,4,9,1,1,0,0,18543,7.4,18893,222,68,2256,1581,29.0,1854.3
4857904403,1,13,4,0,6,4,4,0,0,0,0,17487,7.2,18502,233,50,465,385,28.3,1748.7,33,2,1,4,6,3,1,1,0,0,17022,7.0,18117,218,45,-465,-385,26.3,1702.2
4857653517,0,14,2,0,3,6,4,1,1,0,0,15674,7.0,17794,224,51,-1077,-135,27.5,1567.4,12,5,1,6,3,5,0,0,0,0,16751,7.0,17929,226,52,1077,135,27.8,1675.1
4857629263,0,14,1,1,8,8,7,1,0,1,0,16610,6.2,14948,167,48,-2189,-2675,21.5,1661.0,24,1,0,8,8,8,0,0,0,0,18799,7.0,17623,208,44,2189,2675,25.2,1879.9
4857604268,1,9,4,1,3,2,4,0,0,0,0,15672,6.8,18129,248,59,122,-558,30.7,1567.2,16,1,0,2,3,1,1,1,0,0,15550,7.0,18687,222,76,-122,558,29.8,1555.0
4857578372,0,31,3,1,4,4,5,1,1,0,0,15638,7.0,18479,235,52,-816,-829,28.7,1563.8,29,3,0,4,4,2,0,0,0,0,16454,7.2,19308,242,64,816,829,30.6,1645.4
4857546460,0,11,2,0,3,13,2,1,0,1,0,16291,7.0,18244,244,68,-3112,-813,31.2,1629.1,14,2,1,13,3,14,1,1,0,0,19403,7.2,19057,230,52,3112,813,28.2,1940.3
4857511911,0,12,1,0,3,3,2,0,0,0,0,15282,7.2,18941,234,60,-1058,853,29.4,1528.2,13,0,1,3,3,3,1,1,0,0,16340,6.8,18088,232,55,1058,-853,28.7,1634.0
4855496598,1,0,0,1,34,28,91,0,0,0,1,40957,12.2,46633,90,0,2562,4696,9.0,4095.7,15,0,0,28,34,69,0,0,0,0,38395,11.4,41937,104,0,-2562,-4696,10.4,3839.5
4854261570,1,2,0,1,39,12,103,0,0,0,1,40688,11.8,45280,103,0,5233,6761,10.3,4068.8,1,0,0,12,39,20,0,0,0,0,35455,11.0,38519,91,0,-5233,-6761,9.1,3545.5
4854243615,1,13,0,1,15,14,42,0,0,0,2,36326,10.8,37607,111,0,3028,1717,11.1,3632.6,14,4,0,14,15,29,0,0,0,0,33298,10.4,35890,75,0,-3028,-1717,7.5,3329.8
4854226548,0,0,0,0,18,24,43,0,0,0,2,35624,10.6,37365,91,0,-2650,-5247,9.1,3562.4,0,0,1,24,18,56,0,0,0,0,38274,11.6,42612,112,0,2650,5247,11.2,3827.4
4854178729,0,15,3,1,8,7,6,1,1,0,0,15791,6.6,16705,169,52,-1336,-1663,22.1,1579.1,14,3,0,7,8,7,0,0,0,0,17127,7.0,18368,204,52,1336,1663,25.6,1712.7
4854136025,1,36,2,0,2,5,0,0,0,0,0,14145,6.8,16947,170,56,-2143,-1289,22.6,1414.5,11,13,1,5,2,4,0,0,0,0,16288,7.0,18236,173,52,2143,1289,22.5,1628.8
4854075413,0,13,0,0,6,12,6,0,0,0,0,16954,6.8,18093,230,65,-2796,147,29.5,1695.4,21,1,1,12,6,17,1,0,1,0,19750,6.8,17946,211,49,2796,-147,26.0,1975.0
4850198082,1,34,2,1,4,3,6,1,1,0,0,15994,7.2,17321,223,56,85,-883,27.9,1599.4,35,2,0,3,4,1,0,0,0,0,15909,7.0,18204,213,67,-85,883,28.0,1590.9
4850183376,1,13,5,0,9,3,6,0,0,0,0,19276,7.2,19539,247,60,4389,3090,30.7,1927.6,20,1,1,3,9,3,0,0,0,0,14887,6.6,16449,180,44,-4389,-3090,22.4,1488.7
4857509665,0,12,0,1,4,9,7,0,0,0,0,15004,6.4,15495,180,56,-1998,-2255,23.6,1500.4,14,1,0,9,4,7,2,1,1,0,17002,7.0,17750,215,72,1998,2255,28.7,1700.2
4857481177,1,18,2,0,7,6,7,0,0,0,0,17711,7.0,18462,235,56,747,523,29.1,1771.1,13,4,1,6,7,10,0,0,0,0,16964,6.8,17939,226,67,-747,-523,29.3,1696.4
4857459892,0,15,2,0,3,14,3,0,0,0,0,13733,6.0,14145,156,52,-6592,-4153,20.8,1373.3,18,2,1,14,3,17,1,1,0,0,20325,7.0,18298,200,52,6592,4153,25.2,2032.5
4857328477,0,12,1,1,6,2,6,1,0,1,0,16388,6.8,17020,224,40,1266,-712,26.4,1638.8,10,1,0,2,6,1,1,1,0,0,15122,7.0,17732,215,60,-1266,712,27.5,1512.2
4857303065,1,10,0,0,8,3,8,0,0,0,0,17524,7.0,18137,224,52,2697,679,27.6,1752.4,15,1,1,3,8,3,1,1,0,0,14827,6.8,17458,217,51,-2697,-679,26.8,1482.7
4856488916,1,24,0,1,12,6,13,0,0,0,0,19717,7.0,18753,241,60,3643,1593,30.1,1971.7,12,1,0,6,12,4,0,0,0,0,16074,6.8,17160,229,48,-3643,-1593,27.7,1607.4
4856455669,0,9,0,0,5,11,5,0,0,0,0,16623,6.6,17606,179,56,-5307,-2106,23.5,1662.3,13,1,1,11,5,12,1,1,0,0,21930,7.4,19712,276,44,5307,2106,32.0,2193.0
4856400644,0,12,2,0,5,7,5,0,0,0,0,15571,6.4,14949,174,52,-3580,-3157,22.6,1557.1,19,2,1,7,5,10,0,0,0,0,19151,7.0,18106,220,59,3580,3157,27.9,1915.1
4856363649,0,13,1,0,8,15,7,0,0,0,0,16200,5.6,13055,156,34,-4448,-4177,19.0,1620.0,28,1,1,15,8,19,0,0,0,0,20648,6.6,17232,207,44,4448,4177,25.1,2064.8
4856234602,1,13,4,1,6,5,6,1,1,0,0,16010,6.6,17388,222,48,-14,-469,27.0,1601.0,85,3,0,5,6,3,0,0,0,0,16024,6.8,17857,235,44,14,469,27.9,1602.4
4856178035,1,6,0,0,19,16,61,0,0,0,1,36324,11.0,38364,107,0,1902,1540,10.7,3632.4,13,0,1,16,19,50,0,0,0,0,34422,10.6,36824,106,0,-1902,-1540,10.6,3442.2
4853032758,1,12,1,1,7,8,12,0,0,0,0,16232,6.6,15190,162,52,-933,-2363,21.4,1623.2,10,2,0,8,7,8,0,0,0,0,17165,6.8,17553,220,59,933,2363,27.9,1716.5
4851918595,1,11,1,0,6,7,9,0,0,0,0,16448,6.6,17378,234,56,-465,319,29.0,1644.8,12,0,1,7,6,10,0,0,0,0,16913,6.6,17059,204,63,465,-319,26.7,1691.3
4845332126,1,11,4,0,13,7,8,1,0,1,0,20778,8.0,21497,231,81,4591,4056,31.2,2077.8,15,1,1,6,12,5,0,0,0,0,16187,6.6,17441,210,42,-4591,-4056,25.2,1618.7
4845312270,1,13,1,0,10,7,10,0,0,0,0,18063,7.4,18673,218,56,336,938,27.4,1806.3,14,2,1,7,10,7,0,0,0,0,17727,7.0,17735,230,40,-336,-938,27.0,1772.7
4845278467,0,9,9,0,3,9,6,1,0,1,0,15339,6.2,14781,167,56,-3832,-3755,22.3,1533.9,35,2,1,9,3,5,1,1,0,0,19171,7.0,18536,233,46,3832,3755,27.9,1917.1
4843560519,0,14,2,0,3,6,4,0,0,0,0,15067,6.6,16653,191,56,-2184,-364,24.7,1506.7,12,2,1,6,3,8,1,1,0,0,17251,6.8,17017,203,48,2184,364,25.1,1725.1
4843537974,0,8,3,1,6,8,7,0,0,0,0,17009,6.8,17112,225,49,-319,-644,27.4,1700.9,13,1,0,8,6,5,1,1,0,0,17328,7.2,17756,213,36,319,644,24.9,1732.8
4843500994,0,12,4,1,3,6,3,0,0,0,0,16409,7.0,17694,253,50,382,219,30.3,1640.9,21,2,0,6,3,5,1,1,0,0,16027,6.8,17475,195,58,-382,-219,25.3,1602.7
4843454224,0,12,1,1,8,5,7,1,1,0,0,17403,7.2,19615,228,76,1946,1169,30.4,1740.3,13,1,0,5,8,4,0,0,0,0,15457,6.8,18446,204,67,-1946,-1169,27.1,1545.7
4857317695,1,14,0,1,5,6,6,0,0,0,0,17474,6.8,17351,218,56,725,266,27.4,1747.4,10,0,0,6,5,11,0,0,0,0,16749,6.8,17085,205,56,-725,-266,26.1,1674.9
4857295795,1,5,0,0,19,12,16,0,0,0,0,48050,12.0,55000,1,0,19500,22000,0.1,4805.0,16,0,1,6,13,10,0,0,0,0,28550,7.2,33000,4,0,-19500,-22000,0.4,2855.0
4857225156,1,12,2,1,7,3,9,0,0,0,0,17785,6.8,17241,229,55,3098,1231,28.4,1778.5,122,0,0,3,7,4,1,1,0,0,14687,6.4,16010,188,60,-3098,-1231,24.8,1468.7
4857189247,0,10,1,0,3,7,4,1,1,0,0,16258,7.0,17721,216,51,-2082,-1076,26.7,1625.8,9,3,1,7,3,9,0,0,0,0,18340,7.2,18797,229,52,2082,1076,28.1,1834.0
4857092665,0,13,0,0,2,5,1,1,0,1,0,15225,7.0,18586,229,52,-1961,150,28.1,1522.5,13,1,1,5,2,5,1,1,0,0,17186,7.2,18436,230,62,1961,-150,29.2,1718.6
4857059549,1,12,4,1,2,1,1,0,0,0,0,15690,7.0,18604,244,59,1215,679,30.3,1569.0,19,1,0,1,2,1,0,0,0,0,14475,6.8,17925,240,44,-1215,-679,28.4,1447.5
4857025398,1,11,15,1,5,1,3,0,0,0,0,17352,7.2,19106,230,60,2410,501,29.0,1735.2,31,1,0,1,5,0,0,0,0,0,14942,7.0,18605,230,44,-2410,-501,27.4,1494.2
4856447022,1,18,4,0,5,9,6,0,0,0,0,15414,6.8,16607,214,47,-2686,341,26.1,1541.4,179,2,1,9,5,10,2,1,1,0,18100,6.4,16266,177,46,2686,-341,22.3,1810.0
4856396142,0,13,2,0,9,11,10,0,0,0,0,19360,7.0,18448,238,60,678,42,29.8,1936.0,12,3,1,11,9,8,1,1,0,0,18682,6.8,18406,205,44,-678,-42,24.9,1868.2
4856348868,0,80,0,1,5,8,2,0,0,0,0,16186,6.8,17851,222,47,-823,196,26.9,1618.6,12,1,0,8,5,7,0,0,0,0,17009,7.0,17655,206,59,823,-196,26.5,1700.9
4856226754,1,14,0,1,6,4,6,0,0,0,0,16820,6.6,17031,219,49,1364,490,26.8,1682.0,9,1,0,4,6,5,0,0,0,0,15456,6.6,16541,215,56,-1364,-490,27.1,1545.6
4856081092,0,14,1,1,7,10,7,0,0,0,0,18194,7.0,17444,196,62,456,100,25.8,1819.4,10,1,0,10,7,9,0,0,0,0,17738,6.8,17344,206,44,-456,-100,25.0,1773.8
4856034487,1,11,2,1,5,3,3,1,1,0,0,16702,6.8,18236,247,68,1740,176,31.5,1670.2,23,0,0,3,5,7,0,0,0,0,14962,6.8,18060,208,52,-1740,-176,26.0,1496.2
4856006930,1,24,3,1,3,2,3,1,1,0,0,15687,7.0,18273,231,60,248,-150,29.1,1568.7,19,2,0,2,3,1,0,0,0,0,15439,7.0,18423,234,56,-248,150,29.0,1543.9
4855955564,0,13,1,1,5,8,10,1,0,1,0,16784,7.0,18794,242,60,-1917,-219,30.2,1678.4,13,3,0,8,5,12,1,1,0,0,18701,7.2,19013,253,51,1917,219,30.4,1870.1
4855919923,1,14,2,1,4,11,3,0,0,0,0,15408,6.8,16088,215,58,-3658,-2108,27.3,1540.8,13,2,0,11,4,6,1,1,0,0,19066,7.0,18196,221,44,3658,2108,26.5,1906.6
4855858454,0,11,1,0,7,8,11,0,0,0,0,20267,7.2,19001,224,48,1460,475,27.2,2026.7,13,0,1,8,7,6,0,0,0,0,18807,7.0,18526,146,80,-1460,-475,22.6,1880.7
4855831974,1,12,2,1,9,6,11,0,0,0,0,19726,7.0,18591,230,47,1901,2496,27.7,1972.6,13,0,0,6,9,6,0,0,0,0,17825,6.4,16095,180,75,-1901,-2496,25.5,1782.5
4854927749,1,16,2,1,5,6,4,1,1,0,0,17711,7.0,18033,213,72,440,1414,28.5,1771.1,17,3,0,6,5,10,1,0,1,0,17271,6.6,16619,192,46,-440,-1414,23.8,1727.1
4858175195,0,13,0,0,3,8,1,0,0,0,0,15775,7.2,18651,223,60,-2649,-130,28.3,1577.5,9,0,1,8,3,9,1,1,0,0,18424,7.2,18781,252,60,2649,130,31.2,1842.4
4856202331,0,14,12,0,9,9,9,0,0,0,0,17539,7.0,17931,192,52,-921,277,24.4,1753.9,39,4,1,9,9,10,0,0,0,0,18460,7.0,17654,236,64,921,-277,30.0,1846.0
4846144200,1,12,0,1,12,5,9,0,0,0,0,18701,7.4,19378,232,48,2843,3178,28.0,1870.1,11,3,0,5,12,5,0,0,0,0,15858,6.4,16200,200,51,-2843,-3178,25.1,1585.8
4846102866,0,24,3,1,9,3,14,0,0,0,0,17401,6.6,17296,204,52,1861,-82,25.6,1740.1,13,1,0,3,9,4,1,1,0,0,15540,6.8,17378,243,60,-1861,82,30.3,1554.0
4822096870,1,53,2,1,6,4,8,1,0,1,0,17824,7.0,19116,236,56,2212,2601,29.2,1782.4,10,1,0,4,6,5,0,0,0,0,15612,6.6,16515,205,56,-2212,-2601,26.1,1561.2
4821658858,0,10,0,1,2,10,2,0,0,0,0,15691,6.4,16287,212,56,-3529,-2344,26.8,1569.1,18,1,0,10,2,16,2,1,1,0,19220,7.0,18631,226,76,3529,2344,30.2,1922.0
4821623792,1,10,2,0,8,8,7,1,1,0,0,17686,6.6,16227,203,44,-840,488,24.7,1768.6,16,0,1,8,8,5,0,0,0,0,18526,6.6,15739,172,51,840,-488,22.3,1852.6
4821585339,0,13,2,1,10,4,13,1,0,1,0,18545,7.2,18435,218,56,2190,1182,27.4,1854.5,13,0,0,4,10,5,1,1,0,0,16355,6.8,17253,213,60,-2190,-1182,27.3,1635.5
4821526089,0,11,0,1,6,7,7,0,0,0,0,18674,7.2,18565,233,67,2077,761,30.0,1867.4,12,1,0,7,6,7,0,0,0,0,16597,7.0,17804,210,48,-2077,-761,25.8,1659.7
4821508829,1,17,1,0,5,6,7,0,0,0,0,17452,6.6,17167,198,62,-1550,-1270,26.0,1745.2,9,0,1,6,5,6,0,0,0,0,19002,7.2,18437,239,46,1550,1270,28.5,1900.2
4820726667,1,38,0,1,5,4,5,1,1,0,0,16461,7.0,18280,223,56,623,527,27.9,1646.1,14,8,0,4,5,4,0,0,0,0,15838,6.8,17753,207,59,-623,-527,26.6,1583.8
4820696182,0,59,3,0,5,6,4,1,1,0,0,18042,6.8,18527,209,56,-495,96,26.5,1804.2,15,2,1,6,5,6,1,0,1,0,18537,7.2,18431,213,52,495,-96,26.5,1853.7
4820665408,0,10,3,0,1,5,2,0,0,0,0,15582,7.0,18155,255,64,330,648,31.9,1558.2,22,3,1,5,1,7,0,0,0,0,15252,7.0,17507,198,60,-330,-648,25.8,1525.2
4820634879,1,24,2,0,5,8,7,0,0,0,0,14976,6.2,15053,166,40,-4162,-2557,20.6,1497.6,40,1,1,8,5,8,0,0,0,0,19138,7.2,17610,224,48,4162,2557,27.2,1913.8
4820605919,1,16,0,1,8,3,7,1,0,1,0,18419,7.2,18623,211,52,3327,2284,26.3,1841.9,8,2,0,3,8,2,0,0,0,0,15092,6.6,16339,211,44,-3327,-2284,25.5,1509.2
4820575103,1,16,0,0,7,6,10,1,0,1,0,16727,6.6,16599,210,56,1697,1352,26.6,1672.7,10,1,1,6,7,5,0,0,0,0,15030,6.2,15247,165,38,-1697,-1352,20.3,1503.0
4820545351,0,55,6,1,4,4,4,0,0,0,0,15801,7.0,17701,204,48,-861,-872,25.2,1580.1,41,0,0,4,4,4,0,0,0,0,16662,7.0,18573,226,52,861,872,27.8,1666.2
4820014847,0,16,0,1,7,10,6,1,0,1,0,17066,6.8,17247,219,44,-1595,-1703,26.3,1706.6,13,1,0,10,7,8,0,0,0,0,18661,7.0,18950,217,44,1595,1703,26.1,1866.1
4819547177,0,22,1,1,7,5,9,1,1,0,0,18912,7.2,18995,228,72,1379,1107,30.0,1891.2,16,3,0,5,7,4,0,0,0,0,17533,7.0,17888,224,52,-1379,-1107,27.6,1753.3
4819525739,1,81,0,0,9,10,9,0,0,0,0,18239,6.8,17490,187,48,519,116,23.5,1823.9,13,18,1,10,9,6,0,0,0,0,17720,6.6,17374,219,48,-519,-116,26.7,1772.0
4858160134,0,10,2,0,2,3,0,1,1,0,0,15567,7.2,18997,265,60,325,1018,32.5,1556.7,13,0,1,3,2,2,0,0,0,0,15242,7.2,17979,236,44,-325,-1018,28.0,1524.2
4857160572,1,18,2,1,9,5,10,0,0,0,0,18764,6.8,18382,223,48,2752,1076,27.1,1876.4,14,0,0,5,9,3,1,1,0,0,16012,6.8,17306,212,62,-2752,-1076,27.4,1601.2
4856953527,0,14,1,1,4,6,7,0,0,0,0,16370,6.6,16690,221,46,-524,-657,26.7,1637.0,14,1,0,5,3,2,0,0,0,0,16894,6.8,17347,204,50,524,657,25.4,1689.4
4856094121,0,36,1,1,1,5,0,0,0,0,0,14491,6.8,17868,255,45,-2435,-456,30.0,1449.1,38,1,0,5,1,8,0,0,0,0,16926,7.2,18324,209,63,2435,456,27.2,1692.6
4855809092,0,13,1,0,4,8,5,1,1,0,0,15572,6.4,16626,211,56,-1633,344,26.7,1557.2,15,1,1,8,4,15,0,0,0,0,17205,6.6,16282,203,56,1633,-344,25.9,1720.5
4855780331,1,85,2,1,5,5,5,0,0,0,0,17675,7.2,18846,241,51,665,131,29.2,1767.5,12,0,0,5,5,6,0,0,0,0,17010,7.0,18715,246,60,-665,-131,30.6,1701.0
4854922103,1,38,0,1,8,6,6,0,0,0,0,16901,6.6,17130,212,46,-1051,283,25.8,1690.1,29,1,0,6,8,9,0,0,0,0,17952,6.6,16847,185,48,1051,-283,23.3,1795.2
4854656185,0,16,1,0,4,10,4,0,0,0,0,16516,6.8,17537,220,52,-3537,-1354,27.2,1651.6,14,0,1,10,4,15,1,0,1,0,20053,7.2,18891,248,52,3537,1354,30.0,2005.3
4854621498,0,24,5,1,6,3,7,0,0,0,0,16600,6.8,17811,232,54,925,-132,28.6,1660.0,13,3,0,3,6,3,1,1,0,0,15675,7.0,17943,210,67,-925,132,27.7,1567.5
4854501996,0,10,2,0,4,8,4,0,0,0,0,15440,6.6,16926,215,53,-2887,-1874,26.8,1544.0,13,2,1,8,4,10,0,0,0,0,18327,6.8,18800,230,46,2887,1874,27.6,1832.7
4854478644,1,26,1,1,10,4,15,0,0,0,0,18146,6.8,17969,226,53,830,-715,27.9,1814.6,13,1,0,4,10,5,0,0,0,0,17316,7.0,18684,233,59,-830,715,29.2,1731.6
4854463062,1,12,0,1,5,1,6,0,0,0,0,18192,7.0,18731,243,48,3962,456,29.1,1819.2,6,2,0,1,5,1,0,0,0,0,14230,7.0,18275,227,64,-3962,-456,29.1,1423.0
4853811789,0,15,1,0,4,11,3,0,0,0,0,15685,6.6,16558,173,44,-1822,-1037,21.7,1568.5,14,0,1,11,4,5,0,0,0,0,17507,6.8,17595,157,40,1822,1037,19.7,1750.7
4853767659,0,12,1,1,5,6,4,0,0,0,0,16763,6.8,17179,199,60,433,-1117,25.9,1676.3,11,3,0,6,5,3,1,1,0,0,16330,7.0,18296,242,60,-433,1117,30.2,1633.0
4852662324,1,10,0,0,5,7,6,0,0,0,0,17334,7.0,18291,232,51,-137,1055,28.3,1733.4,9,1,1,7,5,7,0,0,0,0,17471,6.8,17236,222,48,137,-1055,27.0,1747.1
4851643420,1,20,0,1,5,2,5,1,1,0,0,16463,7.2,18262,208,60,827,-174,26.8,1646.3,14,0,0,2,5,1,0,0,0,0,15636,7.0,18436,230,64,-827,174,29.4,1563.6
4849800444,1,15,3,1,5,8,5,1,1,0,0,18519,6.6,17209,213,43,-92,115,25.6,1851.9,13,3,0,8,5,7,0,0,0,0,18611,6.6,17094,213,52,92,-115,26.5,1861.1
4849771606,1,10,2,1,6,5,5,2,1,1,0,17454,7.0,18170,219,59,-874,-372,27.8,1745.4,8,1,0,5,6,5,0,0,0,0,18328,7.2,18542,214,54,874,372,26.8,1832.8
4848655229,0,12,0,1,6,4,8,0,0,0,0,17866,7.0,18405,228,59,1140,41,28.7,1786.6,14,2,0,4,6,6,1,1,0,0,16726,7.0,18364,264,40,-1140,-41,30.4,1672.6
4858138054,1,0,0,1,16,15,15,0,0,0,0,46495,10.0,47500,1,0,18270,19000,0.1,4649.5,0,0,0,10,11,11,0,0,0,0,28225,6.0,28500,1,0,-18270,-19000,0.1,2822.5
4858109680,1,88,0,1,20,10,16,0,0,0,0,47099,10.0,47500,11,0,20707,19000,1.1,4709.9,24,0,0,4,14,5,0,0,0,0,26392,6.0,28500,7,0,-20707,-19000,0.7,2639.2
4858090486,1,20,0,1,19,16,17,0,0,0,0,45950,10.0,47500,0,0,17400,19000,0.0,4595.0,0,0,0,10,13,9,0,0,0,0,28550,6.0,28500,0,0,-17400,-19000,0.0,2855.0
4857726623,0,0,0,0,26,24,66,0,0,0,2,40295,11.4,42444,106,0,2468,3184,10.6,4029.5,0,0,1,24,26,74,0,0,0,0,37827,11.0,39260,117,0,-2468,-3184,11.7,3782.7
4857718618,1,0,0,0,35,21,114,0,0,0,3,42545,11.8,45394,118,0,4172,5183,11.8,4254.5,2,0,1,21,35,43,0,0,0,0,38373,11.0,40211,115,0,-4172,-5183,11.5,3837.3
4856835189,0,12,0,1,34,37,80,0,0,0,0,39437,11.6,43679,95,0,-3797,-4669,9.5,3943.7,2,2,0,37,34,84,0,0,0,0,43234,12.4,48348,114,0,3797,4669,11.4,4323.4
4856820231,1,207,4,1,12,16,11,0,0,0,0,44690,10.0,47500,3,0,16603,19000,0.3,4469.0,176,5,0,11,7,11,0,0,0,0,28087,6.0,28500,0,0,-16603,-19000,0.0,2808.7
4856808267,1,0,0,0,13,18,16,0,0,0,0,46668,10.0,47500,0,0,17397,19000,0.0,4666.8,84,0,1,14,9,10,0,0,0,0,29271,6.0,28500,0,0,-17397,-19000,0.0,2927.1
4856794541,1,0,0,0,20,15,15,0,0,0,0,47700,10.0,47500,0,0,20900,19000,0.0,4770.0,0,0,1,6,11,10,0,0,0,0,26800,6.0,28500,0,0,-20900,-19000,0.0,2680.0
4856787101,1,0,0,1,21,13,21,0,0,0,0,47700,10.0,47500,0,0,21600,19000,0.0,4770.0,0,0,0,6,14,6,0,0,0,0,26100,6.0,28500,0,0,-21600,-19000,0.0,2610.0
4856518951,1,0,0,0,17,14,15,0,0,0,0,48654,10.0,47500,0,0,18743,19000,0.0,4865.4,270,0,1,9,12,10,0,0,0,0,29911,6.0,28500,0,0,-18743,-19000,0.0,2991.1
4856491486,1,0,0,1,15,13,14,0,0,0,0,46135,10.0,47500,0,0,18213,19000,0.0,4613.5,0,0,0,10,12,8,0,0,0,0,27922,6.0,28500,0,0,-18213,-19000,0.0,2792.2
4856470697,1,0,0,0,18,21,16,0,0,0,0,47350,10.6,50500,0,0,18800,22000,0.0,4735.0,0,0,1,12,9,12,0,0,0,0,28550,6.0,28500,0,0,-18800,-22000,0.0,2855.0
4856455885,1,0,0,0,20,11,22,0,0,0,0,47370,10.0,47500,0,0,21570,19000,0.0,4737.0,0,0,1,4,13,4,0,0,0,0,25800,6.0,28500,0,0,-21570,-19000,0.0,2580.0
4856431874,1,0,0,1,18,12,16,0,0,0,0,46025,10.0,47500,0,0,19059,19000,0.0,4602.5,0,0,0,5,11,6,0,0,0,0,26966,6.0,28500,0,0,-19059,-19000,0.0,2696.6
4856406956,1,0,0,1,13,18,18,0,0,0,0,47000,10.0,47500,0,0,17292,19000,0.0,4700.0,0,0,0,12,7,12,0,0,0,0,29708,6.0,28500,0,0,-17292,-19000,0.0,2970.8
4856363436,1,0,0,1,17,16,14,0,0,0,0,46350,10.0,47500,2,0,18850,19000,0.2,4635.0,0,0,0,7,8,11,0,0,0,0,27500,6.0,28500,5,0,-18850,-19000,0.5,2750.0
4856329660,1,0,0,0,18,13,16,0,0,0,0,46300,10.2,48680,0,0,20200,20180,0.0,4630.0,14,0,1,4,9,7,0,0,0,0,26100,6.0,28500,0,0,-20200,-20180,0.0,2610.0
4856307913,1,0,0,0,16,20,14,0,0,0,0,45950,10.0,47500,0,0,17400,19000,0.0,4595.0,0,0,1,11,7,12,0,0,0,0,28550,6.0,28500,0,0,-17400,-19000,0.0,2855.0
4855695311,1,0,0,1,18,12,17,0,0,0,0,49822,10.0,47500,10,0,23670,19000,1.0,4982.2,0,0,0,4,10,5,0,0,0,0,26152,6.0,28500,2,0,-23670,-19000,0.2,2615.2
4858344601,0,11,0,1,5,6,4,0,0,0,0,15670,6.6,17553,189,33,-283,-1015,22.2,1567.0,10,1,0,6,5,4,0,0,0,0,15953,7.0,18568,206,56,283,1015,26.2,1595.3
4858318263,0,6,2,0,21,27,40,0,0,0,1,34851,10.8,39149,89,0,-4706,-4564,8.9,3485.1,15,0,1,27,21,71,0,0,0,0,39557,11.4,43713,103,0,4706,4564,10.3,3955.7
4858288089,1,26,0,0,18,24,49,0,0,0,1,36426,11.0,39390,123,0,100,325,12.3,3642.6,0,20,1,24,18,57,0,0,0,0,36326,10.8,39065,96,0,-100,-325,9.6,3632.6
4858248203,1,0,0,0,26,33,51,0,0,0,1,36350,11.0,39374,82,0,-3662,-5542,8.2,3635.0,0,0,1,33,26,84,0,0,0,0,40012,11.8,44916,90,0,3662,5542,9.0,4001.2
4857394483,0,1,0,1,8,13,20,0,0,0,1,32086,10.0,33670,90,0,-2780,-6443,9.0,3208.6,0,0,0,13,8,34,0,0,0,0,34866,11.2,40113,114,0,2780,6443,11.4,3486.6
4857372764,0,5,0,1,23,25,52,0,0,0,0,37264,11.0,39175,91,0,-46,-3825,9.1,3726.4,89,2,0,25,23,64,0,0,0,0,37310,11.8,43000,107,0,46,3825,10.7,3731.0
4857321016,0,16,0,0,28,21,61,0,0,0,0,36927,11.2,41400,77,0,397,4110,7.7,3692.7,7,4,1,21,28,64,0,0,0,0,36530,10.6,37290,108,0,-397,-4110,10.8,3653.0
4857294969,0,1,1,0,21,29,45,0,0,0,0,36923,11.4,41226,100,0,-998,-99,10.0,3692.3,13,0,1,29,21,68,0,0,0,0,37921,11.4,41325,103,0,998,99,10.3,3792.1
4857265934,1,33,0,1,24,15,58,0,0,0,1,39009,11.4,41902,132,0,4737,4550,13.2,3900.9,0,26,0,15,24,40,0,0,0,0,34272,10.6,37352,83,0,-4737,-4550,8.3,3427.2
4857137185,0,0,0,0,27,33,56,0,0,0,0,39056,11.6,44470,97,0,-418,887,9.7,3905.6,0,0,1,33,27,90,0,0,0,0,39474,11.6,43583,112,0,418,-887,11.2,3947.4
4856206694,1,12,2,0,4,2,5,1,1,0,0,15773,6.8,17927,219,56,914,-289,27.5,1577.3,15,0,1,2,4,1,0,0,0,0,14859,7.0,18216,203,64,-914,289,26.7,1485.9
4856177765,0,0,0,0,16,20,43,0,0,0,0,34160,10.6,35461,105,0,-231,-2040,10.5,3416.0,0,0,1,20,16,50,0,0,0,0,34391,11.0,37501,111,0,231,2040,11.1,3439.1
4856137434,0,71,0,1,14,16,33,0,0,0,1,35570,10.4,36282,95,0,-103,-1882,9.5,3557.0,0,0,0,16,14,36,0,0,0,0,35673,11.0,38164,96,0,103,1882,9.6,3567.3
4856104281,0,7,0,0,10,10,28,0,0,0,0,31887,10.2,33505,118,0,-943,712,11.8,3188.7,0,0,1,10,10,29,0,0,0,0,32830,10.0,32793,109,0,943,-712,10.9,3283.0
4856076143,0,81,0,1,24,16,71,0,0,0,1,38184,11.4,41786,107,0,3465,4831,10.7,3818.4,157,0,0,16,24,37,0,0,0,0,34719,10.8,36955,68,0,-3465,-4831,6.8,3471.9
4855354285,0,0,0,1,30,19,81,0,0,0,0,38431,11.2,41876,114,0,1065,2530,11.4,3843.1,1,0,0,18,29,44,0,0,0,0,37366,10.8,39346,102,0,-1065,-2530,10.2,3736.6
4855326374,1,17,4,1,22,26,54,0,0,0,0,36891,11.2,39460,114,0,1461,-147,11.4,3689.1,13,0,0,26,22,65,0,0,0,0,35430,11.0,39607,105,0,-1461,147,10.5,3543.0
4855301037,0,0,0,1,18,33,38,0,0,0,1,35753,10.6,37234,81,0,-4110,-5415,8.1,3575.3,0,0,0,33,18,65,0,0,0,0,39863,11.4,42649,118,0,4110,5415,11.8,3986.3
4855247740,0,20,3,1,4,4,5,0,0,0,0,15512,6.6,16764,195,40,-255,-2230,23.5,1551.2,14,3,0,4,4,3,1,1,0,0,15767,7.2,18994,214,64,255,2230,27.8,1576.7
4855166452,1,15,0,0,2,5,0,1,1,0,0,14317,7.0,18054,187,64,-1322,-27,25.1,1431.7,7,0,1,5,2,3,0,0,0,0,15639,7.0,18081,207,44,1322,27,25.1,1563.9
4851999909,1,16,1,0,3,3,7,1,1,0,0,15913,6.6,17579,213,52,-1445,-1446,26.5,1591.3,15,2,1,3,3,1,0,0,0,0,17358,7.0,19025,262,63,1445,1446,32.5,1735.8
4851960132,1,13,0,1,4,3,4,1,1,0,0,16252,7.2,18230,215,71,290,-19,28.6,1625.2,120,1,0,3,4,1,1,0,1,0,15962,7.0,18249,237,52,-290,19,28.9,1596.2
4815225265,1,12,1,1,6,4,6,1,1,0,0,17915,7.2,18969,239,68,2580,877,30.7,1791.5,13,1,0,4,6,3,0,0,0,0,15335,6.8,18092,217,72,-2580,-877,28.9,1533.5
4815163610,0,15,1,1,5,5,7,0,0,0,0,16197,6.8,17883,213,64,-398,-390,27.7,1619.7,13,3,0,5,5,4,0,0,0,0,16595,6.8,18273,239,60,398,390,29.9,1659.5
4813645329,1,15,3,1,10,3,7,1,1,0,0,19876,7.2,18775,202,60,5165,2226,26.2,1987.6,17,1,0,3,10,2,0,0,0,0,14711,6.8,16549,195,44,-5165,-2226,23.9,1471.1
4813636196,1,18,2,1,8,7,9,0,0,0,0,16697,6.8,17313,216,37,-159,905,25.3,1669.7,13,4,0,7,8,6,0,0,0,0,16856,6.6,16408,170,54,159,-905,22.4,1685.6
4813624918,1,12,2,1,10,2,9,0,0,0,0,20057,7.4,19681,255,63,6425,3597,31.8,2005.7,11,0,0,2,10,3,0,0,0,0,13632,6.4,16084,169,48,-6425,-3597,21.7,1363.2
4813613905,1,16,1,1,8,3,7,0,0,0,0,17812,7.0,18529,225,48,2109,2339,27.3,1781.2,14,2,0,3,8,3,0,0,0,0,15703,6.4,16190,191,52,-2109,-2339,24.3,1570.3
4798755130,0,10,0,0,11,8,12,0,0,0,0,17528,6.8,16748,178,44,-1,-909,22.2,1752.8,10,1,1,8,11,4,1,1,0,0,17529,6.8,17657,192,64,1,909,25.6,1752.9
4797582387,1,13,2,0,9,7,8,1,1,0,0,18013,6.4,16773,190,60,182,-1153,25.0,1801.3,24,0,1,7,9,4,0,0,0,0,17831,6.8,17926,220,48,-182,1153,26.8,1783.1
4797531150,1,11,3,1,5,5,6,0,0,0,0,15822,7.0,18333,236,55,-366,609,29.1,1582.2,10,0,0,4,4,5,0,0,0,0,16188,6.8,17724,239,48,366,-609,28.7,1618.8
4797513743,1,11,1,1,7,2,6,1,1,0,0,17027,7.0,18499,233,54,1878,1411,28.7,1702.7,13,0,0,2,7,2,0,0,0,0,15149,6.6,17088,241,55,-1878,-1411,29.6,1514.9
4797488338,1,12,1,1,6,6,8,0,0,0,0,16774,7.2,17488,229,55,445,-1029,28.4,1677.4,15,1,0,6,6,2,1,1,0,0,16329,7.0,18517,220,57,-445,1029,27.7,1632.9
4797456602,0,11,0,0,2,4,2,0,0,0,0,15152,7.0,18515,230,55,-1560,-532,28.5,1515.2,14,0,1,4,2,2,0,0,0,0,16712,7.2,19047,241,72,1560,532,31.3,1671.2
4797434465,0,56,1,0,3,7,4,0,0,0,0,15201,7.0,18234,202,67,-2441,-747,26.9,1520.1,13,3,1,7,3,5,1,1,0,0,17642,7.4,18981,218,67,2441,747,28.5,1764.2
4796967575,0,11,2,1,10,8,16,0,0,0,0,19320,6.6,16071,196,46,337,-1295,24.2,1932.0,15,2,0,8,10,12,1,1,0,0,18983,6.6,17366,208,49,-337,1295,25.7,1898.3
4796911734,1,13,13,1,11,4,14,1,0,1,0,19964,7.6,19785,242,60,3830,1293,30.2,1996.4,35,1,0,4,11,6,0,0,0,0,16134,7.2,18492,221,64,-3830,-1293,28.5,1613.4
4796879864,0,12,3,0,10,6,14,0,0,0,0,19496,6.8,18293,248,44,2084,168,29.2,1949.6,12,4,1,6,10,12,0,0,0,0,17412,7.0,18125,204,64,-2084,-168,26.8,1741.2
4792777499,1,17,0,1,3,4,4,1,1,0,0,15928,7.0,18201,222,52,253,990,27.4,1592.8,20,1,0,4,3,7,0,0,0,0,15675,6.8,17211,206,63,-253,-990,26.9,1567.5
4792754567,0,12,0,1,6,10,5,0,0,0,0,16814,6.4,17090,201,36,-1400,-1927,23.7,1681.4,9,1,0,10,6,5,0,0,0,0,18214,7.2,19017,209,68,1400,1927,27.7,1821.4
4858374975,1,13,0,1,6,3,5,0,0,0,0,17046,7.0,17611,233,56,1518,-311,28.9,1704.6,11,1,0,3,6,6,0,0,0,0,15528,7.0,17922,205,56,-1518,311,26.1,1552.8
4858325291,0,13,2,1,7,7,9,0,0,0,0,16721,6.6,16843,215,52,-627,-2733,26.7,1672.1,12,2,0,7,7,9,0,0,0,0,17348,7.4,19576,238,64,627,2733,30.2,1734.8
4858223732,1,10,2,0,12,9,13,0,0,0,0,18677,6.4,16552,204,48,-1575,-1414,25.2,1867.7,30,2,1,9,12,8,2,1,1,0,20252,7.0,17966,227,62,1575,1414,28.9,2025.2
4858184117,1,20,3,0,5,7,4,0,0,0,0,17114,7.0,18475,242,60,-352,539,30.2,1711.4,13,3,1,7,5,6,0,0,0,0,17466,7.0,17936,214,52,352,-539,26.6,1746.6
4858146077,0,13,1,0,2,5,1,0,0,0,0,14760,6.6,16582,220,52,-3085,-3774,27.2,1476.0,14,2,1,5,2,2,1,1,0,0,17845,7.8,20356,246,64,3085,3774,31.0,1784.5
4858106555,0,10,5,0,7,8,5,0,0,0,0,16817,6.6,17228,202,60,-1300,575,26.2,1681.7,16,2,1,8,7,9,0,0,0,0,18117,6.6,16653,211,36,1300,-575,24.7,1811.7
4858054445,0,37,5,0,4,6,3,1,0,1,0,15371,6.8,17287,189,44,-1555,-1107,23.3,1537.1,36,4,1,6,4,8,1,1,0,0,16926,7.2,18394,226,60,1555,1107,28.6,1692.6
4858030231,0,19,0,1,3,5,3,1,1,0,0,15685,7.0,17538,225,39,-643,531,26.4,1568.5,11,1,0,5,3,6,1,0,1,0,16328,6.8,17007,230,57,643,-531,28.7,1632.8
4858005705,0,14,1,1,2,5,2,0,0,0,0,14293,6.8,17480,210,31,-2485,-1756,24.1,1429.3,13,1,0,5,2,7,0,0,0,0,16778,7.0,19236,223,72,2485,1756,29.5,1677.8
4857979963,1,13,1,1,10,8,9,0,0,0,0,18681,6.8,17474,187,48,2172,1430,23.5,1868.1,15,0,0,7,9,4,0,0,0,0,16509,6.4,16044,191,36,-2172,-1430,22.7,1650.9
4857667983,1,0,0,0,14,13,13,0,0,0,0,45250,10.0,47500,0,0,18100,17820,0.0,4525.0,0,0,1,6,7,7,0,0,0,0,27150,6.2,29680,0,0,-18100,-17820,0.0,2715.0
4857530873,1,0,0,1,18,22,17,0,0,0,0,63420,12.0,55000,0,0,25449,22000,0.0,6342.0,31,0,0,13,9,13,0,0,0,0,37971,7.2,33000,0,0,-25449,-22000,0.0,3797.1
4857246710,1,0,0,1,11,17,17,0,0,0,0,45600,10.2,48680,0,0,18100,20180,0.0,4560.0,0,0,0,13,7,9,0,0,0,0,27500,6.0,28500,0,0,-18100,-20180,0.0,2750.0
4857232069,1,4,0,0,12,21,14,0,0,0,0,61137,12.2,56000,0,0,22887,23000,0.0,6113.7,0,0,1,15,6,12,0,0,0,0,38250,7.2,33000,0,0,-22887,-23000,0.0,3825.0
4856601439,1,4,0,1,21,9,23,0,0,0,0,63247,12.0,55000,2,0,26968,22000,0.2,6324.7,540,0,0,5,17,3,0,0,0,0,36279,7.2,33000,2,0,-26968,-22000,0.2,3627.9
4856593136,1,40,0,1,14,17,17,0,0,0,0,48050,10.6,50500,0,0,20200,22000,0.0,4805.0,0,0,0,12,9,5,0,0,0,0,27850,6.0,28500,0,0,-20200,-22000,0.0,2785.0
4856580242,1,0,0,1,17,14,16,0,0,0,0,47075,10.2,48680,0,0,20200,20180,0.0,4707.5,0,0,0,8,11,5,0,0,0,0,26875,6.0,28500,0,0,-20200,-20180,0.0,2687.5
4856568034,1,0,0,0,13,15,18,0,0,0,0,45975,10.6,50500,1,0,18825,22000,0.1,4597.5,0,0,1,10,8,6,0,0,0,0,27150,6.0,28500,0,0,-18825,-22000,0.0,2715.0
4856543637,1,0,0,1,13,18,11,0,0,0,0,45250,10.2,48680,5,0,16700,20180,0.5,4525.0,0,0,0,12,7,12,0,0,0,0,28550,6.0,28500,2,0,-16700,-20180,0.2,2855.0
4856525695,1,29,1,0,12,21,14,0,0,0,0,46925,10.0,47500,8,0,17630,19000,0.8,4692.5,15,4,1,14,5,12,0,0,0,0,29295,6.0,28500,1,0,-17630,-19000,0.1,2929.5
4857729492,0,15,0,0,13,8,10,0,0,0,0,19411,6.8,17327,202,40,2493,1861,24.2,1941.1,14,2,1,8,13,6,1,1,0,0,16918,6.2,15466,172,56,-2493,-1861,22.8,1691.8
4856644982,0,10,1,1,3,7,3,0,0,0,0,16711,7.0,18527,249,63,-1748,788,31.2,1671.1,15,0,0,7,3,9,2,1,1,0,18459,7.0,17739,205,57,1748,-788,26.2,1845.9
4856561878,0,12,0,0,7,10,10,0,0,0,0,17409,6.4,16338,190,40,-3116,-7,23.0,1740.9,16,2,1,10,7,14,0,0,0,0,20525,6.4,16345,192,31,3116,7,22.3,2052.5
4855356622,1,53,0,0,4,3,5,1,1,0,0,17204,7.4,19894,215,80,1114,2150,29.5,1720.4,16,1,1,3,4,3,0,0,0,0,16090,6.8,17744,225,56,-1114,-2150,28.1,1609.0
4855320935,0,11,1,0,5,11,5,1,1,0,0,16606,7.0,18315,212,67,-2812,158,27.9,1660.6,8,0,1,11,5,10,0,0,0,0,19418,6.6,18157,221,48,2812,-158,26.9,1941.8
4855257354,0,16,0,1,11,6,17,0,0,0,0,20114,6.6,17565,202,40,2598,155,24.2,2011.4,13,1,0,6,11,5,0,0,0,0,17516,6.8,17410,221,44,-2598,-155,26.5,1751.6
4840536300,1,12,4,1,9,5,11,1,1,0,0,18200,6.8,17697,203,52,2047,871,25.5,1820.0,12,3,0,5,9,5,0,0,0,0,16153,6.8,16826,209,44,-2047,-871,25.3,1615.3
4837505782,1,13,1,0,6,4,7,0,0,0,0,18092,6.8,18143,223,49,833,37,27.2,1809.2,14,1,1,4,6,3,0,0,0,0,17259,6.8,18106,224,60,-833,-37,28.4,1725.9
4837488135,1,133,0,1,10,7,11,1,1,0,0,18303,6.6,17062,235,40,1809,215,27.5,1830.3,10,1,0,6,9,7,0,0,0,0,16494,6.8,16847,183,47,-1809,-215,23.0,1649.4
4818200066,0,13,0,0,3,10,4,0,0,0,0,15360,6.8,16966,191,56,-4041,-2432,24.7,1536.0,11,2,1,10,3,9,0,0,0,0,19401,7.2,19398,241,60,4041,2432,30.1,1940.1
4818174840,0,15,1,0,6,9,7,0,0,0,0,15687,6.4,15863,175,52,-3467,-2193,22.7,1568.7,15,1,1,9,6,10,1,1,0,0,19154,6.8,18056,215,67,3467,2193,28.2,1915.4
4816091456,1,13,0,1,34,23,80,0,0,0,0,41480,12.0,46382,94,75,2243,3744,16.9,4148.0,12,0,0,23,34,45,0,0,0,0,39237,11.4,42638,97,59,-2243,-3744,15.6,3923.7
4816050585,0,15,4,1,5,4,5,0,0,0,0,17617,7.0,17992,236,60,2585,-132,29.6,1761.7,13,2,0,4,5,2,0,0,0,0,15032,7.0,18124,197,48,-2585,132,24.5,1503.2
4804810884,1,19,4,1,9,4,9,0,0,0,0,17877,6.4,16525,227,47,2676,331,27.4,1787.7,13,3,0,4,9,5,0,0,0,0,15201,6.6,16194,170,56,-2676,-331,22.6,1520.1
4804789346,1,15,3,0,3,2,3,0,0,0,0,15449,7.0,17701,227,60,576,342,28.7,1544.9,10,2,1,2,3,3,0,0,0,0,14873,6.8,17359,237,40,-576,-342,27.7,1487.3
4804760509,1,14,2,0,8,4,10,0,0,0,0,18173,7.2,18912,258,56,3145,1868,31.4,1817.3,15,2,1,4,8,4,0,0,0,0,15028,6.6,17044,194,57,-3145,-1868,25.1,1502.8
4804746345,1,15,1,1,9,3,11,0,0,0,0,18978,7.0,18812,228,64,4423,1299,29.2,1897.8,140,1,0,3,9,1,0,0,0,0,14555,7.0,17513,204,64,-4423,-1299,26.8,1455.5
4802987327,0,33,0,0,9,7,14,0,0,0,0,17156,6.6,16619,195,60,70,-43,25.5,1715.6,32,1,1,7,9,12,2,1,1,0,17086,6.8,16662,174,56,-70,43,23.0,1708.6
4802944209,0,32,0,0,2,4,4,0,0,0,0,15152,6.4,16401,217,52,-2815,-2430,26.9,1515.2,33,1,1,4,2,6,0,0,0,0,17967,7.2,18831,197,59,2815,2430,25.6,1796.7
4794426447,1,9,4,1,6,4,8,1,1,0,0,16129,6.6,16152,203,45,556,-991,24.8,1612.9,27,0,0,4,6,4,0,0,0,0,15573,6.8,17143,183,50,-556,991,23.3,1557.3
4857539832,1,0,0,1,15,16,16,0,0,0,0,42711,10.0,47500,0,0,12400,19000,0.0,4271.1,288,0,0,9,8,9,0,0,0,0,30311,6.0,28500,0,0,-12400,-19000,0.0,3031.1
4857519195,1,1,0,0,17,14,15,0,0,0,0,47760,10.0,47500,15,0,20260,19000,1.5,4776.0,0,0,1,7,10,8,0,0,0,0,27500,6.0,28500,1,0,-20260,-19000,0.1,2750.0
4857502748,1,0,0,0,19,18,17,0,0,0,0,47350,10.4,49000,0,0,17400,20500,0.0,4735.0,0,0,1,10,11,9,0,0,0,0,29950,6.0,28500,0,0,-17400,-20500,0.0,2995.0
4856111323,1,0,5,1,15,13,19,0,0,0,0,46325,10.0,47500,0,0,18505,19000,0.0,4632.5,32,3,0,8,10,5,0,0,0,0,27820,6.0,28500,12,0,-18505,-19000,1.2,2782.0
4856080524,1,0,0,0,20,17,23,0,0,0,0,48200,10.0,47500,11,0,20000,19000,1.1,4820.0,0,0,1,10,13,9,0,0,0,0,28200,6.0,28500,4,0,-20000,-19000,0.4,2820.0
4856064013,1,0,0,0,14,19,17,0,0,0,0,61453,12.0,55000,0,0,24184,22000,0.0,6145.3,0,0,1,13,8,10,0,0,0,0,37269,7.2,33000,0,0,-24184,-22000,0.0,3726.9
4856039205,1,19,1,0,21,18,15,0,0,0,0,62710,12.0,55000,1,0,24110,22000,0.1,6271.0,0,0,1,9,12,11,0,0,0,0,38600,7.2,33000,0,0,-24110,-22000,0.0,3860.0
4856008576,1,0,0,1,19,19,27,0,0,0,0,63050,12.0,55000,0,0,26200,22000,0.0,6305.0,0,0,0,13,13,6,0,0,0,0,36850,7.2,33000,0,0,-26200,-22000,0.0,3685.0
4855987704,1,0,0,0,14,24,19,0,0,0,0,46300,10.0,47500,0,0,16700,19000,0.0,4630.0,0,0,1,18,8,12,0,0,0,0,29600,6.0,28500,0,0,-16700,-19000,0.0,2960.0
4853229050,1,0,0,0,17,19,16,0,0,0,0,47136,10.0,47500,5,0,18366,19000,0.5,4713.6,1,0,1,12,10,13,0,0,0,0,28770,6.0,28500,2,0,-18366,-19000,0.2,2877.0
4853216727,1,0,0,1,23,13,22,0,0,0,0,48750,10.2,48680,0,0,21600,20180,0.0,4875.0,0,0,0,5,15,5,0,0,0,0,27150,6.0,28500,0,0,-21600,-20180,0.0,2715.0
4853215941,1,0,0,1,25,15,19,0,0,0,0,63750,12.0,55000,1,0,28300,22000,0.1,6375.0,0,0,0,4,14,5,0,0,0,0,35450,7.2,33000,2,0,-28300,-22000,0.2,3545.0
4853206797,1,31,7,0,19,14,19,0,0,0,0,46785,10.0,47500,3,0,18900,19000,0.3,4678.5,0,2,1,8,13,9,0,0,0,0,27885,6.0,28500,0,0,-18900,-19000,0.0,2788.5
4853190323,1,35,2,1,21,20,17,0,0,0,0,64028,12.0,55000,5,0,26808,22000,0.5,6402.8,4,4,0,13,14,13,0,0,0,0,37220,7.2,33000,0,0,-26808,-22000,0.0,3722.0
4852825961,1,13,7,1,22,20,17,0,0,0,0,48435,10.0,47500,0,0,16535,19000,0.0,4843.5,33,0,0,11,13,12,0,0,0,0,31900,6.0,28500,8,0,-16535,-19000,0.8,3190.0
4852794422,1,5,12,1,24,18,17,0,0,0,0,48694,10.4,49000,0,0,19614,19320,0.0,4869.4,34,0,0,9,15,10,0,0,0,0,29080,6.2,29680,6,0,-19614,-19320,0.6,2908.0
4852765300,1,0,0,1,20,22,14,0,0,0,0,46650,10.0,47500,0,0,18100,19000,0.0,4665.0,0,0,0,9,7,13,0,0,0,0,28550,6.0,28500,0,0,-18100,-19000,0.0,2855.0
4852744794,1,95,0,1,18,18,16,0,0,0,0,60986,12.0,55000,8,0,23361,22000,0.8,6098.6,0,0,0,10,10,12,0,0,0,0,37625,7.2,33000,6,0,-23361,-22000,0.6,3762.5
4852709968,1,297,0,1,21,16,21,0,0,0,0,62080,12.0,55000,9,0,24780,22000,0.9,6208.0,100,0,0,9,14,10,0,0,0,0,37300,7.2,33000,9,0,-24780,-22000,0.9,3730.0
4852685689,1,24,0,1,23,13,18,0,0,0,0,63540,12.0,55000,1,0,27030,22000,0.1,6354.0,0,0,0,5,15,10,0,0,0,0,36510,7.2,33000,0,0,-27030,-22000,0.0,3651.0
4838871278,0,13,2,0,9,4,10,0,0,0,0,17635,7.0,17539,215,56,483,-1079,27.1,1763.5,11,3,1,3,8,2,2,1,1,0,17152,7.0,18618,219,54,-483,1079,27.3,1715.2
4838843060,0,25,1,1,11,6,11,0,0,0,0,18823,7.0,18627,225,42,1481,921,26.7,1882.3,10,1,0,6,11,11,1,1,0,0,17342,7.0,17706,196,72,-1481,-921,26.8,1734.2
4837425865,0,14,0,1,5,4,7,0,0,0,0,16119,7.0,18555,192,76,388,-813,26.8,1611.9,12,1,0,4,5,0,1,1,0,0,15731,7.2,19368,241,64,-388,813,30.5,1573.1
4837404017,0,28,1,1,6,5,7,0,0,0,0,17451,6.8,17324,214,40,1561,-1619,25.4,1745.1,10,0,0,5,6,1,0,0,0,0,15890,7.0,18943,216,63,-1561,1619,27.9,1589.0
4832612343,1,9,0,0,5,3,6,1,1,0,0,16561,7.2,18396,224,60,1073,456,28.4,1656.1,13,0,1,3,5,0,0,0,0,0,15488,6.8,17940,222,56,-1073,-456,27.8,1548.8
4822593762,1,42,0,1,8,0,7,0,0,0,0,17942,7.2,18852,218,64,3873,1939,28.2,1794.2,13,3,0,0,8,0,0,0,0,0,14069,6.8,16913,218,52,-3873,-1939,27.0,1406.9
4810620914,1,13,1,0,6,5,8,1,0,1,0,17026,6.8,18582,217,72,-1313,1166,28.9,1702.6,13,2,1,5,6,6,1,1,0,0,18339,7.0,17416,216,64,1313,-1166,28.0,1833.9
4810592965,1,9,0,0,3,7,3,1,0,1,0,15017,7.0,17839,215,60,-3554,-1630,27.5,1501.7,9,0,1,7,3,7,0,0,0,0,18571,7.2,19469,252,72,3554,1630,32.4,1857.1
4806121308,0,15,0,1,4,3,3,0,0,0,0,15786,7.0,17295,213,63,-384,-1140,27.6,1578.6,11,3,0,3,4,2,1,1,0,0,16170,7.0,18435,246,70,384,1140,31.6,1617.0
4806088219,1,11,0,1,10,6,12,0,0,0,0,18881,6.8,18936,216,72,3597,2731,28.8,1888.1,7,2,0,6,10,10,1,1,0,0,15284,6.4,16205,189,56,-3597,-2731,24.5,1528.4
4802017074,0,71,1,0,2,5,3,0,0,0,0,14502,6.6,16717,197,44,-3910,-1903,24.1,1450.2,11,2,1,5,2,5,2,1,1,0,18412,6.8,18620,219,76,3910,1903,29.5,1841.2
4801988233,1,35,1,0,7,3,3,0,0,0,0,17043,7.0,18437,225,60,1403,1571,28.5,1704.3,35,4,1,3,7,3,0,0,0,0,15640,6.6,16866,196,52,-1403,-1571,24.8,1564.0
4801951835,0,33,4,1,5,5,6,0,0,0,0,16713,7.2,19104,234,60,-713,-458,29.4,1671.3,36,2,0,5,5,1,1,1,0,0,17426,7.4,19562,225,62,713,458,28.7,1742.6
4800940567,0,15,0,0,4,5,2,0,0,0,0,16591,7.2,18849,241,64,-784,510,30.5,1659.1,122,0,1,5,4,5,1,1,0,0,17375,7.0,18339,220,60,784,-510,28.0,1737.5
4800559387,1,12,2,1,10,3,8,1,1,0,0,19102,7.2,19069,249,64,3091,1398,31.3,1910.2,16,0,0,3,10,2,0,0,0,0,16011,7.0,17671,233,52,-3091,-1398,28.5,1601.1
4800517157,0,12,1,1,5,7,3,1,0,1,0,16585,7.0,18007,225,64,-650,-1524,28.9,1658.5,7,1,0,7,5,4,0,0,0,0,17235,7.4,19531,227,64,650,1524,29.1,1723.5
4800492876,1,10,0,1,6,4,5,0,0,0,0,18037,7.0,18106,224,60,2089,1725,28.4,1803.7,17,0,0,4,6,5,0,0,0,0,15948,6.6,16381,206,58,-2089,-1725,26.4,1594.8
4800461016,0,16,0,0,2,4,0,0,0,0,0,14346,7.0,18220,235,63,-1768,-540,29.8,1434.6,11,0,1,3,1,4,1,0,1,0,16114,7.2,18760,238,76,1768,540,31.4,1611.4
4800428922,1,10,1,1,8,1,7,0,0,0,0,18959,7.2,19296,249,56,3796,942,30.5,1895.9,12,1,0,1,8,1,0,0,0,0,15163,6.8,18354,224,52,-3796,-942,27.6,1516.3
4858362107,1,10,0,1,10,4,11,1,1,0,0,19050,7.0,17388,207,42,4928,1176,24.9,1905.0,8,0,0,3,9,2,0,0,0,0,14122,6.4,16212,178,54,-4928,-1176,23.2,1412.2
4858331789,0,19,0,1,5,2,3,0,0,0,0,16058,7.2,18456,216,60,1137,-93,27.6,1605.8,44,0,0,2,5,1,0,0,0,0,14921,7.0,18549,198,56,-1137,93,25.4,1492.1
4858285332,0,0,0,0,21,21,44,0,0,0,0,34797,10.8,39525,108,0,-547,660,10.8,3479.7,0,0,1,21,21,64,0,0,0,0,35344,11.0,38865,89,0,547,-660,8.9,3534.4
4858244970,0,2,23,0,34,39,89,0,0,0,0,39735,12.0,46107,92,0,-2948,-1035,9.2,3973.5,25,1,1,39,34,112,0,0,0,0,42683,12.0,47142,120,0,2948,1035,12.0,4268.3
4858212140,1,0,0,1,31,34,86,0,0,0,1,39457,12.0,45557,96,0,-1290,891,9.6,3945.7,27,0,0,34,31,87,0,0,0,0,40747,11.6,44666,92,0,1290,-891,9.2,4074.7
4857507451,1,0,0,1,17,14,18,0,0,0,0,63412,12.2,56000,0,0,27612,23000,0.0,6341.2,0,0,0,9,12,8,0,0,0,0,35800,7.2,33000,0,0,-27612,-23000,0.0,3580.0
4857483661,1,4,0,1,15,17,20,0,0,0,0,45600,10.0,47500,0,0,18060,19000,0.0,4560.0,0,0,0,11,9,8,0,0,0,0,27540,6.0,28500,0,0,-18060,-19000,0.0,2754.0
4857467116,1,0,0,0,12,19,13,0,0,0,0,44900,10.0,47500,0,0,15300,19000,0.0,4490.0,0,0,1,13,6,15,0,0,0,0,29600,6.0,28500,0,0,-15300,-19000,0.0,2960.0
4857443009,1,12,0,1,15,22,19,0,0,0,0,62887,12.0,55000,0,0,24963,22000,0.0,6288.7,0,0,0,17,10,9,0,0,0,0,37924,7.2,33000,0,0,-24963,-22000,0.0,3792.4
4857417583,1,77,0,1,18,17,23,0,0,0,0,62012,12.0,55000,0,0,23397,22000,0.0,6201.2,2,0,0,11,12,9,0,0,0,0,38615,7.2,33000,0,0,-23397,-22000,0.0,3861.5
4857393491,1,23,2,1,15,17,19,0,0,0,0,62020,13.6,63000,2,0,25490,30000,0.2,6202.0,0,2,0,11,9,7,0,0,0,0,36530,7.2,33000,3,0,-25490,-30000,0.3,3653.0
4857158385,1,0,0,1,29,25,84,0,0,0,1,39056,11.6,42937,109,0,2237,2173,10.9,3905.6,0,0,0,25,29,60,0,0,0,0,36819,11.2,40764,76,0,-2237,-2173,7.6,3681.9
4857138181,1,0,0,0,36,24,87,0,0,0,1,40826,12.0,45895,98,0,3281,3913,9.8,4082.6,0,0,1,24,36,60,0,0,0,0,37545,11.2,41982,91,0,-3281,-3913,9.1,3754.5
4857106190,0,0,20,0,30,24,94,0,0,0,1,38137,11.2,42099,85,0,107,1254,8.5,3813.7,55,0,1,24,30,58,0,0,0,0,38030,11.2,40845,116,0,-107,-1254,11.6,3803.0
4857080393,0,89,0,1,27,26,64,0,0,0,1,39885,11.8,44410,132,0,2017,3263,13.2,3988.5,0,0,0,26,27,62,0,0,0,0,37868,11.0,41147,97,0,-2017,-3263,9.7,3786.8
4857028524,1,14,3,1,4,5,7,0,0,0,0,17354,7.0,18231,249,56,1296,-421,30.5,1735.4,12,3,0,5,4,5,0,0,0,0,16058,7.0,18652,218,68,-1296,421,28.6,1605.8
4857009878,1,16,0,1,18,19,17,0,0,0,0,46303,10.0,47500,1,0,18103,19000,0.1,4630.3,0,0,0,11,10,10,0,0,0,0,28200,6.0,28500,0,0,-18103,-19000,0.0,2820.0
4856492026,1,5,0,1,19,18,16,0,0,0,0,46300,10.0,47500,0,0,17710,17820,0.0,4630.0,0,0,0,8,9,12,0,0,0,0,28590,6.2,29680,0,0,-17710,-17820,0.0,2859.0
4856390436,0,11,1,0,7,4,4,0,0,0,0,17824,7.2,19037,233,59,455,907,29.2,1782.4,74,1,1,4,7,1,1,1,0,0,17369,7.0,18130,215,64,-455,-907,27.9,1736.9
4856338172,1,13,3,1,7,5,10,1,1,0,0,17707,6.8,17815,246,54,805,-1327,30.0,1770.7,13,1,0,5,7,5,0,0,0,0,16902,7.4,19142,245,48,-805,1327,29.3,1690.2
4828752576,0,13,1,1,3,4,4,0,0,0,0,16406,7.0,18175,237,50,-14,-408,28.7,1640.6,15,0,0,4,3,3,0,0,0,0,16420,7.2,18583,228,65,14,408,29.3,1642.0
4828715951,1,16,2,1,12,10,12,0,0,0,0,21031,7.2,18667,240,48,2836,1638,28.8,2103.1,14,4,0,10,12,6,0,0,0,0,18195,6.6,17029,188,64,-2836,-1638,25.2,1819.5
4828464476,1,13,2,1,14,4,15,0,0,0,0,20705,7.0,19429,239,68,5473,2017,30.7,2070.5,13,1,0,4,14,4,1,1,0,0,15232,6.8,17412,197,68,-5473,-2017,26.5,1523.2
4828182163,0,11,0,1,6,7,12,0,0,0,0,17510,7.0,18528,252,68,245,303,32.0,1751.0,14,0,0,7,6,7,1,1,0,0,17265,7.0,18225,215,52,-245,-303,26.7,1726.5
4827710362,0,16,2,1,5,7,5,1,1,0,0,16786,7.0,18369,224,52,-287,378,27.6,1678.6,13,2,0,7,5,6,0,0,0,0,17073,7.0,17991,205,71,287,-378,27.6,1707.3
4827640630,1,11,1,0,5,6,8,0,0,0,0,16041,6.8,16345,204,44,-1261,-1563,24.8,1604.1,13,0,1,6,5,8,0,0,0,0,17302,7.0,17908,245,63,1261,1563,30.8,1730.2
4827591598,0,12,2,1,5,3,5,1,1,0,0,18010,6.8,17999,205,60,2345,-598,26.5,1801.0,13,0,0,3,5,3,0,0,0,0,15665,7.0,18597,216,72,-2345,598,28.8,1566.5
4827573109,0,10,2,0,1,11,0,1,0,1,0,13164,6.2,15031,191,39,-5474,-3980,23.0,1316.4,14,2,1,11,1,13,1,1,0,0,18638,7.0,19011,217,68,5474,3980,28.5,1863.8
4825416307,1,11,2,0,5,9,3,1,0,1,0,17749,6.8,18302,238,68,-758,-1113,30.6,1774.9,14,0,1,9,5,12,1,1,0,0,18507,7.0,19415,252,67,758,1113,31.9,1850.7
4825394011,0,30,4,0,1,2,1,1,0,1,0,15240,7.0,17616,234,60,-1672,-3207,29.4,1524.0,15,4,1,2,1,3,0,0,0,0,16912,7.6,20823,257,64,1672,3207,32.1,1691.2
4825280464,1,10,1,1,9,3,13,0,0,0,0,18168,6.8,17834,248,50,1556,92,29.8,1816.8,12,1,0,3,9,3,0,0,0,0,16612,6.8,17742,238,45,-1556,-92,28.3,1661.2
4825260591,1,11,0,0,5,5,7,1,1,0,0,16400,7.0,18264,228,69,75,-172,29.7,1640.0,12,1,1,5,5,1,1,0,1,0,16325,7.0,18436,221,58,-75,172,27.9,1632.5
4804434942,1,12,1,1,8,5,11,1,0,1,0,18370,7.0,18416,213,52,1202,260,26.5,1837.0,11,0,0,5,8,6,0,0,0,0,17168,7.0,18156,217,60,-1202,-260,27.7,1716.8
4804196179,1,17,1,0,6,3,6,1,0,1,0,16740,7.2,18410,221,60,481,-547,28.1,1674.0,11,1,1,3,6,4,0,0,0,0,16259,7.2,18957,233,56,-481,547,28.9,1625.9
4804146398,1,11,3,1,8,2,5,0,0,0,0,17418,6.8,17518,211,44,3307,1497,25.5,1741.8,14,0,0,2,8,0,0,0,0,0,14111,6.6,16021,195,56,-3307,-1497,25.1,1411.1
4798054599,0,10,3,1,7,14,7,0,0,0,0,16759,6.6,16424,215,35,-4483,-2492,25.0,1675.9,17,5,0,14,7,14,0,0,0,0,21242,7.0,18916,225,68,4483,2492,29.3,2124.2
4798033659,0,14,3,0,3,10,3,0,0,0,0,14640,6.6,16550,167,55,-4846,-3665,22.2,1464.0,18,1,1,10,3,8,0,0,0,0,19486,7.4,20215,275,68,4846,3665,34.3,1948.6
4798019235,1,18,0,1,8,4,11,0,0,0,0,18281,7.0,17945,217,60,2210,1680,27.7,1828.1,28,2,0,4,8,5,0,0,0,0,16071,6.6,16265,194,64,-2210,-1680,25.8,1607.1
4797981607,0,165,0,0,4,8,6,0,0,0,0,14898,6.8,16259,199,56,-3881,-1244,25.5,1489.8,35,0,1,8,4,8,1,0,1,0,18779,6.8,17503,207,48,3881,1244,25.5,1877.9
4797813493,0,22,1,0,9,7,17,0,0,0,0,19938,7.0,18170,232,59,2520,1478,29.1,1993.8,7,1,1,7,9,13,0,0,0,0,17418,6.6,16692,197,48,-2520,-1478,24.5,1741.8
4852790684,1,13,0,0,8,2,4,0,0,0,0,17725,7.4,19876,226,67,2184,2080,29.3,1772.5,12,0,1,2,8,3,0,0,0,0,15541,6.8,17796,223,60,-2184,-2080,28.3,1554.1
4851624506,0,16,3,0,7,4,2,0,0,0,0,16675,7.0,17671,207,48,63,-745,25.5,1667.5,9,4,1,4,7,4,1,1,0,0,16612,7.0,18416,187,47,-63,745,23.4,1661.2
4851563478,1,69,0,1,8,7,9,0,0,0,0,17301,6.8,17131,195,46,1077,191,24.1,1730.1,10,2,0,7,8,7,0,0,0,0,16224,6.4,16940,220,42,-1077,-191,26.2,1622.4
4851057320,1,10,1,1,6,0,8,0,0,0,0,16157,6.6,17523,209,44,1530,430,25.3,1615.7,12,0,0,0,6,0,0,0,0,0,14627,6.8,17093,231,64,-1530,-430,29.5,1462.7
4850949539,0,11,0,0,6,2,6,1,1,0,0,15793,6.6,17522,192,46,-261,-976,23.8,1579.3,12,0,1,2,6,2,0,0,0,0,16054,7.0,18498,238,57,261,976,29.5,1605.4
4849587449,0,23,1,1,10,2,10,0,0,0,0,19090,7.0,18968,215,76,4834,1426,29.1,1909.0,14,1,0,2,10,2,0,0,0,0,14256,6.8,17542,191,68,-4834,-1426,25.9,1425.6
4849574925,0,25,2,0,7,4,4,0,0,0,0,15933,6.8,17082,179,40,-448,-591,21.9,1593.3,13,1,1,4,7,2,0,0,0,0,16381,7.0,17673,218,56,448,591,27.4,1638.1
4849549579,1,16,2,0,5,2,7,1,1,0,0,17099,7.0,17691,208,52,3693,2476,26.0,1709.9,10,3,1,2,5,1,0,0,0,0,13406,6.2,15215,180,48,-3693,-2476,22.8,1340.6
4840854143,0,0,0,1,26,25,54,0,0,0,1,37044,11.0,40417,100,0,-2296,-3685,10.0,3704.4,0,0,0,25,26,44,0,0,0,0,39340,11.6,44102,109,0,2296,3685,10.9,3934.0
4840835386,1,0,0,0,26,24,71,0,0,0,1,39541,11.4,43625,106,0,3863,2856,10.6,3954.1,81,0,1,24,26,44,0,0,0,0,35678,11.4,40769,107,0,-3863,-2856,10.7,3567.8
4840818523,0,24,0,0,17,22,32,0,0,0,1,34912,10.8,38691,104,0,-2868,-2007,10.4,3491.2,3,21,1,22,17,70,0,0,0,0,37780,11.2,40698,105,0,2868,2007,10.5,3778.0
4840807913,0,0,0,0,22,23,44,0,0,0,0,35797,10.6,37759,113,0,-1702,-4761,11.3,3579.7,14,0,1,22,21,42,0,0,0,0,37499,11.4,42520,108,0,1702,4761,10.8,3749.9
4839657817,0,9,0,0,0,3,0,0,0,0,0,13678,6.6,16802,217,48,-2543,-1603,26.5,1367.8,12,0,1,3,0,1,0,0,0,0,16221,6.8,18405,204,56,2543,1603,26.0,1622.1
4839375771,0,58,3,0,3,3,3,0,0,0,0,14503,6.8,16266,189,52,-1873,-2285,24.1,1450.3,10,1,1,3,3,2,1,1,0,0,16376,7.2,18551,219,72,1873,2285,29.1,1637.6
4839312655,0,21,1,1,6,6,2,0,0,0,0,17133,7.2,19163,223,52,743,2243,27.5,1713.3,13,1,0,6,6,7,0,0,0,0,16390,6.8,16920,205,52,-743,-2243,25.7,1639.0
4839261492,0,14,1,0,2,6,2,0,0,0,0,14980,7.0,18204,201,64,-1965,1189,26.5,1498.0,12,0,1,6,2,10,0,0,0,0,16945,6.8,17015,218,44,1965,-1189,26.2,1694.5
4839189616,1,10,0,0,2,5,3,1,1,0,0,14217,6.6,17006,201,40,-1507,-659,24.1,1421.7,12,0,1,5,2,1,1,0,1,0,15724,6.6,17665,228,72,1507,659,30.0,1572.4
4839119070,0,9,1,1,5,4,7,0,0,0,0,17712,6.8,17838,234,40,347,-814,27.4,1771.2,11,0,0,4,5,6,0,0,0,0,17365,7.2,18652,225,64,-347,814,28.9,1736.5
4838971991,1,12,3,1,8,4,7,0,0,0,0,18152,6.8,17391,193,62,242,-796,25.5,1815.2,14,2,0,4,8,5,1,1,0,0,17910,7.0,18187,201,42,-242,796,24.3,1791.0
4838943297,1,12,1,0,6,5,8,0,0,0,0,16602,7.2,18693,219,44,897,1532,26.3,1660.2,10,0,1,5,6,3,1,0,1,0,15705,6.8,17161,185,48,-897,-1532,23.3,1570.5
4851298999,1,22,0,0,4,4,3,1,1,0,0,16169,7.0,18579,225,59,-740,-1043,28.4,1616.9,11,0,1,4,4,1,1,0,1,0,16909,7.2,19622,238,58,740,1043,29.6,1690.9
4851281152,0,14,4,0,2,5,2,0,0,0,0,14497,6.8,17039,206,52,-3093,-2040,25.8,1449.7,13,2,1,5,2,4,1,1,0,0,17590,7.2,19079,244,68,3093,2040,31.2,1759.0
4851267709,1,13,2,0,7,7,7,1,0,1,0,17224,6.6,16238,198,35,323,-915,23.3,1722.4,13,0,1,7,7,5,0,0,0,0,16901,6.6,17153,192,52,-323,915,24.4,1690.1
4851239732,0,11,1,0,6,9,4,0,0,0,0,16051,7.0,17752,225,63,-1978,-556,28.8,1605.1,14,4,1,9,6,6,1,1,0,0,18029,7.0,18308,239,62,1978,556,30.1,1802.9
4851231686,0,10,0,0,5,13,2,0,0,0,0,15449,6.0,14149,125,47,-4948,-5140,17.2,1544.9,12,1,1,13,5,8,0,0,0,0,20397,7.0,19289,230,56,4948,5140,28.6,2039.7
4851228924,1,14,0,0,11,8,13,1,1,0,0,19710,7.2,19403,201,80,2442,3031,28.1,1971.0,12,0,1,8,11,7,1,0,1,0,17268,6.6,16372,195,56,-2442,-3031,25.1,1726.8
4851224931,0,22,2,1,9,7,9,0,0,0,0,18590,6.8,18196,225,56,592,624,28.1,1859.0,14,0,0,7,9,8,0,0,0,0,17998,7.0,17572,184,60,-592,-624,24.4,1799.8
4851217421,1,15,2,0,10,4,8,0,0,0,0,19235,7.0,18646,222,53,4007,3440,27.5,1923.5,15,3,1,4,10,5,0,0,0,0,15228,6.4,15206,171,48,-4007,-3440,21.9,1522.8
4851174186,1,16,0,0,8,5,9,0,0,0,0,21175,7.6,19970,252,72,5129,2885,32.4,2117.5,10,0,1,5,8,5,1,1,0,0,16046,6.8,17085,204,52,-5129,-2885,25.6,1604.6
4851158869,0,14,5,1,6,5,3,0,0,0,0,16652,7.2,18665,214,64,-460,416,27.8,1665.2,96,0,0,5,6,4,1,1,0,0,17112,7.0,18249,212,52,460,-416,26.4,1711.2
4851137649,0,10,3,1,12,15,10,0,0,0,0,17894,6.4,15234,177,40,-3209,-2544,21.7,1789.4,53,4,0,15,12,22,1,0,1,0,21103,6.8,17778,206,60,3209,2544,26.6,2110.3
4851115457,1,16,2,0,7,4,4,1,1,0,0,16979,6.8,17349,201,68,1027,1168,26.9,1697.9,13,0,1,4,7,4,1,0,1,0,15952,6.4,16181,220,36,-1027,-1168,25.6,1595.2
4850893333,1,22,2,0,12,5,16,1,0,1,0,18710,6.8,17982,195,59,618,220,25.4,1871.0,24,2,1,5,12,4,0,0,0,0,18092,6.6,17762,236,40,-618,-220,27.6,1809.2
4850081480,0,56,1,1,5,8,6,0,0,0,0,15751,6.8,17082,185,48,-4188,-3292,23.3,1575.1,13,1,0,8,5,7,0,0,0,0,19939,7.6,20374,250,68,4188,3292,31.8,1993.9
4850036236,0,14,1,1,2,4,7,1,1,0,0,15331,6.8,17581,206,71,-1761,-1953,27.7,1533.1,12,1,0,4,2,3,0,0,0,0,17092,7.2,19534,279,56,1761,1953,33.5,1709.2
4849990464,0,43,2,0,3,5,3,0,0,0,0,16482,7.2,19242,235,63,-1526,-551,29.8,1648.2,32,0,1,5,3,4,1,1,0,0,18008,7.4,19793,246,72,1526,551,31.8,1800.8
4849878782,0,16,3,1,2,3,2,1,1,0,0,14923,6.6,16748,187,58,-2427,-2070,24.5,1492.3,11,0,0,3,2,2,0,0,0,0,17350,7.0,18818,247,69,2427,2070,31.6,1735.0
4849315680,0,13,1,1,4,5,4,0,0,0,0,16246,6.8,17075,182,50,-150,-1573,23.2,1624.6,11,2,0,5,4,3,1,1,0,0,16396,7.0,18648,252,66,150,1573,31.8,1639.6
4849310960,1,13,0,0,6,8,9,0,0,0,0,18013,7.0,17962,240,56,812,1405,29.6,1801.3,13,0,1,8,6,9,1,0,1,0,17201,6.6,16557,210,45,-812,-1405,25.5,1720.1
4848297699,0,13,1,1,9,8,7,0,0,0,0,17284,6.8,18595,225,56,-97,942,28.1,1728.4,26,1,0,8,9,8,0,0,0,0,17381,6.8,17653,206,51,97,-942,25.7,1738.1
4847460456,1,20,1,1,4,9,2,0,0,0,0,16297,6.8,17251,249,48,-1819,-594,29.7,1629.7,13,0,0,9,4,12,0,0,0,0,18116,6.8,17845,208,53,1819,594,26.1,1811.6
4847337916,1,12,0,0,5,5,5,0,0,0,0,15776,6.6,16836,221,48,-1417,-1940,26.9,1577.6,15,1,1,5,5,5,1,0,1,0,17193,7.2,18776,251,56,1417,1940,30.7,1719.3
4845572344,1,16,1,1,8,9,11,0,0,0,0,19877,7.2,19826,223,55,2113,2369,27.8,1987.7,18,0,0,9,8,9,0,0,0,0,17764,7.0,17457,212,55,-2113,-2369,26.7,1776.4
4845461682,0,13,0,1,18,17,52,0,0,0,1,36834,11.2,40144,104,0,381,750,10.4,3683.4,0,3,0,17,18,35,0,0,0,0,36453,10.8,39394,105,0,-381,-750,10.5,3645.3
4845458351,1,18,0,1,36,24,80,0,0,0,1,41119,12.2,47470,98,0,3706,5479,9.8,4111.9,0,4,0,24,36,54,0,0,0,0,37413,11.2,41991,98,0,-3706,-5479,9.8,3741.3
4844495208,1,0,1,1,30,24,72,0,0,0,0,38872,11.8,44480,105,0,959,1695,10.5,3887.2,16,0,0,24,30,71,0,0,0,0,37913,11.4,42785,91,0,-959,-1695,9.1,3791.3
4840590227,1,17,4,1,8,4,14,1,1,0,0,18571,6.6,17288,208,46,2318,842,25.4,1857.1,15,3,0,4,8,5,0,0,0,0,16253,6.6,16446,222,56,-2318,-842,27.8,1625.3
4840575382,1,13,0,0,1,5,2,0,0,0,0,15321,7.0,17900,225,68,-1630,-356,29.3,1532.1,16,2,1,5,1,10,1,1,0,0,16951,7.2,18256,240,60,1630,356,30.0,1695.1
4840571074,1,173,1,1,10,4,8,1,1,0,0,19465,7.0,18423,218,44,3170,673,26.2,1946.5,10,2,0,4,10,4,1,0,1,0,16295,7.0,17750,221,59,-3170,-673,28.0,1629.5
4840487771,1,14,1,1,21,27,49,0,0,0,1,35322,10.6,36413,103,0,-3431,-6443,10.3,3532.2,3,2,0,27,21,74,0,0,0,0,38753,11.4,42856,123,0,3431,6443,12.3,3875.3
4840462569,1,1,0,1,20,34,41,0,0,0,1,35697,10.4,37275,108,0,-3908,-5575,10.8,3569.7,0,0,0,34,20,94,0,0,0,0,39605,11.4,42850,117,0,3908,5575,11.7,3960.5
4840442934,1,21,0,0,24,20,61,0,0,0,0,37481,11.0,40534,121,0,3134,2761,12.1,3748.1,0,18,1,20,24,39,0,0,0,0,34347,10.6,37773,85,0,-3134,-2761,8.5,3434.7
4840418093,1,0,2,0,20,20,47,0,0,0,0,35817,10.8,38693,120,0,-389,-1078,12.0,3581.7,14,0,1,19,19,55,0,0,0,0,36206,11.2,39771,101,0,389,1078,10.1,3620.6
4839539411,1,138,0,0,7,12,5,0,0,0,0,18476,6.8,18039,203,70,-1157,1249,27.3,1847.6,19,1,1,12,7,13,0,0,0,0,19633,6.6,16790,184,44,1157,-1249,22.8,1963.3
4837998640,1,0,0,0,18,16,31,0,0,0,1,35491,10.8,38866,118,0,-234,2094,11.8,3549.1,0,0,1,16,18,45,0,0,0,0,35725,10.6,36772,97,0,234,-2094,9.7,3572.5
4837973857,1,13,0,0,10,2,10,0,0,0,0,19734,7.4,19348,243,51,4171,2166,29.4,1973.4,13,2,1,2,10,1,0,0,0,0,15563,6.8,17182,215,64,-4171,-2166,27.9,1556.3
4837697473,1,15,1,1,6,4,4,1,1,0,0,17612,7.0,18639,244,52,2029,1411,29.6,1761.2,13,1,0,4,6,4,0,0,0,0,15583,7.0,17228,199,56,-2029,-1411,25.5,1558.3
4837675160,1,11,4,1,9,3,9,1,1,0,0,17335,6.4,16267,195,52,1548,-490,24.7,1733.5,11,1,0,3,9,2,0,0,0,0,15787,6.8,16757,194,48,-1548,490,24.2,1578.7
4837649285,1,13,1,1,8,5,6,0,0,0,1,20437,7.4,19745,237,64,3889,2190,30.1,2043.7,12,0,0,5,8,3,0,0,0,0,16548,6.8,17555,207,44,-3889,-2190,25.1,1654.8
4857387340,1,10,0,0,14,18,15,0,0,0,0,60950,12.2,56000,0,0,21764,23000,0.0,6095.0,0,0,1,15,11,16,0,0,0,0,39186,7.2,33000,0,0,-21764,-23000,0.0,3918.6
4856999405,1,0,0,0,18,15,18,0,0,0,0,63400,12.0,55000,0,0,26200,22000,0.0,6340.0,26,0,1,9,12,8,0,0,0,0,37200,7.2,33000,0,0,-26200,-22000,0.0,3720.0
4856988184,1,20,0,1,20,13,20,0,0,0,0,61650,12.0,55000,0,0,23870,22000,0.0,6165.0,0,0,0,12,19,8,0,0,0,0,37780,7.2,33000,0,0,-23870,-22000,0.0,3778.0
4856966557,1,24,2,1,18,16,16,0,0,0,0,47426,10.0,47500,2,0,18876,17500,0.2,4742.6,4,0,0,10,12,11,0,0,0,0,28550,6.4,30000,0,0,-18876,-17500,0.0,2855.0
4856950674,1,0,0,0,15,15,18,0,0,0,0,61300,12.0,55000,0,0,23993,22000,0.0,6130.0,0,0,1,10,10,8,0,0,0,0,37307,7.2,33000,0,0,-23993,-22000,0.0,3730.7
4855951525,1,0,0,1,26,24,76,0,0,0,0,38514,11.4,43736,114,0,616,2267,11.4,3851.4,0,0,0,24,26,62,0,0,0,0,37898,11.2,41469,93,0,-616,-2267,9.3,3789.8
4855326635,1,0,0,1,26,22,67,0,0,0,1,39262,11.6,43296,118,0,3735,2407,11.8,3926.2,0,0,0,22,26,47,0,0,0,0,35527,11.0,40889,98,0,-3735,-2407,9.8,3552.7
4855164248,1,11,5,0,6,6,5,0,0,0,0,17054,6.8,18166,225,40,-103,-530,26.5,1705.4,14,0,1,6,6,3,0,0,0,0,17157,7.0,18696,250,52,103,530,30.2,1715.7
4855117269,1,2,0,1,18,28,43,0,0,0,1,37098,10.6,37957,124,0,10,-2524,12.4,3709.8,130,0,0,28,18,69,0,0,0,0,37088,11.0,40481,107,0,-10,2524,10.7,3708.8
4855082203,1,0,0,0,26,19,76,0,0,0,1,40481,11.2,41822,123,0,4897,4051,12.3,4048.1,0,0,1,19,26,60,0,0,0,0,35584,10.8,37771,77,0,-4897,-4051,7.7,3558.4
4855041526,1,0,0,1,15,19,31,0,0,0,1,35392,10.6,36692,98,0,-1967,-3719,9.8,3539.2,0,0,0,19,15,57,0,0,0,0,37359,11.0,40411,104,0,1967,3719,10.4,3735.9
4854991566,1,11,2,0,6,4,5,1,0,1,0,18665,7.2,19557,236,64,3224,1192,30.0,1866.5,13,3,1,3,5,2,1,1,0,0,15441,7.0,18365,225,70,-3224,-1192,29.5,1544.1
4854955389,1,11,0,0,18,19,26,0,0,0,0,63650,12.6,59500,0,0,25400,18000,0.0,6365.0,4,0,1,11,10,10,0,0,0,0,38250,8.6,41500,0,0,-25400,-18000,0.0,3825.0
4854784008,1,10,0,1,17,18,16,0,0,0,0,45600,10.0,47500,0,0,16000,19000,0.0,4560.0,0,0,0,9,8,15,0,0,0,0,29600,6.0,28500,0,0,-16000,-19000,0.0,2960.0
4854759975,1,0,0,0,13,17,14,0,0,0,0,60106,12.0,55000,0,0,21506,22000,0.0,6010.6,15,0,1,13,9,12,0,0,0,0,38600,7.2,33000,0,0,-21506,-22000,0.0,3860.0
4854741252,1,0,0,0,19,22,21,0,0,0,0,63629,12.0,55000,0,0,24329,22000,0.0,6362.9,10,0,1,13,10,11,0,0,0,0,39300,7.2,33000,0,0,-24329,-22000,0.0,3930.0
4854605470,1,0,0,0,11,22,12,0,0,0,0,61030,12.0,55000,2,0,19235,22000,0.2,6103.0,0,0,1,15,4,13,0,0,0,0,41795,7.2,33000,1,0,-19235,-22000,0.1,4179.5
4854591722,1,43,0,1,20,19,20,0,0,0,0,52245,12.0,55000,0,0,21325,22000,0.0,5224.5,0,0,0,8,9,11,0,0,0,0,30920,7.2,33000,0,0,-21325,-22000,0.0,3092.0
4854582922,1,124,1,1,12,17,14,0,0,0,0,61135,12.0,55000,6,0,22835,20000,0.6,6113.5,0,3,0,11,6,12,0,0,0,0,38300,7.6,35000,0,0,-22835,-20000,0.0,3830.0
4854567945,1,0,0,1,13,21,12,0,0,0,0,46685,10.0,47500,0,0,17230,19000,0.0,4668.5,0,0,0,12,4,14,0,0,0,0,29455,6.0,28500,1,0,-17230,-19000,0.1,2945.5
4857624323,1,34,0,0,21,9,54,0,0,0,1,37095,11.2,40475,127,0,2711,4096,12.7,3709.5,34,0,1,9,21,23,0,0,0,0,34384,10.4,36379,103,0,-2711,-4096,10.3,3438.4
4857607497,1,0,0,1,16,25,40,0,0,0,2,36369,10.6,37548,108,0,-1249,-3220,10.8,3636.9,0,0,0,25,16,47,0,0,0,0,37618,11.2,40768,112,0,1249,3220,11.2,3761.8
4857595787,0,0,1,1,28,22,59,0,0,0,1,39169,11.6,43046,114,0,3727,5102,11.4,3916.9,28,0,0,22,28,30,0,0,0,0,35442,10.6,37944,99,0,-3727,-5102,9.9,3544.2
4857513135,1,34,0,1,25,15,80,0,0,0,1,37826,11.2,40919,109,0,2722,3301,10.9,3782.6,34,0,0,15,25,35,0,0,0,0,35104,10.4,37618,71,0,-2722,-3301,7.1,3510.4
4857481019,1,0,0,1,28,19,71,0,0,0,0,38659,11.8,44093,104,0,1789,5443,10.4,3865.9,0,0,0,19,28,45,0,0,0,0,36870,11.0,38650,112,0,-1789,-5443,11.2,3687.0
4855106343,0,68,0,0,22,20,56,0,0,0,1,35305,10.8,38859,78,0,-2149,-2335,7.8,3530.5,0,0,1,20,22,53,0,0,0,0,37454,11.4,41194,112,0,2149,2335,11.2,3745.4
4855081118,0,0,0,0,17,20,46,0,0,0,1,34376,10.4,35917,89,0,-3115,-4580,8.9,3437.6,0,0,1,19,16,54,0,0,0,0,37491,11.0,40497,103,0,3115,4580,10.3,3749.1
4855047481,0,0,0,1,17,17,52,0,0,0,1,37110,10.8,38517,91,0,2042,1360,9.1,3711.0,0,0,0,17,17,44,0,0,0,0,35068,10.8,37157,112,0,-2042,-1360,11.2,3506.8
4854993831,0,0,3,0,30,33,76,0,0,0,1,40604,11.8,44506,111,0,665,1003,11.1,4060.4,12,0,1,33,30,78,0,0,0,0,39939,11.4,43503,102,0,-665,-1003,10.2,3993.9
4854250698,1,0,0,1,27,25,56,0,0,0,0,39163,11.8,43081,113,0,385,1687,11.3,3916.3,216,0,0,25,27,65,0,0,0,0,38778,11.2,41394,109,0,-385,-1687,10.9,3877.8
4854239855,1,8,0,0,34,21,87,0,0,0,1,39658,12.0,46797,90,0,3597,8956,9.0,3965.8,33,0,1,21,34,47,0,0,0,0,36061,10.8,37841,102,0,-3597,-8956,10.2,3606.1
4854210316,1,0,0,1,31,25,77,0,0,0,1,37333,11.4,41645,100,0,321,704,10.0,3733.3,0,0,0,25,31,70,0,0,0,0,37012,11.0,40941,77,0,-321,-704,7.7,3701.2
4854185323,1,0,0,0,19,23,56,0,0,0,0,37934,11.0,38966,98,0,1408,712,9.8,3793.4,0,0,1,23,19,70,0,0,0,0,36526,10.6,38254,98,0,-1408,-712,9.8,3652.6
4854130550,1,0,0,0,11,13,29,0,0,0,0,33036,10.2,35276,97,0,-3918,-3072,9.7,3303.6,246,0,1,13,11,30,0,0,0,0,36954,10.8,38348,120,0,3918,3072,12.0,3695.4
4854046845,1,55,0,0,19,20,20,0,0,0,0,39350,10.0,47500,1,0,11800,19000,0.1,3935.0,21,0,1,10,9,11,0,0,0,0,27550,6.0,28500,1,0,-11800,-19000,0.1,2755.0
4854000586,1,4,0,0,15,15,24,0,0,0,0,62350,12.0,55000,0,0,24800,22000,0.0,6235.0,3,0,1,10,10,4,0,0,0,0,37550,7.2,33000,0,0,-24800,-22000,0.0,3755.0
4853972051,1,0,0,1,19,19,16,0,0,0,0,47000,10.0,47500,0,0,19500,19000,0.0,4700.0,0,0,0,7,7,9,0,0,0,0,27500,6.0,28500,0,0,-19500,-19000,0.0,2750.0
4853926578,0,0,0,0,27,30,71,0,0,0,1,39421,11.8,45193,91,0,386,912,9.1,3942.1,18,0,1,30,27,89,0,0,0,0,39035,12.0,44281,80,0,-386,-912,8.0,3903.5
4853895861,0,14,4,0,28,26,83,0,0,0,3,38564,11.0,41434,106,0,-2100,-2250,10.6,3856.4,18,0,1,26,28,66,0,0,0,0,40664,11.4,43684,113,0,2100,2250,11.3,4066.4
4853859934,1,68,0,1,32,28,84,0,0,0,1,39991,11.8,45283,114,0,2033,2553,11.4,3999.1,0,0,0,28,32,57,0,0,0,0,37958,11.6,42730,95,0,-2033,-2553,9.5,3795.8
4847283445,1,11,4,1,11,2,13,0,0,0,0,17700,6.6,16774,182,39,1520,-1492,22.1,1770.0,26,1,0,2,11,2,0,0,0,0,16180,6.8,18266,203,72,-1520,1492,27.5,1618.0
4847276190,1,12,1,1,4,1,2,0,0,0,0,16713,7.0,18430,230,53,2319,1032,28.3,1671.3,12,2,0,1,4,1,1,0,1,0,14394,6.8,17398,200,66,-2319,-1032,26.6,1439.4
4847255651,1,14,0,0,2,6,1,0,0,0,0,15567,7.0,18227,231,54,-1092,252,28.5,1556.7,18,1,1,6,2,4,1,1,0,0,16659,6.8,17975,222,60,1092,-252,28.2,1665.9
4847242433,0,13,2,1,8,7,6,2,1,1,0,18310,6.8,18574,242,52,318,-945,29.4,1831.0,16,1,0,7,8,6,0,0,0,0,17992,7.4,19519,225,63,-318,945,28.8,1799.2
4847222528,0,12,1,1,5,5,4,0,0,0,0,16803,6.8,17849,225,56,863,17,28.1,1680.3,14,3,0,5,5,5,1,1,0,0,15940,7.2,17832,215,60,-863,-17,27.5,1594.0
4846542118,0,14,0,0,5,7,5,0,0,0,0,16695,7.0,18096,203,62,-119,42,26.5,1669.5,11,2,1,7,5,3,0,0,0,0,16814,6.8,18054,194,52,119,-42,24.6,1681.4
4846520822,0,39,0,1,9,9,11,1,1,0,0,19133,6.8,17557,213,60,552,-1276,27.3,1913.3,31,1,0,9,9,6,0,0,0,0,18581,7.0,18833,223,48,-552,1276,27.1,1858.1
4846494757,0,13,2,1,7,6,5,0,0,0,0,19933,7.2,19055,259,51,2670,951,31.0,1993.3,12,1,0,6,7,4,1,1,0,0,17263,6.8,18104,210,88,-2670,-951,29.8,1726.3
4846470350,1,6,1,1,8,8,5,1,1,0,0,17168,6.8,17295,203,62,-2328,-1170,26.5,1716.8,14,0,0,8,8,8,0,0,0,0,19496,7.2,18465,225,47,2328,1170,27.2,1949.6
4846455184,1,12,1,0,4,5,4,0,0,0,0,15339,7.0,18197,222,60,-2280,-1579,28.2,1533.9,13,1,1,5,4,2,1,1,0,0,17619,7.2,19776,259,56,2280,1579,31.5,1761.9
4846436733,1,15,2,1,7,4,9,0,0,0,0,18685,7.2,19023,238,60,1682,754,29.8,1868.5,13,2,0,4,7,4,1,0,1,0,17003,7.0,18269,209,64,-1682,-754,27.3,1700.3
4846382302,0,8,6,0,4,5,5,0,0,0,0,15985,7.0,18152,227,58,-794,-373,28.5,1598.5,21,2,1,5,4,5,1,1,0,0,16779,7.0,18525,227,64,794,373,29.1,1677.9
4846372332,0,14,3,1,6,5,6,0,0,0,0,17114,6.6,17088,195,67,223,-1418,26.2,1711.4,13,0,0,5,6,2,0,0,0,0,16891,7.0,18506,198,64,-223,1418,26.2,1689.1
4846364314,0,53,2,0,5,10,3,0,0,0,0,18388,7.0,19198,220,72,-583,362,29.2,1838.8,18,0,1,10,5,7,1,1,0,0,18971,6.8,18836,189,60,583,-362,24.9,1897.1
4846362858,0,13,1,0,5,11,5,0,0,0,0,15987,6.8,16810,183,60,-4494,-2279,24.3,1598.7,12,2,1,11,5,12,1,1,0,0,20481,7.2,19089,228,60,4494,2279,28.8,2048.1
4846346496,0,11,1,0,4,4,5,2,1,1,0,17843,7.0,18651,203,70,2694,1050,27.3,1784.3,13,0,1,4,4,1,0,0,0,0,15149,7.0,17601,218,56,-2694,-1050,27.4,1514.9
4846258236,1,20,2,1,5,5,4,0,0,0,0,16321,6.4,15580,206,32,-802,-1757,23.8,1632.1,25,1,0,5,5,3,0,0,0,0,17123,6.8,17337,211,48,802,1757,25.9,1712.3
4846237889,1,33,2,1,7,3,5,1,1,0,0,17034,6.6,17297,206,48,189,-183,25.4,1703.4,14,3,0,3,7,4,0,0,0,0,16845,6.6,17480,222,72,-189,183,29.4,1684.5
4845497553,0,18,2,1,11,7,12,0,0,0,0,19972,7.4,19348,225,64,2079,1199,28.9,1997.2,10,5,0,7,11,7,1,1,0,0,17893,7.0,18149,233,56,-2079,-1199,28.9,1789.3
4845496793,1,8,1,1,7,8,13,1,1,0,0,17182,6.8,17632,207,56,-1198,-994,26.3,1718.2,11,0,0,8,7,6,0,0,0,0,18380,6.8,18626,251,68,1198,994,31.9,1838.0
4857427635,0,16,1,0,8,9,10,0,0,0,0,17430,7.0,17218,176,51,-1522,-2458,22.7,1743.0,11,3,1,9,8,9,1,1,0,0,18952,7.6,19676,244,67,1522,2458,31.1,1895.2
4857362363,0,13,3,0,6,3,5,0,0,0,0,18411,7.2,18722,221,60,1372,812,28.1,1841.1,14,0,1,3,6,4,0,0,0,0,17039,6.8,17910,237,48,-1372,-812,28.5,1703.9
4857307364,0,15,1,0,5,5,4,1,1,0,0,16597,6.8,17133,184,56,-103,-171,24.0,1659.7,16,0,1,5,5,3,0,0,0,0,16700,6.8,17304,210,48,103,171,25.8,1670.0
4857243752,0,7,0,1,4,5,3,0,0,0,0,16329,6.6,17303,215,48,547,-507,26.3,1632.9,13,1,0,5,4,5,0,0,0,0,15782,6.8,17810,209,44,-547,507,25.3,1578.2
4857142970,0,12,4,0,1,9,1,0,0,0,0,14487,6.8,16631,225,34,-3437,-3239,25.9,1448.7,12,1,1,9,1,5,0,0,0,0,17924,7.4,19870,237,73,3437,3239,31.0,1792.4
4857091353,1,14,0,0,7,7,2,0,0,0,0,15774,7.0,17524,196,35,-1188,-1252,23.1,1577.4,13,0,1,7,7,1,1,1,0,0,16962,7.0,18776,237,63,1188,1252,30.0,1696.2
4857050454,1,14,1,0,4,8,1,0,0,0,0,15741,7.0,18429,235,76,-1041,990,31.1,1574.1,13,0,1,8,4,7,0,0,0,0,16782,7.0,17439,217,56,1041,-990,27.3,1678.2
4857013570,1,15,1,1,8,3,5,1,1,0,0,18203,7.0,18665,214,64,2840,483,27.8,1820.3,14,1,0,3,8,5,1,0,1,0,15363,7.0,18182,197,64,-2840,-483,26.1,1536.3
4856984064,1,13,0,1,6,5,8,1,1,0,0,16982,6.8,17416,186,68,1080,-540,25.4,1698.2,9,0,0,5,6,2,0,0,0,0,15902,6.8,17956,209,52,-1080,540,26.1,1590.2
4856953047,1,35,2,1,16,8,19,1,1,0,0,19957,6.4,16532,189,42,2562,103,23.1,1995.7,20,15,0,8,16,13,0,0,0,0,17395,6.6,16429,190,42,-2562,-103,23.2,1739.5
4856922237,0,17,2,1,2,2,2,0,0,0,0,15805,7.0,18156,246,52,471,-893,29.8,1580.5,14,1,0,2,2,2,1,1,0,0,15334,7.2,19049,225,67,-471,893,29.2,1533.4
4856901879,0,16,2,1,4,5,4,0,0,0,0,14885,6.8,16956,187,52,-2824,-1073,23.9,1488.5,14,0,0,5,4,7,1,1,0,0,17709,7.0,18029,230,53,2824,1073,28.3,1770.9
4854974580,1,53,0,1,5,6,3,0,0,0,0,17003,6.8,18771,208,48,-1074,540,25.6,1700.3,12,1,0,6,5,5,1,1,0,0,18077,7.0,18231,211,56,1074,-540,26.7,1807.7
4854927749,1,16,2,1,5,6,4,1,1,0,0,17711,7.0,18033,213,72,440,1414,28.5,1771.1,17,3,0,6,5,10,1,0,1,0,17271,6.6,16619,192,46,-440,-1414,23.8,1727.1
4854894135,1,13,2,0,12,7,12,1,1,0,0,19540,7.4,19313,202,64,3055,2878,26.6,1954.0,12,1,1,7,12,8,0,0,0,0,16485,6.8,16435,204,56,-3055,-2878,26.0,1648.5
4854857222,0,8,1,0,3,9,2,0,0,0,0,14879,6.8,16852,205,56,-3354,-948,26.1,1487.9,13,1,1,9,3,12,0,0,0,0,18233,7.0,17800,206,48,3354,948,25.4,1823.3
4854819864,1,17,4,1,7,4,13,1,1,0,0,16658,6.4,16071,186,50,908,-1438,23.6,1665.8,13,3,0,4,7,5,0,0,0,0,15750,6.8,17509,229,68,-908,1438,29.7,1575.0
4854732577,0,92,0,0,5,7,5,1,1,0,0,16843,7.2,18386,224,68,-1774,-534,29.2,1684.3,10,2,1,7,5,3,0,0,0,0,18617,7.0,18920,231,67,1774,534,29.8,1861.7
4854697898,0,10,0,0,15,6,7,0,0,0,0,20764,7.2,19136,208,52,2170,1804,26.0,2076.4,12,0,1,6,15,7,0,0,0,0,18594,6.6,17332,208,46,-2170,-1804,25.4,1859.4
4854662468,0,16,1,0,5,11,1,0,0,0,0,14569,6.4,15824,157,52,-4391,-2367,20.9,1456.9,19,2,1,11,5,9,2,1,1,0,18960,7.0,18191,226,36,4391,2367,26.2,1896.0
4856320450,0,16,1,0,5,12,2,0,0,0,0,15865,6.4,16270,182,68,-3270,-2061,25.0,1586.5,40,1,1,12,5,14,1,1,0,0,19135,7.0,18331,233,60,3270,2061,29.3,1913.5
4854899439,0,15,2,0,3,2,1,0,0,0,0,15121,6.8,17793,234,39,-417,-990,27.3,1512.1,14,1,1,2,3,0,1,1,0,0,15538,7.0,18783,228,72,417,990,30.0,1553.8
4854083113,1,34,0,1,21,14,56,0,0,0,1,37311,11.0,37682,124,0,3876,1921,12.4,3731.1,0,11,0,14,21,44,0,0,0,0,33435,10.6,35761,113,0,-3876,-1921,11.3,3343.5
4854054321,0,0,0,0,27,34,68,0,0,0,1,40183,11.6,44454,111,0,-643,-1228,11.1,4018.3,0,0,1,34,27,99,0,0,0,0,40826,12.0,45682,110,0,643,1228,11.0,4082.6
4854026356,0,28,0,1,20,34,42,0,0,0,1,38003,11.2,41312,96,0,-1692,-2910,9.6,3800.3,0,24,0,34,20,104,0,0,0,0,39695,12.0,44222,108,0,1692,2910,10.8,3969.5
4853995467,1,17,0,1,32,27,92,0,0,0,1,37943,11.2,42126,101,0,-1217,-611,10.1,3794.3,0,0,0,27,32,63,0,0,0,0,39160,11.6,42737,105,0,1217,611,10.5,3916.0
4853964970,1,0,0,1,17,16,16,0,0,0,0,47532,10.0,47500,0,0,18458,19000,0.0,4753.2,0,0,0,8,9,10,0,0,0,0,29074,6.0,28500,0,0,-18458,-19000,0.0,2907.4
4853938289,1,0,0,1,15,17,15,0,0,0,0,62000,12.0,55000,0,0,24200,22000,0.0,6200.0,0,0,0,9,7,9,0,0,0,0,37800,7.2,33000,0,0,-24200,-22000,0.0,3780.0
4853916847,1,0,0,1,20,16,18,0,0,0,0,63695,12.0,55000,0,0,26139,22000,0.0,6369.5,0,0,0,7,11,7,0,0,0,0,37556,7.2,33000,0,0,-26139,-22000,0.0,3755.6
4853886189,1,35,1,1,17,18,17,0,0,0,0,63090,12.0,55000,2,0,22897,22000,0.2,6309.0,0,11,0,10,9,12,0,0,0,0,40193,7.2,33000,0,0,-22897,-22000,0.0,4019.3
4853851030,1,0,0,0,11,15,11,0,0,0,0,47000,10.0,47500,0,0,19500,19000,0.0,4700.0,0,0,1,11,7,9,0,0,0,0,27500,6.0,28500,0,0,-19500,-19000,0.0,2750.0
4853826485,1,3,0,1,12,16,18,0,0,0,0,62700,12.0,55000,0,0,26200,22000,0.0,6270.0,0,0,0,13,9,5,0,0,0,0,36500,7.2,33000,0,1,-26200,-22000,0.1,3650.0
4853806384,1,0,0,0,14,20,16,0,0,0,0,60950,12.0,55000,0,0,23400,20000,0.0,6095.0,0,0,1,11,5,11,0,0,0,0,37550,7.6,35000,0,0,-23400,-20000,0.0,3755.0
4853783914,1,0,0,0,14,13,19,0,0,0,0,47350,10.0,47500,0,0,20200,19000,0.0,4735.0,3,0,1,9,10,5,0,0,0,0,27150,6.0,28500,0,0,-20200,-19000,0.0,2715.0
4853755640,1,1,0,1,16,17,18,0,0,0,0,46000,10.0,47500,1,0,16700,19000,0.1,4600.0,32,0,0,10,9,10,0,0,0,0,29300,6.0,28500,1,0,-16700,-19000,0.1,2930.0
4853738250,1,0,0,1,20,24,19,0,0,0,0,62000,13.0,61980,0,0,23350,24480,0.0,6200.0,17,0,0,12,8,18,0,0,0,0,38650,7.8,37500,1,0,-23350,-24480,0.1,3865.0
4853716237,1,0,0,0,19,15,22,0,0,0,0,47105,10.0,47500,0,0,19575,19000,0.0,4710.5,0,0,1,11,15,8,0,0,0,0,27530,6.0,28500,0,0,-19575,-19000,0.0,2753.0
4853075637,1,0,0,0,27,25,22,0,0,0,0,53100,10.0,47500,3,0,23750,19000,0.3,5310.0,0,0,1,10,12,13,0,0,0,0,29350,6.0,28500,2,0,-23750,-19000,0.2,2935.0
4853055432,1,0,0,0,16,15,11,0,0,0,0,45950,10.0,47500,0,0,17400,19000,0.0,4595.0,0,0,1,9,10,14,0,0,0,0,28550,6.0,28500,0,0,-17400,-19000,0.0,2855.0
4853033126,1,8,0,1,19,10,16,0,0,0,0,62700,12.0,55000,0,0,27600,22000,0.0,6270.0,0,0,0,3,12,5,0,0,0,0,35100,7.2,33000,0,0,-27600,-22000,0.0,3510.0
4853530187,1,12,1,1,7,1,6,0,0,0,0,17386,7.0,18337,223,61,1860,797,28.4,1738.6,13,0,0,1,7,1,0,0,0,0,15526,6.8,17540,240,44,-1860,-797,28.4,1552.6
4853501995,0,18,1,1,2,5,2,0,0,0,0,15598,6.8,17758,214,60,-1560,-1150,27.4,1559.8,13,1,0,5,2,6,0,0,0,0,17158,7.2,18908,222,52,1560,1150,27.4,1715.8
4852108037,1,11,0,1,2,3,0,0,0,0,0,15627,7.2,18874,268,60,-30,770,32.8,1562.7,11,0,0,3,2,3,0,0,0,0,15657,6.8,18104,214,60,30,-770,27.4,1565.7
4852078831,0,17,2,1,7,10,5,1,0,1,0,17575,7.2,19372,217,74,-1476,1711,29.1,1757.5,25,4,0,10,7,9,0,0,0,0,19051,7.0,17661,233,55,1476,-1711,28.8,1905.1
4852042876,0,13,1,0,5,7,8,0,0,0,0,17112,6.8,17878,228,48,227,970,27.6,1711.2,19,0,1,7,5,9,0,0,0,0,16885,6.8,16908,201,56,-227,-970,25.7,1688.5
4852013225,0,11,0,1,7,9,6,0,0,0,0,15882,6.6,17499,217,63,-3012,-732,28.0,1588.2,11,1,0,8,6,9,1,0,1,0,18894,7.0,18231,201,60,3012,732,26.1,1889.4
4851965524,0,12,1,1,6,5,7,0,0,0,0,17649,7.2,18254,217,64,598,286,28.1,1764.9,14,3,0,5,6,8,0,0,0,0,17051,6.8,17968,224,56,-598,-286,28.0,1705.1
4851925021,0,12,0,0,2,10,2,0,0,0,0,16343,6.6,17175,209,48,-2112,-63,25.7,1634.3,13,0,1,10,2,14,0,0,0,0,18455,6.6,17238,198,56,2112,63,25.4,1845.5
4851846700,0,17,1,0,7,7,3,0,0,0,0,16074,6.8,17903,212,50,-709,6,26.2,1607.4,11,1,1,7,7,7,0,0,0,0,16783,7.0,17897,205,52,709,-6,25.7,1678.3
4851795602,0,12,1,1,5,4,2,0,0,0,0,16529,6.8,17742,213,52,884,304,26.5,1652.9,15,0,0,4,5,6,1,1,0,0,15645,6.8,17438,224,56,-884,-304,28.0,1564.5
4851751726,0,14,1,1,8,6,6,0,0,0,0,17880,6.8,17696,216,52,1183,468,26.8,1788.0,10,0,0,6,8,6,0,0,0,0,16697,6.8,17228,216,50,-1183,-468,26.6,1669.7
4851699842,1,13,0,0,6,3,6,0,0,0,0,17136,7.2,18971,224,60,1370,1200,28.4,1713.6,11,4,1,3,6,3,0,0,0,0,15766,7.0,17771,254,60,-1370,-1200,31.4,1576.6
4851648893,1,16,4,1,5,3,8,1,1,0,0,16390,6.4,16680,211,62,1764,506,27.3,1639.0,14,2,0,3,5,2,0,0,0,0,14626,6.4,16174,171,56,-1764,-506,22.7,1462.6
4851562744,1,16,3,0,6,8,6,1,0,1,0,17198,7.0,18941,222,76,-622,559,29.8,1719.8,21,3,1,8,6,10,1,1,0,0,17820,7.0,18382,247,62,622,-559,30.9,1782.0
4851536993,0,8,1,0,3,4,4,1,1,0,0,15587,6.8,17951,240,47,-1752,-1266,28.7,1558.7,18,0,1,4,3,5,1,0,1,0,17339,7.2,19217,202,60,1752,1266,26.2,1733.9
4851499800,1,16,3,1,5,3,7,0,0,0,0,18182,7.2,18885,228,64,3301,371,29.2,1818.2,15,2,0,3,5,1,0,0,0,0,14881,7.4,18514,214,67,-3301,-371,28.1,1488.1
4851467908,0,17,1,1,6,4,8,2,1,1,0,18299,7.0,19040,236,76,2443,2386,31.2,1829.9,10,1,0,4,6,4,0,0,0,0,15856,6.4,16654,189,57,-2443,-2386,24.6,1585.6
4840548074,0,10,0,1,6,10,4,0,0,0,0,17362,6.8,16988,199,40,-940,-1858,23.9,1736.2,11,0,0,9,5,9,0,0,0,0,18302,7.2,18846,197,64,940,1858,26.1,1830.2
4840525083,0,15,2,0,4,9,5,0,0,0,0,15269,6.6,16099,204,52,-2828,-1489,25.6,1526.9,11,1,1,9,4,6,0,0,0,0,18097,6.8,17588,227,52,2828,1489,27.9,1809.7
4840495241,0,20,0,1,3,4,3,0,0,0,0,14789,6.6,17002,194,45,-2265,-2459,23.9,1478.9,23,1,0,4,3,3,0,0,0,0,17054,7.2,19461,204,76,2265,2459,28.0,1705.4
4854932965,1,0,0,0,19,26,27,0,0,0,0,63400,13.0,62500,0,0,24800,25000,0.0,6340.0,0,0,1,16,9,12,0,0,0,0,38600,7.8,37500,0,0,-24800,-25000,0.0,3860.0
4854910029,1,5,0,0,10,22,12,0,0,0,0,48326,10.0,47500,4,0,17171,19000,0.4,4832.6,0,0,1,16,4,11,0,0,0,0,31155,6.0,28500,3,0,-17171,-19000,0.3,3115.5
4854887124,1,5,0,1,17,23,22,0,0,0,0,50575,10.2,48680,0,0,21615,20180,0.0,5057.5,0,0,0,14,8,9,0,0,0,0,28960,6.0,28500,0,0,-21615,-20180,0.0,2896.0
4848862319,0,10,0,1,3,2,3,0,0,0,0,16052,7.2,18817,203,60,-1045,251,26.3,1605.2,12,1,0,2,3,2,1,1,0,0,17097,7.0,18566,244,60,1045,-251,30.4,1709.7
4844153937,1,16,5,0,4,8,3,1,1,0,0,15886,6.8,17822,251,56,-2721,-875,30.7,1588.6,29,0,1,8,4,5,1,0,1,0,18607,7.0,18697,239,40,2721,875,27.9,1860.7
4838584234,0,14,3,0,7,8,9,0,0,0,0,16353,6.6,17638,185,52,-4094,-2115,23.7,1635.3,17,1,1,8,7,5,2,1,1,0,20447,7.4,19753,238,72,4094,2115,31.0,2044.7
4837116260,0,10,2,0,4,9,4,0,0,0,0,16793,7.4,19269,253,75,-2458,-476,32.8,1679.3,12,2,1,9,4,8,1,1,0,0,19251,7.2,19745,253,55,2458,476,30.8,1925.1
4826714287,1,9,0,1,6,2,3,1,1,0,0,16804,7.0,18374,191,52,1699,585,24.3,1680.4,9,0,0,2,6,2,1,0,1,0,15105,7.0,17789,198,72,-1699,-585,27.0,1510.5
4823466592,0,14,0,1,7,5,7,0,0,0,0,17649,6.8,17722,235,52,247,-1254,28.7,1764.9,15,0,0,4,6,5,2,1,1,0,17402,7.0,18976,257,56,-247,1254,31.3,1740.2
4823445730,0,11,1,0,8,10,10,0,0,0,0,19099,6.8,18444,230,52,327,-1503,28.2,1909.9,15,2,1,10,8,3,1,1,0,0,18772,7.2,19947,218,72,-327,1503,29.0,1877.2
4820419961,1,79,0,1,6,4,6,1,1,0,0,16342,7.0,17877,222,55,-317,-724,27.7,1634.2,13,0,0,4,6,4,0,0,0,0,16659,6.8,18601,235,56,317,724,29.1,1665.9
4820119337,0,20,1,1,5,6,4,0,0,0,0,17520,7.0,18445,234,44,1130,747,27.8,1752.0,9,4,0,6,5,4,0,0,0,0,16390,6.8,17698,200,48,-1130,-747,24.8,1639.0
4820089352,0,11,1,0,6,16,6,0,0,0,0,16239,6.4,16323,149,51,-5952,-2599,20.0,1623.9,15,0,1,16,6,14,1,1,0,0,22191,7.0,18922,205,56,5952,2599,26.1,2219.1
4820028639,1,22,0,1,8,5,8,1,1,0,0,16777,6.8,17919,211,48,-1106,-1069,25.9,1677.7,11,4,0,5,8,5,1,0,1,0,17883,7.2,18988,255,56,1106,1069,31.1,1788.3
4819985443,0,10,0,0,7,5,7,1,1,0,0,16506,6.8,17907,210,56,-515,535,26.6,1650.6,15,0,1,5,7,9,0,0,0,0,17021,6.6,17372,225,52,515,-535,27.7,1702.1
4819742819,1,17,1,1,5,4,6,1,0,1,0,17628,7.0,18590,216,48,333,1791,26.4,1762.8,18,2,0,4,5,5,1,1,0,0,17295,6.8,16799,219,48,-333,-1791,26.7,1729.5
4817261626,1,22,2,1,5,3,2,1,1,0,0,16976,7.4,19004,248,63,1468,2180,31.1,1697.6,68,0,0,3,5,4,0,0,0,0,15508,6.8,16824,209,56,-1468,-2180,26.5,1550.8
4816783080,1,13,0,1,6,7,2,0,0,0,0,15405,6.8,17370,190,44,-3154,-1580,23.4,1540.5,17,2,0,7,6,7,0,0,0,0,18559,7.0,18950,229,64,3154,1580,29.3,1855.9
4816765094,0,24,3,0,7,10,6,0,0,0,0,16957,6.8,17195,192,52,-1165,-763,24.4,1695.7,16,2,1,9,6,4,0,0,0,0,18122,6.6,17958,223,48,1165,763,27.1,1812.2
4858160701,1,15,2,0,1,8,1,0,0,0,0,14954,7.0,17176,190,57,-2877,-1715,24.7,1495.4,12,1,1,8,1,8,0,0,0,0,17831,6.8,18891,197,50,2877,1715,24.7,1783.1
4858145196,1,176,0,1,19,20,16,0,0,0,0,62350,12.0,55000,0,0,24800,22000,0.0,6235.0,211,0,0,10,9,12,0,0,0,0,37550,7.2,33000,0,0,-24800,-22000,0.0,3755.0
4857472143,1,13,1,1,9,6,9,0,0,0,0,17462,6.8,17839,212,52,144,-272,26.4,1746.2,6,2,0,5,8,4,0,0,0,0,17318,7.0,18111,221,55,-144,272,27.6,1731.8
4857427635,0,16,1,0,8,9,10,0,0,0,0,17430,7.0,17218,176,51,-1522,-2458,22.7,1743.0,11,3,1,9,8,9,1,1,0,0,18952,7.6,19676,244,67,1522,2458,31.1,1895.2
4857242449,0,13,2,0,9,7,10,0,0,0,0,16917,6.2,15757,200,24,-1787,-1471,22.4,1691.7,11,2,1,7,9,12,1,1,0,0,18704,6.8,17228,190,56,1787,1471,24.6,1870.4
4857193226,0,21,0,1,8,8,12,0,0,0,0,18466,6.8,17442,215,56,171,36,27.1,1846.6,11,3,0,8,8,9,0,0,0,0,18295,6.6,17406,203,44,-171,-36,24.7,1829.5
4856943114,1,0,0,1,17,14,21,0,0,0,0,47350,10.0,47500,0,0,19500,19000,0.0,4735.0,8,0,0,10,13,7,0,0,0,0,27850,6.0,28500,0,0,-19500,-19000,0.0,2785.0
4856018283,1,9,0,0,5,7,5,0,0,0,0,16112,6.6,16328,194,52,-51,-996,24.6,1611.2,12,3,1,7,5,8,1,1,0,0,16163,6.8,17324,201,52,51,996,25.3,1616.3
4855996874,1,0,0,0,18,20,21,0,0,0,0,47045,10.0,47500,0,0,16379,19000,0.0,4704.5,0,0,1,12,10,10,0,0,0,0,30666,6.0,28500,0,0,-16379,-19000,0.0,3066.6
4855977937,1,0,0,0,21,13,21,0,0,0,0,64100,13.0,62500,0,0,28294,28000,0.0,6410.0,9,0,1,5,13,4,0,0,0,0,35806,7.4,34500,0,0,-28294,-28000,0.0,3580.6
4855876826,1,0,0,0,22,29,17,0,0,0,0,64703,12.0,55000,0,0,26453,22000,0.0,6470.3,0,0,1,15,8,19,0,0,0,0,38250,7.2,33000,0,0,-26453,-22000,0.0,3825.0
4855274048,1,0,0,1,16,20,16,0,0,0,0,62000,12.0,55000,0,0,24800,22000,0.0,6200.0,110,0,0,12,8,12,0,0,0,0,37200,7.2,33000,0,0,-24800,-22000,0.0,3720.0
4855247452,1,0,3,1,21,21,17,0,0,0,0,47532,10.6,50500,0,0,18902,22000,0.0,4753.2,35,1,0,13,13,11,0,0,0,0,28630,6.0,28500,3,0,-18902,-22000,0.3,2863.0
4855228057,1,0,0,0,13,15,19,0,0,0,0,46675,10.0,47500,1,0,18825,19000,0.1,4667.5,12,0,1,14,12,6,0,0,0,0,27850,6.0,28500,0,0,-18825,-19000,0.0,2785.0
4852719222,1,34,2,0,19,23,17,0,0,0,0,47873,10.0,47500,4,0,18250,19000,0.4,4787.3,0,4,1,14,10,14,0,0,0,0,29623,6.0,28500,0,0,-18250,-19000,0.0,2962.3
4852698365,1,0,0,0,19,18,21,0,0,0,0,62350,12.0,55000,0,0,24800,22000,0.0,6235.0,0,0,1,12,13,11,0,0,0,0,37550,7.2,33000,0,0,-24800,-22000,0.0,3755.0
4849025996,1,0,0,1,25,25,78,0,0,0,0,36900,11.2,40586,104,0,-849,-382,10.4,3690.0,0,0,0,25,25,61,0,0,0,0,37749,11.2,40968,116,0,849,382,11.6,3774.9
4847024726,0,21,1,1,4,2,4,0,0,0,0,16545,7.0,16954,195,44,1226,86,23.9,1654.5,10,0,0,2,4,3,0,0,0,0,15319,6.6,16868,218,48,-1226,-86,26.6,1531.9
4845990311,0,4,0,0,40,26,121,0,0,0,1,41833,11.8,45075,98,0,2083,1150,9.8,4183.3,12,0,1,26,40,66,0,0,0,0,39750,12.0,43925,96,0,-2083,-1150,9.6,3975.0
4845965985,0,16,1,1,8,7,5,0,0,0,0,17790,6.6,17561,188,52,1251,-292,24.0,1779.0,11,0,0,7,8,5,0,0,0,0,16539,6.8,17853,193,64,-1251,292,25.7,1653.9
4857824443,1,16,0,1,7,4,4,0,0,0,0,19139,7.2,19363,220,56,3813,2246,27.6,1913.9,10,1,0,4,7,5,0,0,0,0,15326,7.0,17117,206,48,-3813,-2246,25.4,1532.6
4857806527,0,10,0,0,4,9,4,0,0,0,0,15310,6.8,16674,190,48,-2114,-1954,23.8,1531.0,138,1,1,9,4,5,1,1,0,0,17424,7.2,18628,221,58,2114,1954,27.9,1742.4
4857798120,0,10,2,0,4,11,4,0,0,0,0,14723,6.6,16581,186,58,-2980,-3010,24.4,1472.3,23,0,1,11,4,7,1,1,0,0,17703,7.2,19591,220,58,2980,3010,27.8,1770.3
4856971298,1,0,0,0,25,31,55,0,0,0,0,38807,11.8,43537,115,0,495,879,11.5,3880.7,0,0,1,31,25,82,0,0,0,0,38312,11.6,42658,109,0,-495,-879,10.9,3831.2
4856947682,0,0,6,0,33,25,73,0,0,0,0,38220,11.6,44193,109,0,-1201,792,10.9,3822.0,105,0,1,25,33,48,0,0,0,0,39421,11.6,43401,108,0,1201,-792,10.8,3942.1
4854721672,0,12,0,0,3,10,4,0,0,0,0,15509,6.8,17883,224,64,-4017,-1574,28.8,1550.9,10,2,1,10,3,9,0,0,0,0,19526,7.2,19457,269,56,4017,1574,32.5,1952.6
4853847072,1,35,1,0,2,5,0,1,1,0,0,16860,7.4,19839,253,68,-574,894,32.1,1686.0,29,2,1,5,2,6,0,0,0,0,17434,7.2,18945,211,48,574,-894,25.9,1743.4
4853803277,1,10,24,1,3,4,1,1,0,1,0,15854,7.0,18736,251,56,-444,9,30.7,1585.4,99,1,0,4,3,5,1,1,0,0,16298,7.0,18727,247,44,444,-9,29.1,1629.8
4853764524,1,33,1,0,9,9,10,1,0,1,0,20040,7.2,18703,232,62,2770,1903,29.4,2004.0,31,2,1,9,9,6,1,1,0,0,17270,6.8,16800,188,62,-2770,-1903,25.0,1727.0
4853729950,0,13,0,1,5,9,5,0,0,0,0,17137,6.8,17903,227,50,-1581,-763,27.7,1713.7,12,1,0,9,5,7,0,0,0,0,18718,7.0,18666,255,57,1581,763,31.2,1871.8
4846896435,0,9,3,1,4,2,6,0,0,0,0,17244,7.0,19140,233,68,952,-1,30.1,1724.4,14,1,0,2,4,3,0,0,0,0,16292,7.2,19141,247,56,-952,1,30.3,1629.2
4846866033,0,51,1,0,1,8,0,0,0,0,0,15848,7.2,19328,213,72,-3163,645,28.5,1584.8,13,3,1,8,1,9,1,1,0,0,19011,7.2,18683,214,65,3163,-645,27.9,1901.1
4846804955,1,8,5,1,8,6,9,0,0,0,0,18247,6.8,17155,195,64,1423,-198,25.9,1824.7,24,3,0,6,8,4,1,1,0,0,16824,6.6,17353,212,58,-1423,198,27.0,1682.4
4842351591,0,12,0,0,2,6,1,0,0,0,0,15103,6.8,17506,216,60,-2077,-1204,27.6,1510.3,13,4,1,6,2,8,1,1,0,0,17180,7.2,18710,210,68,2077,1204,27.8,1718.0
4841897326,1,82,2,1,5,3,8,1,0,1,0,17078,7.2,18536,231,56,2642,788,28.7,1707.8,12,1,0,3,5,0,0,0,0,0,14436,6.8,17748,225,48,-2642,-788,27.3,1443.6
4841550902,0,128,0,0,8,8,4,1,1,0,0,17508,6.8,17410,202,54,-399,-1121,25.6,1750.8,12,1,1,8,8,11,0,0,0,0,17907,7.0,18531,237,52,399,1121,28.9,1790.7
4841511420,1,9,3,1,2,1,1,0,0,0,0,15137,7.0,17887,200,64,-1080,-2139,26.4,1513.7,12,0,0,1,2,0,0,0,0,0,16217,7.2,20026,224,48,1080,2139,27.2,1621.7
4841251153,0,40,1,0,8,6,10,0,0,0,0,17001,7.2,18237,210,56,-284,-245,26.6,1700.1,13,11,1,6,8,5,1,1,0,0,17285,7.0,18482,176,76,284,245,25.2,1728.5
4834729640,0,16,0,0,9,8,8,0,0,0,0,17161,7.0,18709,204,63,-131,98,26.7,1716.1,17,1,1,7,8,8,1,1,0,0,17292,7.2,18611,209,67,131,-98,27.6,1729.2
4834316623,1,9,0,1,16,18,23,0,0,0,2,38485,11.2,40358,120,51,1410,-906,17.1,3848.5,12,0,0,18,16,43,0,0,0,0,37075,11.0,41264,129,45,-1410,906,17.4,3707.5
4843517965,0,10,1,1,4,2,6,0,0,0,0,16335,6.8,17687,198,48,-1152,-829,24.6,1633.5,16,0,0,2,4,2,0,0,0,0,17487,6.8,18516,240,52,1152,829,29.2,1748.7
4843068207,0,15,2,1,3,4,2,0,0,0,0,16929,7.0,17484,207,57,-726,-1559,26.4,1692.9,13,1,0,4,3,4,1,1,0,0,17655,7.2,19043,214,62,726,1559,27.6,1765.5
4842991237,0,13,3,0,9,8,9,0,0,0,0,18445,7.0,18728,211,71,584,850,28.2,1844.5,53,1,1,8,9,4,1,1,0,0,17861,6.8,17878,194,52,-584,-850,24.6,1786.1
4842958157,0,11,5,0,8,4,9,0,0,0,0,19672,7.4,19131,213,43,4031,1436,25.6,1967.2,15,0,1,4,8,2,1,0,1,0,15641,6.8,17695,196,63,-4031,-1436,25.9,1564.1
4842942857,1,82,1,1,12,3,17,1,1,0,0,19347,7.2,18258,221,52,3749,1163,27.3,1934.7,11,1,0,3,12,4,0,0,0,0,15598,6.6,17095,232,60,-3749,-1163,29.2,1559.8
4842915885,1,15,2,1,6,4,3,0,0,0,0,17931,7.0,18715,237,65,2163,960,30.2,1793.1,11,2,0,4,6,3,1,0,1,0,15768,7.0,17755,218,42,-2163,-960,26.0,1576.8
4842286213,0,12,0,0,8,7,5,0,0,0,0,16695,7.0,18128,186,57,-1763,-20,24.3,1669.5,14,0,1,7,8,12,1,1,0,0,18458,7.0,18148,221,56,1763,20,27.7,1845.8
4841060153,1,33,1,1,10,2,16,1,1,0,0,19866,7.4,19798,249,68,4874,2623,31.7,1986.6,15,1,0,2,10,3,0,0,0,0,14992,6.8,17175,209,56,-4874,-2623,26.5,1499.2
4839542256,0,32,0,1,4,5,5,0,0,0,0,16357,7.2,18816,234,52,-131,-451,28.6,1635.7,32,1,0,5,4,3,0,0,0,0,16488,7.4,19267,197,64,131,451,26.1,1648.8
4839528565,0,71,1,0,5,11,2,0,0,0,0,17323,6.4,16385,177,40,-3131,-938,21.7,1732.3,13,4,1,11,5,13,2,1,1,0,20454,6.6,17323,212,40,3131,938,25.2,2045.4
4839527799,1,20,1,1,6,1,2,0,0,0,0,18302,7.4,19652,244,59,5398,4875,30.3,1830.2,11,3,0,1,6,0,1,1,0,0,12904,6.2,14777,147,62,-5398,-4875,20.9,1290.4
4839508624,1,18,1,1,8,2,12,0,0,0,0,18612,7.2,19187,240,47,2535,1659,28.7,1861.2,74,0,0,2,8,1,0,0,0,0,16077,6.8,17528,211,56,-2535,-1659,26.7,1607.7
4838363267,1,12,2,0,6,4,4,0,0,0,0,16958,6.8,17679,217,64,1722,903,28.1,1695.8,13,2,1,4,6,2,0,0,0,0,15236,6.6,16776,172,64,-1722,-903,23.6,1523.6
4838318490,0,51,0,1,8,5,9,0,0,0,0,17760,7.2,18383,221,57,1114,363,27.8,1776.0,15,1,0,5,8,10,1,1,0,0,16646,7.0,18020,212,60,-1114,-363,27.2,1664.6
4838270071,1,14,4,1,7,5,5,0,0,0,0,18344,7.4,19351,248,60,2693,621,30.8,1834.4,15,0,0,5,7,5,0,0,0,0,15651,7.2,18730,202,40,-2693,-621,24.2,1565.1
4835224680,0,0,0,1,28,37,67,0,0,0,0,37584,11.2,41256,108,0,-2124,-5705,10.8,3758.4,0,0,0,37,28,116,0,0,0,0,39708,12.0,46961,119,0,2124,5705,11.9,3970.8
4832769538,1,14,3,0,6,6,5,2,1,1,0,18609,7.0,18635,229,57,2436,2676,28.6,1860.9,11,2,1,6,6,8,0,0,0,0,16173,6.6,15959,183,42,-2436,-2676,22.5,1617.3
4832746460,1,14,1,1,14,5,14,0,0,0,0,19106,6.8,17947,212,60,3379,1605,27.2,1910.6,17,1,0,5,14,3,0,0,0,0,15727,6.6,16342,198,48,-3379,-1605,24.6,1572.7
4832094617,1,13,1,0,4,7,5,0,0,0,0,17204,7.2,18536,236,56,-131,16,29.2,1720.4,8,1,1,7,4,10,0,0,0,0,17335,7.2,18520,224,52,131,-16,27.6,1733.5
4832080778,0,13,0,0,2,8,1,0,0,0,0,16930,6.6,17472,210,59,133,-211,26.9,1693.0,14,0,1,8,2,7,0,0,0,0,16797,6.8,17683,202,60,-133,211,26.2,1679.7
4855448826,0,0,2,1,31,31,71,0,0,0,2,39729,11.6,43240,111,0,-65,5,11.1,3972.9,22,0,0,31,31,72,0,0,0,0,39794,11.4,43235,116,0,65,-5,11.6,3979.4
4855434083,1,0,0,0,31,27,88,0,0,0,1,39858,11.6,42898,104,0,1146,1489,10.4,3985.8,15,0,1,27,31,75,0,0,0,0,38712,11.2,41409,94,0,-1146,-1489,9.4,3871.2
4855414143,1,34,6,0,22,24,69,0,0,0,1,38501,11.0,40569,120,0,2224,-185,12.0,3850.1,75,0,1,24,22,60,0,0,0,0,36277,11.2,40754,92,0,-2224,185,9.2,3627.7
4855395328,0,15,6,0,17,27,51,0,0,0,1,33720,10.6,36036,103,0,-4567,-4292,10.3,3372.0,33,0,1,27,17,69,0,0,0,0,38287,11.0,40328,107,0,4567,4292,10.7,3828.7
4853474736,1,0,0,1,19,17,22,0,0,0,0,68465,12.8,61000,0,0,31002,25000,0.0,6846.5,2,0,0,11,13,9,0,0,0,0,37463,7.6,36000,0,0,-31002,-25000,0.0,3746.3
4853460922,1,7,2,0,23,14,20,0,0,0,0,48770,10.0,47500,2,0,20870,19000,0.2,4877.0,17,0,1,6,15,7,0,0,0,0,27900,6.0,28500,1,0,-20870,-19000,0.1,2790.0
4853442571,1,3,3,1,23,18,21,0,0,0,0,48070,10.0,47500,0,0,20065,19000,0.0,4807.0,40,1,0,8,13,8,0,0,0,0,28005,6.0,28500,6,0,-20065,-19000,0.6,2800.5
4853431133,1,0,0,0,21,21,55,0,0,0,0,37184,11.0,40644,100,0,1309,546,10.0,3718.4,0,0,1,21,21,48,0,0,0,0,35875,11.0,40098,101,0,-1309,-546,10.1,3587.5
4853166873,1,383,0,1,18,17,17,0,0,0,0,46100,10.2,48500,3,0,18250,18500,0.3,4610.0,37,0,0,9,10,12,0,0,0,0,27850,6.4,30000,0,0,-18250,-18500,0.0,2785.0
4853151897,1,6,0,1,21,15,15,0,0,0,0,47350,10.2,48680,0,0,20200,20180,0.0,4735.0,0,0,0,6,12,11,0,0,0,0,27150,6.0,28500,0,0,-20200,-20180,0.0,2715.0
4853130038,1,0,0,0,18,19,18,0,0,0,0,45950,10.0,47500,0,0,17400,19000,0.0,4595.0,6,0,1,10,9,14,0,0,0,0,28550,6.0,28500,0,0,-17400,-19000,0.0,2855.0
4853112288,1,382,4,0,16,19,17,0,0,0,0,46370,10.2,48680,2,0,17445,20180,0.2,4637.0,0,5,1,11,8,10,0,0,0,0,28925,6.0,28500,0,0,-17445,-20180,0.0,2892.5
4853096113,1,19,0,0,22,20,25,0,0,0,0,64563,12.0,55000,4,0,27001,21000,0.4,6456.3,80,0,1,10,12,6,0,0,0,0,37562,7.4,34000,1,0,-27001,-21000,0.1,3756.2
4853069160,1,21,0,0,20,20,19,0,0,0,0,62700,12.0,55000,0,0,24184,22000,0.0,6270.0,0,0,1,10,10,13,0,0,0,0,38516,7.2,33000,0,0,-24184,-22000,0.0,3851.6
4852949353,1,16,0,1,27,26,85,0,0,0,1,37987,11.4,42330,122,0,-1732,-650,12.2,3798.7,2,0,0,26,27,74,0,0,0,0,39719,11.4,42980,105,0,1732,650,10.5,3971.9
4851066229,0,9,0,0,24,37,51,0,0,0,2,37358,11.2,41545,98,0,-2965,-3888,9.8,3735.8,0,0,1,37,24,85,0,0,0,0,40323,11.8,45433,114,0,2965,3888,11.4,4032.3
4851049982,0,21,0,0,22,40,43,0,0,0,1,35731,10.6,38573,83,0,-8112,-7534,8.3,3573.1,37,5,1,40,22,97,0,0,0,0,43843,11.6,46107,119,0,8112,7534,11.9,4384.3
4850976468,1,26,0,1,25,24,71,0,0,0,1,37959,11.0,40141,103,0,90,-19,10.3,3795.9,0,3,0,24,25,62,0,0,0,0,37869,11.0,40160,105,0,-90,19,10.5,3786.9
4850951621,1,26,0,1,24,21,63,0,0,0,2,37059,11.0,39443,107,0,317,-1042,10.7,3705.9,0,0,0,21,24,42,0,0,0,0,36742,11.2,40485,105,0,-317,1042,10.5,3674.2
4850666576,1,0,0,1,31,21,81,0,0,0,1,39654,11.8,44185,116,0,2939,3091,11.6,3965.4,0,0,0,21,31,42,0,0,0,0,36715,11.2,41094,91,0,-2939,-3091,9.1,3671.5
4825898368,1,14,2,0,8,6,6,0,0,0,0,18627,6.6,17587,204,60,2350,796,26.4,1862.7,10,1,1,6,8,5,1,1,0,0,16277,6.8,16791,206,48,-2350,-796,25.4,1627.7
4825864187,0,9,0,1,6,5,8,0,0,0,0,17824,7.2,18935,219,68,1684,-441,28.7,1782.4,10,0,0,5,6,5,1,1,0,0,16140,7.0,19376,215,80,-1684,441,29.5,1614.0
4819084550,0,10,0,1,3,4,3,0,0,0,0,17473,7.2,19645,247,70,869,653,31.7,1747.3,12,0,0,4,3,4,1,1,0,0,16604,7.4,18992,246,63,-869,-653,30.9,1660.4
4819031589,1,48,2,0,6,3,4,0,0,0,0,16463,7.0,18153,205,67,-56,250,27.2,1646.3,18,0,1,3,6,4,0,0,0,0,16519,7.0,17903,213,56,56,-250,26.9,1651.9
4818934929,1,14,3,1,7,8,8,0,0,0,0,18275,7.2,18988,227,60,125,1613,28.7,1827.5,76,3,0,8,7,6,0,0,0,0,18150,7.0,17375,203,64,-125,-1613,26.7,1815.0
4818902284,1,32,3,1,5,2,9,0,0,0,0,17514,7.4,18853,260,64,1527,789,32.4,1751.4,33,3,0,2,5,5,0,0,0,0,15987,6.8,18064,244,54,-1527,-789,29.8,1598.7
4818854821,0,18,2,1,5,1,5,1,1,0,0,16812,7.2,18216,225,72,1511,-338,29.7,1681.2,12,1,0,1,5,1,0,0,0,0,15301,6.8,18554,221,51,-1511,338,27.2,1530.1
4818809259,0,13,1,0,3,8,4,0,0,0,0,15995,7.0,17503,251,51,-2022,-1185,30.2,1599.5,45,2,1,8,3,12,1,1,0,0,18017,7.2,18688,202,52,2022,1185,25.4,1801.7
4818779883,1,13,2,0,9,4,9,1,1,0,0,18974,7.0,18476,225,56,3416,803,28.1,1897.4,10,1,1,4,9,4,0,0,0,0,15558,6.8,17673,229,48,-3416,-803,27.7,1555.8
4818028033,1,14,2,0,7,7,8,0,0,0,0,17956,7.0,18486,242,55,-350,603,29.7,1795.6,22,2,1,7,7,10,1,0,1,0,18306,7.0,17883,221,60,350,-603,28.1,1830.6
4817974396,1,50,1,0,3,4,3,1,1,0,0,15286,7.0,18035,218,58,-945,-164,27.6,1528.6,8,0,1,4,3,2,0,0,0,0,16231,7.0,18199,255,56,945,164,31.1,1623.1
4817459167,0,16,1,0,9,8,9,1,0,1,0,19144,7.0,18136,225,48,114,-49,27.3,1914.4,13,1,1,8,9,8,0,0,0,0,19030,7.0,18185,221,52,-114,49,27.3,1903.0
4816536946,0,10,0,0,4,8,5,0,0,0,0,15886,6.6,17356,180,50,-2097,-1016,23.0,1588.6,13,1,1,8,4,7,0,0,0,0,17983,7.0,18372,233,60,2097,1016,29.3,1798.3
4816516819,0,14,3,0,5,9,4,1,1,0,0,18058,7.2,18535,226,64,-1429,-882,29.0,1805.8,12,0,1,9,5,13,0,0,0,0,19487,7.2,19417,249,64,1429,882,31.3,1948.7
4816481203,0,11,2,1,2,2,4,1,1,0,0,15286,6.8,17783,225,71,291,220,29.6,1528.6,17,1,0,2,2,2,1,0,1,0,14995,6.6,17563,230,56,-291,-220,28.6,1499.5
4811511395,0,13,4,0,4,9,7,0,0,0,0,15793,6.6,16830,232,48,-3829,-2095,28.0,1579.3,14,2,1,9,4,9,0,0,0,0,19622,7.2,18925,236,67,3829,2095,30.3,1962.2
4811490827,1,14,1,1,21,2,8,1,1,0,0,20631,7.4,20688,230,68,7204,5284,29.8,2063.1,4,0,0,2,21,1,0,0,0,0,13427,6.4,15404,180,48,-7204,-5284,22.8,1342.7
4807636253,0,14,0,1,8,5,8,0,0,0,0,17963,6.6,16973,198,46,1014,-1276,24.4,1796.3,10,0,0,5,8,5,0,0,0,0,16949,7.0,18249,201,61,-1014,1276,26.2,1694.9
4806240154,0,12,0,0,2,6,1,0,0,0,0,15873,7.0,18327,215,64,-2819,-1244,27.9,1587.3,12,0,1,6,2,6,0,0,0,0,18692,7.2,19571,253,64,2819,1244,31.7,1869.2
4805562730,0,16,1,1,3,1,2,0,0,0,0,17139,7.2,19299,250,52,1839,604,30.2,1713.9,9,0,0,1,3,1,0,0,0,0,15300,7.0,18695,246,68,-1839,-604,31.4,1530.0
4838348402,0,10,0,0,8,8,7,0,0,0,0,16911,6.6,17304,208,36,-1031,-232,24.4,1691.1,8,2,1,8,8,11,0,0,0,0,17942,6.8,17536,193,68,1031,232,26.1,1794.2
4837893619,1,13,0,1,11,5,10,1,1,0,0,17795,6.6,16718,178,44,316,-1625,22.2,1779.5,9,0,0,5,11,3,0,0,0,0,17479,7.2,18343,222,57,-316,1625,27.9,1747.9
4837864917,1,21,0,0,5,2,2,0,0,0,0,16506,6.8,17740,221,58,1651,869,27.9,1650.6,69,0,1,2,5,1,0,0,0,0,14855,6.6,16871,216,56,-1651,-869,27.2,1485.5
4837822384,1,12,0,0,5,5,4,1,1,0,0,16445,7.2,18484,242,47,7,279,28.9,1644.5,25,0,1,5,5,3,0,0,0,0,16438,7.0,18205,210,69,-7,-279,27.9,1643.8
4837797420,0,10,1,0,3,3,3,0,0,0,0,17076,7.0,18065,227,56,1671,855,28.3,1707.6,11,0,1,3,3,4,2,1,1,0,15405,6.6,17210,231,52,-1671,-855,28.3,1540.5
4836578993,1,10,4,1,3,2,3,0,0,0,0,16792,6.8,18257,214,74,427,1045,28.8,1679.2,14,2,0,2,3,5,2,1,1,0,16365,6.8,17212,226,60,-427,-1045,28.6,1636.5
4832840909,1,13,0,1,7,6,4,0,0,0,0,17796,7.4,18832,233,64,-131,304,29.7,1779.6,11,0,0,6,7,9,0,0,0,0,17927,7.0,18528,188,64,131,-304,25.2,1792.7
4832818856,0,10,2,0,3,7,2,0,0,0,0,15816,7.0,18273,251,60,-1892,-1571,31.1,1581.6,12,1,1,7,3,6,1,1,0,0,17708,7.4,19844,244,76,1892,1571,32.0,1770.8
4832783895,0,49,2,1,4,6,4,0,0,0,0,15947,7.0,18232,207,68,-2223,-568,27.5,1594.7,16,3,0,6,4,5,0,0,0,0,18170,7.0,18800,247,53,2223,568,30.0,1817.0
4832764406,1,43,1,1,9,7,9,0,0,0,0,19848,7.2,18872,208,67,3359,1149,27.5,1984.8,12,2,0,7,9,4,0,0,0,0,16489,7.0,17723,217,56,-3359,-1149,27.3,1648.9
4832742159,0,16,2,0,7,4,8,0,0,0,0,16371,7.0,18125,233,55,239,656,28.8,1637.1,15,0,1,4,7,3,0,0,0,0,16132,7.0,17469,236,48,-239,-656,28.4,1613.2
4832204612,1,37,0,0,6,3,2,1,1,0,0,17042,7.2,19648,218,72,1854,1911,29.0,1704.2,31,0,1,3,6,4,0,0,0,0,15188,7.0,17737,209,48,-1854,-1911,25.7,1518.8
4832159577,0,21,1,1,2,2,1,0,0,0,0,16362,7.2,19239,229,75,530,973,30.4,1636.2,14,2,0,2,2,2,0,0,0,0,15832,7.0,18266,255,40,-530,-973,29.5,1583.2
4831927122,0,24,2,1,8,6,9,0,0,0,0,18005,7.2,18528,227,56,1266,559,28.3,1800.5,12,4,0,5,7,6,0,0,0,0,16739,7.0,17969,219,58,-1266,-559,27.7,1673.9
4831901977,1,18,1,1,3,5,3,0,0,0,0,15091,7.0,17314,215,60,-859,-1456,27.5,1509.1,13,2,0,5,3,3,0,0,0,0,15950,7.4,18770,233,60,859,1456,29.3,1595.0
4831883602,1,30,0,1,8,4,5,0,0,0,0,18513,7.4,19248,230,63,3954,2407,29.3,1851.3,35,1,0,4,8,0,1,1,0,0,14559,6.6,16841,196,56,-3954,-2407,25.2,1455.9
4831408232,0,15,1,1,5,3,8,0,0,0,0,16620,7.0,17792,195,75,558,-487,27.0,1662.0,12,3,0,3,5,2,0,0,0,0,16062,7.0,18279,248,60,-558,487,30.8,1606.2
4831368288,0,13,3,1,9,6,11,0,0,0,0,17694,6.8,17121,204,46,-554,-1505,25.0,1769.4,15,2,0,6,9,4,0,0,0,0,18248,6.8,18626,205,71,554,1505,27.6,1824.8
4831046462,1,12,1,1,11,8,5,1,1,0,0,17965,6.6,17529,231,52,991,1662,28.3,1796.5,12,1,0,8,11,9,0,0,0,0,16974,6.4,15867,175,55,-991,-1662,23.0,1697.4
4844941700,1,13,2,0,11,7,10,0,0,0,0,18755,7.0,17624,216,54,3253,1427,27.0,1875.5,13,1,1,7,11,9,0,0,0,0,15502,6.6,16197,185,48,-3253,-1427,23.3,1550.2
4844913948,1,16,1,1,6,6,10,0,0,0,0,17453,7.0,17862,233,56,600,-1118,28.9,1745.3,10,2,0,6,6,4,2,1,1,0,16853,7.0,18980,217,68,-600,1118,28.5,1685.3
4844880473,0,106,3,0,2,6,1,0,0,0,0,15383,7.2,18375,228,64,-1251,3,29.2,1538.3,11,3,1,6,2,5,0,0,0,0,16634,7.0,18372,232,52,1251,-3,28.4,1663.4
4843452709,0,14,0,1,1,8,1,0,0,0,0,13607,6.4,15878,181,56,-4989,-3259,23.7,1360.7,16,1,0,8,1,4,0,0,0,0,18596,7.0,19137,242,48,4989,3259,29.0,1859.6
4843396737,0,55,8,1,4,0,7,0,0,0,0,16309,7.0,17800,237,44,2135,31,28.1,1630.9,26,0,0,0,4,0,0,0,0,0,14174,6.8,17769,226,60,-2135,-31,28.6,1417.4
4843348863,1,14,0,0,5,4,2,1,1,0,0,15976,7.0,18047,227,72,-310,82,29.9,1597.6,12,0,1,4,5,5,0,0,0,0,16286,7.0,17965,220,59,310,-82,27.9,1628.6
4843292007,1,99,0,0,8,4,8,0,0,0,0,17470,6.6,17812,214,52,1696,-809,26.6,1747.0,12,0,1,4,8,1,0,0,0,0,15774,7.2,18621,222,59,-1696,809,28.1,1577.4
4843235370,1,11,1,1,1,4,1,1,0,1,0,15025,7.0,18580,247,68,-2029,-746,31.5,1502.5,11,0,0,4,1,3,0,0,0,0,17054,7.2,19326,252,60,2029,746,31.2,1705.4
4843199226,0,13,3,0,4,6,3,0,0,0,0,15181,7.2,18100,211,52,-2752,-564,26.3,1518.1,13,3,1,6,4,6,1,1,0,0,17933,7.2,18664,256,72,2752,564,32.8,1793.3
4843165295,0,18,4,0,7,4,8,0,0,0,0,16643,7.2,18537,236,52,-79,434,28.8,1664.3,19,3,1,4,7,2,2,1,1,0,16722,7.0,18103,224,56,79,-434,28.0,1672.2
4843109786,0,39,3,1,4,2,5,0,0,0,0,16456,7.0,18220,240,52,1559,-82,29.2,1645.6,29,4,0,2,4,2,0,0,0,0,14897,7.0,18302,219,47,-1559,82,26.6,1489.7
4843068614,0,12,0,1,7,10,8,1,1,0,0,15254,6.4,15282,151,54,-2694,-3237,20.5,1525.4,10,0,0,10,7,5,0,0,0,0,17948,7.0,18519,212,50,2694,3237,26.2,1794.8
4843040595,0,20,0,0,4,4,2,0,0,0,0,15500,6.6,16998,211,60,-1202,-510,27.1,1550.0,48,2,1,4,4,4,0,0,0,0,16702,6.8,17508,238,55,1202,510,29.3,1670.2
4843007866,1,12,3,0,5,4,8,1,1,0,0,16679,7.2,19015,241,75,161,394,31.6,1667.9,13,0,1,4,5,3,0,0,0,0,16518,7.0,18621,268,59,-161,-394,32.7,1651.8
4842977240,0,13,2,1,4,2,2,1,1,0,0,16347,7.0,18853,239,64,342,-623,30.3,1634.7,25,2,0,2,4,2,0,0,0,0,16005,7.4,19476,227,62,-342,623,28.9,1600.5
4842863146,0,30,4,1,6,5,6,0,0,0,0,17141,7.0,17416,222,56,1760,200,27.8,1714.1,13,1,0,5,6,4,1,1,0,0,15381,7.0,17216,185,52,-1760,-200,23.7,1538.1
4842847021,1,56,3,1,2,4,2,1,1,0,0,14732,6.8,17457,198,52,-598,-210,25.0,1473.2,33,1,0,4,2,6,0,0,0,0,15330,6.8,17667,221,48,598,210,26.9,1533.0
4842823631,0,12,13,0,6,4,3,1,1,0,0,17439,7.0,18803,232,70,1899,773,30.2,1743.9,30,2,1,4,6,4,0,0,0,0,15540,7.0,18030,211,60,-1899,-773,27.1,1554.0
4842811614,0,14,2,1,9,5,8,1,1,0,0,17615,7.0,18441,212,72,1296,908,28.4,1761.5,13,3,0,5,9,3,0,0,0,0,16319,6.8,17533,230,51,-1296,-908,28.1,1631.9
4842797783,1,12,1,0,1,3,1,1,1,0,0,15062,7.0,18839,221,64,-1058,-7,28.5,1506.2,11,2,1,3,1,4,0,0,0,0,16120,7.2,18846,247,67,1058,7,31.4,1612.0
4852112063,1,11,0,1,3,4,5,1,1,0,0,15798,6.6,17694,217,52,-1657,-1090,26.9,1579.8,10,1,0,4,3,3,1,0,1,0,17455,7.0,18784,233,56,1657,1090,28.9,1745.5
4851925495,1,7,1,1,8,8,5,0,0,0,0,17811,6.8,17812,223,54,-325,352,27.7,1781.1,10,0,0,8,8,8,1,1,0,0,18136,6.8,17460,233,49,325,-352,28.2,1813.6
4851887113,1,25,5,1,12,6,14,0,0,0,0,19698,6.8,17583,231,60,4798,3032,29.1,1969.8,13,5,0,6,12,6,0,0,0,0,14900,6.2,14551,174,46,-4798,-3032,22.0,1490.0
4850252288,1,11,4,1,5,4,2,1,1,0,0,15833,7.0,18511,204,56,-610,1149,26.0,1583.3,12,1,0,4,5,3,1,0,1,0,16443,6.8,17362,209,52,610,-1149,26.1,1644.3
4850228622,0,14,0,1,7,5,10,1,1,0,0,16106,6.8,17459,203,40,-1082,-652,24.3,1610.6,13,1,0,5,7,5,0,0,0,0,17188,7.2,18111,230,56,1082,652,28.6,1718.8
4850210663,1,10,1,1,7,1,6,0,0,0,0,18129,7.4,19846,262,48,4224,2960,31.0,1812.9,12,2,0,1,7,1,0,0,0,0,13905,6.6,16886,208,64,-4224,-2960,27.2,1390.5
4850152872,1,13,2,0,11,7,5,0,0,0,0,17595,6.8,17666,169,60,-315,177,22.9,1759.5,8,0,1,7,11,3,1,1,0,0,17910,6.8,17489,194,52,315,-177,24.6,1791.0
4850105558,1,5,1,0,5,8,1,1,1,0,0,16526,6.6,17334,216,40,-808,545,25.6,1652.6,8,0,1,8,5,8,0,0,0,0,17334,6.8,16789,177,52,808,-545,22.9,1733.4
4850011291,0,18,6,1,9,6,7,1,0,1,0,17965,6.6,16816,158,55,696,-1038,21.3,1796.5,15,0,0,6,9,4,0,0,0,0,17269,7.0,17854,204,44,-696,1038,24.8,1726.9
4844293253,0,13,0,1,4,8,2,0,0,0,0,15484,6.6,17015,171,51,-2459,-2555,22.2,1548.4,14,1,0,8,4,6,1,1,0,0,17943,7.4,19570,206,50,2459,2555,25.6,1794.3
4844256315,0,11,1,0,4,5,3,0,0,0,0,15504,6.6,16111,155,52,-2070,-2758,20.7,1550.4,13,1,1,5,4,3,0,0,0,0,17574,7.2,18869,221,48,2070,2758,26.9,1757.4
4838211071,0,58,2,0,5,5,4,0,0,0,0,16021,6.8,17407,206,64,-2527,-1251,27.0,1602.1,15,5,1,5,5,7,0,0,0,0,18548,7.0,18658,266,44,2527,1251,31.0,1854.8
4837481299,1,14,2,1,5,3,4,0,0,0,0,16652,7.0,18432,231,64,30,404,29.5,1665.2,11,1,0,3,5,3,0,0,0,0,16622,7.2,18028,261,44,-30,-404,30.5,1662.2
4837275005,0,17,2,1,8,8,14,1,1,0,0,18235,6.6,16658,202,42,-201,-1263,24.4,1823.5,15,3,0,8,8,6,0,0,0,0,18436,6.8,17921,208,45,201,1263,25.3,1843.6
4836328176,1,12,1,0,8,7,3,0,0,0,0,18874,7.2,19063,214,59,2311,2223,27.3,1887.4,15,2,1,7,8,9,1,1,0,0,16563,6.6,16840,194,56,-2311,-2223,25.0,1656.3
4836248788,0,12,1,0,5,3,6,0,0,0,0,16082,6.8,17633,214,51,-719,-1339,26.5,1608.2,15,1,1,3,5,4,0,0,0,0,16801,7.2,18972,256,72,719,1339,32.8,1680.1
4835403931,0,13,1,1,5,4,4,0,0,0,0,16694,6.8,17682,249,60,1158,-427,30.9,1669.4,13,0,0,4,5,4,0,0,0,0,15536,7.0,18109,213,68,-1158,427,28.1,1553.6
4835389070,1,13,0,1,10,11,14,1,1,0,0,19010,6.8,16727,202,48,-661,-2273,25.0,1901.0,9,0,0,11,10,9,0,0,0,0,19671,7.4,19000,214,52,661,2273,26.6,1967.1
4835366633,1,12,3,0,8,8,10,0,0,0,0,17959,6.8,18113,200,62,998,724,26.2,1795.9,12,1,1,8,8,7,0,0,0,0,16961,6.8,17389,231,37,-998,-724,26.8,1696.1
