gameId,blueWins,blueWardsPlaced,blueWardsDestroyed,blueFirstBlood,blueKills,blueDeaths,blueAssists,blueEliteMonsters,blueDragons,blueHeralds,blueTowersDestroyed,blueTotalGold,blueAvgLevel,blueTotalExperience,blueTotalMinionsKilled,blueTotalJungleMinionsKilled,blueGoldDiff,blueExperienceDiff,blueCSPerMin,blueGoldPerMin,redWardsPlaced,redWardsDestroyed,redFirstBlood,redKills,redDeaths,redAssists,redEliteMonsters,redDragons,redHeralds,redTowersDestroyed,redTotalGold,redAvgLevel,redTotalExperience,redTotalMinionsKilled,redTotalJungleMinionsKilled,redGoldDiff,redExperienceDiff,redCSPerMin,redGoldPerMin
4812159823,1,48,2,0,8,7,7,1,1,0,0,15876,6.8,16805,161,48,17,1020,20.9,1587.6,12,0,1,7,8,4,0,0,0,0,15859,6.6,15785,153,44,-17,-1020,19.7,1585.9
4812115700,0,15,2,0,3,10,6,0,0,0,0,14023,6.6,16413,160,64,-4014,-2287,22.4,1402.3,13,1,1,10,3,5,0,0,0,0,18037,7.2,18700,212,48,4014,2287,26.0,1803.7
4812089556,0,12,3,1,4,10,4,0,0,0,0,14585,6.4,15648,120,40,-3737,-2346,16.0,1458.5,14,2,0,10,4,8,0,0,0,0,18322,7.0,17994,182,56,3737,2346,23.8,1832.2
4812049589,0,17,1,0,4,3,3,0,0,0,0,15730,7.0,18618,192,59,956,1849,25.1,1573.0,14,1,1,3,4,1,0,0,0,0,14774,6.6,16769,201,40,-956,-1849,24.1,1477.4
4812009081,1,13,0,1,7,7,12,0,0,0,0,18046,6.8,18403,164,52,705,771,21.6,1804.6,12,0,0,7,7,8,1,1,0,0,17341,6.8,17632,198,56,-705,-771,25.4,1734.1
4853975110,0,26,0,0,2,1,0,0,0,0,0,13774,6.8,18121,193,52,-89,-32,24.5,1377.4,8,0,1,1,2,0,0,0,0,0,13863,6.8,18153,206,60,89,32,26.6,1386.3
4850615084,0,92,0,1,1,0,2,0,0,0,0,14234,7.2,18658,192,55,844,894,24.7,1423.4,15,16,0,0,1,0,0,0,0,0,13390,6.8,17764,194,44,-844,-894,23.8,1339.0
4849753141,1,8,1,1,4,3,2,0,0,0,0,15247,7.2,18173,180,36,1638,2055,21.6,1524.7,71,0,0,3,4,2,0,0,0,0,13609,6.6,16118,159,44,-1638,-2055,20.3,1360.9
4848620468,1,17,1,1,18,6,10,0,0,0,0,19488,7.0,18894,164,56,3836,2029,22.0,1948.8,10,0,0,6,18,1,0,0,0,0,15652,6.6,16865,169,48,-3836,-2029,21.7,1565.2
4847881157,0,20,2,1,6,4,8,0,0,0,0,15292,6.8,17184,191,44,796,-1130,23.5,1529.2,12,1,0,4,6,3,0,0,0,0,14496,7.0,18314,186,52,-796,1130,23.8,1449.6
4847046259,1,19,1,0,5,3,4,0,0,0,0,15776,6.8,17642,210,40,2013,2170,25.0,1577.6,14,2,1,3,5,1,0,0,0,0,13763,6.0,15472,140,36,-2013,-2170,17.6,1376.3
4844021265,1,9,0,0,2,4,1,1,1,0,0,13941,6.8,16783,177,48,-1642,-336,22.5,1394.1,76,0,1,4,2,1,0,0,0,0,15583,6.6,17119,190,52,1642,336,24.2,1558.3
4843989262,1,17,1,1,4,1,4,1,1,0,0,15202,7.0,17116,164,52,1732,103,21.6,1520.2,64,0,0,1,4,0,0,0,0,0,13470,6.6,17013,165,56,-1732,-103,22.1,1347.0
4836696119,1,39,1,1,6,3,5,0,0,0,0,15334,6.4,15962,161,51,1167,-1329,21.2,1533.4,77,0,0,3,6,4,1,1,0,0,14167,6.6,17291,176,60,-1167,1329,23.6,1416.7
4836660407,1,24,1,0,2,3,0,0,0,0,0,13373,6.8,17257,156,60,-266,-833,21.6,1337.3,74,1,1,2,1,0,0,0,0,0,13639,6.8,18090,158,57,266,833,21.5,1363.9
4835749516,0,69,0,0,0,6,0,0,0,0,0,13220,6.4,15752,178,56,-1945,-2200,23.4,1322.0,19,0,1,6,0,0,0,0,0,0,15165,6.6,17952,198,40,1945,2200,23.8,1516.5
4835727160,0,85,0,0,3,2,0,0,0,0,0,13768,6.2,15997,177,40,-815,-665,21.7,1376.8,10,1,1,2,3,3,1,1,0,0,14583,6.8,16662,181,44,815,665,22.5,1458.3
4834792958,0,11,0,0,1,4,0,0,0,0,0,13442,6.8,17163,199,52,-893,6,25.1,1344.2,85,1,1,4,1,3,1,1,0,0,14335,6.6,17157,148,52,893,-6,20.0,1433.5
4832136407,1,16,1,1,3,1,0,0,0,0,0,15699,7.2,18527,236,52,925,331,28.8,1569.9,22,0,0,1,3,1,0,0,0,0,14774,7.0,18196,205,64,-925,-331,26.9,1477.4
4830398646,1,10,1,1,10,10,3,1,1,0,0,17008,6.6,16708,170,48,799,501,21.8,1700.8,71,0,0,9,9,6,0,0,0,0,16209,6.6,16207,154,44,-799,-501,19.8,1620.9
4830262552,1,60,2,0,1,4,1,0,0,0,0,13666,6.6,16438,182,52,-1240,-1391,23.4,1366.6,245,0,1,4,1,0,1,1,0,0,14906,6.8,17829,169,56,1240,1391,22.5,1490.6
4830243649,1,74,1,0,2,5,2,0,0,0,0,15672,6.6,17374,204,52,640,243,25.6,1567.2,14,0,1,5,2,2,0,0,0,0,15032,6.8,17131,185,56,-640,-243,24.1,1503.2
4829503985,0,10,0,0,1,4,1,0,0,0,0,13850,6.8,16920,196,40,-1245,-1314,23.6,1385.0,79,0,1,4,1,3,1,1,0,0,15095,7.2,18234,183,52,1245,1314,23.5,1509.5
4829446705,1,13,3,0,2,1,0,0,0,0,0,14065,7.0,17964,196,46,1170,2814,24.2,1406.5,69,2,1,1,2,1,0,0,0,0,12895,6.2,15150,158,50,-1170,-2814,20.8,1289.5
4857195381,0,18,0,1,3,4,3,0,0,0,0,13472,6.8,17230,121,52,-1123,-1176,17.3,1347.2,21,0,0,4,3,1,1,1,0,0,14595,7.0,18406,188,48,1123,1176,23.6,1459.5
4855747728,1,14,0,1,4,6,1,0,0,0,0,14651,6.8,17169,147,56,317,108,20.3,1465.1,11,0,0,6,4,2,0,0,0,0,14334,6.8,17061,146,44,-317,-108,19.0,1433.4
4854014171,0,17,2,0,1,7,1,0,0,0,0,13373,6.4,15888,153,55,-2435,-1893,20.8,1337.3,11,1,1,7,1,3,1,1,0,0,15808,7.0,17781,182,40,2435,1893,22.2,1580.8
4853967672,1,12,0,1,4,1,1,0,0,0,0,14621,6.8,17504,166,44,3278,2032,21.0,1462.1,16,0,0,1,4,1,0,0,0,0,11343,6.2,15472,118,32,-3278,-2032,15.0,1134.3
4853745371,1,25,2,0,5,2,5,0,0,0,0,16348,6.8,18033,216,55,2683,1402,27.1,1634.8,8,2,1,2,5,1,0,0,0,0,13665,6.6,16631,177,44,-2683,-1402,22.1,1366.5
4852731731,1,8,0,0,3,5,3,1,1,0,0,13145,6.4,16367,168,36,-1563,-422,20.4,1314.5,21,0,1,5,3,8,0,0,0,0,14708,6.8,16789,162,52,1563,422,21.4,1470.8
4852603920,1,25,2,0,4,4,4,1,1,0,0,14808,6.8,18122,178,64,779,158,24.2,1480.8,15,2,1,4,4,0,0,0,0,0,14029,6.8,17964,169,56,-779,-158,22.5,1402.9
4850012002,0,11,0,0,3,6,1,0,0,0,0,14224,6.6,17060,174,48,-1499,72,22.2,1422.4,9,0,1,6,3,5,0,0,0,0,15723,6.6,16988,167,40,1499,-72,20.7,1572.3
4848501198,0,26,0,0,3,6,2,0,0,0,0,13690,5.6,13758,171,5,-1484,-2320,17.6,1369.0,76,16,1,6,3,6,1,1,0,0,15174,6.4,16078,166,56,1484,2320,22.2,1517.4
4847941274,1,8,0,0,3,5,3,0,0,0,0,13315,6.4,16150,164,44,-1433,-1498,20.8,1331.5,9,0,1,5,3,0,1,1,0,0,14748,6.8,17648,170,56,1433,1498,22.6,1474.8
4847784782,0,14,0,0,4,5,5,0,0,0,0,15306,6.8,17036,166,56,-1463,-627,22.2,1530.6,28,1,1,5,4,5,0,0,0,0,16769,6.8,17663,184,52,1463,627,23.6,1676.9
4847730126,1,11,0,0,16,5,17,0,0,0,0,20203,6.6,17233,183,44,6288,3388,22.7,2020.3,7,0,1,5,16,9,1,0,1,0,13915,5.8,13845,105,56,-6288,-3388,16.1,1391.5
4846845166,0,6,1,0,4,7,2,0,0,0,0,14460,6.4,15885,175,48,-1876,-2126,22.3,1446.0,14,0,1,7,4,3,1,1,0,0,16336,7.0,18011,168,68,1876,2126,23.6,1633.6
4846052471,1,21,1,1,7,1,3,0,0,0,0,16645,7.0,18721,207,64,3505,1432,27.1,1664.5,13,0,0,1,7,0,0,0,0,0,13140,6.8,17289,173,52,-3505,-1432,22.5,1314.0
4844998261,0,15,1,1,5,5,5,0,0,0,0,14957,6.6,16952,141,48,-2412,-1124,18.9,1495.7,319,2,0,5,5,4,1,1,0,0,17369,7.2,18076,200,54,2412,1124,25.4,1736.9
4843975299,0,140,7,0,3,5,3,1,1,0,0,13825,6.4,16808,171,44,-1781,-1581,21.5,1382.5,31,0,1,5,3,2,0,0,0,0,15606,7.0,18389,186,52,1781,1581,23.8,1560.6
4842938340,0,15,1,0,4,4,3,0,0,0,0,14771,7.0,17594,191,43,-691,-306,23.4,1477.1,20,0,1,4,4,4,0,0,0,0,15462,7.0,17900,175,60,691,306,23.5,1546.2
4842415917,0,14,1,1,7,5,7,0,0,0,0,15592,6.4,15886,148,52,86,-406,20.0,1559.2,25,0,0,5,7,5,1,1,0,0,15506,6.4,16292,163,40,-86,406,20.3,1550.6
4841193648,0,17,1,0,5,7,6,1,1,0,0,15743,6.4,16309,162,52,-243,54,21.4,1574.3,10,0,1,7,5,9,0,0,0,0,15986,6.6,16255,196,38,243,-54,23.4,1598.6
4840963270,0,11,1,0,0,4,0,0,0,0,0,13341,6.6,17084,161,48,-1761,-610,20.9,1334.1,11,1,1,4,0,3,0,0,0,0,15102,7.0,17694,182,36,1761,610,21.8,1510.2
4759974407,1,30,0,1,5,3,2,0,0,0,0,16258,7.2,19550,180,52,2756,1474,23.2,1625.8,6,9,0,2,4,0,0,0,0,0,13502,7.0,18076,135,52,-2756,-1474,18.7,1350.2
4747692264,1,12,0,0,0,0,0,1,1,0,0,12498,7.0,18315,122,52,-513,1999,17.4,1249.8,11,0,0,0,0,0,0,0,0,0,13011,6.4,16316,170,51,513,-1999,22.1,1301.1
4747673374,0,11,0,0,8,11,6,0,0,0,0,16065,6.4,16550,140,51,-4342,-1959,19.1,1606.5,9,0,1,11,8,11,0,0,0,0,20407,7.0,18509,188,36,4342,1959,22.4,2040.7
4732809012,0,15,2,0,5,11,5,0,0,0,0,15326,6.6,16337,169,44,-2015,-1193,21.3,1532.6,24,2,1,11,5,6,0,0,0,0,17341,6.8,17530,151,56,2015,1193,20.7,1734.1
4732769565,1,9,2,0,11,11,5,0,0,0,0,19000,6.8,18210,219,46,552,1614,26.5,1900.0,12,1,1,11,11,6,0,0,0,0,18448,6.6,16596,178,44,-552,-1614,22.2,1844.8
4732740839,1,16,1,0,4,3,3,0,0,0,0,16377,6.6,17399,209,60,2924,1671,26.9,1637.7,159,0,1,3,4,4,1,1,0,0,13453,6.2,15728,150,44,-2924,-1671,19.4,1345.3
4732663157,0,12,0,1,5,2,5,0,0,0,0,15531,6.8,17546,155,52,2162,308,20.7,1553.1,196,0,0,2,5,1,2,1,1,0,13369,6.8,17238,146,52,-2162,-308,19.8,1336.9
4700328998,0,11,0,1,3,3,4,1,1,0,0,14197,6.6,17017,135,60,-1035,-1439,19.5,1419.7,11,0,0,3,3,3,0,0,0,0,15232,7.0,18456,217,50,1035,1439,26.7,1523.2
4693953609,0,13,0,0,3,8,3,1,1,0,0,13284,6.4,15330,121,52,-3606,-2569,17.3,1328.4,59,3,1,8,3,6,0,0,0,0,16890,7.0,17899,162,48,3606,2569,21.0,1689.0
4693050147,1,30,0,1,9,0,6,1,0,1,0,17067,7.0,18259,169,40,4837,1522,20.9,1706.7,28,0,0,0,9,0,0,0,0,0,12230,6.6,16737,139,60,-4837,-1522,19.9,1223.0
4693037968,1,13,2,1,12,1,1,0,0,0,0,17344,7.0,18250,194,40,5314,3556,23.4,1734.4,11,1,0,0,11,0,0,0,0,0,12030,6.4,14694,127,36,-5314,-3556,16.3,1203.0
4692998042,0,62,11,1,7,3,8,0,0,0,0,16757,6.8,17490,148,48,730,-348,19.6,1675.7,34,0,0,3,7,3,1,1,0,0,16027,7.0,17838,180,64,-730,348,24.4,1602.7
4692982901,0,7,0,1,17,3,16,0,0,0,0,18556,6.6,16540,132,0,6969,3702,13.2,1855.6,0,0,0,3,17,0,0,0,0,0,11587,5.6,12838,81,0,-6969,-3702,8.1,1158.7
4692943725,1,19,2,1,12,2,5,0,0,0,0,21688,7.4,19999,218,55,8647,4829,27.3,2168.8,36,0,0,2,12,2,0,0,0,0,13041,6.2,15170,152,42,-8647,-4829,19.4,1304.1
4663556919,1,9,1,1,7,8,7,0,0,0,0,15368,6.4,15091,146,52,-1518,-2000,19.8,1536.8,19,0,0,8,7,11,0,0,0,0,16886,6.8,17091,157,48,1518,2000,20.5,1688.6
4663534741,1,14,2,1,8,3,8,1,1,0,0,16467,6.6,16435,194,36,3467,-336,23.0,1646.7,20,1,0,1,6,0,0,0,0,0,13000,6.6,16771,181,49,-3467,336,23.0,1300.0
4663471628,1,13,1,0,4,5,5,0,0,0,0,15486,7.0,18541,162,48,-467,1292,21.0,1548.6,13,2,1,5,4,3,0,0,0,0,15953,6.8,17249,190,44,467,-1292,23.4,1595.3
4663426579,0,13,13,0,3,11,0,0,0,0,0,14588,6.8,17227,176,56,-3487,-1045,23.2,1458.8,42,2,1,11,3,8,1,1,0,0,18075,7.0,18272,173,48,3487,1045,22.1,1807.5
4663385355,1,11,1,1,6,6,2,0,0,0,0,15040,6.8,16720,160,56,-873,265,21.6,1504.0,17,1,0,6,6,5,0,0,0,0,15913,6.6,16455,180,44,873,-265,22.4,1591.3
4662307854,0,0,0,0,27,30,74,0,0,0,1,39512,11.4,43356,94,0,1072,-808,9.4,3951.2,0,0,1,30,27,66,0,0,0,0,38440,11.6,44164,109,0,-1072,808,10.9,3844.0
4855783270,0,0,0,0,17,23,49,0,0,0,0,34211,10.4,37014,97,0,-4038,-4301,9.7,3421.1,0,0,1,23,17,60,0,0,0,0,38249,11.2,41315,110,0,4038,4301,11.0,3824.9
4853630879,1,113,0,1,21,23,56,0,0,0,0,32998,10.6,37443,53,0,-3134,-1208,5.3,3299.8,0,0,0,23,21,61,0,0,0,0,36132,10.8,38651,92,0,3134,1208,9.2,3613.2
4853614210,0,38,0,0,18,21,41,0,0,0,0,36782,11.0,39343,106,0,-923,95,10.6,3678.2,0,23,1,21,18,44,0,0,0,0,37705,11.2,39248,96,0,923,-95,9.6,3770.5
4853596221,0,0,0,0,7,22,9,0,0,0,1,33852,10.6,36193,107,0,-1462,-2145,10.7,3385.2,0,0,1,22,7,59,0,0,0,0,35314,11.0,38338,110,0,1462,2145,11.0,3531.4
4852579968,1,0,0,0,23,25,68,0,0,0,0,37566,11.4,41490,94,0,-27,1252,9.4,3756.6,0,0,1,25,23,72,0,0,0,0,37593,11.2,40238,85,0,27,-1252,8.5,3759.3
4852550590,1,0,0,0,12,7,26,0,0,0,0,32672,10.2,35001,95,0,1225,2571,9.5,3267.2,0,0,1,7,12,13,0,0,0,0,31447,10.0,32430,110,0,-1225,-2571,11.0,3144.7
4852535343,0,0,0,0,25,21,45,0,0,0,1,37101,11.2,42144,94,0,2144,4313,9.4,3710.1,0,0,1,21,25,48,0,0,0,0,34957,10.6,37831,85,0,-2144,-4313,8.5,3495.7
4851490612,0,0,0,0,24,42,49,0,0,0,2,38322,11.8,43395,106,0,-3894,-3054,10.6,3832.2,20,0,1,42,24,108,0,0,0,0,42216,12.0,46449,100,0,3894,3054,10.0,4221.6
4850557390,1,0,0,0,26,21,66,0,0,0,1,37263,11.6,41760,103,0,1983,2839,10.3,3726.3,0,0,1,21,26,58,0,0,0,0,35280,10.8,38921,88,0,-1983,-2839,8.8,3528.0
4849701245,0,15,0,0,23,27,58,0,0,0,0,36456,11.2,39749,99,0,129,-470,9.9,3645.6,0,2,1,27,23,65,0,0,0,0,36327,10.8,40219,98,0,-129,470,9.8,3632.7
4849690745,1,14,0,0,20,16,56,0,0,0,1,36571,10.8,39412,103,0,3350,4087,10.3,3657.1,0,0,1,16,20,40,0,0,0,0,33221,10.2,35325,90,0,-3350,-4087,9.0,3322.1
4849670742,0,34,0,1,25,25,73,0,0,0,0,36639,11.2,41441,98,0,-287,178,9.8,3663.9,34,0,0,25,25,64,0,0,0,0,36926,11.4,41263,105,0,287,-178,10.5,3692.6
4849647295,0,0,0,1,24,31,56,0,0,0,0,36970,11.2,41648,105,0,-1071,-2077,10.5,3697.0,0,0,0,31,24,87,0,0,0,0,38041,11.6,43725,80,0,1071,2077,8.0,3804.1
4845723221,1,0,0,1,23,23,39,0,0,0,0,35190,10.8,39038,112,0,-389,582,11.2,3519.0,0,0,0,23,23,56,0,0,0,0,35579,10.8,38456,86,0,389,-582,8.6,3557.9
4845712064,1,0,0,0,28,27,78,0,0,0,1,38486,11.0,41068,104,0,1287,-829,10.4,3848.6,0,0,1,27,28,62,0,0,0,0,37199,11.4,41897,89,0,-1287,829,8.9,3719.9
4841751515,1,77,0,0,26,32,68,0,0,0,0,38665,11.6,43524,102,0,345,-890,10.2,3866.5,0,0,1,32,26,64,0,0,0,0,38320,11.6,44414,86,0,-345,890,8.6,3832.0
4839623584,0,0,0,1,17,30,43,0,0,0,1,35922,10.8,39441,117,0,-3808,-5277,11.7,3592.2,139,0,0,30,17,70,0,0,0,0,39730,11.8,44718,95,0,3808,5277,9.5,3973.0
4838904402,1,3,0,1,27,24,84,0,0,0,1,38607,11.6,43791,101,0,2818,4456,10.1,3860.7,0,0,0,24,27,74,0,0,0,0,35789,11.0,39335,87,0,-2818,-4456,8.7,3578.9
4836706603,1,16,0,1,17,10,50,0,0,0,1,37737,10.8,39246,113,0,5269,3466,11.3,3773.7,29,3,0,10,17,28,0,0,0,0,32468,10.6,35780,85,0,-5269,-3466,8.5,3246.8
4836694092,1,84,5,1,23,35,57,0,0,0,1,36825,11.2,40115,114,0,-2897,-4746,11.4,3682.5,15,3,0,35,23,84,0,0,0,0,39722,11.8,44861,91,0,2897,4746,9.1,3972.2
4857261302,1,9,1,1,5,8,8,0,0,0,0,16578,6.6,16955,196,47,341,-601,24.3,1657.8,16,0,0,8,5,6,0,0,0,0,16237,7.0,17556,167,44,-341,601,21.1,1623.7
4857205077,0,9,2,0,6,7,2,0,0,0,0,15752,6.6,18165,203,55,-596,1382,25.8,1575.2,11,1,1,7,6,7,1,1,0,0,16348,6.8,16783,196,48,596,-1382,24.4,1634.8
4856209260,1,135,0,1,7,5,5,1,1,0,0,15321,6.8,17129,179,48,504,-19,22.7,1532.1,63,1,0,4,6,4,0,0,0,0,14817,6.8,17148,179,44,-504,19,22.3,1481.7
4856147901,1,135,0,1,2,2,0,0,0,0,0,12937,6.4,16266,157,52,-550,-818,20.9,1293.7,15,2,0,2,2,3,0,0,0,0,13487,6.6,17084,164,60,550,818,22.4,1348.7
4833618680,0,10,1,1,10,7,8,1,1,0,0,16123,6.8,17403,164,56,751,387,22.0,1612.3,15,0,0,7,10,3,0,0,0,0,15372,6.8,17016,152,52,-751,-387,20.4,1537.2
4833598348,0,12,1,0,3,3,3,1,1,0,0,13705,6.4,15879,143,56,-964,-2131,19.9,1370.5,17,1,1,3,3,2,0,0,0,0,14669,7.0,18010,183,48,964,2131,23.1,1466.9
4833586256,1,45,0,0,7,3,6,0,0,0,0,16756,7.2,19366,173,64,3324,3735,23.7,1675.6,5,0,1,3,7,2,0,0,0,0,13432,6.4,15631,141,52,-3324,-3735,19.3,1343.2
4832986591,1,13,1,1,6,2,6,1,1,0,0,16004,6.6,17377,165,62,1175,1306,22.7,1600.4,7,0,0,2,6,1,0,0,0,0,14829,6.6,16071,186,49,-1175,-1306,23.5,1482.9
4832944294,0,12,14,1,6,3,5,0,0,0,0,14733,6.4,15848,169,28,183,-1849,19.7,1473.3,36,1,0,3,6,3,0,0,0,0,14550,6.8,17697,182,40,-183,1849,22.2,1455.0
4829541004,1,10,2,1,12,6,10,1,1,0,0,18604,7.0,17729,197,44,2826,1551,24.1,1860.4,12,2,0,6,12,7,0,0,0,0,15778,6.6,16178,120,44,-2826,-1551,16.4,1577.8
4827398685,1,20,2,1,6,7,8,0,0,0,0,15021,6.4,16023,165,24,-921,-318,18.9,1502.1,18,1,0,7,6,5,1,1,0,0,15942,6.4,16341,187,60,921,318,24.7,1594.2
4827378735,1,12,1,1,7,4,6,0,0,0,0,15604,7.0,17930,166,56,797,401,22.2,1560.4,10,1,0,4,7,3,0,0,0,0,14807,6.8,17529,178,52,-797,-401,23.0,1480.7
4827356322,1,11,1,1,10,2,14,0,0,0,0,17673,6.6,16875,191,40,3820,-382,23.1,1767.3,16,0,0,2,10,4,0,0,0,0,13853,6.8,17257,188,42,-3820,382,23.0,1385.3
4827322422,0,15,1,1,5,4,6,0,0,0,0,15590,6.8,17071,178,40,666,-367,21.8,1559.0,15,1,0,4,5,7,1,1,0,0,14924,6.6,17438,183,48,-666,367,23.1,1492.4
4827291626,0,11,0,0,4,6,3,0,0,0,0,15365,6.4,16802,191,44,-234,812,23.5,1536.5,11,0,1,6,4,4,0,0,0,0,15599,6.6,15990,187,49,234,-812,23.6,1559.9
4823403252,0,18,0,1,5,5,4,1,1,0,0,15095,7.0,17838,178,56,-1823,-1466,23.4,1509.5,18,1,0,5,5,6,0,0,0,0,16918,7.2,19304,231,60,1823,1466,29.1,1691.8
4823382925,0,196,1,0,1,4,0,0,0,0,0,12795,6.4,15939,142,52,-1908,-1121,19.4,1279.5,16,0,1,4,1,3,0,0,0,0,14703,6.6,17060,183,56,1908,1121,23.9,1470.3
4823363929,1,12,0,0,7,4,7,0,0,0,0,16295,6.6,16818,165,49,1466,681,21.4,1629.5,11,0,1,4,7,3,0,0,0,0,14829,6.4,16137,180,51,-1466,-681,23.1,1482.9
4821913455,1,13,0,0,8,8,7,1,1,0,0,16618,6.8,17468,180,48,52,1144,22.8,1661.8,7,2,1,8,8,8,0,0,0,0,16566,6.6,16324,164,52,-52,-1144,21.6,1656.6
4821869945,1,8,0,0,5,5,3,0,0,0,0,15750,6.8,17089,174,40,703,88,21.4,1575.0,24,2,1,5,5,5,0,0,0,0,15047,6.8,17001,139,44,-703,-88,18.3,1504.7
4837996044,0,10,2,0,6,9,6,0,0,0,0,14728,6.6,16442,129,52,-1973,-1503,18.1,1472.8,10,1,1,9,6,6,1,1,0,0,16701,7.0,17945,192,40,1973,1503,23.2,1670.1
4811312532,1,0,0,0,14,16,40,0,0,0,1,35180,10.6,36615,98,0,235,-20,9.8,3518.0,18,0,1,16,14,52,0,0,0,0,34945,10.4,36635,92,0,-235,20,9.2,3494.5
4811282879,1,0,0,0,18,28,34,0,0,0,0,35453,11.0,39673,95,0,-2854,-3413,9.5,3545.3,0,0,1,28,18,76,0,0,0,0,38307,11.4,43086,82,0,2854,3413,8.2,3830.7
4807350300,1,13,0,1,3,3,1,1,0,1,0,13864,6.4,16036,163,56,-505,-982,21.9,1386.4,9,1,0,3,3,2,0,0,0,0,14369,6.8,17018,142,56,505,982,19.8,1436.9
4807301111,0,13,0,0,5,8,3,0,0,0,0,15977,6.8,16904,181,52,-1102,-1035,23.3,1597.7,10,1,1,8,5,7,0,0,0,0,17079,7.0,17939,195,40,1102,1035,23.5,1707.9
4807267827,1,0,0,1,34,23,86,0,0,0,0,39764,12.0,45836,101,0,3078,5583,10.1,3976.4,0,0,0,23,34,54,0,0,0,0,36686,10.8,40253,91,0,-3078,-5583,9.1,3668.6
4805385487,0,10,2,0,1,6,1,0,0,0,0,12812,6.2,15462,136,52,-3161,-1953,18.8,1281.2,16,2,1,6,1,5,1,1,0,0,15973,7.0,17415,190,44,3161,1953,23.4,1597.3
4805342228,0,70,1,1,3,2,2,0,0,0,0,14380,7.0,17287,185,48,105,-655,23.3,1438.0,11,1,0,2,3,1,1,1,0,0,14275,6.8,17942,213,60,-105,655,27.3,1427.5
4800716919,0,0,0,1,23,22,42,0,0,0,0,37216,11.2,41452,92,0,-447,848,9.2,3721.6,0,0,0,22,23,45,0,0,0,0,37663,11.0,40604,97,0,447,-848,9.7,3766.3
4792345177,1,0,0,0,16,19,47,0,0,0,1,33979,10.4,35394,109,0,-1800,-2174,10.9,3397.9,108,0,1,19,16,44,0,0,0,0,35779,10.6,37568,113,0,1800,2174,11.3,3577.9
4792328393,1,0,0,1,26,16,64,0,0,0,1,38102,11.0,41223,112,0,4571,5527,11.2,3810.2,0,0,0,16,26,35,0,0,0,0,33531,10.4,35696,85,0,-4571,-5527,8.5,3353.1
4789680851,0,13,1,0,4,5,3,0,0,0,0,14203,6.8,16650,176,60,-745,-901,23.6,1420.3,81,1,1,5,4,2,1,1,0,0,14948,6.6,17551,169,58,745,901,22.7,1494.8
4789630046,1,10,0,1,4,4,1,0,0,0,0,15350,6.8,17746,209,52,954,430,26.1,1535.0,11,2,0,4,4,1,0,0,0,0,14396,6.8,17316,164,60,-954,-430,22.4,1439.6
4787524171,1,114,2,0,8,4,5,1,1,0,0,16067,6.6,16159,157,44,1710,-344,20.1,1606.7,12,0,1,4,8,2,0,0,0,0,14357,6.6,16503,162,36,-1710,344,19.8,1435.7
4787504081,0,16,0,1,2,5,1,0,0,0,0,14105,6.6,16510,158,41,108,-341,19.9,1410.5,227,1,0,5,2,1,0,0,0,0,13997,6.6,16851,143,52,-108,341,19.5,1399.7
4787483296,0,9,0,1,25,20,53,0,0,0,1,36856,11.2,41106,82,0,549,1781,8.2,3685.6,0,2,0,20,25,44,0,0,0,0,36307,11.0,39325,98,0,-549,-1781,9.8,3630.7
4785984821,0,36,0,1,21,26,55,0,0,0,2,36493,11.2,40269,96,0,-2553,-1115,9.6,3649.3,11,17,0,26,21,64,0,0,0,0,39046,11.4,41384,90,0,2553,1115,9.0,3904.6
4785965509,0,0,0,0,18,32,38,0,0,0,2,35487,11.0,40704,85,0,-4582,-1638,8.5,3548.7,2,0,1,32,18,67,0,0,0,0,40069,11.6,42342,116,0,4582,1638,11.6,4006.9
4857611003,0,34,0,0,14,20,30,0,0,0,0,34153,10.8,37412,88,0,-1852,-1558,8.8,3415.3,123,0,1,20,14,49,0,0,0,0,36005,11.0,38970,98,0,1852,1558,9.8,3600.5
4856780052,0,35,3,0,2,11,4,0,0,0,0,12995,6.2,14337,153,28,-4315,-2573,18.1,1299.5,17,14,1,11,2,8,0,0,0,0,17310,6.6,16910,130,56,4315,2573,18.6,1731.0
4856386876,0,14,1,0,4,4,4,0,0,0,0,15472,6.6,16602,158,56,-848,-878,21.4,1547.2,10,2,1,4,4,2,1,1,0,0,16320,6.8,17480,163,52,848,878,21.5,1632.0
4856322342,1,13,1,1,2,6,2,0,0,0,0,15899,6.6,16468,175,60,1121,394,23.5,1589.9,16,3,0,6,2,6,0,0,0,0,14778,6.4,16074,146,52,-1121,-394,19.8,1477.8
4856286011,0,7,0,0,5,11,8,0,0,0,0,14172,6.2,14978,150,40,-4459,-3208,19.0,1417.2,187,1,1,11,5,12,0,0,0,0,18631,6.8,18186,211,48,4459,3208,25.9,1863.1
4856228472,0,10,6,1,4,3,3,0,0,0,0,16057,6.8,16959,171,48,620,-1411,21.9,1605.7,31,1,0,3,4,0,1,1,0,0,15437,7.0,18370,207,64,-620,1411,27.1,1543.7
4856174944,1,30,2,1,4,1,4,0,0,0,0,15487,6.8,17026,212,36,594,209,24.8,1548.7,12,3,0,1,4,1,0,0,0,0,14893,6.8,16817,208,56,-594,-209,26.4,1489.3
4854176437,0,13,1,1,6,7,9,0,0,0,0,16489,7.0,17633,164,36,-655,30,20.0,1648.9,115,1,0,7,6,5,1,1,0,0,17144,6.8,17603,200,56,655,-30,25.6,1714.4
4854139500,1,80,1,1,1,2,0,0,0,0,0,14465,6.6,17222,169,60,1198,923,22.9,1446.5,13,1,0,2,1,0,0,0,0,0,13267,6.6,16299,165,40,-1198,-923,20.5,1326.7
4853823543,0,0,0,0,6,16,17,0,0,0,1,32345,10.0,34361,74,0,-2172,-1897,7.4,3234.5,0,0,1,16,6,48,0,0,0,0,34517,10.4,36258,102,0,2172,1897,10.2,3451.7
4852901255,1,0,0,0,14,12,34,0,0,0,1,36222,10.8,39027,103,0,3507,4379,10.3,3622.2,0,0,1,12,14,32,0,0,0,0,32715,10.2,34648,90,0,-3507,-4379,9.0,3271.5
4851996218,1,67,1,1,25,21,34,0,0,0,2,35810,10.8,38823,94,0,-38,144,9.4,3581.0,3,0,0,20,24,53,0,0,0,0,35848,10.8,38679,110,0,38,-144,11.0,3584.8
4851953446,0,66,0,0,10,22,11,0,0,0,0,33110,10.4,37221,94,0,-2146,-1100,9.4,3311.0,0,0,1,22,10,45,0,0,0,0,35256,10.8,38321,99,0,2146,1100,9.9,3525.6
4850882694,0,11,1,0,3,8,1,0,0,0,0,13385,6.4,15564,144,52,-2944,-1095,19.6,1338.5,13,0,1,8,3,7,2,1,1,0,16329,6.4,16659,157,51,2944,1095,20.8,1632.9
4850834377,0,12,0,1,1,2,1,0,0,0,0,13872,6.6,16903,166,52,346,279,21.8,1387.2,23,1,0,2,1,1,1,0,1,0,13526,6.4,16624,154,56,-346,-279,21.0,1352.6
4850793735,1,20,2,1,5,2,2,1,1,0,0,16019,7.0,17970,206,72,2111,800,27.8,1601.9,14,1,0,2,5,1,0,0,0,0,13908,6.8,17170,181,48,-2111,-800,22.9,1390.8
4850764792,0,0,0,1,15,24,35,0,0,0,1,35305,10.8,38074,83,0,-911,-1811,8.3,3530.5,0,0,0,23,14,68,0,0,0,0,36216,11.2,39885,78,0,911,1811,7.8,3621.6
4850619147,1,10,12,0,8,5,6,1,1,0,0,17626,7.0,18421,198,64,1393,930,26.2,1762.6,35,2,1,5,8,5,0,0,0,0,16233,6.6,17491,184,52,-1393,-930,23.6,1623.3
4850584933,1,88,0,1,8,4,3,0,0,0,0,16741,6.8,17243,186,48,3575,2132,23.4,1674.1,30,0,0,4,8,0,0,0,0,0,13166,6.2,15111,150,28,-3575,-2132,17.8,1316.6
4758637316,1,0,0,0,22,26,50,0,0,0,0,36605,11.2,40470,107,0,-733,-1454,10.7,3660.5,3,0,1,26,22,60,0,0,0,0,37338,11.2,41924,103,0,733,1454,10.3,3733.8
4758550181,1,0,0,1,34,34,91,0,0,0,0,41185,12.0,46066,116,0,2503,246,11.6,4118.5,0,0,0,34,34,54,0,0,0,0,38682,11.8,45820,103,0,-2503,-246,10.3,3868.2
4752750354,0,12,3,1,5,4,6,0,0,0,0,15442,6.8,16908,171,60,-319,-1104,23.1,1544.2,14,1,0,4,5,1,0,0,0,0,15761,6.8,18012,228,52,319,1104,28.0,1576.1
4752722348,1,13,3,1,5,3,7,1,1,0,0,16553,7.0,17686,187,52,2064,1473,23.9,1655.3,16,2,0,3,5,4,0,0,0,0,14489,6.6,16213,208,48,-2064,-1473,25.6,1448.9
4752700934,0,12,1,0,2,7,2,0,0,0,0,15176,6.8,18076,208,56,-2660,-1192,26.4,1517.6,11,1,1,7,2,8,0,0,0,0,17836,7.2,19268,198,60,2660,1192,25.8,1783.6
4752563140,1,0,0,1,26,21,51,0,0,0,0,37861,11.4,42517,103,0,1009,3577,10.3,3786.1,3,0,0,21,26,35,0,0,0,0,36852,10.8,38940,87,0,-1009,-3577,8.7,3685.2
4752549413,1,0,1,1,39,30,114,0,0,0,1,42251,12.4,48357,124,0,3863,4974,12.4,4225.1,3,0,0,30,39,64,0,0,0,0,38388,11.4,43383,104,0,-3863,-4974,10.4,3838.8
4751846655,1,42,0,1,33,29,97,0,0,0,1,39962,11.8,44033,101,0,769,1325,10.1,3996.2,0,0,0,29,33,87,0,0,0,0,39193,11.4,42708,113,0,-769,-1325,11.3,3919.3
4751825785,1,0,0,0,20,19,48,0,0,0,1,36885,11.2,40388,94,0,1291,1795,9.4,3688.5,0,0,1,19,20,35,0,0,0,0,35594,11.0,38593,96,0,-1291,-1795,9.6,3559.4
4750564768,0,68,0,1,29,21,82,0,0,0,2,38636,11.2,41350,78,0,1713,1334,7.8,3863.6,0,0,0,21,29,57,0,0,0,0,36923,11.0,40016,82,0,-1713,-1334,8.2,3692.3
4750552916,1,11,14,1,35,16,100,0,0,0,0,39645,11.6,43697,108,0,4331,4964,10.8,3964.5,19,1,0,16,35,34,0,0,0,0,35314,10.8,38733,88,0,-4331,-4964,8.8,3531.4
4749866937,1,12,0,0,21,26,41,0,0,0,1,35598,11.0,38196,101,0,-1227,-1600,10.1,3559.8,0,3,1,26,21,58,0,0,0,0,36825,11.2,39796,103,0,1227,1600,10.3,3682.5
4749767119,0,0,0,1,21,18,59,0,0,0,1,37087,11.0,39032,111,0,1094,909,11.1,3708.7,0,0,0,18,21,34,0,0,0,0,35993,10.8,38123,114,0,-1094,-909,11.4,3599.3
4749754217,0,39,0,1,30,27,99,0,0,0,1,40327,11.8,44143,97,0,411,998,9.7,4032.7,0,1,0,27,30,71,0,0,0,0,39916,11.4,43145,113,0,-411,-998,11.3,3991.6
4748895779,0,2,1,1,22,26,52,0,0,0,2,37513,10.8,40010,98,0,-1162,-2114,9.8,3751.3,20,0,0,26,22,71,0,0,0,0,38675,11.4,42124,85,0,1162,2114,8.5,3867.5
4748190896,1,12,0,1,18,18,43,0,0,0,0,34270,10.6,37065,88,0,-1205,115,8.8,3427.0,4,2,0,18,18,36,0,0,0,0,35475,10.6,36950,113,0,1205,-115,11.3,3547.5
4748172970,1,75,0,1,14,13,44,0,0,0,0,35799,10.8,38596,97,0,1042,1836,9.7,3579.9,0,0,0,13,14,33,0,0,0,0,34757,10.4,36760,84,0,-1042,-1836,8.4,3475.7
4748144326,1,0,0,0,26,28,63,0,0,0,1,38998,11.2,42066,105,0,-260,-1330,10.5,3899.8,68,0,1,28,26,49,0,0,0,0,39258,11.4,43396,108,0,260,1330,10.8,3925.8
4748122407,0,34,0,1,21,24,56,0,0,0,0,35591,11.0,40121,91,0,276,1078,9.1,3559.1,0,0,0,24,21,60,0,0,0,0,35315,11.0,39043,85,0,-276,-1078,8.5,3531.5
4748098549,1,0,0,1,26,13,68,0,0,0,0,37147,11.0,39816,107,0,2776,3236,10.7,3714.7,0,0,0,13,26,24,0,0,0,0,34371,10.4,36580,108,0,-2776,-3236,10.8,3437.1
4855357830,1,10,1,1,4,1,2,1,1,0,0,14876,6.8,17752,179,62,2124,1799,24.1,1487.6,18,0,0,1,4,1,0,0,0,0,12752,6.8,15953,169,48,-2124,-1799,21.7,1275.2
4855291554,1,16,0,0,5,1,2,0,0,0,0,15576,7.2,18889,173,60,1721,1418,23.3,1557.6,11,0,1,1,5,1,0,0,0,0,13855,6.6,17471,195,52,-1721,-1418,24.7,1385.5
4855040757,1,0,0,1,24,16,17,0,0,0,0,47750,10.0,47500,1,0,18850,19000,0.1,4775.0,0,0,0,6,14,13,0,0,0,0,28900,6.0,28500,0,0,-18850,-19000,0.0,2890.0
4854932981,1,10,1,1,3,3,2,0,0,0,0,16949,7.2,18611,192,68,2132,2248,26.0,1694.9,11,2,0,3,3,4,0,0,0,0,14817,6.4,16363,216,32,-2132,-2248,24.8,1481.7
4854243161,1,2,0,0,20,15,22,0,0,0,0,46650,10.0,47500,0,0,20200,19000,0.0,4665.0,0,0,1,7,12,5,0,0,0,0,26450,6.0,28500,0,0,-20200,-19000,0.0,2645.0
4854220236,1,4,0,0,20,12,18,0,0,0,0,48700,10.0,47500,0,0,21900,17500,0.0,4870.0,148,0,1,6,14,6,0,0,0,0,26800,6.4,30000,0,0,-21900,-17500,0.0,2680.0
4854200494,1,4,0,0,18,20,21,0,0,0,0,62700,12.0,55000,0,0,35500,22000,0.0,6270.0,16,0,1,11,9,10,0,0,0,0,27200,7.2,33000,0,0,-35500,-22000,0.0,2720.0
4853904400,1,8,0,1,19,19,18,0,0,0,0,51137,12.0,55000,0,0,20787,22000,0.0,5113.7,0,0,0,11,11,8,0,0,0,0,30350,7.2,33000,0,0,-20787,-22000,0.0,3035.0
4853779694,1,20,9,0,24,18,57,0,0,0,0,36573,11.0,39752,98,0,-12,-1,9.8,3657.3,108,0,1,18,24,48,0,0,0,0,36585,11.2,39753,103,0,12,1,10.3,3658.5
4853760598,0,34,0,1,23,22,54,0,0,0,0,37152,11.2,41446,107,0,759,1579,10.7,3715.2,34,0,0,22,23,55,0,0,0,0,36393,11.0,39867,89,0,-759,-1579,8.9,3639.3
4853741789,1,66,0,0,40,29,95,0,0,0,2,44542,12.6,50737,107,0,6640,8533,10.7,4454.2,19,0,1,29,40,65,0,0,0,0,37902,11.4,42204,86,0,-6640,-8533,8.6,3790.2
4853711597,1,0,0,0,16,15,15,0,0,0,0,60685,12.0,55000,1,0,22730,22000,0.1,6068.5,0,0,1,10,11,10,0,0,0,0,37955,7.2,33000,1,0,-22730,-22000,0.1,3795.5
4853698012,1,0,0,0,19,21,18,0,0,0,0,48775,10.0,47500,0,0,19435,19000,0.0,4877.5,0,0,1,14,12,12,0,0,0,0,29340,6.0,28500,0,0,-19435,-19000,0.0,2934.0
4853670087,1,0,0,0,13,20,14,0,0,0,0,45950,10.0,47500,0,0,17400,19000,0.0,4595.0,0,0,1,13,6,11,0,0,0,0,28550,6.0,28500,0,0,-17400,-19000,0.0,2855.0
4852714780,1,0,0,0,8,15,13,0,0,0,0,43850,10.0,47500,0,0,16000,19000,0.0,4385.0,0,0,1,13,6,7,0,0,0,0,27850,6.0,28500,0,0,-16000,-19000,0.0,2785.0
4852692434,1,44,3,0,10,17,12,0,0,0,0,60665,12.0,55000,1,0,22695,22000,0.1,6066.5,20,4,1,13,6,9,0,0,0,0,37970,7.2,33000,1,0,-22695,-22000,0.1,3797.0
4852499392,1,4,0,1,15,18,25,0,0,0,0,62350,12.0,55000,0,0,24790,22000,0.0,6235.0,24,0,0,15,12,5,0,0,0,0,37560,7.2,33000,1,0,-24790,-22000,0.1,3756.0
4852485591,1,31,0,0,22,18,22,0,0,0,0,47700,10.0,47500,0,0,19500,19000,0.0,4770.0,0,0,1,11,15,11,0,0,0,0,28200,6.0,28500,0,0,-19500,-19000,0.0,2820.0
4852473152,1,0,0,0,19,17,52,0,0,0,1,36635,11.0,39651,99,0,2113,2220,9.9,3663.5,0,0,1,17,19,40,0,0,0,0,34522,10.6,37431,75,0,-2113,-2220,7.5,3452.2
4857326568,1,10,0,0,3,6,2,1,1,0,0,15180,6.6,16937,142,52,-17,-643,19.4,1518.0,9,0,1,6,3,1,0,0,0,0,15197,7.0,17580,198,40,17,643,23.8,1519.7
4855803246,0,46,2,0,1,2,0,0,0,0,0,13016,6.8,17302,182,52,-1454,-1021,23.4,1301.6,11,2,1,2,1,2,0,0,0,0,14470,7.0,18323,188,56,1454,1021,24.4,1447.0
4855754676,0,90,1,0,3,6,1,1,1,0,0,13661,6.8,16576,162,48,-1774,-747,21.0,1366.1,8,15,1,6,3,7,0,0,0,0,15435,6.8,17323,146,43,1774,747,18.9,1543.5
4855726955,0,83,2,0,3,5,1,0,0,0,0,14410,6.6,16791,214,40,-286,-385,25.4,1441.0,12,2,1,5,3,4,0,0,0,0,14696,6.8,17176,184,52,286,385,23.6,1469.6
4854716224,0,13,1,1,5,7,4,0,0,0,0,16021,6.8,17977,216,40,1498,1918,25.6,1602.1,92,1,0,7,5,5,0,0,0,0,14523,6.6,16059,145,48,-1498,-1918,19.3,1452.3
4854680133,0,72,3,0,1,5,1,1,1,0,0,14503,7.0,17338,212,56,-2208,-846,26.8,1450.3,14,1,1,5,1,3,0,0,0,0,16711,6.8,18184,214,52,2208,846,26.6,1671.1
4854629889,0,161,0,0,8,7,6,0,0,0,0,17232,6.8,16943,201,45,1762,-566,24.6,1723.2,62,1,1,7,8,1,1,1,0,0,15470,6.8,17509,182,63,-1762,566,24.5,1547.0
4854562029,1,70,1,0,3,7,3,1,1,0,0,14641,6.6,16948,164,52,-1736,-780,21.6,1464.1,12,1,1,7,3,5,0,0,0,0,16377,6.8,17728,176,60,1736,780,23.6,1637.7
4854531669,0,75,2,1,5,3,4,0,0,0,0,15618,7.0,18633,189,52,-913,998,24.1,1561.8,13,1,0,3,5,5,0,0,0,0,16531,7.0,17635,199,52,913,-998,25.1,1653.1
4839974518,1,38,2,0,4,5,3,1,1,0,0,15747,7.0,18782,198,60,334,1227,25.8,1574.7,71,11,1,5,4,4,0,0,0,0,15413,6.6,17555,218,48,-334,-1227,26.6,1541.3
4839919637,0,77,3,1,7,3,10,1,1,0,0,15601,7.0,17927,158,44,1711,1126,20.2,1560.1,20,2,0,3,7,2,0,0,0,0,13890,6.6,16801,151,48,-1711,-1126,19.9,1389.0
4836871877,0,36,2,0,2,10,0,0,0,0,0,12919,6.4,15399,157,40,-3375,-2296,19.7,1291.9,75,3,1,10,2,6,1,1,0,0,16294,6.8,17695,194,52,3375,2296,24.6,1629.4
4836701496,0,66,0,0,1,3,0,0,0,0,0,13568,6.8,17735,161,52,-1251,739,21.3,1356.8,31,0,1,3,1,2,0,0,0,0,14819,6.8,16996,175,48,1251,-739,22.3,1481.9
4836652576,0,11,8,0,1,3,0,0,0,0,0,12392,6.8,16796,148,52,-3078,-1525,20.0,1239.2,21,1,1,3,1,2,0,0,0,0,15470,7.0,18321,210,48,3078,1525,25.8,1547.0
4834044161,1,10,2,0,5,4,1,0,0,0,0,15039,6.8,17223,175,40,335,-24,21.5,1503.9,74,1,1,4,5,0,0,0,0,0,14704,6.8,17247,211,40,-335,24,25.1,1470.4
4834024307,1,13,2,0,1,2,0,0,0,0,0,15000,7.2,19103,201,68,2885,4535,26.9,1500.0,121,0,1,2,1,0,0,0,0,0,12115,5.8,14568,171,20,-2885,-4535,19.1,1211.5
4833975204,0,71,1,0,5,6,7,0,0,0,0,15304,6.4,15278,156,44,1034,1091,20.0,1530.4,15,1,1,6,5,6,0,0,0,0,14270,6.0,14187,114,40,-1034,-1091,15.4,1427.0
4832850612,0,75,0,1,3,3,2,0,0,0,0,14513,6.6,16548,196,44,-588,-268,24.0,1451.3,7,2,0,3,3,1,1,0,1,0,15101,6.8,16816,202,56,588,268,25.8,1510.1
4832817542,0,50,0,1,2,2,1,0,0,0,0,13614,7.0,18001,194,40,-1519,-1405,23.4,1361.4,74,0,0,2,2,2,0,0,0,0,15133,7.2,19406,211,72,1519,1405,28.3,1513.3
4831287647,1,71,1,1,2,0,1,1,1,0,0,14698,6.8,18447,207,57,874,215,26.4,1469.8,14,0,0,0,2,0,0,0,0,0,13824,6.6,18232,225,41,-874,-215,26.6,1382.4
4850799268,1,68,0,0,29,24,79,0,0,0,1,38767,11.4,42096,95,0,1394,-2020,9.5,3876.7,0,0,1,24,29,57,0,0,0,0,37373,11.6,44116,105,0,-1394,2020,10.5,3737.3
4850750767,0,87,1,1,3,2,2,0,0,0,0,15401,6.8,17344,191,47,1279,472,23.8,1540.1,14,1,0,2,3,1,0,0,0,0,14122,6.8,16872,164,60,-1279,-472,22.4,1412.2
4850690896,1,14,3,0,6,4,3,1,1,0,0,14742,6.8,17271,172,48,1106,-715,22.0,1474.2,17,2,1,4,6,3,0,0,0,0,13636,6.8,17986,171,36,-1106,715,20.7,1363.6
4850651089,1,12,1,0,5,7,4,1,1,0,0,14548,6.6,17212,148,52,-1470,-140,20.0,1454.8,22,2,1,7,5,4,0,0,0,0,16018,6.8,17352,171,56,1470,140,22.7,1601.8
4850634048,1,20,0,1,8,1,2,1,1,0,0,16387,7.0,19066,183,56,2980,2430,23.9,1638.7,7,1,0,1,8,0,0,0,0,0,13407,6.6,16636,175,43,-2980,-2430,21.8,1340.7
4849888493,1,0,0,0,24,24,51,0,0,0,0,36921,11.2,41767,102,0,-488,-158,10.2,3692.1,0,0,1,24,24,66,0,0,0,0,37409,11.4,41925,97,0,488,158,9.7,3740.9
4849859317,1,4,0,0,22,22,64,0,0,0,0,38243,11.4,41993,101,0,1661,2017,10.1,3824.3,41,0,1,22,22,66,0,0,0,0,36582,11.0,39976,103,0,-1661,-2017,10.3,3658.2
4849692507,1,19,0,0,30,16,76,0,0,0,1,40726,11.8,43732,100,0,6326,6987,10.0,4072.6,0,4,1,16,30,42,0,0,0,0,34400,10.6,36745,73,0,-6326,-6987,7.3,3440.0
4849679933,0,0,0,0,24,23,64,0,0,0,0,36223,11.2,39926,94,0,-2076,-2107,9.4,3622.3,36,0,1,23,24,65,0,0,0,0,38299,11.4,42033,109,0,2076,2107,10.9,3829.9
4849646123,1,89,1,0,2,4,0,1,1,0,0,13208,6.8,16737,174,57,-320,-937,23.1,1320.8,16,1,1,4,2,3,0,0,0,0,13528,6.8,17674,138,43,320,937,18.1,1352.8
4849625770,1,27,5,1,2,0,2,1,1,0,0,15490,6.8,17591,172,56,2878,1534,22.8,1549.0,16,1,0,0,2,0,0,0,0,0,12612,6.4,16057,165,52,-2878,-1534,21.7,1261.2
4848831054,1,5,0,1,13,23,18,0,0,0,0,35214,10.6,36783,72,0,-511,-1809,7.2,3521.4,0,0,0,23,13,69,0,0,0,0,35725,11.0,38592,88,0,511,1809,8.8,3572.5
4848810947,0,172,4,0,19,20,51,0,0,0,1,35470,11.0,39901,102,0,-867,1105,10.2,3547.0,14,0,1,20,19,56,0,0,0,0,36337,10.8,38796,100,0,867,-1105,10.0,3633.7
4848784289,0,15,0,1,26,22,62,0,0,0,1,38765,11.2,41295,89,0,1871,3470,8.9,3876.5,0,0,0,22,26,68,0,0,0,0,36894,10.6,37825,114,0,-1871,-3470,11.4,3689.4
4848768249,0,0,0,0,19,22,43,0,0,0,1,34668,10.8,38002,91,0,-1799,-2037,9.1,3466.8,0,0,1,22,19,66,0,0,0,0,36467,11.0,40039,111,0,1799,2037,11.1,3646.7
4848737836,1,15,2,0,3,5,1,0,0,0,0,14294,6.8,16947,153,30,-295,1090,18.3,1429.4,12,1,1,5,3,4,0,0,0,0,14589,6.4,15857,131,42,295,-1090,17.3,1458.9
4848715097,0,16,3,0,1,8,0,1,1,0,0,13365,7.0,17601,183,54,-2913,-1666,23.7,1336.5,85,4,1,8,1,7,0,0,0,0,16278,7.2,19267,183,44,2913,1666,22.7,1627.8
4848151504,0,21,0,1,25,14,68,0,0,0,0,36766,11.2,40437,91,0,3033,4846,9.1,3676.6,0,3,0,14,25,43,0,0,0,0,33733,10.2,35591,103,0,-3033,-4846,10.3,3373.3
4848136058,1,0,2,1,29,23,80,0,0,0,0,38446,11.6,42123,104,0,1295,3479,10.4,3844.6,20,0,0,23,29,52,0,0,0,0,37151,11.0,38644,94,0,-1295,-3479,9.4,3715.1
4821687714,0,15,2,0,5,7,5,0,0,0,0,14720,6.2,15495,139,56,-1856,-2274,19.5,1472.0,18,3,1,7,5,2,1,1,0,0,16576,6.8,17769,190,60,1856,2274,25.0,1657.6
4821655734,0,15,2,0,5,7,3,1,1,0,0,14590,6.8,18010,159,52,-2284,-324,21.1,1459.0,14,0,1,7,5,7,0,0,0,0,16874,7.0,18334,225,56,2284,324,28.1,1687.4
4820041260,0,15,2,0,6,5,10,0,0,0,0,15326,6.6,17050,138,60,-187,-27,19.8,1532.6,14,1,1,5,6,2,1,1,0,0,15513,6.6,17077,168,56,187,27,22.4,1551.3
4819986480,0,13,1,0,4,6,2,0,0,0,0,13886,6.6,16691,187,48,-1315,-15,23.5,1388.6,11,0,1,5,3,4,0,0,0,0,15201,6.6,16706,161,48,1315,15,20.9,1520.1
4814483928,1,8,1,1,4,1,3,0,0,0,0,14383,6.4,15672,155,56,1669,-793,21.1,1438.3,10,0,0,1,4,0,0,0,0,0,12714,6.6,16465,145,44,-1669,793,18.9,1271.4
4814431116,0,9,1,1,3,1,2,0,0,0,0,13617,6.8,17097,159,52,1222,151,21.1,1361.7,12,0,0,0,2,0,0,0,0,0,12395,6.8,16946,140,52,-1222,-151,19.2,1239.5
4814388079,0,186,0,1,5,5,9,0,0,0,0,14721,6.6,16867,154,52,-1535,-2534,20.6,1472.1,11,1,0,5,5,3,1,1,0,0,16256,7.2,19401,194,80,1535,2534,27.4,1625.6
4814265203,0,12,1,1,7,6,2,0,0,0,0,16025,6.8,17644,176,47,-592,-727,22.3,1602.5,15,0,0,6,7,5,0,0,0,0,16617,7.0,18371,180,53,592,727,23.3,1661.7
4813330689,0,26,1,1,7,2,5,0,0,0,0,15594,6.8,17590,165,60,1781,835,22.5,1559.4,14,1,0,2,7,2,1,1,0,0,13813,6.8,16755,168,48,-1781,-835,21.6,1381.3
4807458769,1,13,11,1,3,1,2,1,1,0,0,14478,6.4,16029,189,56,-482,-1511,24.5,1447.8,34,1,0,1,3,0,0,0,0,0,14960,6.8,17540,171,56,482,1511,22.7,1496.0
4807424841,1,21,1,1,7,2,4,0,0,0,0,16125,6.8,18114,198,44,2795,895,24.2,1612.5,9,1,0,2,7,1,0,0,0,0,13330,6.8,17219,157,52,-2795,-895,20.9,1333.0
4807382646,0,5,0,0,0,9,0,0,0,0,0,13498,6.6,16228,152,56,-4149,-2288,20.8,1349.8,13,0,1,9,0,6,1,1,0,0,17647,7.0,18516,201,52,4149,2288,25.3,1764.7
4566906026,1,11,0,1,11,7,15,1,1,0,0,18286,6.6,17636,159,51,2012,208,21.0,1828.6,16,0,0,7,11,5,0,0,0,0,16274,6.6,17428,149,56,-2012,-208,20.5,1627.4
4222802532,1,9,0,0,3,4,0,1,1,0,0,14319,6.8,18132,178,51,299,1215,22.9,1431.9,11,0,1,3,2,3,0,0,0,0,14020,6.8,16917,180,40,-299,-1215,22.0,1402.0
4216664035,0,11,3,0,3,7,2,1,1,0,0,13540,6.4,15576,179,55,-2901,-2064,23.4,1354.0,14,2,1,7,3,6,0,0,0,0,16441,7.0,17640,179,44,2901,2064,22.3,1644.1
4216246959,0,13,3,0,7,5,3,0,0,0,0,15940,6.8,16620,149,37,479,920,18.6,1594.0,22,1,1,5,7,6,0,0,0,0,15461,6.6,15700,154,58,-479,-920,21.2,1546.1
4216205593,1,12,4,1,8,2,12,1,1,0,0,16274,6.6,16801,168,56,2673,-138,22.4,1627.4,13,2,0,2,8,0,0,0,0,0,13601,6.6,16939,175,48,-2673,138,22.3,1360.1
4216243128,0,18,0,0,1,4,2,0,0,0,0,13533,6.2,15644,169,36,-2112,-568,20.5,1353.3,9,3,1,4,1,5,1,1,0,0,15645,6.4,16212,199,52,2112,568,25.1,1564.5
4215188068,0,10,2,1,3,3,3,0,0,0,0,14113,6.4,16648,179,56,-617,-1112,23.5,1411.3,10,1,0,3,3,1,0,0,0,0,14730,6.8,17760,195,44,617,1112,23.9,1473.0
4215205378,0,16,1,1,3,5,2,0,0,0,0,15438,7.2,18138,177,52,820,293,22.9,1543.8,15,5,0,5,3,3,1,1,0,0,14618,7.0,17845,163,60,-820,-293,22.3,1461.8
4853981648,1,9,4,1,2,4,0,1,1,0,0,14603,6.8,17310,208,56,-1756,-979,26.4,1460.3,25,2,0,4,2,2,0,0,0,0,16359,6.8,18289,226,55,1756,979,28.1,1635.9
4852673625,0,10,1,1,4,2,2,0,0,0,0,15839,7.4,19435,221,76,2359,2335,29.7,1583.9,11,1,0,2,4,0,0,0,0,0,13480,6.8,17100,170,52,-2359,-2335,22.2,1348.0
4851679799,1,12,1,0,2,3,1,0,0,0,0,14521,6.8,17606,209,52,-259,334,26.1,1452.1,15,1,1,3,2,2,1,1,0,0,14780,7.0,17272,170,56,259,-334,22.6,1478.0
4849063639,1,0,0,1,26,26,61,0,0,0,0,37523,11.4,42947,93,0,-366,205,9.3,3752.3,11,0,0,26,26,67,0,0,0,0,37889,11.4,42742,90,0,366,-205,9.0,3788.9
4849041879,0,0,0,1,24,22,71,0,0,0,2,37973,11.4,40540,111,0,40,-399,11.1,3797.3,0,0,0,22,24,54,0,0,0,0,37933,11.2,40939,99,0,-40,399,9.9,3793.3
4849015110,1,0,0,1,14,14,34,0,0,0,1,34290,10.2,35264,118,0,1460,1345,11.8,3429.0,0,0,0,14,14,27,0,0,0,0,32830,9.8,33919,107,0,-1460,-1345,10.7,3283.0
4846996672,0,11,0,0,3,3,1,0,0,0,0,14600,7.2,18385,183,68,-739,711,25.1,1460.0,22,0,1,3,3,2,1,1,0,0,15339,6.8,17674,234,52,739,-711,28.6,1533.9
4845852324,0,35,1,1,5,4,4,0,0,0,0,16818,7.2,18623,203,64,471,275,26.7,1681.8,37,2,0,4,5,2,0,0,0,0,16347,7.0,18348,212,52,-471,-275,26.4,1634.7
4845050864,0,36,0,1,5,5,2,0,0,0,0,16801,7.0,17924,202,52,-213,-542,25.4,1680.1,31,1,0,5,5,6,0,0,0,0,17014,7.2,18466,218,63,213,542,28.1,1701.4
4844997131,1,13,12,1,5,1,5,0,0,0,0,15960,6.8,17560,187,56,2012,-858,24.3,1596.0,89,1,0,1,5,0,0,0,0,0,13948,7.0,18418,199,48,-2012,858,24.7,1394.8
4842193869,1,13,0,1,3,3,0,0,0,0,0,14575,7.0,17957,213,64,-82,-397,27.7,1457.5,13,0,0,3,3,1,0,0,0,0,14657,6.8,18354,216,54,82,397,27.0,1465.7
4840985367,1,34,0,1,6,6,14,0,0,0,0,30972,9.6,30815,88,0,-627,-3493,8.8,3097.2,34,0,0,6,6,20,0,0,0,0,31599,10.2,34308,96,0,627,3493,9.6,3159.9
4840971197,1,19,0,1,22,16,51,0,0,0,1,38452,11.2,40182,128,0,4239,3496,12.8,3845.2,0,5,0,16,22,26,0,0,0,0,34213,10.4,36686,95,0,-4239,-3496,9.5,3421.3
4840952007,0,0,24,0,22,37,52,0,0,0,1,38091,11.2,41989,97,0,-2512,-4244,9.7,3809.1,22,0,1,37,22,85,0,0,0,0,40603,12.0,46233,101,0,2512,4244,10.1,4060.3
4840932181,0,0,0,0,29,31,62,0,0,0,1,37760,11.6,43396,93,0,-3586,-1149,9.3,3776.0,3,0,1,31,29,77,0,0,0,0,41346,11.6,44545,110,0,3586,1149,11.0,4134.6
4840913246,1,68,0,1,30,22,64,0,0,0,0,37949,11.4,43850,70,0,1570,3229,7.0,3794.9,0,0,0,22,30,60,0,0,0,0,36379,11.2,40621,107,0,-1570,-3229,10.7,3637.9
4840894770,1,0,0,1,12,12,26,0,0,0,0,34625,10.6,36059,113,0,2618,2665,11.3,3462.5,0,0,0,12,12,26,0,0,0,0,32007,9.8,33394,80,0,-2618,-2665,8.0,3200.7
4840875408,0,0,0,1,25,43,48,0,0,0,1,38449,11.6,42351,82,0,-5600,-7338,8.2,3844.9,16,0,0,43,25,105,0,0,0,0,44049,12.6,49689,101,0,5600,7338,10.1,4404.9
4840380575,0,0,0,0,28,29,78,0,0,0,0,38179,11.6,43749,89,0,-239,798,8.9,3817.9,0,0,1,29,28,89,0,0,0,0,38418,11.4,42951,106,0,239,-798,10.6,3841.8
4840357563,0,10,0,0,19,29,30,0,0,0,1,34444,10.6,38246,90,0,-3412,-2849,9.0,3444.4,0,4,1,29,19,65,0,0,0,0,37856,11.4,41095,108,0,3412,2849,10.8,3785.6
4819615707,0,15,1,0,7,5,5,0,0,0,0,17744,6.8,17002,206,44,1258,18,25.0,1774.4,14,2,1,5,7,2,1,1,0,0,16486,6.8,16984,177,56,-1258,-18,23.3,1648.6
4814949718,1,14,0,1,7,4,11,0,0,0,0,17792,7.0,18417,204,52,2015,1156,25.6,1779.2,10,2,0,4,7,3,0,0,0,0,15777,7.0,17261,166,36,-2015,-1156,20.2,1577.7
4814900318,1,15,0,1,3,3,4,0,0,0,0,15331,6.6,17027,188,56,1409,1029,24.4,1533.1,12,1,0,3,3,2,0,0,0,0,13922,6.4,15998,163,52,-1409,-1029,21.5,1392.2
4814883005,1,11,1,1,5,3,3,1,1,0,0,16218,7.0,18412,196,52,1963,599,24.8,1621.8,11,0,0,3,5,2,0,0,0,0,14255,6.8,17813,169,60,-1963,-599,22.9,1425.5
4814595296,1,14,0,0,3,3,3,0,0,0,0,14626,6.8,16588,174,36,-232,-816,21.0,1462.6,10,0,1,3,3,3,0,0,0,0,14858,6.6,17404,204,64,232,816,26.8,1485.8
4814582148,1,9,1,1,11,7,4,1,1,0,0,17911,7.0,18126,189,72,2292,2244,26.1,1791.1,8,0,0,7,11,5,1,0,1,0,15619,6.4,15882,166,40,-2292,-2244,20.6,1561.9
4814555035,0,10,0,1,5,7,3,0,0,0,0,15857,7.2,18058,194,59,-1120,-1283,25.3,1585.7,11,2,0,7,5,5,1,1,0,0,16977,7.2,19341,200,56,1120,1283,25.6,1697.7
4814459682,0,12,0,1,2,3,1,0,0,0,0,15204,7.0,18746,232,64,-23,531,29.6,1520.4,11,0,0,3,2,2,0,0,0,0,15227,7.0,18215,180,68,23,-531,24.8,1522.7
4814422163,1,13,1,1,5,3,5,1,1,0,0,15654,6.6,17014,193,59,1098,-264,25.2,1565.4,10,1,0,3,5,4,0,0,0,0,14556,6.8,17278,183,48,-1098,264,23.1,1455.6
4812429062,1,94,1,0,3,2,5,0,0,0,0,15852,6.8,17814,198,44,1787,767,24.2,1585.2,13,1,1,2,3,2,0,0,0,0,14065,6.6,17047,179,60,-1787,-767,23.9,1406.5
4812059230,1,11,1,1,13,4,17,0,0,0,0,19475,7.0,18062,212,44,3507,58,25.6,1947.5,171,1,0,4,13,2,1,1,0,0,15968,6.8,18004,177,56,-3507,-58,23.3,1596.8
4812018364,1,14,0,1,7,6,7,1,1,0,0,16856,6.8,17845,163,64,829,359,22.7,1685.6,13,0,0,6,7,5,0,0,0,0,16027,6.6,17486,179,62,-829,-359,24.1,1602.7
4807682727,0,14,0,0,9,4,9,1,1,0,0,17637,6.8,17222,196,56,1068,-198,25.2,1763.7,10,0,1,4,9,2,0,0,0,0,16569,6.8,17420,210,56,-1068,198,26.6,1656.9
4806592068,0,11,0,0,7,8,5,0,0,0,0,16585,7.0,18195,197,60,-410,-883,25.7,1658.5,9,0,1,8,7,3,2,1,1,0,16995,7.4,19078,226,56,410,883,28.2,1699.5
4806556570,0,13,2,0,5,8,4,1,0,1,0,15626,6.6,16923,183,52,-1943,-1324,23.5,1562.6,10,3,1,8,5,7,1,1,0,0,17569,6.8,18247,223,44,1943,1324,26.7,1756.9
4533388067,0,11,3,0,8,9,4,1,1,0,0,18390,7.0,18634,196,46,1651,3140,24.2,1839.0,11,0,1,9,8,12,0,0,0,0,16739,6.4,15494,145,64,-1651,-3140,20.9,1673.9
4224972910,0,14,1,1,3,5,3,0,0,0,0,13981,6.6,15879,176,56,-3432,-2787,23.2,1398.1,13,1,0,5,3,8,1,1,0,0,17413,7.0,18666,196,48,3432,2787,24.4,1741.3
4786725774,0,13,0,1,7,1,6,0,0,0,0,16589,7.2,18619,215,60,2413,1257,27.5,1658.9,15,0,0,1,7,0,1,1,0,0,14176,6.8,17362,184,60,-2413,-1257,24.4,1417.6
4786696482,1,19,2,1,5,1,5,2,1,1,0,16975,7.0,18527,222,69,2330,2096,29.1,1697.5,16,1,0,1,5,1,0,0,0,0,14645,6.4,16431,196,54,-2330,-2096,25.0,1464.5
4786679021,0,14,1,1,3,4,2,0,0,0,0,14839,7.0,18174,191,60,-1370,-1251,25.1,1483.9,11,3,0,4,3,3,2,1,1,0,16209,7.0,19425,219,72,1370,1251,29.1,1620.9
4786655322,0,12,2,0,2,8,2,0,0,0,0,14722,6.6,17215,187,60,-1719,-422,24.7,1472.2,20,3,1,8,2,8,1,1,0,0,16441,7.0,17637,168,52,1719,422,22.0,1644.1
4786050489,1,15,0,1,4,3,3,1,1,0,0,15136,7.0,17355,189,60,-472,-1145,24.9,1513.6,6,0,0,3,4,3,0,0,0,0,15608,7.0,18500,230,60,472,1145,29.0,1560.8
4786028813,1,8,0,1,13,7,13,1,1,0,0,19824,7.0,18180,214,55,3936,2588,26.9,1982.4,9,0,0,7,13,6,0,0,0,0,15888,6.4,15592,164,48,-3936,-2588,21.2,1588.8
4785977662,0,13,1,0,7,10,2,1,1,0,0,15315,6.4,15962,150,52,-3974,-2235,20.2,1531.5,11,1,1,10,7,9,0,0,0,0,19289,7.0,18197,200,52,3974,2235,25.2,1928.9
4566750474,0,257,9,0,15,22,17,0,0,0,4,35408,9.8,32794,213,20,-4859,-1594,23.3,3540.8,48,0,1,22,15,23,1,1,0,0,40267,10.0,34388,220,8,4859,1594,22.8,4026.7
4566734548,0,39,1,1,15,31,25,1,1,0,3,35063,10.0,32446,176,53,-10164,-5178,22.9,3506.3,57,0,0,31,15,32,0,0,0,0,45227,10.6,37624,232,50,10164,5178,28.2,4522.7
4566092395,1,60,0,0,29,28,22,0,0,0,1,43959,10.4,36278,223,12,3608,2428,23.5,4395.9,24,0,1,28,29,33,1,1,0,0,40351,10.0,33850,189,39,-3608,-2428,22.8,4035.1
4566052508,0,27,1,1,28,24,27,0,0,0,3,42902,10.8,37928,227,21,5423,1620,24.8,4290.2,22,0,0,24,28,26,0,0,0,0,37479,10.4,36308,176,8,-5423,-1620,18.4,3747.9
4565695766,1,23,0,0,17,13,17,0,0,0,1,37186,9.8,31173,210,24,2726,-1,23.4,3718.6,22,0,1,13,17,13,0,0,0,0,34460,9.6,31174,219,10,-2726,1,22.9,3446.0
4565684946,0,19,1,0,10,23,10,1,1,0,1,31157,9.6,31208,206,20,-9412,-4161,22.6,3115.7,19,0,1,23,10,29,0,0,0,0,40569,10.6,35369,213,56,9412,4161,26.9,4056.9
4565666351,1,20,0,0,35,16,50,1,1,0,4,47015,9.8,33237,235,16,12824,1747,25.1,4701.5,21,0,1,16,35,29,0,0,0,0,34191,9.8,31490,142,14,-12824,-1747,15.6,3419.1
4565187906,1,16,0,1,28,15,30,0,0,0,2,39319,10.0,32622,192,12,5649,2909,20.4,3931.9,23,1,0,15,28,16,1,1,0,0,33670,9.4,29713,176,24,-5649,-2909,20.0,3367.0
4565152809,0,18,18,0,9,17,3,0,0,0,3,27378,9.4,30817,186,4,-11470,-4019,19.0,2737.8,54,2,1,17,9,18,0,0,0,0,38848,10.4,34836,265,23,11470,4019,28.8,3884.8
4565124060,1,40,1,1,20,20,20,0,0,0,3,35468,10.0,32939,158,12,-4490,18,17.0,3546.8,19,0,0,20,20,22,0,0,0,0,39958,10.0,32921,193,32,4490,-18,22.5,3995.8
4565101238,0,17,0,1,17,21,12,0,0,0,4,33862,10.0,32179,136,16,-7751,-492,15.2,3386.2,14,0,0,21,17,15,0,0,0,0,41613,9.8,32671,231,20,7751,492,25.1,4161.3
4565080156,0,15,0,1,19,17,17,0,0,0,2,32005,9.8,31969,158,0,-8333,-4207,15.8,3200.5,17,0,0,17,19,20,1,1,0,0,40338,10.2,36176,241,24,8333,4207,26.5,4033.8
4857409013,1,0,0,1,14,14,16,0,0,0,0,45950,10.0,47500,0,0,18100,19000,0.0,4595.0,2,0,0,9,9,9,0,0,0,0,27850,6.0,28500,0,0,-18100,-19000,0.0,2785.0
4857375729,1,0,0,1,21,12,23,0,0,0,0,64613,12.0,55000,2,0,27707,22000,0.2,6461.3,73,0,0,6,15,5,0,0,0,0,36906,7.2,33000,1,0,-27707,-22000,0.1,3690.6
4857357419,1,0,0,1,15,11,17,0,0,0,0,63050,12.0,55000,0,0,28300,22000,0.0,6305.0,0,0,0,6,10,4,0,0,0,0,34750,7.2,33000,0,0,-28300,-22000,0.0,3475.0
4857335599,1,189,1,0,25,19,21,0,0,0,0,63426,12.0,55000,1,0,26908,21950,0.1,6342.6,403,0,1,7,13,11,0,0,0,0,36518,7.2,33050,0,0,-26908,-21950,0.0,3651.8
4857318748,1,0,0,1,21,16,21,0,0,0,0,48778,10.0,47500,0,0,20174,19000,0.0,4877.8,0,0,0,8,13,8,0,0,0,0,28604,6.0,28500,0,0,-20174,-19000,0.0,2860.4
4857207176,1,0,0,1,20,14,22,0,0,0,0,63450,12.0,55000,2,0,26950,22000,0.2,6345.0,0,0,0,7,13,10,0,0,0,0,36500,7.2,33000,0,0,-26950,-22000,0.0,3650.0
4857183414,1,0,0,1,21,18,21,0,0,0,0,63412,12.0,55000,0,0,24812,22000,0.0,6341.2,0,0,0,13,16,8,0,0,0,0,38600,7.2,33000,0,0,-24812,-22000,0.0,3860.0
4857071383,0,9,9,0,0,12,0,0,0,0,0,12418,6.4,15944,157,56,-6860,-3481,21.3,1241.8,36,1,1,12,0,9,1,1,0,0,19278,7.4,19425,226,52,6860,3481,27.8,1927.8
4856368756,0,12,0,0,5,4,3,1,1,0,0,14041,6.4,15999,172,44,-1815,-3549,21.6,1404.1,10,0,1,4,5,1,0,0,0,0,15856,7.4,19548,193,68,1815,3549,26.1,1585.6
4856213963,0,10,0,0,7,7,7,1,1,0,0,16046,6.2,15064,150,48,-393,-1239,19.8,1604.6,60,0,1,7,7,4,0,0,0,0,16439,6.6,16303,142,48,393,1239,19.0,1643.9
4855932301,1,10,0,0,20,18,20,0,0,0,0,63074,12.0,55000,0,0,26218,22000,0.0,6307.4,180,0,1,9,11,7,0,0,0,0,36856,7.2,33000,0,0,-26218,-22000,0.0,3685.6
4855270359,0,29,1,1,4,2,4,0,0,0,0,15336,6.8,17018,192,52,-134,70,24.4,1533.6,15,8,0,2,4,2,1,1,0,0,15470,6.8,16948,207,48,134,-70,25.5,1547.0
4855178327,1,21,1,1,6,3,7,2,1,1,0,15122,7.0,18388,172,60,1171,1826,23.2,1512.2,22,1,0,3,6,2,0,0,0,0,13951,6.6,16562,168,48,-1171,-1826,21.6,1395.1
4854709608,1,30,0,1,19,18,14,0,0,0,0,48050,10.0,47500,0,0,19500,17500,0.0,4805.0,0,0,0,10,11,11,0,0,0,0,28550,6.4,30000,0,0,-19500,-17500,0.0,2855.0
4854005084,1,12,1,1,8,1,8,0,0,0,0,16626,6.8,17017,169,31,3249,48,20.0,1662.6,9,1,0,1,8,0,0,0,0,0,13377,6.6,16969,169,40,-3249,-48,20.9,1337.7
4853955066,1,65,1,1,3,0,2,0,0,0,0,15967,6.8,17550,191,48,3165,1511,23.9,1596.7,10,0,0,0,3,0,0,0,0,0,12802,6.4,16039,178,40,-3165,-1511,21.8,1280.2
4853749036,1,11,0,0,10,9,8,0,0,0,0,17292,6.4,17617,173,44,1306,2318,21.7,1729.2,13,3,1,9,10,9,0,0,0,0,15986,6.2,15299,145,36,-1306,-2318,18.1,1598.6
4853682436,1,2,0,1,23,10,21,0,0,0,0,48750,10.0,47500,0,0,22300,19000,0.0,4875.0,0,0,0,1,14,4,0,0,0,0,26450,6.0,28500,0,0,-22300,-19000,0.0,2645.0
4852879413,1,0,0,0,16,19,21,0,0,0,0,60657,12.0,55000,0,0,23424,22000,0.0,6065.7,0,0,1,13,10,11,0,0,0,0,37233,7.2,33000,0,0,-23424,-22000,0.0,3723.3
4852756170,1,17,0,1,23,17,19,0,0,0,0,50940,10.4,49000,1,0,23790,20500,0.1,5094.0,12,0,0,6,12,12,0,0,0,0,27150,6.0,28500,0,0,-23790,-20500,0.0,2715.0
4832170354,0,11,0,0,4,14,3,0,0,0,2,24824,10.2,33429,94,44,-9006,-6184,13.8,2482.4,15,0,1,14,4,19,0,0,0,0,33830,11.0,39613,106,55,9006,6184,16.1,3383.0
4815029344,0,86,0,0,0,4,0,0,0,0,0,13023,6.8,17403,190,57,-1042,-587,24.7,1302.3,17,1,1,4,0,0,0,0,0,0,14065,6.8,17990,186,48,1042,587,23.4,1406.5
4814971697,0,117,1,1,2,2,1,0,0,0,0,14875,7.2,18567,174,72,429,1186,24.6,1487.5,15,0,0,2,2,1,1,1,0,0,14446,7.0,17381,168,52,-429,-1186,22.0,1444.6
4801646242,1,16,2,0,3,3,2,1,1,0,0,14155,6.6,16238,172,48,-428,-756,22.0,1415.5,11,2,1,3,3,3,0,0,0,0,14583,6.8,16994,178,52,428,756,23.0,1458.3
4786824066,1,20,1,0,7,5,9,0,0,0,0,16805,7.0,17973,182,56,2080,1399,23.8,1680.5,12,1,1,5,7,9,0,0,0,0,14725,6.6,16574,173,40,-2080,-1399,21.3,1472.5
4766288568,1,14,2,0,4,7,4,0,0,0,0,14366,6.2,15919,155,32,-3114,-2352,18.7,1436.6,79,3,1,7,4,10,0,0,0,0,17480,7.2,18271,183,50,3114,2352,23.3,1748.0
4762254510,1,12,0,1,7,4,7,0,0,0,0,16046,6.8,17692,164,56,844,-447,22.0,1604.6,10,1,0,4,7,1,0,0,0,0,15202,6.8,18139,200,60,-844,447,26.0,1520.2
4747408153,1,4,2,1,3,2,4,1,1,0,0,15571,7.2,19164,210,56,2062,2171,26.6,1557.1,48,0,0,2,3,0,0,0,0,0,13509,6.8,16993,178,48,-2062,-2171,22.6,1350.9
4747351923,1,27,1,0,2,4,2,0,0,0,0,13690,6.8,18310,171,52,-1434,-491,22.3,1369.0,33,2,1,4,2,1,1,1,0,0,15124,7.2,18801,185,52,1434,491,23.7,1512.4
4747278682,1,22,0,1,9,10,8,1,1,0,0,16850,6.8,16289,131,64,-192,-530,19.5,1685.0,11,0,0,10,9,7,1,0,1,0,17042,6.6,16819,167,40,192,530,20.7,1704.2
4740763011,0,20,0,1,6,2,2,0,0,0,0,17374,7.2,19578,189,64,4167,3308,25.3,1737.4,81,0,0,2,6,0,0,0,0,0,13207,6.6,16270,151,44,-4167,-3308,19.5,1320.7
4730288490,1,11,0,0,3,3,1,0,0,0,0,15190,7.0,18390,168,56,373,935,22.4,1519.0,10,1,1,3,3,2,0,0,0,0,14817,7.0,17455,158,48,-373,-935,20.6,1481.7
4728943172,1,12,0,1,9,1,8,1,0,1,0,18756,7.0,18815,186,43,5725,1416,22.9,1875.6,30,0,0,1,9,1,0,0,0,0,13031,6.6,17399,186,45,-5725,-1416,23.1,1303.1
4728905146,0,8,0,0,6,5,8,0,0,0,0,16845,6.8,16562,160,64,1433,-250,22.4,1684.5,27,0,1,5,6,5,0,0,0,0,15412,6.6,16812,176,28,-1433,250,20.4,1541.2
4728599147,1,11,1,0,4,4,3,0,0,0,0,14524,6.6,17602,188,52,-652,1289,24.0,1452.4,25,2,1,4,4,3,0,0,0,0,15176,6.6,16313,172,44,652,-1289,21.6,1517.6
4728169961,1,130,0,1,5,3,4,1,1,0,0,15876,6.8,17486,199,48,-866,-233,24.7,1587.6,17,0,0,3,5,3,0,0,0,0,16742,6.8,17719,197,53,866,233,25.0,1674.2
4725736416,0,19,1,0,2,6,1,1,1,0,0,12703,6.0,14767,139,40,-5515,-3751,17.9,1270.3,17,0,1,6,2,1,0,0,0,0,18218,7.0,18518,191,53,5515,3751,24.4,1821.8
4724797671,0,36,0,1,5,5,8,1,1,0,0,15192,6.4,16341,179,52,-1479,-1788,23.1,1519.2,120,2,0,5,5,3,0,0,0,0,16671,6.8,18129,202,52,1479,1788,25.4,1667.1
4794761586,1,8,2,1,7,10,8,0,0,0,0,16879,6.6,16818,183,56,-1415,-1578,23.9,1687.9,13,3,0,10,7,9,1,1,0,0,18294,7.0,18396,173,44,1415,1578,21.7,1829.4
4782561712,1,10,3,0,6,3,8,0,0,0,0,16644,6.8,16942,196,52,2167,245,24.8,1664.4,12,1,1,3,6,2,0,0,0,0,14477,6.6,16697,202,48,-2167,-245,25.0,1447.7
4775640268,1,12,0,1,10,7,5,0,0,0,0,16849,6.8,17719,144,52,751,-105,19.6,1684.9,11,0,0,6,9,1,1,1,0,0,16098,7.0,17824,167,68,-751,105,23.5,1609.8
4770201622,0,15,0,1,8,3,10,1,1,0,0,16470,6.6,16265,172,56,860,-1157,22.8,1647.0,10,2,0,3,8,2,0,0,0,0,15610,6.8,17422,179,64,-860,1157,24.3,1561.0
4769776806,1,15,0,1,6,3,5,1,1,0,0,16238,7.4,19555,197,72,498,1671,26.9,1623.8,12,1,0,3,6,1,0,0,0,0,15740,6.8,17884,190,48,-498,-1671,23.8,1574.0
4769414724,0,13,6,1,4,5,2,0,0,0,0,13859,6.6,16323,135,56,-390,-581,19.1,1385.9,26,1,0,5,4,2,1,1,0,0,14249,6.4,16904,129,52,390,581,18.1,1424.9
4766264066,1,20,0,1,11,6,7,1,1,0,0,18623,7.0,18657,179,56,3553,2252,23.5,1862.3,12,0,0,6,11,5,0,0,0,0,15070,6.6,16405,143,48,-3553,-2252,19.1,1507.0
4766218349,0,11,0,1,5,4,7,1,1,0,0,15059,6.8,17930,167,68,-1485,215,23.5,1505.9,10,0,0,4,5,6,0,0,0,0,16544,6.8,17715,239,56,1485,-215,29.5,1654.4
4766136468,0,135,0,0,1,5,1,1,1,0,0,13743,6.6,15878,168,56,-1829,-2365,22.4,1374.3,18,0,1,5,1,2,0,0,0,0,15572,7.0,18243,198,56,1829,2365,25.4,1557.2
4765424210,1,11,1,1,4,0,3,0,0,0,0,18320,7.0,18712,230,52,5834,3941,28.2,1832.0,15,0,0,0,4,0,0,0,0,0,12486,6.0,14771,165,56,-5834,-3941,22.1,1248.6
4745575330,0,7,0,1,5,7,2,1,1,0,0,15871,7.0,17947,200,56,-1453,-505,25.6,1587.1,17,1,0,7,5,4,0,0,0,0,17324,7.0,18452,184,64,1453,505,24.8,1732.4
4745554901,1,15,18,1,9,2,6,1,1,0,0,18538,7.0,18931,209,48,5739,3116,25.7,1853.8,37,0,0,1,8,0,0,0,0,0,12799,6.4,15815,156,55,-5739,-3116,21.1,1279.9
4745081606,1,12,1,1,5,4,3,0,0,0,0,14285,5.8,15104,133,40,-2358,-2890,17.3,1428.5,13,1,0,4,5,1,0,0,0,0,16643,7.0,17994,185,46,2358,2890,23.1,1664.3
4745070405,0,20,1,0,3,6,3,1,1,0,0,13958,6.4,15718,190,45,-2918,-813,23.5,1395.8,16,0,1,6,3,4,0,0,0,0,16876,6.4,16531,194,49,2918,813,24.3,1687.6
4744516925,0,13,2,0,7,6,6,0,0,0,0,16351,7.0,17875,179,48,611,-386,22.7,1635.1,10,1,1,5,6,3,0,0,0,0,15740,7.2,18261,158,48,-611,386,20.6,1574.0
4744490988,0,10,1,0,3,7,3,1,0,1,0,15471,6.8,17798,200,60,-1520,-1303,26.0,1547.1,10,1,1,6,2,2,0,0,0,0,16991,7.0,19101,205,48,1520,1303,25.3,1699.1
4744459320,1,11,15,1,5,5,2,1,1,0,0,16142,7.2,19021,190,68,1610,1732,25.8,1614.2,32,1,0,4,4,4,0,0,0,0,14532,6.8,17289,165,44,-1610,-1732,20.9,1453.2
4739361826,1,8,0,0,2,5,0,1,1,0,0,14036,6.8,17244,202,52,-127,957,25.4,1403.6,8,0,1,5,2,3,0,0,0,0,14163,6.6,16287,152,48,127,-957,20.0,1416.3
4737748318,1,53,2,1,7,3,5,0,0,0,0,15413,6.6,17586,148,44,766,1648,19.2,1541.3,17,0,0,3,7,2,1,1,0,0,14647,6.4,15938,189,44,-766,-1648,23.3,1464.7
4730140746,1,14,2,1,8,11,7,1,0,1,0,18043,7.0,17383,185,40,-533,475,22.5,1804.3,215,3,0,11,8,7,1,1,0,0,18576,6.6,16908,156,56,533,-475,21.2,1857.6
4755570655,0,14,0,0,2,2,3,1,1,0,0,14146,6.8,17152,188,56,-1253,-1082,24.4,1414.6,10,1,1,2,2,1,0,0,0,0,15399,6.8,18234,258,44,1253,1082,30.2,1539.9
4754623318,0,9,2,1,4,2,0,0,0,0,0,15491,7.0,19028,189,60,1139,1490,24.9,1549.1,103,2,0,2,4,1,0,0,0,0,14352,7.0,17538,191,56,-1139,-1490,24.7,1435.2
4754571548,1,5,1,1,2,3,0,0,0,0,0,13700,7.0,18443,160,60,-1650,-468,22.0,1370.0,11,0,0,2,1,2,0,0,0,0,15350,7.0,18911,202,60,1650,468,26.2,1535.0
4752143957,1,70,0,1,7,2,9,0,0,0,0,17551,6.6,17090,137,40,4180,1282,17.7,1755.1,4,0,0,2,7,2,0,0,0,0,13371,6.4,15808,155,41,-4180,-1282,19.6,1337.1
4752111182,1,0,0,1,16,15,17,0,0,0,0,48400,10.0,47500,0,0,16435,19000,0.0,4840.0,0,0,0,10,11,5,0,0,0,0,31965,6.0,28500,0,0,-16435,-19000,0.0,3196.5
4750259895,0,48,0,0,3,6,2,0,0,0,0,15061,6.8,17330,188,61,310,1887,24.9,1506.1,187,1,1,6,3,8,1,1,0,0,14751,6.4,15443,107,50,-310,-1887,15.7,1475.1
4745537410,1,12,1,1,4,4,4,0,0,0,0,15794,7.0,17760,166,76,-441,-947,24.2,1579.4,11,0,0,4,4,1,1,1,0,0,16235,6.8,18707,181,60,441,947,24.1,1623.5
4745505565,1,12,0,1,10,1,11,0,0,0,0,17938,7.0,19027,190,60,3607,3208,25.0,1793.8,11,1,0,1,10,1,0,0,0,0,14331,6.4,15819,151,56,-3607,-3208,20.7,1433.1
4742861744,1,6,0,1,9,6,3,0,0,0,0,16987,6.8,17653,164,51,3880,3316,21.5,1698.7,5,0,0,5,8,4,0,0,0,0,13107,6.2,14337,116,36,-3880,-3316,15.2,1310.7
4742830252,0,6,0,0,3,11,0,1,1,0,0,13471,6.0,14595,122,52,-4587,-3107,17.4,1347.1,14,0,1,11,3,14,0,0,0,0,18058,6.8,17702,145,44,4587,3107,18.9,1805.8
4742799042,1,6,0,1,4,4,2,0,0,0,0,15652,6.6,16418,196,0,3092,1157,19.6,1565.2,208,0,0,4,4,4,0,0,0,0,12560,6.4,15261,129,4,-3092,-1157,13.3,1256.0
4740915490,0,1,0,0,19,32,27,0,0,0,1,34776,11.0,40085,71,0,-4719,-4620,7.1,3477.6,0,0,1,32,19,86,0,0,0,0,39495,11.8,44705,107,0,4719,4620,10.7,3949.5
4740869383,1,26,0,1,7,4,3,0,0,0,0,14621,6.6,17422,136,68,-1003,288,20.4,1462.1,3,13,0,3,6,2,0,0,0,0,15624,6.6,17134,158,56,1003,-288,21.4,1562.4
4740847126,1,14,0,1,7,4,6,0,0,0,0,17948,7.2,17879,157,48,3767,838,20.5,1794.8,9,0,0,4,7,4,0,0,0,0,14181,6.8,17041,129,60,-3767,-838,18.9,1418.1
4734908484,0,7,0,1,5,1,1,0,0,0,0,14012,7.0,18487,141,48,288,1104,18.9,1401.2,7,0,0,1,5,1,0,0,0,0,13724,7.0,17383,175,56,-288,-1104,23.1,1372.4
4734885905,1,7,0,1,8,4,2,0,0,0,0,17235,6.4,16308,141,56,4058,3522,19.7,1723.5,153,0,0,4,8,2,0,0,0,0,13177,5.6,12786,89,43,-4058,-3522,13.2,1317.7
4734857857,0,6,0,1,7,11,3,0,0,0,0,14269,5.8,13678,121,0,-4179,-3449,12.1,1426.9,4,0,0,11,7,9,0,0,0,0,18448,7.0,17127,139,56,4179,3449,19.5,1844.8
4734824455,1,6,0,0,8,4,5,1,1,0,0,18367,6.8,18352,183,66,5523,5007,24.9,1836.7,3,0,1,3,7,4,0,0,0,0,12844,6.0,13345,102,0,-5523,-5007,10.2,1284.4
4589763299,1,13,0,1,6,6,6,0,0,0,0,16825,6.6,16335,208,36,1514,41,24.4,1682.5,9,0,0,6,6,5,0,0,0,0,15311,6.6,16294,152,44,-1514,-41,19.6,1531.1
4545307494,1,11,1,0,5,10,6,0,0,0,0,17004,7.0,18284,193,40,-2048,-479,23.3,1700.4,170,2,1,10,5,4,0,0,0,0,19052,7.2,18763,177,47,2048,479,22.4,1905.2
4857631109,0,0,1,0,18,31,32,0,0,0,0,34300,10.6,37598,84,0,-5186,-5711,8.4,3430.0,13,0,1,31,18,89,0,0,0,0,39486,11.6,43309,80,0,5186,5711,8.0,3948.6
4857623022,1,0,0,0,23,29,56,0,0,0,1,36714,11.4,41534,97,0,325,-53,9.7,3671.4,0,0,1,29,23,80,0,0,0,0,36389,11.4,41587,75,0,-325,53,7.5,3638.9
4857576027,1,7,0,1,20,15,14,0,0,0,0,46650,10.0,47500,0,0,20200,19000,0.0,4665.0,19,0,0,4,9,5,0,0,0,0,26450,6.0,28500,0,0,-20200,-19000,0.0,2645.0
4857557140,1,0,0,1,27,26,66,0,0,0,0,38704,11.4,42430,103,0,983,34,10.3,3870.4,0,0,0,26,27,72,0,0,0,0,37721,11.4,42396,102,0,-983,-34,10.2,3772.1
4857536209,1,0,0,0,32,21,80,0,0,0,1,40000,11.8,45204,101,0,4378,5176,10.1,4000.0,0,0,1,21,32,42,0,0,0,0,35622,11.2,40028,69,0,-4378,-5176,6.9,3562.2
4857476767,0,216,0,1,15,23,38,0,0,0,1,33765,10.6,37492,103,0,-3348,-3945,10.3,3376.5,0,0,0,23,15,55,0,0,0,0,37113,11.2,41437,94,0,3348,3945,9.4,3711.3
4857405415,1,0,0,0,25,35,51,0,0,0,1,39656,11.4,44329,104,0,38,-2190,10.4,3965.6,0,0,1,35,25,75,0,0,0,0,39618,12.0,46519,77,0,-38,2190,7.7,3961.8
4857385087,1,36,0,1,16,17,15,0,0,0,0,46648,10.0,47500,1,0,18448,19000,0.1,4664.8,0,0,0,9,8,10,0,0,0,0,28200,6.0,28500,0,0,-18448,-19000,0.0,2820.0
4857363345,1,0,0,0,20,15,17,0,0,0,0,47700,10.0,47500,0,0,20200,19000,0.0,4770.0,0,0,1,7,12,9,0,0,0,0,27500,6.0,28500,0,0,-20200,-19000,0.0,2750.0
4857343282,1,105,0,1,21,23,17,0,0,0,0,63050,12.8,59000,0,0,25490,26000,0.0,6305.0,0,1,0,10,8,14,0,0,0,0,37560,7.2,33000,1,0,-25490,-26000,0.1,3756.0
4857318045,0,89,3,0,25,33,66,0,0,0,0,37966,11.0,40571,108,0,-682,-3861,10.8,3796.6,22,0,1,33,25,104,0,0,0,0,38648,11.6,44432,101,0,682,3861,10.1,3864.8
4857274633,0,0,0,0,28,20,84,0,0,0,1,38053,11.4,42193,92,0,223,2167,9.2,3805.3,0,0,1,20,28,58,0,0,0,0,37830,11.0,40026,93,0,-223,-2167,9.3,3783.0
4857245591,1,16,0,0,15,18,20,0,0,0,0,46045,10.0,47500,3,0,18165,19000,0.3,4604.5,0,0,1,10,7,10,0,0,0,0,27880,6.0,28500,0,0,-18165,-19000,0.0,2788.0
4857208101,1,28,0,1,19,18,24,0,0,0,0,64100,12.0,55000,0,0,25500,22000,0.0,6410.0,0,0,0,12,13,6,0,0,0,0,38600,7.2,33000,0,0,-25500,-22000,0.0,3860.0
4857177927,0,0,0,1,31,39,88,0,0,0,0,41128,12.0,46870,103,0,689,-737,10.3,4112.8,0,0,0,39,31,96,0,0,0,0,40439,12.2,47607,92,0,-689,737,9.2,4043.9
4857151057,1,183,0,1,31,20,71,0,0,0,1,38489,11.6,44246,96,0,2116,2162,9.6,3848.9,0,0,0,20,31,35,0,0,0,0,36373,11.2,42084,74,0,-2116,-2162,7.4,3637.3
4856484037,1,0,0,0,17,18,22,0,0,0,0,48050,10.0,47500,0,0,20200,16000,0.0,4805.0,0,0,1,12,11,6,0,0,0,0,27850,6.6,31500,0,0,-20200,-16000,0.0,2785.0
4856447197,1,0,4,1,24,26,58,0,0,0,0,36487,11.2,40204,119,0,-380,-2529,11.9,3648.7,16,0,0,26,24,63,0,0,0,0,36867,11.4,42733,87,0,380,2529,8.7,3686.7
4856410106,1,0,0,1,22,18,66,0,0,0,0,36808,10.8,38721,106,0,1206,-2136,10.6,3680.8,11,0,0,18,22,50,0,0,0,0,35602,11.2,40857,94,0,-1206,2136,9.4,3560.2
4856389139,0,15,0,0,16,36,39,0,0,0,1,34937,11.0,38747,71,0,-7202,-7433,7.1,3493.7,0,0,1,36,16,102,0,0,0,0,42139,12.0,46180,98,0,7202,7433,9.8,4213.9
4833608321,1,9,0,0,4,6,4,0,0,0,0,16316,6.6,17000,193,40,1264,266,23.3,1631.6,84,0,1,6,4,7,0,0,0,0,15052,6.6,16734,130,52,-1264,-266,18.2,1505.2
4833587047,1,9,1,1,4,2,1,0,0,0,0,15038,6.8,17385,193,36,1573,1956,22.9,1503.8,11,2,0,2,4,2,0,0,0,0,13465,6.4,15429,157,56,-1573,-1956,21.3,1346.5
4833577000,0,13,0,1,9,23,21,0,0,0,2,32604,11.2,42138,63,59,-4288,-936,12.2,3260.4,9,0,0,23,9,37,0,0,0,0,36892,11.8,43074,86,67,4288,936,15.3,3689.2
4832867073,0,10,0,0,5,24,7,0,0,0,0,26284,9.8,31838,76,43,-10175,-9171,11.9,2628.4,25,0,1,24,5,45,0,0,0,0,36459,11.4,41009,55,71,10175,9171,12.6,3645.9
4832846457,0,9,0,0,7,22,13,0,0,0,1,30839,10.6,35966,82,36,-7221,-6923,11.8,3083.9,7,0,1,22,7,45,0,0,0,0,38060,11.6,42889,82,79,7221,6923,16.1,3806.0
4832839970,0,18,0,0,4,17,6,0,0,0,0,24245,9.6,30018,63,40,-5273,-6582,10.3,2424.5,12,0,1,17,4,28,0,0,0,0,29518,10.6,36600,57,51,5273,6582,10.8,2951.8
4828510551,1,26,20,1,15,6,32,0,0,0,1,33662,10.8,38103,84,51,-1258,1899,13.5,3366.2,34,2,0,6,15,8,0,0,0,0,34920,10.6,36204,100,53,1258,-1899,15.3,3492.0
4818570027,1,9,2,0,14,12,23,0,0,0,0,29651,10.4,34088,58,31,-3303,-1732,8.9,2965.1,18,0,1,12,14,12,0,0,0,0,32954,10.6,35820,61,52,3303,1732,11.3,3295.4
4813440112,0,18,0,1,2,4,2,0,0,0,0,14335,6.4,16476,182,58,-671,-1682,24.0,1433.5,17,0,0,4,2,2,0,0,0,0,15006,6.8,18158,180,48,671,1682,22.8,1500.6
4813379288,1,16,1,0,6,5,6,1,0,1,0,16460,6.8,17276,184,52,1013,-694,23.6,1646.0,15,2,1,5,6,5,0,0,0,0,15447,7.0,17970,165,56,-1013,694,22.1,1544.7
4812989572,1,10,1,0,9,10,12,0,0,0,1,34409,10.8,38414,94,63,6077,7031,15.7,3440.9,11,0,1,10,9,16,0,0,0,0,28332,9.8,31383,67,47,-6077,-7031,11.4,2833.2
4812975417,1,7,0,0,7,16,6,0,0,0,1,30029,10.0,32704,71,44,-5670,-6750,11.5,3002.9,7,0,1,16,7,27,0,0,0,0,35699,10.8,39454,68,58,5670,6750,12.6,3569.9
4812966239,0,15,1,0,5,37,12,0,0,0,2,27447,10.8,36713,55,47,-19339,-16215,10.2,2744.7,12,0,1,36,4,52,0,0,0,0,46786,12.8,52928,129,79,19339,16215,20.8,4678.6
4812954882,0,11,0,1,17,9,29,0,0,0,0,31539,10.6,37047,71,55,-586,131,12.6,3153.9,11,0,0,9,17,17,0,0,0,0,32125,10.6,36916,45,48,586,-131,9.3,3212.5
4812939744,1,37,0,0,9,10,10,0,0,0,0,26627,10.2,35490,83,47,-133,-1945,13.0,2662.7,21,14,1,10,9,9,0,0,0,0,26760,10.6,37435,76,46,133,1945,12.2,2676.0
4812904665,0,8,0,1,14,8,28,0,0,0,1,32164,11.0,37693,87,51,2505,2426,13.8,3216.4,109,0,0,8,14,23,0,0,0,0,29659,10.2,35267,78,51,-2505,-2426,12.9,2965.9
4812892485,1,7,1,1,27,10,53,0,0,0,2,39017,11.4,41253,90,55,5630,5050,14.5,3901.7,10,0,0,10,27,18,0,0,0,0,33387,10.4,36203,52,47,-5630,-5050,9.9,3338.7
4812020751,0,20,2,0,13,34,18,0,0,0,2,38136,11.0,37148,75,55,-1726,-9040,13.0,3813.6,34,0,1,34,13,78,0,0,0,0,39862,12.0,46188,80,61,1726,9040,14.1,3986.2
4811999113,0,20,0,1,11,28,12,0,0,0,1,37449,11.0,36887,73,50,-2096,-5810,12.3,3744.9,9,0,0,28,11,54,0,0,0,0,39545,11.6,42697,97,55,2096,5810,15.2,3954.5
4753063171,1,12,0,1,8,6,7,0,0,0,0,16291,7.0,18385,150,64,999,1065,21.4,1629.1,64,0,0,6,8,1,0,0,0,0,15292,6.8,17320,188,36,-999,-1065,22.4,1529.2
4753019401,1,85,0,0,5,5,6,1,1,0,0,15604,7.0,17593,147,56,1003,-136,20.3,1560.4,9,0,1,5,5,0,0,0,0,0,14601,7.0,17729,165,48,-1003,136,21.3,1460.1
4749448286,0,20,9,1,7,7,5,1,1,0,0,15656,6.6,17287,177,40,-661,-776,21.7,1565.6,34,0,0,6,6,3,0,0,0,0,16317,7.0,18063,190,56,661,776,24.6,1631.7
4749428667,0,11,0,0,6,6,6,0,0,0,0,14590,5.8,13892,132,39,-1620,-3332,17.1,1459.0,7,0,1,6,6,4,0,0,0,0,16210,6.8,17224,186,43,1620,3332,22.9,1621.0
4741938218,1,10,1,1,5,6,5,0,0,0,0,16721,6.8,17560,170,48,-10,-568,21.8,1672.1,219,1,0,6,5,6,0,0,0,0,16731,7.0,18128,192,56,10,568,24.8,1673.1
4741913743,1,11,3,0,3,4,1,0,0,0,0,15029,6.8,17564,158,48,-1004,-1337,20.6,1502.9,10,1,1,4,3,2,0,0,0,0,16033,7.0,18901,228,68,1004,1337,29.6,1603.3
4741807838,0,27,3,1,3,2,1,0,0,0,0,14475,6.6,17179,168,51,-118,-355,21.9,1447.5,13,2,0,2,3,3,1,1,0,0,14593,6.8,17534,171,56,118,355,22.7,1459.3
4736758604,1,17,0,0,4,1,2,0,0,0,0,15114,7.0,17944,201,48,2180,1042,24.9,1511.4,11,0,1,1,4,2,0,0,0,0,12934,6.8,16902,157,44,-2180,-1042,20.1,1293.4
4735306428,0,12,2,1,5,2,4,0,0,0,0,15086,6.8,16952,152,52,2097,1174,20.4,1508.6,13,0,0,2,5,1,0,0,0,0,12989,6.4,15778,144,48,-2097,-1174,19.2,1298.9
4735284780,1,15,0,1,3,2,4,0,0,0,0,14207,6.8,17788,166,56,192,-483,22.2,1420.7,12,0,0,2,3,2,0,0,0,0,14015,6.8,18271,176,52,-192,483,22.8,1401.5
4734811855,1,13,10,0,4,4,2,1,1,0,0,15578,7.0,18634,243,44,591,1863,28.7,1557.8,28,2,1,4,4,3,0,0,0,0,14987,6.6,16771,193,48,-591,-1863,24.1,1498.7
4734769600,0,13,0,0,8,7,4,0,0,0,0,15949,6.6,16504,156,44,-977,-803,20.0,1594.9,14,1,1,7,8,5,0,0,0,0,16926,6.8,17307,185,56,977,803,24.1,1692.6
4734197782,1,36,3,1,9,3,9,1,0,1,0,18456,6.8,17364,194,68,4109,1123,26.2,1845.6,20,5,0,3,9,2,0,0,0,0,14347,6.6,16241,175,35,-4109,-1123,21.0,1434.7
4734158506,1,7,0,1,4,3,2,1,1,0,0,15064,6.8,18607,152,52,-390,707,20.4,1506.4,5,1,0,3,4,4,0,0,0,0,15454,6.8,17900,188,48,390,-707,23.6,1545.4
4733826383,0,54,1,1,1,1,1,0,0,0,0,14646,7.2,19209,209,43,-227,119,25.2,1464.6,18,1,0,1,1,1,1,1,0,0,14873,7.0,19090,203,60,227,-119,26.3,1487.3
4733805746,1,14,2,1,8,2,6,0,0,0,0,17069,7.0,17934,175,56,3510,1597,23.1,1706.9,226,1,0,2,8,1,0,0,0,0,13559,6.4,16337,173,44,-3510,-1597,21.7,1355.9
4733765249,1,11,3,1,3,2,2,1,1,0,0,14334,6.6,16358,142,44,331,-174,18.6,1433.4,228,0,0,2,3,1,0,0,0,0,14003,6.6,16532,195,36,-331,174,23.1,1400.3
4732703703,0,44,5,0,5,3,4,0,0,0,0,14162,5.8,14800,150,23,-1143,-2567,17.3,1416.2,36,0,1,3,5,1,1,1,0,0,15305,6.8,17367,192,56,1143,2567,24.8,1530.5
4731540721,1,54,0,0,17,12,14,0,0,0,0,63450,12.0,55000,1,0,26200,21000,0.1,6345.0,2,0,1,6,11,6,0,0,0,0,37250,7.4,34000,1,0,-26200,-21000,0.1,3725.0
4845302109,0,13,1,0,5,3,3,0,0,0,0,14337,7.0,17845,139,52,76,1380,19.1,1433.7,11,0,1,3,5,3,1,1,0,0,14261,6.8,16465,153,68,-76,-1380,22.1,1426.1
4844397218,1,110,1,0,1,1,2,2,1,1,0,14963,6.8,17920,202,56,-73,-917,25.8,1496.3,12,0,1,1,1,1,0,0,0,0,15036,7.0,18837,181,56,73,917,23.7,1503.6
4843488389,0,11,0,0,0,1,0,0,0,0,0,12444,6.6,16709,157,50,-1567,-893,20.7,1244.4,11,0,1,1,0,0,1,1,0,0,14011,6.6,17602,197,45,1567,893,24.2,1401.1
4841381536,1,34,1,1,8,3,7,1,1,0,0,17818,7.0,18365,170,44,4097,2119,21.4,1781.8,32,1,0,3,8,4,0,0,0,0,13721,6.6,16246,150,43,-4097,-2119,19.3,1372.1
4841347642,0,14,0,1,7,7,4,0,0,0,0,15067,6.4,15881,135,40,-3883,-3003,17.5,1506.7,312,2,0,7,7,4,1,1,0,0,18950,7.0,18884,232,44,3883,3003,27.6,1895.0
4839233892,0,14,0,1,7,6,7,0,0,0,0,15239,6.6,16519,146,51,-1599,-2120,19.7,1523.9,83,0,0,6,7,1,0,0,0,0,16838,7.2,18639,204,57,1599,2120,26.1,1683.8
4837167991,0,19,0,1,2,3,1,0,0,0,0,14123,6.8,17310,140,33,-816,-121,17.3,1412.3,10,0,0,3,2,1,0,0,0,0,14939,6.8,17431,182,46,816,121,22.8,1493.9
4837120823,0,15,0,0,6,6,3,1,1,0,0,15078,6.8,17067,118,48,-854,-24,16.6,1507.8,14,0,1,6,6,5,0,0,0,0,15932,6.6,17091,169,64,854,24,23.3,1593.2
4837057703,0,9,1,0,4,3,6,0,0,0,0,14255,6.6,16358,157,32,-2197,-1770,18.9,1425.5,23,3,1,3,4,2,0,0,0,0,16452,6.6,18128,186,52,2197,1770,23.8,1645.2
4836138905,1,76,3,1,7,3,4,1,1,0,0,16401,7.4,19016,193,48,2423,1871,24.1,1640.1,15,0,0,3,7,2,0,0,0,0,13978,6.8,17145,175,48,-2423,-1871,22.3,1397.8
4836093671,1,22,0,0,4,4,4,0,0,0,0,15336,6.6,16766,206,0,-344,-1261,20.6,1533.6,4,0,1,4,4,3,1,1,0,0,15680,7.0,18027,157,56,344,1261,21.3,1568.0
4835037990,0,14,1,0,2,4,2,1,1,0,0,13805,6.4,16246,152,32,-3709,-2766,18.4,1380.5,12,0,1,4,2,4,1,0,1,0,17514,7.0,19012,210,59,3709,2766,26.9,1751.4
4834134835,1,17,0,1,4,7,5,0,0,0,0,14575,6.6,16863,146,52,-213,38,19.8,1457.5,9,0,0,7,4,5,1,1,0,0,14788,6.8,16825,147,48,213,-38,19.5,1478.8
4834077217,1,13,5,0,4,3,4,1,1,0,0,14106,6.2,15688,187,52,-604,-1050,23.9,1410.6,12,2,1,3,4,3,0,0,0,0,14710,6.8,16738,197,36,604,1050,23.3,1471.0
4833703898,0,13,0,1,4,7,4,0,0,0,0,15261,6.8,16774,159,44,-2057,-2433,20.3,1526.1,167,2,0,7,4,6,1,1,0,0,17318,7.0,19207,192,48,2057,2433,24.0,1731.8
4833301110,1,12,2,1,4,4,4,1,0,1,0,15505,6.8,17516,176,44,1254,-202,22.0,1550.5,10,1,0,4,4,2,0,0,0,0,14251,6.8,17718,158,60,-1254,202,21.8,1425.1
4833253555,0,10,0,1,3,11,0,0,0,0,0,13896,6.4,15350,134,51,-3735,-2398,18.5,1389.6,22,1,0,11,3,6,1,1,0,0,17631,7.0,17748,169,52,3735,2398,22.1,1763.1
4832310674,1,10,3,0,5,7,9,1,1,0,0,15412,6.4,16113,171,44,-608,-982,21.5,1541.2,14,1,1,7,5,9,0,0,0,0,16020,6.8,17095,159,56,608,982,21.5,1602.0
4831471126,0,11,0,0,1,4,1,0,0,0,0,13341,6.4,15580,186,50,-2367,-3895,23.6,1334.1,12,1,1,4,1,2,0,0,0,0,15708,7.2,19475,229,68,2367,3895,29.7,1570.8
4830650053,0,17,1,1,9,3,6,0,0,0,0,18255,7.0,18409,182,68,3457,1702,25.0,1825.5,9,0,0,3,9,3,0,0,0,0,14798,6.8,16707,146,32,-3457,-1702,17.8,1479.8
4845899752,0,26,3,0,6,3,7,1,1,0,0,14004,6.4,15962,139,40,366,-542,17.9,1400.4,162,2,1,3,6,0,0,0,0,0,13638,6.4,16504,158,40,-366,542,19.8,1363.8
4841315683,0,11,0,0,2,9,1,0,0,0,0,12470,6.4,14708,128,39,-4626,-1437,16.7,1247.0,10,0,1,9,2,9,1,1,0,0,17096,6.4,16145,158,52,4626,1437,21.0,1709.6
4833401671,0,11,0,0,6,8,8,0,0,0,0,14796,6.6,16309,138,60,-2969,-1517,19.8,1479.6,8,0,1,8,6,9,0,0,0,0,17765,6.8,17826,186,48,2969,1517,23.4,1776.5
4833394245,1,17,2,1,11,2,11,1,1,0,0,18320,6.8,17897,164,66,4648,2597,23.0,1832.0,13,2,0,2,11,1,0,0,0,0,13672,6.0,15300,170,42,-4648,-2597,21.2,1367.2
4832850363,1,13,0,1,8,4,12,1,1,0,0,16212,6.6,16256,176,52,1458,-146,22.8,1621.2,16,1,0,4,8,2,0,0,0,0,14754,6.4,16402,171,52,-1458,146,22.3,1475.4
4831164547,0,9,0,1,5,9,2,0,0,0,0,16428,7.0,18082,207,40,957,980,24.7,1642.8,19,0,0,9,5,4,2,1,1,0,15471,6.6,17102,132,56,-957,-980,18.8,1547.1
4818923454,1,0,0,0,32,26,86,0,0,0,0,40113,11.8,44690,102,0,1092,2584,10.2,4011.3,0,0,1,26,32,53,0,0,0,0,39021,11.4,42106,74,0,-1092,-2584,7.4,3902.1
4818107931,0,0,0,0,21,34,46,0,0,0,1,35348,10.8,40488,80,0,-4145,-4202,8.0,3534.8,0,0,1,34,21,84,0,0,0,0,39493,11.6,44690,86,0,4145,4202,8.6,3949.3
4813750632,0,12,1,1,6,15,4,0,0,0,0,16057,6.6,17404,163,44,-4428,-2971,20.7,1605.7,13,0,0,15,6,6,2,1,1,0,20485,7.4,20375,183,76,4428,2971,25.9,2048.5
4810764686,1,0,0,1,25,22,40,0,0,0,0,38543,11.6,42359,117,0,3531,3338,11.7,3854.3,0,0,0,21,24,41,0,0,0,0,35012,10.8,39021,90,0,-3531,-3338,9.0,3501.2
4810754145,0,0,3,1,21,25,53,0,0,0,1,35483,10.6,38737,88,0,-2999,-4572,8.8,3548.3,30,0,0,25,21,67,0,0,0,0,38482,11.6,43309,107,0,2999,4572,10.7,3848.2
4810738413,0,6,2,1,24,28,67,0,0,0,1,36921,11.2,39989,100,0,-1568,-4233,10.0,3692.1,11,0,0,28,24,58,0,0,0,0,38489,11.6,44222,109,0,1568,4233,10.9,3848.9
4808210513,0,20,2,0,6,3,9,0,0,0,0,15914,6.6,16568,179,48,1825,86,22.7,1591.4,17,0,1,3,6,1,0,0,0,0,14089,6.6,16482,133,48,-1825,-86,18.1,1408.9
4807783300,1,15,1,0,7,5,2,2,1,1,0,15779,6.8,17220,149,56,806,676,20.5,1577.9,11,1,1,5,7,4,0,0,0,0,14973,6.6,16544,174,28,-806,-676,20.2,1497.3
4807252810,1,11,0,0,4,6,3,0,0,0,0,14957,6.6,17001,167,48,-183,621,21.5,1495.7,15,2,1,6,4,5,0,0,0,0,15140,6.6,16380,152,47,183,-621,19.9,1514.0
4806883352,0,10,2,1,4,5,2,1,1,0,0,14950,6.6,16444,145,40,-213,-1709,18.5,1495.0,11,2,0,5,4,3,0,0,0,0,15163,7.0,18153,188,52,213,1709,24.0,1516.3
4806856642,0,9,0,0,3,3,2,0,0,0,0,13238,6.8,17073,130,60,-594,-89,19.0,1323.8,19,0,1,3,3,0,1,1,0,0,13832,6.8,17162,165,60,594,89,22.5,1383.2
4786651061,1,0,0,1,33,23,99,0,0,0,0,40333,11.6,44671,113,0,2493,2507,11.3,4033.3,0,0,0,23,33,46,0,0,0,0,37840,11.4,42164,102,0,-2493,-2507,10.2,3784.0
4786632671,0,0,0,0,24,37,67,0,0,0,2,36199,10.6,39148,93,0,-7141,-7643,9.3,3619.9,0,0,1,37,24,85,0,0,0,0,43340,12.0,46791,116,0,7141,7643,11.6,4334.0
4856382038,1,12,1,1,4,1,2,0,0,0,0,15452,7.2,18655,211,48,2156,1508,25.9,1545.2,8,0,0,1,4,0,1,1,0,0,13296,6.6,17147,162,68,-2156,-1508,23.0,1329.6
4854034074,1,34,0,1,9,6,5,0,0,0,0,16599,6.6,16512,138,44,1532,622,18.2,1659.9,35,3,0,5,8,5,1,0,1,0,15067,6.6,15890,159,44,-1532,-622,20.3,1506.7
4853983430,1,50,1,0,4,6,2,0,0,0,0,15230,6.8,18048,146,58,-447,639,20.4,1523.0,10,1,1,6,4,5,0,0,0,0,15677,6.8,17409,179,59,447,-639,23.8,1567.7
4845854427,0,12,0,0,5,9,6,0,0,0,0,16610,6.8,16887,180,56,114,-1094,23.6,1661.0,8,0,1,9,5,5,0,0,0,0,16496,6.8,17981,163,44,-114,1094,20.7,1649.6
4845783325,1,11,1,0,3,2,3,0,0,0,0,14783,7.0,17638,163,56,-23,77,21.9,1478.3,62,0,1,2,3,0,0,0,0,0,14806,6.8,17561,173,72,23,-77,24.5,1480.6
4845760762,1,13,0,0,4,2,5,2,1,1,0,16076,7.0,18687,182,56,1538,921,23.8,1607.6,4,0,1,2,4,1,0,0,0,0,14538,6.8,17766,145,56,-1538,-921,20.1,1453.8
4845735722,1,49,0,1,8,3,7,1,1,0,0,15764,7.2,18156,179,48,1081,1466,22.7,1576.4,11,0,0,3,8,3,0,0,0,0,14683,6.8,16690,181,56,-1081,-1466,23.7,1468.3
4842562595,0,13,0,1,5,7,2,0,0,0,0,15690,6.6,17754,173,44,662,-129,21.7,1569.0,13,1,0,7,5,2,0,0,0,0,15028,6.8,17883,154,48,-662,129,20.2,1502.8
4842525800,1,12,0,0,2,7,1,0,0,0,0,13257,6.6,17602,167,56,-1741,-303,22.3,1325.7,11,0,1,7,2,6,0,0,0,0,14998,6.8,17905,149,48,1741,303,19.7,1499.8
4840501567,1,10,1,0,6,2,3,0,0,0,0,15284,6.8,17564,168,44,145,305,21.2,1528.4,15,1,1,2,6,1,0,0,0,0,15139,6.8,17259,173,48,-145,-305,22.1,1513.9
4840464467,1,12,1,0,5,5,3,0,0,0,0,15063,7.0,17415,176,48,-405,-1124,22.4,1506.3,14,0,1,5,5,2,0,0,0,0,15468,7.0,18539,196,52,405,1124,24.8,1546.8
4840050080,1,14,1,1,6,8,4,0,0,0,0,16613,6.8,17160,208,40,205,-554,24.8,1661.3,12,2,0,8,6,5,0,0,0,0,16408,6.8,17714,152,56,-205,554,20.8,1640.8
4808158465,0,174,0,1,7,4,2,0,0,0,0,16081,7.2,18315,173,60,710,1458,23.3,1608.1,15,1,0,4,7,2,0,0,0,0,15371,6.8,16857,168,48,-710,-1458,21.6,1537.1
4808140093,1,13,0,1,6,0,7,0,0,0,0,15448,6.4,15735,196,40,2337,-967,23.6,1544.8,15,0,0,0,6,0,0,0,0,0,13111,6.6,16702,166,56,-2337,967,22.2,1311.1
4808119115,0,13,0,0,2,6,1,0,0,0,0,12946,6.2,15319,138,56,-3245,-3172,19.4,1294.6,9,0,1,6,2,0,0,0,0,0,16191,6.8,18491,173,60,3245,3172,23.3,1619.1
4801883003,1,15,1,1,6,2,2,1,1,0,0,17210,7.2,19192,177,68,3789,1533,24.5,1721.0,8,0,0,2,6,2,0,0,0,0,13421,7.0,17659,171,44,-3789,-1533,21.5,1342.1
4801823076,0,14,1,0,6,4,4,0,0,0,0,15465,6.8,17609,176,56,482,-250,23.2,1546.5,15,1,1,4,6,2,0,0,0,0,14983,6.8,17859,177,44,-482,250,22.1,1498.3
4796216776,0,0,0,1,22,21,43,0,0,0,2,36767,11.0,39334,102,0,124,-1704,10.2,3676.7,3,0,0,21,22,47,0,0,0,0,36643,11.2,41038,99,0,-124,1704,9.9,3664.3
4792966401,0,17,0,0,4,6,2,0,0,0,0,14061,6.6,16427,174,44,-1521,-2721,21.8,1406.1,12,1,1,6,4,0,0,0,0,0,15582,7.2,19148,161,56,1521,2721,21.7,1558.2
4856351570,1,306,0,0,32,15,96,0,0,0,2,38892,11.4,41854,104,0,4028,4705,10.4,3889.2,8,0,1,15,32,41,0,0,0,0,34864,10.4,37149,87,0,-4028,-4705,8.7,3486.4
4856315590,1,89,0,1,19,27,39,0,0,0,0,35584,11.0,39928,102,0,-2070,-1959,10.2,3558.4,2,5,0,27,19,46,0,0,0,0,37654,11.4,41887,109,0,2070,1959,10.9,3765.4
4851956595,0,13,0,1,3,2,4,0,0,0,0,13562,6.4,15733,134,48,448,-1915,18.2,1356.2,7,0,0,2,3,1,0,0,0,0,13114,6.8,17648,151,52,-448,1915,20.3,1311.4
4851246708,1,17,3,1,3,4,2,0,0,0,0,14009,6.4,15454,157,43,-1096,-2178,20.0,1400.9,22,4,0,4,3,4,0,0,0,0,15105,6.8,17632,168,55,1096,2178,22.3,1510.5
4849091023,1,12,0,1,2,6,0,0,0,0,0,13974,6.4,16417,162,60,-899,-1011,22.2,1397.4,18,0,0,6,2,2,1,0,1,0,14873,6.8,17428,171,36,899,1011,20.7,1487.3
4848639372,1,0,0,0,21,22,58,0,0,0,1,35704,10.8,37483,68,0,-1839,-3562,6.8,3570.4,0,0,1,22,21,68,0,0,0,0,37543,11.2,41045,91,0,1839,3562,9.1,3754.3
4848623745,1,4,0,0,21,22,50,0,0,0,0,35693,10.8,39318,99,0,315,1527,9.9,3569.3,0,0,1,22,21,50,0,0,0,0,35378,10.6,37791,86,0,-315,-1527,8.6,3537.8
4848607821,1,0,0,0,24,17,70,0,0,0,1,37178,11.2,41652,101,0,1998,5273,10.1,3717.8,2,0,1,17,24,37,0,0,0,0,35180,10.4,36379,97,0,-1998,-5273,9.7,3518.0
4846177175,0,29,1,0,2,3,2,0,0,0,0,14122,7.0,17842,168,60,139,913,22.8,1412.2,13,9,1,3,2,3,0,0,0,0,13983,6.6,16929,145,47,-139,-913,19.2,1398.3
4846130405,1,53,1,1,4,0,5,0,0,0,0,15118,6.8,17798,155,60,2106,933,21.5,1511.8,16,0,0,0,4,0,0,0,0,0,13012,6.6,16865,165,44,-2106,-933,20.9,1301.2
4844974108,0,11,1,1,6,3,8,0,0,0,0,16162,6.8,17168,171,44,314,-750,21.5,1616.2,11,2,0,3,6,3,0,0,0,0,15848,6.8,17918,198,40,-314,750,23.8,1584.8
4844918852,0,9,1,1,6,1,2,0,0,0,0,15105,6.8,17480,178,36,1529,885,21.4,1510.5,15,0,0,1,6,0,0,0,0,0,13576,6.8,16595,186,72,-1529,-885,25.8,1357.6
4843418838,0,13,0,0,2,5,3,1,1,0,0,14389,6.8,17178,161,48,-1558,-835,20.9,1438.9,14,0,1,5,2,4,0,0,0,0,15947,7.0,18013,148,60,1558,835,20.8,1594.7
4843370564,0,9,1,0,2,6,0,0,0,0,0,15692,6.8,17785,184,52,-967,69,23.6,1569.2,17,0,1,6,2,4,1,1,0,0,16659,6.8,17716,206,40,967,-69,24.6,1665.9
4842476524,0,33,0,0,1,11,1,0,0,0,0,13673,6.4,15616,121,40,-3750,-2332,16.1,1367.3,30,0,1,11,1,9,0,0,0,0,17423,7.0,17948,143,52,3750,2332,19.5,1742.3
4842443573,1,9,0,1,7,4,5,1,1,0,0,15951,7.0,18000,174,60,1418,697,23.4,1595.1,13,0,0,4,7,3,0,0,0,0,14533,6.8,17303,163,52,-1418,-697,21.5,1453.3
4841462511,1,12,1,0,3,4,1,0,0,0,0,15097,6.8,17642,168,44,847,3031,21.2,1509.7,11,0,1,4,3,3,0,0,0,0,14250,6.4,14611,116,36,-847,-3031,15.2,1425.0
4841396547,0,8,0,1,7,5,6,0,0,0,0,16849,6.8,17607,184,48,-807,640,23.2,1684.9,14,0,0,5,7,6,0,0,0,0,17656,6.8,16967,172,48,807,-640,22.0,1765.6
4840297690,1,1,0,1,17,22,32,0,0,0,0,33904,10.6,36070,87,0,-3146,-4089,8.7,3390.4,0,0,0,22,17,63,0,0,0,0,37050,11.0,40159,106,0,3146,4089,10.6,3705.0
4840202943,1,11,0,1,3,0,2,0,0,0,0,14623,6.8,18344,157,60,2719,2603,21.7,1462.3,12,0,0,0,3,0,0,0,0,0,11904,6.4,15741,126,36,-2719,-2603,16.2,1190.4
4849862415,1,10,0,0,1,5,0,0,0,0,0,13417,6.8,17535,173,56,-1387,993,22.9,1341.7,17,0,1,5,1,4,0,0,0,0,14804,6.4,16542,145,52,1387,-993,19.7,1480.4
4840791417,1,12,1,0,5,12,4,0,0,0,0,16309,6.4,15501,130,52,-1530,-1229,18.2,1630.9,102,1,1,12,5,19,0,0,0,0,17839,6.8,16730,186,36,1530,1229,22.2,1783.9
4840762969,1,14,1,0,3,1,2,0,0,0,0,14702,6.8,17594,188,48,-411,-177,23.6,1470.2,12,1,1,1,3,1,1,0,1,0,15113,6.8,17771,199,48,411,177,24.7,1511.3
4840744157,0,17,0,0,3,4,3,0,0,0,0,14008,6.4,16286,143,50,-1784,-722,19.3,1400.8,15,0,1,4,3,2,0,0,0,0,15792,6.6,17008,174,48,1784,722,22.2,1579.2
4836612421,1,14,0,0,6,6,8,0,0,0,0,14824,6.4,15615,160,36,-996,-1223,19.6,1482.4,17,1,1,6,6,7,0,0,0,0,15820,6.8,16838,168,43,996,1223,21.1,1582.0
4833677070,0,12,0,0,3,8,4,0,0,0,0,13513,6.8,17148,147,52,-4438,-1221,19.9,1351.3,6,0,1,8,3,5,0,0,0,0,17951,7.0,18369,160,60,4438,1221,22.0,1795.1
4833654888,1,32,0,0,4,1,4,0,0,0,0,13958,6.2,15263,129,36,276,-1456,16.5,1395.8,13,0,1,1,4,1,0,0,0,0,13682,6.6,16719,166,64,-276,1456,23.0,1368.2
4795660624,1,9,2,0,4,5,3,0,0,0,0,15301,6.8,17501,194,40,599,998,23.4,1530.1,14,2,1,5,4,1,0,0,0,0,14702,6.4,16503,179,56,-599,-998,23.5,1470.2
4795643229,0,221,1,0,1,4,2,0,0,0,0,12954,6.6,16638,151,48,-2311,-331,19.9,1295.4,23,3,1,4,1,1,0,0,0,0,15265,6.6,16969,176,52,2311,331,22.8,1526.5
4787538866,0,75,1,0,1,4,1,0,0,0,0,12793,6.6,16265,136,48,-2879,-2633,18.4,1279.3,11,0,1,4,1,2,0,0,0,0,15672,7.0,18898,156,44,2879,2633,20.0,1567.2
4785111836,1,14,1,1,9,3,5,0,0,0,0,16636,6.6,17367,152,48,2133,338,20.0,1663.6,15,1,0,3,9,1,0,0,0,0,14503,6.8,17029,196,52,-2133,-338,24.8,1450.3
4782321355,1,17,0,1,7,7,4,1,1,0,0,14799,6.6,16601,147,48,-1574,-1217,19.5,1479.9,10,0,0,7,7,4,0,0,0,0,16373,6.8,17818,171,60,1574,1217,23.1,1637.3
4781670895,1,401,1,1,4,2,5,0,0,0,0,14804,6.6,16059,161,32,1704,551,19.3,1480.4,7,1,0,2,4,0,0,0,0,0,13100,6.4,15508,139,44,-1704,-551,18.3,1310.0
4781291880,0,11,0,0,4,6,2,0,0,0,0,14390,6.6,16770,138,40,-1248,504,17.8,1439.0,39,1,1,6,4,6,0,0,0,0,15638,6.8,16266,108,56,1248,-504,16.4,1563.8
4781261511,0,18,1,0,4,6,4,0,0,0,0,14054,6.6,15680,136,40,-2067,-1087,17.6,1405.4,9,1,1,6,4,3,0,0,0,0,16121,6.6,16767,180,48,2067,1087,22.8,1612.1
4780653471,0,16,1,1,5,4,2,0,0,0,0,13894,6.8,16207,136,40,-1272,-1925,17.6,1389.4,18,3,0,4,5,4,1,1,0,0,15166,7.0,18132,167,88,1272,1925,25.5,1516.6
4780623604,1,19,2,0,4,7,3,0,0,0,0,15308,6.8,16945,164,46,583,-486,21.0,1530.8,78,0,1,7,4,4,1,1,0,0,14725,6.8,17431,143,42,-583,486,18.5,1472.5
4780586888,0,29,0,1,2,3,1,0,0,0,0,13793,6.4,16714,169,56,72,870,22.5,1379.3,10,9,0,3,2,5,1,1,0,0,13721,6.6,15844,127,64,-72,-870,19.1,1372.1
4775167580,1,14,0,0,7,4,6,0,0,0,0,16403,6.6,16650,136,56,2648,336,19.2,1640.3,10,1,1,4,7,2,1,1,0,0,13755,6.6,16314,119,52,-2648,-336,17.1,1375.5
4750583590,1,17,0,1,7,6,4,0,0,0,0,15964,6.8,18032,203,36,365,714,23.9,1596.4,9,0,0,5,6,3,1,1,0,0,15599,6.8,17318,162,44,-365,-714,20.6,1559.9
4750572751,1,10,0,1,6,1,4,0,0,0,0,17512,7.0,18771,228,60,4589,2051,28.8,1751.2,8,1,0,1,6,0,0,0,0,0,12923,6.6,16720,182,43,-4589,-2051,22.5,1292.3
4750532342,0,30,0,0,3,14,0,0,0,0,0,12522,6.0,14858,142,48,-6759,-3149,19.0,1252.2,9,13,1,14,3,17,1,1,0,0,19281,6.6,18007,164,52,6759,3149,21.6,1928.1
4749971789,0,116,0,1,4,8,1,0,0,0,0,14487,6.6,16496,164,46,-3042,-2178,21.0,1448.7,14,3,0,7,3,6,1,1,0,0,17529,6.8,18674,167,45,3042,2178,21.2,1752.9
4749889077,1,246,0,1,3,4,2,1,1,0,0,14522,6.8,16925,169,52,306,705,22.1,1452.2,11,0,0,4,3,2,0,0,0,0,14216,6.2,16220,156,48,-306,-705,20.4,1421.6
4749764306,1,242,0,0,5,8,7,0,0,0,0,16511,7.0,17890,207,48,-376,-516,25.5,1651.1,8,0,1,8,5,7,0,0,0,0,16887,6.8,18406,192,52,376,516,24.4,1688.7
4749668605,1,114,2,0,4,5,6,1,1,0,0,13996,6.8,16763,150,43,-1392,-1349,19.3,1399.6,13,1,1,5,4,2,0,0,0,0,15388,6.8,18112,185,44,1392,1349,22.9,1538.8
4749613987,0,7,0,1,4,8,2,0,0,0,0,14585,6.8,17136,153,48,-1291,-806,20.1,1458.5,221,0,0,8,4,3,1,1,0,0,15876,6.8,17942,176,56,1291,806,23.2,1587.6
4749599392,0,47,1,0,2,4,1,0,0,0,0,11897,6.6,16263,123,40,-4451,-2844,16.3,1189.7,82,0,1,4,2,3,1,1,0,0,16348,7.0,19107,209,52,4451,2844,26.1,1634.8
4749141230,0,8,1,1,8,6,11,1,1,0,0,16804,6.4,16807,140,56,-662,-1118,19.6,1680.4,10,1,0,6,8,5,0,0,0,0,17466,6.8,17925,185,55,662,1118,24.0,1746.6
4749103563,1,9,0,0,3,4,2,1,0,1,0,16327,6.6,17011,178,48,2152,-239,22.6,1632.7,10,0,1,4,3,5,1,1,0,0,14175,6.8,17250,137,64,-2152,239,20.1,1417.5
4748954306,1,11,3,0,3,9,1,1,1,0,0,14594,6.8,17888,161,54,-3011,-407,21.5,1459.4,13,1,1,9,3,6,0,0,0,0,17605,6.8,18295,195,46,3011,407,24.1,1760.5
4748932323,0,7,0,1,6,5,4,1,0,1,0,16077,7.0,18391,187,52,473,588,23.9,1607.7,7,0,0,5,6,2,1,1,0,0,15604,6.8,17803,193,48,-473,-588,24.1,1560.4
4748815749,0,14,1,0,5,8,3,0,0,0,0,15187,6.6,17640,194,44,-1070,878,23.8,1518.7,15,1,1,8,5,5,0,0,0,0,16257,6.8,16762,179,44,1070,-878,22.3,1625.7
4856578427,1,12,4,0,25,26,70,0,0,0,1,38418,11.6,42769,110,0,1876,2366,11.0,3841.8,13,0,1,25,24,46,0,0,0,0,36542,11.0,40403,77,0,-1876,-2366,7.7,3654.2
4856560415,1,0,2,1,17,23,36,0,0,0,0,35891,11.2,41266,94,0,1257,2770,9.4,3589.1,15,0,0,23,17,61,0,0,0,0,34634,11.0,38496,84,0,-1257,-2770,8.4,3463.4
4856251097,0,1,0,1,26,39,53,0,0,0,2,37777,11.2,40892,74,0,-5038,-7253,7.4,3777.7,0,0,0,39,26,95,0,0,0,0,42815,12.4,48145,116,0,5038,7253,11.6,4281.5
4855415305,1,77,0,0,25,21,62,0,0,0,0,36744,11.4,42659,85,0,-44,2208,8.5,3674.4,0,0,1,21,25,39,0,0,0,0,36788,11.2,40451,95,0,44,-2208,9.5,3678.8
4855397583,0,0,0,0,26,25,63,0,0,0,2,37919,11.2,40839,89,0,-170,996,8.9,3791.9,0,0,1,25,26,67,0,0,0,0,38089,11.0,39843,110,0,170,-996,11.0,3808.9
4855327325,0,32,0,0,11,14,33,0,0,0,1,33397,10.2,34586,101,0,-2453,-2681,10.1,3339.7,0,28,1,14,11,44,0,0,0,0,35850,10.6,37267,104,0,2453,2681,10.4,3585.0
4854275422,0,0,0,0,12,30,28,0,0,0,0,32710,10.2,34951,79,0,-3837,-5648,7.9,3271.0,0,0,1,30,12,89,0,0,0,0,36547,11.2,40599,98,0,3837,5648,9.8,3654.7
4854053774,0,23,0,0,18,19,50,0,0,0,0,35267,10.8,37029,93,0,101,211,9.3,3526.7,0,1,1,19,18,54,0,0,0,0,35166,10.6,36818,85,0,-101,-211,8.5,3516.6
4853125164,1,0,0,1,30,17,69,0,0,0,1,38882,11.6,43370,89,0,2625,5693,8.9,3888.2,0,0,0,17,30,40,0,0,0,0,36257,10.8,37677,99,0,-2625,-5693,9.9,3625.7
4853037814,1,0,0,0,24,15,59,0,0,0,0,37252,11.2,40492,106,0,2648,2041,10.6,3725.2,3,0,1,15,24,29,0,0,0,0,34604,10.8,38451,85,0,-2648,-2041,8.5,3460.4
4852063577,0,0,2,1,23,12,48,0,0,0,0,36689,11.2,40017,116,0,3922,5169,11.6,3668.9,12,0,0,12,23,29,0,0,0,0,32767,10.0,34848,97,0,-3922,-5169,9.7,3276.7
4852016364,1,0,1,0,33,24,81,0,0,0,1,40758,11.8,44808,105,0,4730,4038,10.5,4075.8,13,0,1,24,33,54,0,0,0,0,36028,11.2,40770,78,0,-4730,-4038,7.8,3602.8
4851105518,1,0,2,1,22,33,50,0,0,0,0,38309,11.0,40914,99,0,464,-1855,9.9,3830.9,16,0,0,33,22,93,0,0,0,0,37845,11.6,42769,82,0,-464,1855,8.2,3784.5
4850067400,0,0,0,1,14,17,28,0,0,0,1,32835,10.4,35271,92,0,-2757,-3272,9.2,3283.5,0,0,0,17,14,41,0,0,0,0,35592,11.0,38543,120,0,2757,3272,12.0,3559.2
4849215400,1,0,0,1,44,33,113,0,0,0,1,43835,12.6,49537,116,0,2910,2342,11.6,4383.5,0,0,0,33,44,82,0,0,0,0,40925,12.4,47195,110,0,-2910,-2342,11.0,4092.5
4849199311,0,0,0,0,13,12,33,0,0,0,1,34306,10.8,36475,92,0,-1888,-1263,9.2,3430.6,0,0,1,12,13,41,0,0,0,0,36194,10.8,37738,101,0,1888,1263,10.1,3619.4
4848200501,1,2,1,1,12,21,26,0,0,0,0,33346,10.4,37103,87,0,-411,-1432,8.7,3334.6,16,0,0,21,12,54,0,0,0,0,33757,10.8,38535,103,0,411,1432,10.3,3375.7
4848188452,0,0,0,1,28,33,90,0,0,0,2,40851,12.0,44971,95,0,278,751,9.5,4085.1,0,0,0,33,28,79,0,0,0,0,40573,11.8,44220,112,0,-278,-751,11.2,4057.3
4847085399,1,14,0,0,31,23,76,0,0,0,0,39801,11.6,43814,103,0,4093,4185,10.3,3980.1,13,4,1,23,31,51,0,0,0,0,35708,11.0,39629,87,0,-4093,-4185,8.7,3570.8
4846125324,0,22,0,0,24,29,60,0,0,0,0,37835,11.2,41882,86,0,-752,-2960,8.6,3783.5,0,3,1,29,24,67,0,0,0,0,38587,11.6,44842,109,0,752,2960,10.9,3858.7
4854807484,0,18,6,1,6,6,4,0,0,0,0,16886,6.8,17335,207,46,-807,-1611,25.3,1688.6,19,3,0,6,6,1,0,0,0,0,17693,7.0,18946,223,60,807,1611,28.3,1769.3
4844720430,1,12,0,1,7,5,5,0,0,0,0,16289,6.6,17246,174,52,986,270,22.6,1628.9,7,0,0,5,7,5,0,0,0,0,15303,6.6,16976,163,48,-986,-270,21.1,1530.3
4844694484,1,17,0,0,3,7,2,1,1,0,0,14124,6.8,16811,158,56,-1092,-432,21.4,1412.4,12,1,1,7,3,8,0,0,0,0,15216,6.8,17243,165,60,1092,432,22.5,1521.6
4844567627,1,9,3,1,6,3,7,0,0,0,0,14552,6.4,15952,129,36,605,-418,16.5,1455.2,288,1,0,3,6,0,1,1,0,0,13947,6.6,16370,154,44,-605,418,19.8,1394.7
4843947689,1,13,1,0,6,4,2,1,1,0,0,14929,7.2,18632,152,43,634,2427,19.5,1492.9,178,1,1,4,6,2,0,0,0,0,14295,6.8,16205,164,56,-634,-2427,22.0,1429.5
4843926116,0,12,1,0,8,8,5,0,0,0,0,14568,6.4,16438,139,40,-3302,-1491,17.9,1456.8,10,0,1,8,8,7,0,0,0,0,17870,7.0,17929,180,40,3302,1491,22.0,1787.0
4843892405,0,37,1,0,3,2,4,0,0,0,0,14425,6.4,16224,219,32,346,57,25.1,1442.5,11,16,1,2,3,2,0,0,0,0,14079,6.6,16167,166,52,-346,-57,21.8,1407.9
4843184400,0,21,0,1,27,22,69,0,0,0,1,38860,11.0,41572,114,0,2747,1387,11.4,3886.0,0,17,0,22,27,62,0,0,0,0,36113,11.0,40185,73,0,-2747,-1387,7.3,3611.3
4843166135,0,0,0,1,23,23,46,0,0,0,1,35431,11.0,40582,112,0,-3021,-1468,11.2,3543.1,0,0,0,23,23,54,0,0,0,0,38452,11.4,42050,124,0,3021,1468,12.4,3845.2
4841846825,1,24,2,1,7,1,5,1,1,0,0,17843,6.8,18108,170,52,5028,3078,22.2,1784.3,14,2,0,1,7,0,0,0,0,0,12815,6.0,15030,161,48,-5028,-3078,20.9,1281.5
4841815186,0,83,16,0,4,8,3,0,0,0,0,15040,6.8,17306,141,48,-2259,-1393,18.9,1504.0,32,1,1,8,4,5,0,0,0,0,17299,7.0,18699,177,64,2259,1393,24.1,1729.9
4839826414,0,14,0,1,3,9,2,0,0,0,0,13672,6.6,15489,151,37,-3649,-5317,18.8,1367.2,10,0,0,9,3,4,2,1,1,0,17321,7.6,20806,161,71,3649,5317,23.2,1732.1
4839787916,1,226,0,0,7,5,4,1,1,0,0,16700,7.2,18222,163,57,1287,1340,22.0,1670.0,7,0,1,5,7,0,0,0,0,0,15413,6.4,16882,175,50,-1287,-1340,22.5,1541.3
4839762139,0,101,0,0,19,25,54,0,0,0,0,34806,11.0,38425,95,0,-1764,-2338,9.5,3480.6,0,3,1,25,19,49,0,0,0,0,36570,11.2,40763,89,0,1764,2338,8.9,3657.0
4839747351,0,0,0,0,22,24,46,0,0,0,0,35584,10.8,39939,84,0,-1593,-572,8.4,3558.4,0,0,1,24,22,61,0,0,0,0,37177,11.2,40511,96,0,1593,572,9.6,3717.7
4839711800,0,235,1,1,22,24,55,0,0,0,0,36645,10.8,38929,111,0,-2013,-3071,11.1,3664.5,5,23,0,24,22,59,0,0,0,0,38658,11.2,42000,101,0,2013,3071,10.1,3865.8
4839696303,1,2,0,0,15,22,31,0,0,0,0,33452,10.6,37280,103,0,-2521,-3087,10.3,3345.2,0,0,1,22,15,50,0,0,0,0,35973,11.0,40367,100,0,2521,3087,10.0,3597.3
4857416784,0,57,2,0,5,3,4,0,0,0,0,15930,6.6,16251,175,53,-313,-408,22.8,1593.0,14,1,1,3,5,4,0,0,0,0,16243,6.6,16659,178,52,313,408,23.0,1624.3
4857358227,0,15,1,0,1,4,0,1,1,0,0,13248,6.6,16843,147,56,-3118,-2328,20.3,1324.8,15,1,1,4,1,3,0,0,0,0,16366,7.0,19171,207,64,3118,2328,27.1,1636.6
4856424005,1,12,0,1,11,8,10,0,0,0,0,17892,6.6,16260,166,44,-91,-279,21.0,1789.2,199,0,0,8,11,12,1,1,0,0,17983,6.6,16539,155,52,91,279,20.7,1798.3
4856352608,0,13,1,0,4,3,4,0,0,0,0,16687,6.8,16718,172,43,1692,-198,21.5,1668.7,11,0,1,3,4,0,0,0,0,0,14995,6.6,16916,175,48,-1692,198,22.3,1499.5
4856305445,0,12,1,0,0,9,0,0,0,0,0,13626,7.0,16608,161,44,-3201,-2527,20.5,1362.6,156,0,1,9,0,3,1,1,0,0,16827,6.8,19135,195,52,3201,2527,24.7,1682.7
4855872990,1,15,1,0,5,6,3,0,0,0,0,15387,6.6,16694,199,44,-59,1753,24.3,1538.7,34,0,1,6,5,5,0,0,0,0,15446,6.4,14941,159,40,59,-1753,19.9,1544.6
4855820340,0,13,1,0,2,3,2,1,1,0,0,13927,6.8,17191,176,49,-495,-715,22.5,1392.7,10,2,1,3,2,2,0,0,0,0,14422,6.6,17906,199,32,495,715,23.1,1442.2
4855793781,0,10,1,0,5,5,5,1,1,0,0,15462,6.6,17182,194,52,386,-477,24.6,1546.2,9,2,1,5,5,1,0,0,0,0,15076,6.8,17659,217,52,-386,477,26.9,1507.6
4855753470,1,12,2,0,8,5,10,1,1,0,0,17153,6.6,16383,181,56,1327,-1115,23.7,1715.3,10,2,1,5,8,3,0,0,0,0,15826,6.8,17498,180,56,-1327,1115,23.6,1582.6
4855741850,0,10,9,1,3,3,0,0,0,0,0,14866,6.8,17592,175,60,-684,-40,23.5,1486.6,33,1,0,3,3,3,1,1,0,0,15550,6.8,17632,189,48,684,40,23.7,1555.0
4855271513,0,16,1,1,4,7,8,0,0,0,0,16650,6.6,16077,127,48,-82,-553,17.5,1665.0,13,2,0,7,4,3,0,0,0,0,16732,6.6,16630,187,52,82,553,23.9,1673.2
4855224525,1,8,0,1,11,5,4,0,0,0,0,19555,7.2,18750,217,60,4068,1578,27.7,1955.5,16,0,0,5,11,2,1,1,0,0,15487,7.0,17172,165,60,-4068,-1578,22.5,1548.7
4855177323,1,16,3,1,5,4,2,0,0,0,0,14728,6.2,15829,177,36,1368,2570,21.3,1472.8,12,1,0,4,5,6,0,0,0,0,13360,5.8,13259,124,40,-1368,-2570,16.4,1336.0
4853989712,1,14,1,0,2,8,1,0,0,0,0,15881,6.4,16531,197,51,-1154,-466,24.8,1588.1,101,1,1,8,2,12,1,1,0,0,17035,6.6,16997,192,40,1154,466,23.2,1703.5
4852498371,1,11,0,0,23,20,55,0,0,0,1,37951,11.2,42523,111,0,5663,5767,11.1,3795.1,0,0,1,20,23,30,0,0,0,0,32288,10.4,36756,52,0,-5663,-5767,5.2,3228.8
4851820264,0,13,1,1,2,6,2,1,1,0,0,14304,6.4,15880,158,60,-419,-1036,21.8,1430.4,15,0,0,6,2,4,0,0,0,0,14723,6.6,16916,158,36,419,1036,19.4,1472.3
4851773269,0,15,1,0,5,7,4,0,0,0,0,14106,6.2,15075,131,30,-2179,-2374,16.1,1410.6,16,2,1,7,5,4,0,0,0,0,16285,6.8,17449,193,46,2179,2374,23.9,1628.5
4851718701,0,77,0,0,2,7,1,0,0,0,0,13806,6.6,16369,153,44,-3718,-1895,19.7,1380.6,15,0,1,7,2,7,1,1,0,0,17524,7.0,18264,177,60,3718,1895,23.7,1752.4
4851678615,0,15,2,0,5,3,5,1,1,0,0,16060,6.6,17212,189,44,407,-1588,23.3,1606.0,8,5,1,3,5,1,0,0,0,0,15653,7.2,18800,210,68,-407,1588,27.8,1565.3
4851624494,0,13,0,1,4,5,3,0,0,0,0,14754,6.6,16816,161,31,-133,-286,19.2,1475.4,12,1,0,5,4,5,0,0,0,0,14887,6.8,17102,178,53,133,286,23.1,1488.7
4851502611,0,15,3,0,6,7,7,0,0,0,0,14890,6.4,15682,146,38,-1835,-2051,18.4,1489.0,19,3,1,7,6,6,0,0,0,0,16725,6.8,17733,195,43,1835,2051,23.8,1672.5
4851486339,0,14,14,0,5,7,3,0,0,0,0,14174,6.8,16628,124,38,-2441,-543,16.2,1417.4,195,2,1,7,5,7,0,0,0,0,16615,6.6,17171,195,33,2441,543,22.8,1661.5
4850639330,0,14,0,1,8,6,3,0,0,0,0,15817,6.6,17062,178,40,-1111,216,21.8,1581.7,207,1,0,6,8,5,1,1,0,0,16928,6.6,16846,177,52,1111,-216,22.9,1692.8
4849813098,0,12,0,0,2,4,1,0,0,0,0,13115,6.6,17193,152,52,-1380,-47,20.4,1311.5,11,0,1,4,2,3,1,1,0,0,14495,6.8,17240,177,48,1380,47,22.5,1449.5
4849774350,0,15,2,1,3,5,2,0,0,0,0,12551,6.4,15281,135,56,-2436,-2641,19.1,1255.1,20,1,0,4,2,3,0,0,0,0,14987,6.8,17922,160,40,2436,2641,20.0,1498.7
4849729721,0,74,1,1,5,3,5,0,0,0,0,15689,6.8,17344,158,62,2227,1513,22.0,1568.9,15,0,0,3,5,1,0,0,0,0,13462,6.4,15831,177,36,-2227,-1513,21.3,1346.2
4849689622,1,17,3,1,4,6,8,1,1,0,0,15864,6.6,17198,173,48,742,228,22.1,1586.4,8,1,0,6,4,4,0,0,0,0,15122,6.6,16970,195,42,-742,-228,23.7,1512.2
4849045743,1,11,1,1,7,2,5,0,0,0,0,15723,6.6,16801,160,40,2175,-160,20.0,1572.3,14,0,0,2,7,1,0,0,0,0,13548,6.8,16961,200,43,-2175,160,24.3,1354.8
4848978716,0,8,2,1,4,5,2,0,0,0,0,13954,6.4,15632,180,52,-1719,-2482,23.2,1395.4,12,1,0,5,4,5,1,1,0,0,15673,7.0,18114,174,56,1719,2482,23.0,1567.3
4848937868,0,14,2,0,7,8,2,0,0,0,0,14545,6.4,16452,155,48,-1750,-1511,20.3,1454.5,165,2,1,8,7,5,0,0,0,0,16295,7.0,17963,183,51,1750,1511,23.4,1629.5
4848906371,1,9,0,1,16,3,5,1,1,0,0,18508,7.0,18123,136,75,6477,5743,21.1,1850.8,127,0,0,3,16,1,0,0,0,0,12031,5.6,12380,134,0,-6477,-5743,13.4,1203.1
4848056872,0,33,3,0,4,3,6,0,0,0,0,15601,7.2,18178,217,67,271,266,28.4,1560.1,41,4,1,3,4,1,0,0,0,0,15330,6.8,17912,213,56,-271,-266,26.9,1533.0
4847999929,1,13,0,0,2,6,3,0,0,0,0,15607,7.2,18339,240,58,-1631,-1506,29.8,1560.7,106,0,1,6,2,2,0,0,0,0,17238,7.2,19845,223,71,1631,1506,29.4,1723.8
4847058536,0,9,1,0,2,9,3,0,0,0,0,14661,6.4,15264,163,60,-3393,-3479,22.3,1466.1,20,1,1,9,2,6,1,1,0,0,18054,7.0,18743,214,48,3393,3479,26.2,1805.4
4847017328,1,80,1,1,7,5,5,0,0,0,0,15933,6.6,16790,197,52,-551,695,24.9,1593.3,12,1,0,5,7,6,1,1,0,0,16484,6.4,16095,195,44,551,-695,23.9,1648.4
4838293258,1,6,2,0,5,6,3,0,0,0,0,15592,6.6,16495,189,32,-911,-173,22.1,1559.2,16,0,1,6,5,3,0,0,0,0,16503,6.8,16668,183,48,911,173,23.1,1650.3
4838205249,0,12,2,0,3,5,2,0,0,0,0,15303,6.8,17539,184,52,-960,-224,23.6,1530.3,10,2,1,5,3,5,1,1,0,0,16263,6.8,17763,207,56,960,224,26.3,1626.3
4834161453,0,27,0,1,6,9,3,0,0,0,0,16861,6.8,17165,182,52,-895,-1334,23.4,1686.1,13,9,0,9,6,9,0,0,0,0,17756,7.0,18499,180,48,895,1334,22.8,1775.6
4845489304,0,20,1,0,3,5,2,0,0,0,0,14285,6.4,16288,168,50,-1048,-1302,21.8,1428.5,15,2,1,5,3,3,1,1,0,0,15333,7.0,17590,202,52,1048,1302,25.4,1533.3
4839574585,0,10,2,0,3,8,2,0,0,0,0,14155,6.8,17678,188,40,-2200,408,22.8,1415.5,14,0,1,8,3,11,0,0,0,0,16355,7.0,17270,159,47,2200,-408,20.6,1635.5
4839564212,0,15,3,1,12,10,10,0,0,0,0,18531,6.6,16254,162,56,32,170,21.8,1853.1,18,2,0,10,12,13,1,1,0,0,18499,6.4,16084,154,49,-32,-170,20.3,1849.9
4839556177,1,11,1,1,5,7,6,0,0,0,0,17374,6.8,17397,172,52,-372,-306,22.4,1737.4,11,1,0,7,5,3,0,0,0,0,17746,6.8,17703,178,44,372,306,22.2,1774.6
4839541463,1,6,2,0,8,6,6,0,0,0,0,16532,6.6,17404,173,48,660,-913,22.1,1653.2,13,0,1,6,8,2,1,1,0,0,15872,7.0,18317,218,64,-660,913,28.2,1587.2
4838591613,1,17,1,0,2,1,1,0,0,0,0,13332,6.8,16516,191,40,-463,-440,23.1,1333.2,11,1,1,1,2,1,0,0,0,0,13795,6.8,16956,197,48,463,440,24.5,1379.5
4838584806,1,14,1,0,5,4,2,0,0,0,0,16972,6.8,17754,212,52,2038,1546,26.4,1697.2,122,0,1,4,5,4,1,1,0,0,14934,6.8,16208,165,44,-2038,-1546,20.9,1493.4
4838565381,0,31,1,0,2,4,1,1,1,0,0,15638,7.0,18012,209,65,416,-66,27.4,1563.8,32,0,1,4,2,4,0,0,0,0,15222,7.2,18078,158,62,-416,66,22.0,1522.2
4838558087,1,16,1,1,8,3,8,0,0,0,0,17743,7.2,18480,197,60,3743,2048,25.7,1774.3,9,1,0,3,8,3,0,0,0,0,14000,6.4,16432,166,40,-3743,-2048,20.6,1400.0
4780299082,1,10,2,1,2,2,1,0,0,0,0,16001,7.2,19206,224,68,1562,646,29.2,1600.1,10,0,0,2,2,1,0,0,0,0,14439,6.8,18560,214,60,-1562,-646,27.4,1443.9
4776865631,1,14,3,1,8,1,7,0,0,0,0,17343,6.6,16864,209,36,3413,-688,24.5,1734.3,9,3,0,1,8,0,0,0,0,0,13930,7.0,17552,214,48,-3413,688,26.2,1393.0
4774728471,0,8,2,1,6,7,2,0,0,0,0,14626,6.6,15714,177,40,-2290,-729,21.7,1462.6,20,0,0,7,6,10,0,0,0,0,16916,6.6,16443,180,48,2290,729,22.8,1691.6
4774706338,1,9,3,0,5,6,3,0,0,0,0,15549,7.2,17877,175,52,-341,1433,22.7,1554.9,29,0,1,6,5,5,1,1,0,0,15890,6.8,16444,195,59,341,-1433,25.4,1589.0
4769555542,1,16,2,0,9,6,3,0,0,0,0,16227,7.0,17071,163,44,1021,287,20.7,1622.7,9,1,1,6,9,2,0,0,0,0,15206,6.6,16784,185,44,-1021,-287,22.9,1520.6
4769530068,0,10,0,0,4,5,1,0,0,0,0,15714,6.8,17771,215,52,-876,-914,26.7,1571.4,19,2,1,5,4,7,1,1,0,0,16590,7.2,18685,218,72,876,914,29.0,1659.0
4857275258,0,41,1,1,21,24,56,0,0,0,0,35937,11.0,40559,92,0,-1459,-1432,9.2,3593.7,14,0,0,24,21,65,0,0,0,0,37396,11.0,41991,89,0,1459,1432,8.9,3739.6
4857244149,1,2,0,1,20,16,64,0,0,0,0,37843,11.0,40076,98,0,2979,1339,9.8,3784.3,84,1,0,16,20,43,0,0,0,0,34864,10.8,38737,104,0,-2979,-1339,10.4,3486.4
4857213485,1,15,0,1,30,18,66,0,0,0,1,38648,11.4,43120,102,0,3883,3821,10.2,3864.8,0,0,0,18,30,31,0,0,0,0,34765,11.0,39299,64,0,-3883,-3821,6.4,3476.5
4857187740,1,0,0,0,21,27,41,0,0,0,0,36514,10.8,39295,94,0,-1705,-2975,9.4,3651.4,0,0,1,27,21,81,0,0,0,0,38219,11.4,42270,88,0,1705,2975,8.8,3821.9
4857139179,1,38,2,0,15,15,12,0,0,0,0,46632,10.0,47500,3,0,16887,19000,0.3,4663.2,34,0,1,10,10,10,0,0,0,0,29745,6.0,28500,1,0,-16887,-19000,0.1,2974.5
4857112661,1,8,0,1,15,21,15,0,0,0,0,60600,12.0,55000,0,0,20600,22000,0.0,6060.0,0,0,0,14,8,15,0,0,0,0,40000,7.2,33000,0,0,-20600,-22000,0.0,4000.0
4857100395,0,306,0,1,21,28,57,0,0,0,2,39199,11.2,41514,107,0,355,-1319,10.7,3919.9,0,0,0,28,21,61,0,0,0,0,38844,11.4,42833,114,0,-355,1319,11.4,3884.4
4857074591,0,11,0,1,19,16,41,0,0,0,0,34968,10.8,38523,106,0,1086,1515,10.6,3496.8,0,2,0,16,19,46,0,0,0,0,33882,10.6,37008,98,0,-1086,-1515,9.8,3388.2
4857051669,1,0,0,1,26,14,70,0,0,0,0,37885,11.2,41370,103,0,3681,5823,10.3,3788.5,0,0,0,14,26,26,0,0,0,0,34204,10.2,35547,90,0,-3681,-5823,9.0,3420.4
4856586405,0,85,1,0,3,6,0,0,0,0,0,14916,6.4,16750,178,60,-1269,-442,23.8,1491.6,14,0,1,6,3,7,1,1,0,0,16185,6.6,17192,203,36,1269,442,23.9,1618.5
4856574261,1,10,0,0,9,6,5,0,0,0,0,16415,6.2,15765,149,48,1229,-573,19.7,1641.5,17,0,1,6,9,3,0,0,0,0,15186,6.4,16338,157,56,-1229,573,21.3,1518.6
4856553481,1,15,1,0,1,2,1,0,0,0,0,13666,6.8,16707,206,42,-525,-893,24.8,1366.6,290,0,1,2,1,0,1,1,0,0,14191,6.8,17600,184,49,525,893,23.3,1419.1
4856536007,1,11,3,0,5,5,2,0,0,0,0,14381,6.6,16337,159,42,-102,133,20.1,1438.1,14,1,1,5,5,4,0,0,0,0,14483,6.6,16204,157,39,102,-133,19.6,1448.3
4855447953,1,15,0,1,4,4,3,1,1,0,0,15300,6.8,16823,176,60,633,-7,23.6,1530.0,11,0,0,4,4,1,1,0,1,0,14667,6.8,16830,137,52,-633,7,18.9,1466.7
4855434366,1,8,0,1,18,16,17,0,0,0,0,60250,12.0,55000,0,0,22000,22000,0.0,6025.0,4,0,0,10,12,13,0,0,0,0,38250,7.2,33000,0,0,-22000,-22000,0.0,3825.0
4855401469,0,0,10,1,27,19,65,0,0,0,0,37200,11.4,41723,100,0,3682,5127,10.0,3720.0,15,0,0,19,27,32,0,0,0,0,33518,10.6,36596,73,0,-3682,-5127,7.3,3351.8
4855382397,1,9,0,1,28,21,67,0,0,0,1,40719,11.4,42928,115,0,5144,3101,11.5,4071.9,0,0,0,21,28,46,0,0,0,0,35575,11.2,39827,85,0,-5144,-3101,8.5,3557.5
4855351326,1,0,0,0,28,39,74,0,0,0,1,38971,11.4,44118,109,0,-3966,-3438,10.9,3897.1,0,0,1,39,28,120,0,0,0,0,42937,12.2,47556,103,0,3966,3438,10.3,4293.7
4855326016,1,0,0,0,21,20,49,0,0,0,0,36051,11.4,40894,105,0,731,1500,10.5,3605.1,0,0,1,20,21,37,0,0,0,0,35320,10.8,39394,94,0,-731,-1500,9.4,3532.0
4855167304,0,69,0,0,23,18,58,0,0,0,1,35956,11.0,39928,77,0,242,2518,7.7,3595.6,31,0,1,18,23,42,0,0,0,0,35714,10.8,37410,101,0,-242,-2518,10.1,3571.4
4857531107,0,14,1,0,1,7,0,0,0,0,0,12700,6.6,16002,167,48,-3179,-1130,21.5,1270.0,12,0,1,7,1,8,0,0,0,0,15879,6.6,17132,148,52,3179,1130,20.0,1587.9
4856431267,0,12,1,0,2,7,5,0,0,0,0,14442,6.6,16569,188,52,-2117,-1013,24.0,1444.2,10,0,1,7,2,8,0,0,0,0,16559,6.8,17582,187,48,2117,1013,23.5,1655.9
4856406944,1,16,1,1,13,6,17,0,0,0,0,19868,7.0,18082,186,52,3116,356,23.8,1986.8,13,0,0,6,13,5,0,0,0,0,16752,7.0,17726,155,64,-3116,-356,21.9,1675.2
4855905586,0,9,0,1,4,9,3,1,1,0,0,14153,5.8,13824,110,52,-3617,-4441,16.2,1415.3,6,0,0,9,4,10,0,0,0,0,17770,7.0,18265,169,64,3617,4441,23.3,1777.0
4855415419,0,13,0,1,1,4,1,0,0,0,0,12463,6.8,16017,145,44,-2808,-1829,18.9,1246.3,12,0,0,4,1,6,1,1,0,0,15271,6.8,17846,184,59,2808,1829,24.3,1527.1
4854916176,0,9,0,1,11,2,10,0,0,0,0,17985,6.6,16816,176,32,3883,326,20.8,1798.5,261,0,0,2,11,1,1,1,0,0,14102,6.6,16490,163,56,-3883,-326,21.9,1410.2
4854884981,1,14,1,1,6,4,3,0,0,0,0,15333,6.6,16337,163,30,2103,1148,19.3,1533.3,11,1,0,4,6,4,0,0,0,0,13230,6.4,15189,109,40,-2103,-1148,14.9,1323.0
4854282381,0,11,1,0,6,5,3,0,0,0,0,15279,6.8,16560,167,6,-589,-1320,17.3,1527.9,10,1,1,5,6,3,0,0,0,0,15868,7.0,17880,171,54,589,1320,22.5,1586.8
4851094308,0,12,2,1,12,7,9,0,0,0,0,18103,6.4,16408,158,40,1995,-709,19.8,1810.3,11,1,0,7,12,4,0,0,0,0,16108,6.6,17117,168,40,-1995,709,20.8,1610.8
4851062935,1,23,1,1,2,4,1,0,0,0,0,13748,6.8,16633,174,48,-1509,-1142,22.2,1374.8,9,0,0,4,2,3,0,0,0,0,15257,6.8,17775,185,56,1509,1142,24.1,1525.7
4851031874,0,11,0,1,2,6,3,0,0,0,0,13527,6.6,15780,173,44,-2725,-3299,21.7,1352.7,44,0,0,6,2,4,1,1,0,0,16252,7.0,19079,187,68,2725,3299,25.5,1625.2
4850976199,0,15,0,1,8,9,11,0,0,0,0,17530,6.6,15207,127,52,-1136,-1442,17.9,1753.0,17,0,0,9,8,12,0,0,0,0,18666,6.6,16649,168,52,1136,1442,22.0,1866.6
4850944514,0,15,1,1,5,4,2,0,0,0,0,14747,6.6,16879,182,48,-336,-11,23.0,1474.7,24,1,0,4,5,1,1,0,1,0,15083,6.6,16890,169,45,336,11,21.4,1508.3
4850886260,1,13,0,0,7,7,9,0,0,0,0,16676,6.4,15376,178,48,643,-461,22.6,1667.6,11,0,1,7,7,8,1,1,0,0,16033,6.2,15837,165,56,-643,461,22.1,1603.3
4850035319,0,136,0,0,10,7,9,0,0,0,0,17989,6.6,16357,180,42,871,176,22.2,1798.9,23,1,1,7,10,6,0,0,0,0,17118,6.6,16181,187,52,-871,-176,23.9,1711.8
4849187982,0,39,0,1,2,4,2,0,0,0,0,15185,7.0,17664,199,47,-922,-658,24.6,1518.5,10,19,0,4,2,2,0,0,0,0,16107,7.0,18322,213,56,922,658,26.9,1610.7
4848997660,0,15,1,0,2,7,0,0,0,0,0,13501,6.8,16907,171,44,-2596,-714,21.5,1350.1,13,0,1,7,2,6,0,0,0,0,16097,6.8,17621,189,48,2596,714,23.7,1609.7
4848109733,1,12,1,1,7,12,5,0,0,0,0,16954,6.8,16515,147,56,-2775,-2167,20.3,1695.4,78,0,0,12,7,8,0,0,0,0,19729,7.2,18682,206,64,2775,2167,27.0,1972.9
4848086859,1,12,1,1,8,2,5,0,0,0,0,17692,7.4,19520,196,64,5239,3889,26.0,1769.2,12,2,0,2,8,2,0,0,0,0,12453,6.4,15631,145,44,-5239,-3889,18.9,1245.3
4804404045,1,16,1,1,3,1,4,1,1,0,1,17106,7.0,18187,182,68,5638,6931,25.0,1710.6,17,3,0,1,3,1,0,0,0,0,11468,5.0,11256,112,12,-5638,-6931,12.4,1146.8
4803684018,0,31,0,1,1,0,1,0,0,0,0,13550,6.8,17490,174,52,818,-349,22.6,1355.0,29,0,0,0,1,0,1,1,0,0,12732,7.0,17839,173,64,-818,349,23.7,1273.2
4803599258,0,396,0,1,2,5,1,1,1,0,0,14267,6.8,17631,190,55,-1018,-630,24.5,1426.7,9,0,0,5,2,5,0,0,0,0,15285,6.8,18261,144,60,1018,630,20.4,1528.5
4802641739,0,16,0,0,4,6,5,0,0,0,0,15223,6.4,15522,168,52,-1394,-409,22.0,1522.3,14,1,1,6,4,14,1,1,0,0,16617,6.4,15931,144,56,1394,409,20.0,1661.7
4802474449,1,10,0,0,7,7,4,0,0,0,0,15668,6.6,16247,117,47,-159,-372,16.4,1566.8,10,0,1,7,7,7,1,1,0,0,15827,6.6,16619,165,48,159,372,21.3,1582.7
4801825058,0,74,0,1,6,4,6,0,0,0,0,14860,6.2,15840,161,37,333,805,19.8,1486.0,11,0,0,4,6,6,0,0,0,0,14527,6.2,15035,131,36,-333,-805,16.7,1452.7
4801709075,0,14,1,1,5,4,3,1,1,0,0,15059,6.8,18126,181,56,1015,917,23.7,1505.9,10,0,0,4,5,1,0,0,0,0,14044,6.8,17209,151,48,-1015,-917,19.9,1404.4
4801663868,0,13,2,0,2,4,1,0,0,0,0,13766,6.6,15927,148,48,-1986,-1479,19.6,1376.6,14,2,1,4,2,6,0,0,0,0,15752,6.8,17406,172,58,1986,1479,23.0,1575.2
4798641693,0,12,0,0,3,5,1,0,0,0,0,14518,6.8,16853,124,56,104,816,18.0,1451.8,10,0,1,5,3,3,0,0,0,0,14414,6.4,16037,138,36,-104,-816,17.4,1441.4
4797054744,1,14,0,1,4,3,2,0,0,0,0,15168,7.2,18788,166,60,1072,2615,22.6,1516.8,9,1,0,3,4,3,1,1,0,0,14096,6.4,16173,180,40,-1072,-2615,22.0,1409.6
4797011845,1,153,1,0,5,8,6,0,0,0,0,15067,6.6,17160,147,52,-1159,-242,19.9,1506.7,11,0,1,8,5,3,1,1,0,0,16226,6.4,17402,171,60,1159,242,23.1,1622.6
4796914495,1,324,0,1,7,4,6,0,0,0,0,15869,6.6,16883,168,48,1999,1686,21.6,1586.9,12,1,0,4,7,3,1,1,0,0,13870,6.4,15197,139,44,-1999,-1686,18.3,1387.0
4794170985,1,13,3,1,6,7,11,0,0,0,0,16471,6.4,16370,193,48,1150,856,24.1,1647.1,17,1,0,7,6,10,2,1,1,0,15321,6.4,15514,161,42,-1150,-856,20.3,1532.1
4791284552,0,11,3,1,1,2,0,1,1,0,0,13705,6.8,17911,192,60,345,1131,25.2,1370.5,78,1,0,2,1,2,0,0,0,0,13360,6.6,16780,148,64,-345,-1131,21.2,1336.0
4790702380,0,31,0,1,4,7,3,1,0,1,0,14680,6.6,16640,160,52,-2511,-2574,21.2,1468.0,153,9,0,7,4,6,1,1,0,0,17191,7.2,19214,182,56,2511,2574,23.8,1719.1
4789820389,1,13,0,1,8,1,7,0,0,0,0,17692,7.2,18948,178,47,4929,2905,22.5,1769.2,205,0,0,1,8,1,0,0,0,0,12763,6.6,16043,151,56,-4929,-2905,20.7,1276.3
4788990427,0,14,0,1,4,7,3,0,0,0,0,13421,6.0,13978,106,52,-4475,-3619,15.8,1342.1,10,3,0,7,4,11,1,1,0,0,17896,6.8,17597,152,64,4475,3619,21.6,1789.6
4788957308,0,13,0,0,2,9,1,0,0,0,0,12455,6.2,15133,133,48,-4286,-2390,18.1,1245.5,12,0,1,9,2,10,1,1,0,0,16741,6.8,17523,163,52,4286,2390,21.5,1674.1
4788732122,0,25,1,1,5,2,4,0,0,0,0,15203,6.8,17767,167,48,-704,-944,21.5,1520.3,9,10,0,2,5,1,1,1,0,0,15907,7.2,18711,175,52,704,944,22.7,1590.7
4787877939,1,12,0,0,3,4,1,0,0,0,0,13845,6.6,16718,174,44,-1853,-1564,21.8,1384.5,63,0,1,4,3,4,0,0,0,0,15698,7.0,18282,170,58,1853,1564,22.8,1569.8
4836162932,1,13,0,1,5,3,6,0,0,0,0,16317,6.8,17696,180,40,1156,-120,22.0,1631.7,14,2,0,3,5,4,1,1,0,0,15161,7.0,17816,162,56,-1156,120,21.8,1516.1
4836028613,0,10,0,0,3,11,3,1,1,0,0,13641,6.2,14909,135,48,-4641,-3358,18.3,1364.1,13,2,1,11,3,10,0,0,0,0,18282,7.0,18267,202,44,4641,3358,24.6,1828.2
4835865626,0,18,0,0,1,4,0,0,0,0,0,11738,6.2,15213,133,43,-4210,-1057,17.6,1173.8,15,1,1,4,1,4,0,0,0,0,15948,6.2,16270,181,36,4210,1057,21.7,1594.8
4835832346,1,14,0,1,4,3,5,1,0,1,0,15252,7.0,17845,188,52,1469,1465,24.0,1525.2,13,1,0,3,4,4,1,1,0,0,13783,6.4,16380,182,58,-1469,-1465,24.0,1378.3
4835777010,1,11,0,1,3,1,2,1,0,1,0,15787,7.2,18824,217,64,2189,1042,28.1,1578.7,13,1,0,1,3,1,0,0,0,0,13598,6.8,17782,174,72,-2189,-1042,24.6,1359.8
4835721997,0,11,0,1,10,5,8,0,0,0,0,17574,6.8,16755,183,42,2079,403,22.5,1757.4,13,0,0,5,10,7,0,0,0,0,15495,6.8,16352,138,49,-2079,-403,18.7,1549.5
4835689029,0,11,0,0,5,11,5,0,0,0,0,14777,6.4,16039,164,40,-3343,-2982,20.4,1477.7,9,1,1,11,5,6,1,1,0,0,18120,7.2,19021,208,60,3343,2982,26.8,1812.0
4835660942,1,15,1,1,3,2,3,1,0,1,0,15226,6.6,17114,174,40,2398,13,21.4,1522.6,121,0,0,2,3,0,1,1,0,0,12828,6.6,17101,144,62,-2398,-13,20.6,1282.8
4227008153,0,0,0,1,13,12,35,0,0,0,1,33556,10.2,35344,86,0,1044,-1418,8.6,3355.6,0,0,0,12,13,13,0,0,0,0,32512,10.4,36762,89,0,-1044,1418,8.9,3251.2
4222933873,1,0,0,0,11,14,28,0,0,0,2,34238,10.6,37049,112,0,2450,1361,11.2,3423.8,0,0,1,14,11,21,0,0,0,0,31788,10.4,35688,74,0,-2450,-1361,7.4,3178.8
4205067869,1,0,0,1,18,14,50,0,0,0,1,37020,11.0,39430,101,0,5164,3922,10.1,3702.0,4,0,0,14,18,30,0,0,0,0,31856,10.0,35508,78,0,-5164,-3922,7.8,3185.6
4205047201,0,0,0,0,12,21,17,0,0,0,2,32315,10.4,37619,73,0,-4881,-3450,7.3,3231.5,0,0,1,21,12,47,0,0,0,0,37196,11.4,41069,109,0,4881,3450,10.9,3719.6
4204206681,1,5,0,0,15,11,28,0,0,0,1,35122,10.4,37442,121,0,3075,2266,12.1,3512.2,0,1,1,11,15,24,0,0,0,0,32047,10.4,35176,83,0,-3075,-2266,8.3,3204.7
4204171599,0,0,0,0,13,14,29,0,0,0,0,33025,10.6,36475,86,0,341,661,8.6,3302.5,0,0,1,14,13,19,0,0,0,0,32684,10.4,35814,109,0,-341,-661,10.9,3268.4
4204156692,0,16,0,0,9,20,23,0,0,0,1,30820,9.8,33041,109,0,-5080,-5561,10.9,3082.0,0,5,1,20,9,60,0,0,0,0,35900,11.0,38602,113,0,5080,5561,11.3,3590.0
4204130950,0,0,0,1,25,27,64,0,0,0,1,35937,11.2,39692,87,0,-3136,-4540,8.7,3593.7,22,0,0,27,25,63,0,0,0,0,39073,11.4,44232,112,0,3136,4540,11.2,3907.3
4157857820,0,29,0,0,2,11,2,0,0,0,0,14199,6.6,16337,195,48,-3653,-3035,24.3,1419.9,33,0,1,11,2,7,0,0,0,0,17852,7.4,19372,204,52,3653,3035,25.6,1785.2
4857346276,1,0,0,0,16,17,29,0,0,0,0,34140,10.8,39275,97,0,-986,1919,9.7,3414.0,0,0,1,17,16,37,0,0,0,0,35126,10.8,37356,89,0,986,-1919,8.9,3512.6
4857317984,0,0,0,1,19,12,42,0,0,0,1,37125,10.8,39164,125,0,3343,5171,12.5,3712.5,78,0,0,11,18,23,0,0,0,0,33782,9.8,33993,94,0,-3343,-5171,9.4,3378.2
4857272154,0,0,0,1,28,23,68,0,0,0,0,38452,11.6,43099,102,0,232,1225,10.2,3845.2,0,0,0,23,28,55,0,0,0,0,38220,11.2,41874,88,0,-232,-1225,8.8,3822.0
4857239948,1,0,0,1,24,18,58,0,0,0,1,36839,11.2,40600,91,0,-407,168,9.1,3683.9,0,0,0,17,23,34,0,0,0,0,37246,11.2,40432,101,0,407,-168,10.1,3724.6
4857207003,0,0,1,1,30,26,74,0,0,0,1,39662,11.8,44647,102,0,1576,521,10.2,3966.2,7,0,0,26,30,58,0,0,0,0,38086,11.8,44126,113,0,-1576,-521,11.3,3808.6
4857165163,1,0,5,1,22,27,42,0,0,0,0,36851,11.4,40678,104,0,-1703,-1978,10.4,3685.1,20,0,0,27,22,62,0,0,0,0,38554,11.4,42656,107,0,1703,1978,10.7,3855.4
4857136526,1,11,0,1,26,26,67,0,0,0,1,37467,11.0,42030,92,0,193,1366,9.2,3746.7,0,2,0,26,26,66,0,0,0,0,37274,11.2,40664,93,0,-193,-1366,9.3,3727.4
4857108542,0,8,0,0,23,23,55,0,0,0,0,36851,11.2,41777,99,0,-255,1559,9.9,3685.1,0,3,1,23,23,53,0,0,0,0,37106,11.2,40218,106,0,255,-1559,10.6,3710.6
4855210466,0,2,2,1,16,22,43,0,0,0,0,35001,11.0,37568,114,0,-1593,-1321,11.4,3500.1,21,2,0,22,16,54,0,0,0,0,36594,10.8,38889,110,0,1593,1321,11.0,3659.4
4855183967,1,1,2,1,21,16,55,0,0,0,0,35258,10.6,37075,97,0,1217,348,9.7,3525.8,14,0,0,16,21,39,0,0,0,0,34041,10.4,36727,80,0,-1217,-348,8.0,3404.1
4855111203,1,7,0,1,24,3,5,1,1,0,0,23609,7.6,21161,140,84,12603,10269,22.4,2360.9,0,0,0,2,23,0,0,0,0,0,11006,5.2,10892,72,0,-12603,-10269,7.2,1100.6
4855070206,1,34,0,1,17,7,51,0,0,0,0,35266,10.8,38811,104,0,5054,4875,10.4,3526.6,34,0,0,7,17,9,0,0,0,0,30212,10.0,33936,87,0,-5054,-4875,8.7,3021.2
4855027527,0,0,3,0,19,20,47,0,0,0,0,36753,10.8,39484,105,0,1948,2339,10.5,3675.3,17,0,1,20,19,60,0,0,0,0,34805,10.6,37145,104,0,-1948,-2339,10.4,3480.5
4854985635,0,0,0,1,18,31,50,0,0,0,0,37094,11.0,39812,84,0,-728,-202,8.4,3709.4,0,0,0,31,18,93,0,0,0,0,37822,11.0,40014,114,0,728,202,11.4,3782.2
4854037517,0,0,0,1,29,28,73,0,0,0,1,39430,11.6,43629,96,0,758,2256,9.6,3943.0,0,0,0,28,29,81,0,0,0,0,38672,11.2,41373,108,0,-758,-2256,10.8,3867.2
4854009498,0,10,0,0,28,25,71,0,0,0,1,37909,11.4,42696,96,0,324,2499,9.6,3790.9,85,0,1,25,28,76,0,0,0,0,37585,11.0,40197,111,0,-324,-2499,11.1,3758.5
4853974653,1,68,2,0,24,27,62,0,0,0,1,36398,11.2,40528,79,0,-1773,-2300,7.9,3639.8,168,0,1,27,24,76,0,0,0,0,38171,11.8,42828,104,0,1773,2300,10.4,3817.1
4853943877,0,24,0,0,23,22,59,0,0,0,0,36967,11.0,40290,92,0,498,1491,9.2,3696.7,0,2,1,22,23,55,0,0,0,0,36469,10.8,38799,99,0,-498,-1491,9.9,3646.9
4853897826,0,68,0,1,21,18,51,0,0,0,0,34005,11.0,39287,82,0,771,2669,8.2,3400.5,0,0,0,18,21,52,0,0,0,0,33234,10.6,36618,80,0,-771,-2669,8.0,3323.4
4853857341,0,0,0,0,17,27,38,0,0,0,0,35263,10.6,38698,111,0,-1829,-2760,11.1,3526.3,0,0,1,27,17,66,0,0,0,0,37092,11.4,41458,106,0,1829,2760,10.6,3709.2
4856293196,1,9,0,1,3,4,3,0,0,0,0,14335,6.8,17814,162,68,-151,-371,23.0,1433.5,12,2,0,4,3,4,1,1,0,0,14486,6.8,18185,185,56,151,371,24.1,1448.6
4853600570,0,54,1,1,5,6,3,0,0,0,0,15785,7.0,17874,176,48,82,1076,22.4,1578.5,14,1,0,6,5,6,1,1,0,0,15703,6.6,16798,171,52,-82,-1076,22.3,1570.3
4851737775,0,41,1,0,3,4,2,1,0,1,0,15676,7.0,17476,215,52,-219,-940,26.7,1567.6,6,11,1,4,3,1,0,0,0,0,15895,7.0,18416,200,60,219,940,26.0,1589.5
4851689517,0,16,3,0,4,9,1,0,0,0,0,14579,6.8,17919,192,56,-2512,24,24.8,1457.9,11,2,1,9,4,6,1,1,0,0,17091,6.8,17895,199,51,2512,-24,25.0,1709.1
4850868388,0,21,2,0,4,7,2,0,0,0,0,15852,6.8,17420,175,52,-237,862,22.7,1585.2,9,2,1,7,4,7,0,0,0,0,16089,6.4,16558,179,60,237,-862,23.9,1608.9
4850833467,1,10,0,1,11,4,12,0,0,0,0,17860,6.6,17154,170,36,3386,1132,20.6,1786.0,12,0,0,4,11,2,0,0,0,0,14474,6.4,16022,149,56,-3386,-1132,20.5,1447.4
4850548249,1,16,1,0,4,9,3,1,1,0,0,15626,7.0,18162,200,62,-1249,-609,26.2,1562.6,10,2,1,9,4,4,0,0,0,0,16875,7.0,18771,188,49,1249,609,23.7,1687.5
4842150515,1,11,0,1,3,3,1,0,0,0,0,13973,7.0,17795,162,72,-543,513,23.4,1397.3,15,0,0,3,3,1,0,0,0,0,14516,6.6,17282,206,44,543,-513,25.0,1451.6
4842126937,1,9,0,1,3,2,0,0,0,0,0,14860,7.0,17739,205,52,1199,953,25.7,1486.0,8,0,0,2,3,2,0,0,0,0,13661,6.6,16786,177,60,-1199,-953,23.7,1366.1
4842076725,0,32,1,0,4,8,5,0,0,0,0,15862,6.8,16725,193,52,-936,-1488,24.5,1586.2,333,1,1,8,4,4,0,0,0,0,16798,7.0,18213,206,48,936,1488,25.4,1679.8
4840489091,1,120,0,0,7,7,5,0,0,0,0,18200,7.0,19186,227,56,3682,2334,28.3,1820.0,10,0,1,6,6,2,0,0,0,0,14518,6.6,16852,158,44,-3682,-2334,20.2,1451.8
4840443924,0,13,0,1,4,9,2,0,0,0,0,15195,6.4,16194,213,52,-2040,-3114,26.5,1519.5,15,0,0,9,4,3,0,0,0,0,17235,7.0,19308,198,68,2040,3114,26.6,1723.5
4840399292,0,44,1,0,2,6,0,0,0,0,0,13107,6.6,16523,153,40,-3241,-1017,19.3,1310.7,13,0,1,6,2,6,0,0,0,0,16348,6.8,17540,185,48,3241,1017,23.3,1634.8
4838932394,0,176,1,1,2,4,1,0,0,0,0,16044,6.8,17754,175,72,-234,-1664,24.7,1604.4,13,2,0,4,2,5,1,1,0,0,16278,7.2,19418,208,60,234,1664,26.8,1627.8
4838326892,1,10,0,1,7,4,7,1,1,0,0,16121,6.8,16974,138,68,2017,968,20.6,1612.1,85,0,0,4,7,2,0,0,0,0,14104,6.4,16006,150,40,-2017,-968,19.0,1410.4
4828714670,0,14,0,1,8,5,3,0,0,0,0,17484,7.4,19960,221,48,1897,2312,26.9,1748.4,100,1,0,5,8,7,0,0,0,0,15587,6.8,17648,155,60,-1897,-2312,21.5,1558.7
4827980095,0,12,0,1,3,8,3,0,0,0,0,14046,6.8,16749,179,44,-3039,-2967,22.3,1404.6,7,0,0,8,3,5,0,0,0,0,17085,7.4,19716,206,68,3039,2967,27.4,1708.5
4827952819,1,21,1,1,8,5,8,0,0,0,0,17874,6.8,17087,171,44,1187,71,21.5,1787.4,10,2,0,5,8,6,0,0,0,0,16687,6.8,17016,186,44,-1187,-71,23.0,1668.7
4827886831,0,12,0,1,2,9,1,0,0,0,0,13428,6.0,14660,172,52,-3324,-3740,22.4,1342.8,13,2,0,9,2,6,0,0,0,0,16752,7.0,18400,216,52,3324,3740,26.8,1675.2
4853619468,0,11,0,0,4,7,3,0,0,0,0,14339,6.2,15268,170,40,-2778,-3549,21.0,1433.9,10,1,1,7,4,4,1,1,0,0,17117,7.0,18817,210,56,2778,3549,26.6,1711.7
4853588041,1,7,0,1,3,1,4,1,0,1,0,15729,7.0,17996,203,56,2544,2204,25.9,1572.9,25,0,0,1,3,2,1,1,0,0,13185,6.6,15792,176,40,-2544,-2204,21.6,1318.5
4852509882,1,0,0,1,17,17,17,0,0,0,0,62350,12.0,55000,0,0,26200,22000,0.0,6235.0,20,0,0,9,9,8,0,0,0,0,36150,7.2,33000,0,0,-26200,-22000,0.0,3615.0
4852480784,1,0,0,0,20,19,22,0,0,0,0,49210,10.6,50500,1,0,20898,20820,0.1,4921.0,0,0,1,11,12,10,0,0,0,0,28312,6.2,29680,0,0,-20898,-20820,0.0,2831.2
4847173131,0,19,0,1,6,8,5,1,0,1,0,16766,6.4,15558,153,52,269,-1046,20.5,1676.6,17,0,0,8,6,13,1,1,0,0,16497,6.6,16604,147,40,-269,1046,18.7,1649.7
4820873544,1,21,3,1,2,3,2,1,1,0,0,15070,6.8,17886,215,52,1492,725,26.7,1507.0,15,2,0,3,2,2,1,0,1,0,13578,6.6,17161,154,52,-1492,-725,20.6,1357.8
4820829634,0,13,0,1,3,5,4,0,0,0,0,13976,6.4,16523,163,40,-796,-1447,20.3,1397.6,12,1,0,5,3,3,0,0,0,0,14772,7.0,17970,169,54,796,1447,22.3,1477.2
4820782012,1,75,2,0,3,6,1,0,0,0,0,14990,6.8,16877,160,40,-258,80,20.0,1499.0,124,0,1,6,3,4,0,0,0,0,15248,6.8,16797,171,36,258,-80,20.7,1524.8
4820563079,0,10,0,0,0,4,0,0,0,0,0,13683,6.8,17445,205,56,-2818,-649,26.1,1368.3,12,0,1,4,0,6,0,0,0,0,16501,6.8,18094,223,55,2818,649,27.8,1650.1
4806473355,0,13,0,0,0,5,0,0,0,0,0,13126,6.6,16720,148,48,-3222,-1350,19.6,1312.6,12,1,1,5,0,2,1,1,0,0,16348,7.0,18070,166,64,3222,1350,23.0,1634.8
4805649585,1,14,0,1,8,2,3,0,0,0,0,15877,6.8,17768,198,54,1998,262,25.2,1587.7,10,0,0,2,8,0,0,0,0,0,13879,6.8,17506,129,68,-1998,-262,19.7,1387.9
4804760063,0,6,0,0,1,1,1,1,1,0,0,11628,5.0,11881,103,48,-2827,-6564,15.1,1162.8,8,0,1,1,1,0,0,0,0,0,14455,6.8,18445,206,52,2827,6564,25.8,1445.5
4804729114,1,16,10,1,5,6,8,0,0,0,0,15483,6.4,15836,172,44,-1412,-1511,21.6,1548.3,36,0,0,6,5,7,0,0,0,0,16895,6.8,17347,186,40,1412,1511,22.6,1689.5
4803911875,1,35,2,1,3,1,3,1,1,0,0,14684,6.8,17272,197,54,707,109,25.1,1468.4,75,12,0,1,3,1,0,0,0,0,13977,6.6,17163,187,56,-707,-109,24.3,1397.7
4803867709,1,17,1,1,8,4,7,0,0,0,0,16855,6.2,16172,166,44,1698,382,21.0,1685.5,12,2,0,4,8,5,0,0,0,0,15157,6.4,15790,124,48,-1698,-382,17.2,1515.7
4802121845,1,64,0,1,4,5,2,0,0,0,0,14205,7.0,17582,166,52,-269,188,21.8,1420.5,233,0,0,5,4,5,0,0,0,0,14474,6.8,17394,163,48,269,-188,21.1,1447.4
4802091077,0,11,0,1,2,4,2,0,0,0,0,13120,6.6,16715,167,40,-1772,-1019,20.7,1312.0,11,0,0,4,2,4,0,0,0,0,14892,6.8,17734,186,48,1772,1019,23.4,1489.2
4802073849,1,14,0,1,12,5,8,0,0,0,0,17648,6.6,16238,142,45,3841,809,18.7,1764.8,232,1,0,5,12,2,0,0,0,0,13807,6.4,15429,142,38,-3841,-809,18.0,1380.7
4802049693,0,71,1,1,3,4,2,0,0,0,0,14343,6.8,17139,181,44,-917,-1645,22.5,1434.3,17,1,0,4,3,2,1,1,0,0,15260,7.0,18784,199,60,917,1645,25.9,1526.0
4851948184,1,95,0,0,16,18,32,0,0,0,0,33519,10.2,36133,106,0,-764,-686,10.6,3351.9,13,2,1,18,16,53,0,0,0,0,34283,10.6,36819,120,0,764,686,12.0,3428.3
4851895058,0,11,0,0,6,9,2,0,0,0,0,16325,6.8,17237,186,38,-1029,188,22.4,1632.5,184,1,1,9,6,15,1,1,0,0,17354,6.8,17049,160,44,1029,-188,20.4,1735.4
4849966732,1,13,2,1,6,5,10,0,0,0,0,15482,6.2,15594,153,52,-75,-2905,20.5,1548.2,11,1,0,5,6,2,0,0,0,0,15557,7.0,18499,203,55,75,2905,25.8,1555.7
4849935763,0,179,0,1,2,5,1,0,0,0,0,14739,6.6,16669,183,55,-1664,-1250,23.8,1473.9,7,1,0,5,2,6,2,1,1,0,16403,6.8,17919,203,60,1664,1250,26.3,1640.3
4846097697,0,0,0,0,9,15,27,0,0,0,1,32527,10.0,33624,85,0,-2977,-3554,8.5,3252.7,25,0,1,15,9,36,0,0,0,0,35504,10.8,37178,102,0,2977,3554,10.2,3550.4
4842433914,0,23,0,1,12,19,27,0,0,0,0,35457,10.6,37741,62,59,52,-1536,12.1,3545.7,11,0,0,19,12,38,0,0,0,0,35405,11.0,39277,80,60,-52,1536,14.0,3540.5
4842406396,0,13,0,0,12,22,17,0,0,0,1,28795,9.6,30174,42,51,-8460,-8442,9.3,2879.5,19,0,1,22,12,38,0,0,0,0,37255,10.8,38616,74,67,8460,8442,14.1,3725.5
4842388862,0,15,0,0,5,28,7,0,0,0,2,30689,10.0,33739,61,43,-10327,-10211,10.4,3068.9,16,0,1,28,5,47,0,0,0,0,41016,11.6,43950,79,75,10327,10211,15.4,4101.6
4842356298,0,14,1,0,11,6,17,0,0,0,1,31272,10.4,35409,105,55,2306,1019,16.0,3127.2,14,0,1,6,11,9,0,0,0,0,28966,10.4,34390,79,59,-2306,-1019,13.8,2896.6
4839304447,1,13,2,0,18,21,55,0,0,0,0,37637,11.6,42811,77,53,-1770,1883,13.0,3763.7,18,0,1,20,17,45,0,0,0,0,39407,11.2,40928,98,67,1770,-1883,16.5,3940.7
4839280816,1,14,0,1,21,10,50,0,0,0,0,33117,11.2,40883,89,51,1361,1860,14.0,3311.7,30,0,0,10,21,21,0,0,0,0,31756,11.2,39023,103,47,-1361,-1860,15.0,3175.6
4838126775,0,44,0,0,10,10,19,0,0,0,0,32965,11.0,38876,90,59,-1433,-3437,14.9,3296.5,14,23,1,10,10,30,0,0,0,0,34398,11.4,42313,87,71,1433,3437,15.8,3439.8
4838086740,1,13,0,1,16,8,37,0,0,0,1,33975,10.8,39098,70,63,5604,5466,13.3,3397.5,13,0,0,8,16,21,0,0,0,0,28371,10.2,33632,86,43,-5604,-5466,12.9,2837.1
4838054200,0,22,0,1,12,16,22,0,0,0,1,32735,10.6,37030,80,48,-6958,-3528,12.8,3273.5,14,1,0,16,12,33,0,0,0,0,39693,11.2,40558,92,72,6958,3528,16.4,3969.3
4838028775,0,28,0,0,16,20,29,0,0,0,0,33760,10.6,36963,75,47,-4500,-5377,12.2,3376.0,9,0,1,20,16,46,0,0,0,0,38260,11.4,42340,76,63,4500,5377,13.9,3826.0
4837985256,0,15,0,1,10,22,14,0,0,0,0,32081,10.6,37499,61,59,-5539,-4900,12.0,3208.1,11,2,0,21,9,53,0,0,0,0,37620,11.6,42399,79,75,5539,4900,15.4,3762.0
4835151991,0,12,0,0,23,14,56,0,0,0,0,36141,11.4,42013,90,59,-2702,-574,14.9,3614.1,13,0,1,14,23,37,0,0,0,0,38843,11.6,42587,70,71,2702,574,14.1,3884.3
4835128995,1,13,0,1,10,11,20,0,0,0,0,33508,11.0,38697,85,44,-552,2711,12.9,3350.8,12,0,0,11,10,29,0,0,0,0,34060,10.4,35986,101,56,552,-2711,15.7,3406.0
4834985680,1,19,1,1,17,13,31,0,0,0,1,36229,11.8,43856,91,67,2365,4031,15.8,3622.9,28,0,0,13,17,31,0,0,0,0,33864,10.8,39825,89,67,-2365,-4031,15.6,3386.4
4794761586,1,8,2,1,7,10,8,0,0,0,0,16879,6.6,16818,183,56,-1415,-1578,23.9,1687.9,13,3,0,10,7,9,1,1,0,0,18294,7.0,18396,173,44,1415,1578,21.7,1829.4
4782561712,1,10,3,0,6,3,8,0,0,0,0,16644,6.8,16942,196,52,2167,245,24.8,1664.4,12,1,1,3,6,2,0,0,0,0,14477,6.6,16697,202,48,-2167,-245,25.0,1447.7
4775640268,1,12,0,1,10,7,5,0,0,0,0,16849,6.8,17719,144,52,751,-105,19.6,1684.9,11,0,0,6,9,1,1,1,0,0,16098,7.0,17824,167,68,-751,105,23.5,1609.8
4770201622,0,15,0,1,8,3,10,1,1,0,0,16470,6.6,16265,172,56,860,-1157,22.8,1647.0,10,2,0,3,8,2,0,0,0,0,15610,6.8,17422,179,64,-860,1157,24.3,1561.0
4769776806,1,15,0,1,6,3,5,1,1,0,0,16238,7.4,19555,197,72,498,1671,26.9,1623.8,12,1,0,3,6,1,0,0,0,0,15740,6.8,17884,190,48,-498,-1671,23.8,1574.0
4769414724,0,13,6,1,4,5,2,0,0,0,0,13859,6.6,16323,135,56,-390,-581,19.1,1385.9,26,1,0,5,4,2,1,1,0,0,14249,6.4,16904,129,52,390,581,18.1,1424.9
4766264066,1,20,0,1,11,6,7,1,1,0,0,18623,7.0,18657,179,56,3553,2252,23.5,1862.3,12,0,0,6,11,5,0,0,0,0,15070,6.6,16405,143,48,-3553,-2252,19.1,1507.0
4766218349,0,11,0,1,5,4,7,1,1,0,0,15059,6.8,17930,167,68,-1485,215,23.5,1505.9,10,0,0,4,5,6,0,0,0,0,16544,6.8,17715,239,56,1485,-215,29.5,1654.4
4766136468,0,135,0,0,1,5,1,1,1,0,0,13743,6.6,15878,168,56,-1829,-2365,22.4,1374.3,18,0,1,5,1,2,0,0,0,0,15572,7.0,18243,198,56,1829,2365,25.4,1557.2
4765424210,1,11,1,1,4,0,3,0,0,0,0,18320,7.0,18712,230,52,5834,3941,28.2,1832.0,15,0,0,0,4,0,0,0,0,0,12486,6.0,14771,165,56,-5834,-3941,22.1,1248.6
4745575330,0,7,0,1,5,7,2,1,1,0,0,15871,7.0,17947,200,56,-1453,-505,25.6,1587.1,17,1,0,7,5,4,0,0,0,0,17324,7.0,18452,184,64,1453,505,24.8,1732.4
4745554901,1,15,18,1,9,2,6,1,1,0,0,18538,7.0,18931,209,48,5739,3116,25.7,1853.8,37,0,0,1,8,0,0,0,0,0,12799,6.4,15815,156,55,-5739,-3116,21.1,1279.9
4745081606,1,12,1,1,5,4,3,0,0,0,0,14285,5.8,15104,133,40,-2358,-2890,17.3,1428.5,13,1,0,4,5,1,0,0,0,0,16643,7.0,17994,185,46,2358,2890,23.1,1664.3
4745070405,0,20,1,0,3,6,3,1,1,0,0,13958,6.4,15718,190,45,-2918,-813,23.5,1395.8,16,0,1,6,3,4,0,0,0,0,16876,6.4,16531,194,49,2918,813,24.3,1687.6
4744516925,0,13,2,0,7,6,6,0,0,0,0,16351,7.0,17875,179,48,611,-386,22.7,1635.1,10,1,1,5,6,3,0,0,0,0,15740,7.2,18261,158,48,-611,386,20.6,1574.0
4744490988,0,10,1,0,3,7,3,1,0,1,0,15471,6.8,17798,200,60,-1520,-1303,26.0,1547.1,10,1,1,6,2,2,0,0,0,0,16991,7.0,19101,205,48,1520,1303,25.3,1699.1
4744459320,1,11,15,1,5,5,2,1,1,0,0,16142,7.2,19021,190,68,1610,1732,25.8,1614.2,32,1,0,4,4,4,0,0,0,0,14532,6.8,17289,165,44,-1610,-1732,20.9,1453.2
4739361826,1,8,0,0,2,5,0,1,1,0,0,14036,6.8,17244,202,52,-127,957,25.4,1403.6,8,0,1,5,2,3,0,0,0,0,14163,6.6,16287,152,48,127,-957,20.0,1416.3
4737748318,1,53,2,1,7,3,5,0,0,0,0,15413,6.6,17586,148,44,766,1648,19.2,1541.3,17,0,0,3,7,2,1,1,0,0,14647,6.4,15938,189,44,-766,-1648,23.3,1464.7
4730140746,1,14,2,1,8,11,7,1,0,1,0,18043,7.0,17383,185,40,-533,475,22.5,1804.3,215,3,0,11,8,7,1,1,0,0,18576,6.6,16908,156,56,533,-475,21.2,1857.6
4804657324,1,14,0,0,2,2,0,0,0,0,0,13263,6.8,17608,179,48,-285,560,22.7,1326.3,123,1,1,2,2,1,1,1,0,0,13548,6.6,17048,155,60,285,-560,21.5,1354.8
4784124443,0,9,0,0,4,5,3,1,0,1,0,14907,7.0,17734,166,64,-1246,-848,23.0,1490.7,10,0,1,5,4,3,1,1,0,0,16153,7.2,18582,156,52,1246,848,20.8,1615.3
4784106976,1,19,0,0,5,5,2,0,0,0,0,16304,6.8,17825,174,42,2697,1590,21.6,1630.4,8,0,1,5,5,1,0,0,0,0,13607,6.4,16235,121,34,-2697,-1590,15.5,1360.7
4784076549,0,16,1,0,7,5,4,1,1,0,0,15363,6.6,16297,177,48,1520,277,22.5,1536.3,78,2,1,5,7,2,0,0,0,0,13843,6.4,16020,144,52,-1520,-277,19.6,1384.3
4771165641,0,5,0,1,2,1,1,1,1,0,0,12875,6.6,16949,139,43,-933,-1297,18.2,1287.5,63,0,0,1,2,0,0,0,0,0,13808,7.2,18246,157,56,933,1297,21.3,1380.8
4766199298,0,93,0,1,4,4,5,1,1,0,0,14847,7.0,18009,177,56,-972,371,23.3,1484.7,79,0,0,4,4,2,1,0,1,0,15819,6.6,17638,175,48,972,-371,22.3,1581.9
4766165779,1,11,0,0,4,8,3,0,0,0,0,15750,6.8,16385,140,48,-34,-699,18.8,1575.0,12,0,1,8,4,6,1,1,0,0,15784,6.8,17084,170,36,34,699,20.6,1578.4
4766141269,0,9,2,1,10,9,6,0,0,0,0,16712,6.4,16008,110,43,-575,-676,15.3,1671.2,166,1,0,9,10,3,1,1,0,0,17287,6.8,16684,176,62,575,676,23.8,1728.7
4766110097,1,11,1,1,4,3,4,1,1,0,0,14443,6.6,16536,179,44,-1234,-2190,22.3,1444.3,9,0,0,3,4,0,0,0,0,0,15677,7.0,18726,179,60,1234,2190,23.9,1567.7
4765911264,1,33,3,1,2,1,4,1,1,0,0,14234,6.6,16170,171,50,262,-1289,22.1,1423.4,14,7,0,1,2,1,0,0,0,0,13972,6.6,17459,171,52,-262,1289,22.3,1397.2
4765903501,0,5,0,0,5,9,1,0,0,0,0,14073,5.8,14712,116,52,-4553,-3358,16.8,1407.3,7,1,1,9,5,5,1,1,0,0,18626,6.8,18070,190,60,4553,3358,25.0,1862.6
4765898981,0,10,0,1,4,2,0,1,0,1,0,14659,6.6,17051,145,56,665,684,20.1,1465.9,235,1,0,2,4,1,0,0,0,0,13994,6.6,16367,151,46,-665,-684,19.7,1399.4
4765157743,0,10,0,0,4,2,1,0,0,0,0,15644,6.8,18017,233,28,2011,522,26.1,1564.4,11,0,1,2,4,0,0,0,0,0,13633,7.0,17495,165,68,-2011,-522,23.3,1363.3
4764590748,0,0,15,1,13,16,28,0,0,0,0,32954,9.8,33915,86,0,-1659,-2970,8.6,3295.4,20,0,0,16,13,45,0,0,0,0,34613,10.6,36885,109,0,1659,2970,10.9,3461.3
4764278671,0,9,1,0,11,5,8,1,1,0,0,17155,6.6,16620,136,56,219,-883,19.2,1715.5,164,0,1,5,11,2,0,0,0,0,16936,6.8,17503,152,58,-219,883,21.0,1693.6
4764258555,1,13,0,1,6,5,0,1,1,0,0,15519,7.2,17821,189,68,-1100,558,25.7,1551.9,9,0,0,5,6,3,0,0,0,0,16619,7.0,17263,171,52,1100,-558,22.3,1661.9
4764249149,1,14,0,1,7,3,6,1,1,0,0,16400,6.8,17603,179,55,1203,-895,23.4,1640.0,8,0,0,3,7,0,0,0,0,0,15197,7.0,18498,164,41,-1203,895,20.5,1519.7
4763371048,1,15,0,1,5,2,2,0,0,0,0,15909,7.0,18432,177,60,2566,1621,23.7,1590.9,216,0,0,2,5,1,0,0,0,0,13343,6.6,16811,144,52,-2566,-1621,19.6,1334.3
4763355246,1,12,0,0,6,5,1,1,1,0,0,14599,6.8,18148,167,48,-981,85,21.5,1459.9,11,0,1,5,6,4,0,0,0,0,15580,7.0,18063,177,67,981,-85,24.4,1558.0
4857040543,1,6,0,1,14,15,18,0,0,0,0,44900,10.0,47500,0,0,16700,19000,0.0,4490.0,7,0,0,13,12,7,0,0,0,0,28200,6.0,28500,0,0,-16700,-19000,0.0,2820.0
4856972789,1,0,0,1,21,22,17,0,0,0,0,62725,12.0,55000,1,0,24075,22000,0.1,6272.5,0,0,0,11,10,14,0,0,0,0,38650,7.2,33000,1,0,-24075,-22000,0.1,3865.0
4856953134,1,32,3,1,21,8,18,0,0,0,0,48090,10.0,47500,1,0,21630,19000,0.1,4809.0,0,2,0,3,16,6,0,0,0,0,26460,6.0,28500,0,0,-21630,-19000,0.0,2646.0
4853802546,0,89,3,0,3,9,3,0,0,0,0,14495,6.6,16523,188,48,-5348,-2835,23.6,1449.5,9,2,1,9,3,7,1,1,0,0,19843,7.4,19358,232,52,5348,2835,28.4,1984.3
4853780963,1,15,3,1,10,8,4,2,1,1,0,18609,7.2,19341,228,60,1578,2682,28.8,1860.9,15,0,0,8,10,8,0,0,0,0,17031,6.8,16659,186,38,-1578,-2682,22.4,1703.1
4853738103,1,37,0,0,6,9,2,1,0,1,0,18375,7.0,17927,212,64,-86,1140,27.6,1837.5,13,12,1,9,6,13,0,0,0,0,18461,6.8,16787,200,32,86,-1140,23.2,1846.1
4853693525,0,33,0,0,7,6,6,0,0,0,0,17153,6.8,17477,182,52,-751,-955,23.4,1715.3,33,0,1,6,7,2,0,0,0,0,17904,7.0,18432,227,56,751,955,28.3,1790.4
4851602117,1,0,0,1,25,14,66,0,0,0,0,35849,11.2,40030,105,0,1223,3699,10.5,3584.9,0,0,0,14,25,30,0,0,0,0,34626,10.2,36331,106,0,-1223,-3699,10.6,3462.6
4851579576,1,0,0,1,28,16,72,0,0,0,0,38995,11.4,41757,123,0,4303,4777,12.3,3899.5,0,0,0,16,28,40,0,0,0,0,34692,10.6,36980,102,0,-4303,-4777,10.2,3469.2
4849845775,0,9,0,1,7,5,5,0,0,0,0,16924,6.8,17848,212,48,1050,1577,26.0,1692.4,14,0,0,5,7,5,1,1,0,0,15874,6.6,16271,182,44,-1050,-1577,22.6,1587.4
4849801781,1,11,2,1,4,1,6,0,0,0,0,15610,6.8,18543,202,54,2779,1700,25.6,1561.0,10,0,0,1,4,1,0,0,0,0,12831,6.8,16843,139,48,-2779,-1700,18.7,1283.1
4848631740,0,0,0,1,23,25,54,0,0,0,0,37605,11.0,39823,113,0,578,-684,11.3,3760.5,16,0,0,25,23,63,0,0,0,0,37027,11.0,40507,101,0,-578,684,10.1,3702.7
4848608179,1,7,2,0,17,24,43,0,0,0,0,34617,11.0,39306,110,0,-2946,-2777,11.0,3461.7,11,0,1,24,17,56,0,0,0,0,37563,11.6,42083,107,0,2946,2777,10.7,3756.3
4844130472,1,85,3,0,4,2,2,0,0,0,0,15786,7.0,18457,220,56,891,212,27.6,1578.6,16,1,1,2,4,1,1,1,0,0,14895,7.0,18245,190,62,-891,-212,25.2,1489.5
4844088841,1,12,1,1,5,6,8,0,0,0,0,17172,6.8,16937,216,44,-720,-2408,26.0,1717.2,14,0,0,6,5,4,0,0,0,0,17892,7.2,19345,221,64,720,2408,28.5,1789.2
4844056059,1,153,1,0,5,5,4,0,0,0,0,16226,6.4,16978,175,51,982,560,22.6,1622.6,10,2,1,5,5,9,0,0,0,0,15244,6.6,16418,182,32,-982,-560,21.4,1524.4
4841119649,0,11,1,0,1,7,1,0,0,0,0,13155,6.6,17490,153,60,-4540,-1202,21.3,1315.5,14,2,1,7,1,5,1,0,1,0,17695,7.2,18692,221,68,4540,1202,28.9,1769.5
4841080351,1,13,0,0,3,8,2,1,1,0,0,14917,6.8,16856,208,56,-1501,-466,26.4,1491.7,14,1,1,8,3,7,0,0,0,0,16418,6.8,17322,184,52,1501,466,23.6,1641.8
4841044258,0,11,0,0,3,3,1,0,0,0,0,16362,7.2,18864,222,48,958,1247,27.0,1636.2,12,1,1,3,3,2,1,1,0,0,15404,6.8,17617,252,56,-958,-1247,30.8,1540.4
4841009401,1,11,0,1,6,3,7,0,0,0,0,16119,6.6,16535,179,48,100,-2433,22.7,1611.9,279,1,0,3,6,3,0,0,0,0,16019,7.2,18968,236,60,-100,2433,29.6,1601.9
4826766436,0,11,2,0,4,4,7,1,1,0,0,15777,7.0,18282,178,54,402,610,23.2,1577.7,14,1,1,4,4,2,0,0,0,0,15375,7.0,17672,229,48,-402,-610,27.7,1537.5
4826731481,0,130,0,0,2,5,1,0,0,0,0,13090,6.8,16741,176,52,-3314,-2395,22.8,1309.0,13,1,1,5,2,5,1,1,0,0,16404,7.2,19136,183,60,3314,2395,24.3,1640.4
4826677577,1,10,1,1,7,9,3,1,1,0,0,18287,7.0,18568,233,44,2143,2705,27.7,1828.7,77,1,0,9,7,12,0,0,0,0,16144,6.4,15863,148,40,-2143,-2705,18.8,1614.4
4826635278,1,7,0,0,6,10,2,0,0,0,0,16748,7.0,18163,190,48,213,1743,23.8,1674.8,15,0,1,10,6,5,1,1,0,0,16535,6.8,16420,165,48,-213,-1743,21.3,1653.5
4821150823,0,7,1,0,3,6,1,0,0,0,0,13284,7.0,16984,140,44,-2173,-516,18.4,1328.4,12,0,1,6,3,1,1,1,0,0,15457,6.8,17500,197,60,2173,516,25.7,1545.7
4821124816,0,12,0,0,1,13,0,0,0,0,1,11406,6.0,13091,111,25,-8092,-6756,13.6,1140.6,9,0,1,13,1,3,1,1,0,0,19498,7.2,19847,205,72,8092,6756,27.7,1949.8
4821048046,0,19,0,1,5,3,2,0,0,0,0,16732,6.6,17959,183,60,2205,2175,24.3,1673.2,183,2,0,3,5,5,1,1,0,0,14527,6.2,15784,190,52,-2205,-2175,24.2,1452.7
4820818515,1,351,1,0,5,4,3,0,0,0,0,15405,6.8,17903,175,60,207,-910,23.5,1540.5,18,0,1,4,5,0,0,0,0,0,15198,7.2,18813,175,40,-207,910,21.5,1519.8
4820784091,0,13,0,0,1,9,1,0,0,0,0,13016,6.4,16068,140,42,-4042,-2235,18.2,1301.6,11,0,1,9,1,7,0,0,0,0,17058,7.4,18303,176,57,4042,2235,23.3,1705.8
4820758140,1,12,1,0,8,14,2,0,0,0,1,15846,6.6,16170,149,51,-3407,842,20.0,1584.6,11,0,1,14,8,18,0,0,0,0,19253,6.4,15328,169,56,3407,-842,22.5,1925.3
4820719455,0,14,1,1,8,12,4,0,0,0,0,16288,6.6,16525,178,48,-2121,-205,22.6,1628.8,12,2,0,12,8,11,1,1,0,0,18409,6.8,16730,139,52,2121,205,19.1,1840.9
4820692512,0,11,0,1,1,8,1,0,0,0,0,13307,6.4,15729,153,40,-3310,-2576,19.3,1330.7,11,0,0,8,1,4,1,1,0,0,16617,7.0,18305,172,48,3310,2576,22.0,1661.7
4820669232,1,15,0,1,7,1,10,0,0,0,0,15653,6.6,16818,169,48,2084,276,21.7,1565.3,11,0,0,0,6,0,0,0,0,0,13569,6.6,16542,186,59,-2084,-276,24.5,1356.9
4820132328,1,8,0,0,3,3,1,1,1,0,0,13564,6.8,16509,161,44,-955,-677,20.5,1356.4,20,0,1,3,3,2,0,0,0,0,14519,6.6,17186,167,35,955,677,20.2,1451.9
4820094551,1,27,0,1,6,2,5,0,0,0,0,16161,6.4,16826,178,56,3639,326,23.4,1616.1,11,23,0,2,6,0,0,0,0,0,12522,6.4,16500,136,52,-3639,-326,18.8,1252.2
4820072870,1,14,0,1,10,4,6,0,0,0,0,17361,6.8,18190,164,60,2256,1634,22.4,1736.1,267,0,0,4,10,3,1,0,1,0,15105,6.6,16556,145,43,-2256,-1634,18.8,1510.5
4814569433,0,13,1,1,4,3,1,0,0,0,0,15123,7.0,17836,202,52,215,51,25.4,1512.3,15,0,0,3,4,1,0,0,0,0,14908,7.0,17785,181,56,-215,-51,23.7,1490.8
4814549571,1,20,0,1,12,0,3,0,0,0,0,16546,7.2,18010,171,60,3516,3128,23.1,1654.6,5,0,0,0,12,0,0,0,0,0,13030,6.2,14882,140,56,-3516,-3128,19.6,1303.0
4814500601,0,13,0,0,7,9,5,0,0,0,0,16709,7.0,17299,137,60,-299,-85,19.7,1670.9,13,0,1,9,7,7,0,0,0,0,17008,6.8,17384,177,48,299,85,22.5,1700.8
4750583590,1,17,0,1,7,6,4,0,0,0,0,15964,6.8,18032,203,36,365,714,23.9,1596.4,9,0,0,5,6,3,1,1,0,0,15599,6.8,17318,162,44,-365,-714,20.6,1559.9
4750572751,1,10,0,1,6,1,4,0,0,0,0,17512,7.0,18771,228,60,4589,2051,28.8,1751.2,8,1,0,1,6,0,0,0,0,0,12923,6.6,16720,182,43,-4589,-2051,22.5,1292.3
4750532342,0,30,0,0,3,14,0,0,0,0,0,12522,6.0,14858,142,48,-6759,-3149,19.0,1252.2,9,13,1,14,3,17,1,1,0,0,19281,6.6,18007,164,52,6759,3149,21.6,1928.1
4749971789,0,116,0,1,4,8,1,0,0,0,0,14487,6.6,16496,164,46,-3042,-2178,21.0,1448.7,14,3,0,7,3,6,1,1,0,0,17529,6.8,18674,167,45,3042,2178,21.2,1752.9
4749889077,1,246,0,1,3,4,2,1,1,0,0,14522,6.8,16925,169,52,306,705,22.1,1452.2,11,0,0,4,3,2,0,0,0,0,14216,6.2,16220,156,48,-306,-705,20.4,1421.6
4749764306,1,242,0,0,5,8,7,0,0,0,0,16511,7.0,17890,207,48,-376,-516,25.5,1651.1,8,0,1,8,5,7,0,0,0,0,16887,6.8,18406,192,52,376,516,24.4,1688.7
4749668605,1,114,2,0,4,5,6,1,1,0,0,13996,6.8,16763,150,43,-1392,-1349,19.3,1399.6,13,1,1,5,4,2,0,0,0,0,15388,6.8,18112,185,44,1392,1349,22.9,1538.8
4749613987,0,7,0,1,4,8,2,0,0,0,0,14585,6.8,17136,153,48,-1291,-806,20.1,1458.5,221,0,0,8,4,3,1,1,0,0,15876,6.8,17942,176,56,1291,806,23.2,1587.6
4749599392,0,47,1,0,2,4,1,0,0,0,0,11897,6.6,16263,123,40,-4451,-2844,16.3,1189.7,82,0,1,4,2,3,1,1,0,0,16348,7.0,19107,209,52,4451,2844,26.1,1634.8
4749141230,0,8,1,1,8,6,11,1,1,0,0,16804,6.4,16807,140,56,-662,-1118,19.6,1680.4,10,1,0,6,8,5,0,0,0,0,17466,6.8,17925,185,55,662,1118,24.0,1746.6
4749103563,1,9,0,0,3,4,2,1,0,1,0,16327,6.6,17011,178,48,2152,-239,22.6,1632.7,10,0,1,4,3,5,1,1,0,0,14175,6.8,17250,137,64,-2152,239,20.1,1417.5
4748954306,1,11,3,0,3,9,1,1,1,0,0,14594,6.8,17888,161,54,-3011,-407,21.5,1459.4,13,1,1,9,3,6,0,0,0,0,17605,6.8,18295,195,46,3011,407,24.1,1760.5
4748932323,0,7,0,1,6,5,4,1,0,1,0,16077,7.0,18391,187,52,473,588,23.9,1607.7,7,0,0,5,6,2,1,1,0,0,15604,6.8,17803,193,48,-473,-588,24.1,1560.4
4748815749,0,14,1,0,5,8,3,0,0,0,0,15187,6.6,17640,194,44,-1070,878,23.8,1518.7,15,1,1,8,5,5,0,0,0,0,16257,6.8,16762,179,44,1070,-878,22.3,1625.7
4856618579,1,0,1,0,29,23,88,0,0,0,0,38300,11.4,41993,82,0,2266,410,8.2,3830.0,6,0,1,23,29,48,0,0,0,0,36034,11.2,41583,75,0,-2266,-410,7.5,3603.4
4856509406,1,13,2,1,3,6,1,0,0,0,0,13259,6.6,16657,152,48,-2570,-879,20.0,1325.9,15,1,0,6,3,4,1,1,0,0,15829,6.8,17536,189,56,2570,879,24.5,1582.9
4855760967,0,15,3,0,5,3,3,1,1,0,0,15869,6.8,17360,152,55,998,2456,20.7,1586.9,12,1,1,3,5,2,0,0,0,0,14871,6.2,14904,149,32,-998,-2456,18.1,1487.1
4855436168,0,133,1,1,4,7,3,1,1,0,0,14264,6.6,16355,167,44,-2398,-358,21.1,1426.4,19,2,0,7,4,10,1,0,1,0,16662,6.8,16713,170,44,2398,358,21.4,1666.2
4855310092,1,20,0,1,32,27,84,0,0,0,1,43095,11.8,46583,132,0,6634,6476,13.2,4309.5,0,3,0,27,32,64,0,0,0,0,36461,11.2,40107,103,0,-6634,-6476,10.3,3646.1
4855276929,1,13,0,1,28,20,70,0,0,0,1,35143,11.0,40189,80,0,-774,1787,8.0,3514.3,0,5,0,20,28,33,0,0,0,0,35917,11.0,38402,121,0,774,-1787,12.1,3591.7
4854701420,1,107,2,1,1,0,0,0,0,0,0,13826,6.8,17616,193,52,204,984,24.5,1382.6,15,1,0,0,1,0,0,0,0,0,13622,6.6,16632,218,40,-204,-984,25.8,1362.2
4854663449,0,10,0,0,6,5,4,1,1,0,0,15473,6.6,16705,207,36,-1049,-1654,24.3,1547.3,12,0,1,5,6,6,0,0,0,0,16522,7.0,18359,193,72,1049,1654,26.5,1652.2
4829817167,0,9,0,0,19,21,33,0,0,0,0,36096,11.2,40386,104,0,-649,1654,10.4,3609.6,0,0,1,21,19,42,0,0,0,0,36745,10.8,38732,103,0,649,-1654,10.3,3674.5
4823148761,0,0,5,1,19,18,53,0,0,0,1,35942,10.6,38403,109,0,-797,-2093,10.9,3594.2,17,0,0,18,19,52,0,0,0,0,36739,11.2,40496,88,0,797,2093,8.8,3673.9
4821205850,1,0,3,0,40,32,112,0,0,0,1,43855,12.4,49464,132,0,4021,4782,13.2,4385.5,15,0,1,32,40,60,0,0,0,0,39834,11.8,44682,89,0,-4021,-4782,8.9,3983.4
4821031532,1,38,0,1,22,20,49,0,0,0,0,37135,10.8,40345,121,0,1386,1431,12.1,3713.5,34,0,0,20,22,43,0,0,0,0,35749,10.6,38914,83,0,-1386,-1431,8.3,3574.9
4820904960,0,0,1,1,21,25,52,0,0,0,0,35876,10.8,38534,77,0,-1917,-3875,7.7,3587.6,14,0,0,25,21,72,0,0,0,0,37793,11.4,42409,100,0,1917,3875,10.0,3779.3
4819158172,0,20,0,0,24,29,56,0,0,0,0,37841,11.0,39660,95,0,-981,-4144,9.5,3784.1,0,2,1,29,24,72,0,0,0,0,38822,11.4,43804,107,0,981,4144,10.7,3882.2
4819132887,0,22,0,0,19,31,40,0,0,0,1,36174,11.0,39216,95,0,-3329,-3533,9.5,3617.4,0,0,1,31,19,80,0,0,0,0,39503,11.8,42749,114,0,3329,3533,11.4,3950.3
4819091044,1,15,0,0,26,19,64,0,0,0,1,36047,11.0,39930,92,0,1448,3560,9.2,3604.7,0,5,1,19,26,43,0,0,0,0,34599,10.4,36370,111,0,-1448,-3560,11.1,3459.9
4819054926,1,0,0,0,18,13,46,0,0,0,1,34418,10.8,37440,89,0,1035,3038,8.9,3441.8,0,0,1,13,18,34,0,0,0,0,33383,10.0,34402,98,0,-1035,-3038,9.8,3338.3
4818326540,0,92,2,1,8,8,6,0,0,0,0,17288,7.2,18298,176,48,1013,1039,22.4,1728.8,10,2,0,8,8,7,0,0,0,0,16275,7.0,17259,153,32,-1013,-1039,18.5,1627.5
4818262136,1,172,0,0,23,19,48,0,0,0,2,37046,11.2,41687,97,0,1792,4625,9.7,3704.6,0,0,1,19,23,49,0,0,0,0,35254,10.6,37062,93,0,-1792,-4625,9.3,3525.4
4857409013,1,0,0,1,14,14,16,0,0,0,0,45950,10.0,47500,0,0,18100,19000,0.0,4595.0,2,0,0,9,9,9,0,0,0,0,27850,6.0,28500,0,0,-18100,-19000,0.0,2785.0
4857375729,1,0,0,1,21,12,23,0,0,0,0,64613,12.0,55000,2,0,27707,22000,0.2,6461.3,73,0,0,6,15,5,0,0,0,0,36906,7.2,33000,1,0,-27707,-22000,0.1,3690.6
4857357419,1,0,0,1,15,11,17,0,0,0,0,63050,12.0,55000,0,0,28300,22000,0.0,6305.0,0,0,0,6,10,4,0,0,0,0,34750,7.2,33000,0,0,-28300,-22000,0.0,3475.0
4857335599,1,189,1,0,25,19,21,0,0,0,0,63426,12.0,55000,1,0,26908,21950,0.1,6342.6,403,0,1,7,13,11,0,0,0,0,36518,7.2,33050,0,0,-26908,-21950,0.0,3651.8
4857318748,1,0,0,1,21,16,21,0,0,0,0,48778,10.0,47500,0,0,20174,19000,0.0,4877.8,0,0,0,8,13,8,0,0,0,0,28604,6.0,28500,0,0,-20174,-19000,0.0,2860.4
4857207176,1,0,0,1,20,14,22,0,0,0,0,63450,12.0,55000,2,0,26950,22000,0.2,6345.0,0,0,0,7,13,10,0,0,0,0,36500,7.2,33000,0,0,-26950,-22000,0.0,3650.0
4857183414,1,0,0,1,21,18,21,0,0,0,0,63412,12.0,55000,0,0,24812,22000,0.0,6341.2,0,0,0,13,16,8,0,0,0,0,38600,7.2,33000,0,0,-24812,-22000,0.0,3860.0
4857071383,0,9,9,0,0,12,0,0,0,0,0,12418,6.4,15944,157,56,-6860,-3481,21.3,1241.8,36,1,1,12,0,9,1,1,0,0,19278,7.4,19425,226,52,6860,3481,27.8,1927.8
4856368756,0,12,0,0,5,4,3,1,1,0,0,14041,6.4,15999,172,44,-1815,-3549,21.6,1404.1,10,0,1,4,5,1,0,0,0,0,15856,7.4,19548,193,68,1815,3549,26.1,1585.6
4856213963,0,10,0,0,7,7,7,1,1,0,0,16046,6.2,15064,150,48,-393,-1239,19.8,1604.6,60,0,1,7,7,4,0,0,0,0,16439,6.6,16303,142,48,393,1239,19.0,1643.9
4855932301,1,10,0,0,20,18,20,0,0,0,0,63074,12.0,55000,0,0,26218,22000,0.0,6307.4,180,0,1,9,11,7,0,0,0,0,36856,7.2,33000,0,0,-26218,-22000,0.0,3685.6
4855270359,0,29,1,1,4,2,4,0,0,0,0,15336,6.8,17018,192,52,-134,70,24.4,1533.6,15,8,0,2,4,2,1,1,0,0,15470,6.8,16948,207,48,134,-70,25.5,1547.0
4855178327,1,21,1,1,6,3,7,2,1,1,0,15122,7.0,18388,172,60,1171,1826,23.2,1512.2,22,1,0,3,6,2,0,0,0,0,13951,6.6,16562,168,48,-1171,-1826,21.6,1395.1
4854709608,1,30,0,1,19,18,14,0,0,0,0,48050,10.0,47500,0,0,19500,17500,0.0,4805.0,0,0,0,10,11,11,0,0,0,0,28550,6.4,30000,0,0,-19500,-17500,0.0,2855.0
4854005084,1,12,1,1,8,1,8,0,0,0,0,16626,6.8,17017,169,31,3249,48,20.0,1662.6,9,1,0,1,8,0,0,0,0,0,13377,6.6,16969,169,40,-3249,-48,20.9,1337.7
4853955066,1,65,1,1,3,0,2,0,0,0,0,15967,6.8,17550,191,48,3165,1511,23.9,1596.7,10,0,0,0,3,0,0,0,0,0,12802,6.4,16039,178,40,-3165,-1511,21.8,1280.2
4853749036,1,11,0,0,10,9,8,0,0,0,0,17292,6.4,17617,173,44,1306,2318,21.7,1729.2,13,3,1,9,10,9,0,0,0,0,15986,6.2,15299,145,36,-1306,-2318,18.1,1598.6
4853682436,1,2,0,1,23,10,21,0,0,0,0,48750,10.0,47500,0,0,22300,19000,0.0,4875.0,0,0,0,1,14,4,0,0,0,0,26450,6.0,28500,0,0,-22300,-19000,0.0,2645.0
4852879413,1,0,0,0,16,19,21,0,0,0,0,60657,12.0,55000,0,0,23424,22000,0.0,6065.7,0,0,1,13,10,11,0,0,0,0,37233,7.2,33000,0,0,-23424,-22000,0.0,3723.3
4852756170,1,17,0,1,23,17,19,0,0,0,0,50940,10.4,49000,1,0,23790,20500,0.1,5094.0,12,0,0,6,12,12,0,0,0,0,27150,6.0,28500,0,0,-23790,-20500,0.0,2715.0
4855357830,1,10,1,1,4,1,2,1,1,0,0,14876,6.8,17752,179,62,2124,1799,24.1,1487.6,18,0,0,1,4,1,0,0,0,0,12752,6.8,15953,169,48,-2124,-1799,21.7,1275.2
4855291554,1,16,0,0,5,1,2,0,0,0,0,15576,7.2,18889,173,60,1721,1418,23.3,1557.6,11,0,1,1,5,1,0,0,0,0,13855,6.6,17471,195,52,-1721,-1418,24.7,1385.5
4855040757,1,0,0,1,24,16,17,0,0,0,0,47750,10.0,47500,1,0,18850,19000,0.1,4775.0,0,0,0,6,14,13,0,0,0,0,28900,6.0,28500,0,0,-18850,-19000,0.0,2890.0
4854932981,1,10,1,1,3,3,2,0,0,0,0,16949,7.2,18611,192,68,2132,2248,26.0,1694.9,11,2,0,3,3,4,0,0,0,0,14817,6.4,16363,216,32,-2132,-2248,24.8,1481.7
4854243161,1,2,0,0,20,15,22,0,0,0,0,46650,10.0,47500,0,0,20200,19000,0.0,4665.0,0,0,1,7,12,5,0,0,0,0,26450,6.0,28500,0,0,-20200,-19000,0.0,2645.0
4854220236,1,4,0,0,20,12,18,0,0,0,0,48700,10.0,47500,0,0,21900,17500,0.0,4870.0,148,0,1,6,14,6,0,0,0,0,26800,6.4,30000,0,0,-21900,-17500,0.0,2680.0
4854200494,1,4,0,0,18,20,21,0,0,0,0,62700,12.0,55000,0,0,35500,22000,0.0,6270.0,16,0,1,11,9,10,0,0,0,0,27200,7.2,33000,0,0,-35500,-22000,0.0,2720.0
4853904400,1,8,0,1,19,19,18,0,0,0,0,51137,12.0,55000,0,0,20787,22000,0.0,5113.7,0,0,0,11,11,8,0,0,0,0,30350,7.2,33000,0,0,-20787,-22000,0.0,3035.0
4853779694,1,20,9,0,24,18,57,0,0,0,0,36573,11.0,39752,98,0,-12,-1,9.8,3657.3,108,0,1,18,24,48,0,0,0,0,36585,11.2,39753,103,0,12,1,10.3,3658.5
4853760598,0,34,0,1,23,22,54,0,0,0,0,37152,11.2,41446,107,0,759,1579,10.7,3715.2,34,0,0,22,23,55,0,0,0,0,36393,11.0,39867,89,0,-759,-1579,8.9,3639.3
4853741789,1,66,0,0,40,29,95,0,0,0,2,44542,12.6,50737,107,0,6640,8533,10.7,4454.2,19,0,1,29,40,65,0,0,0,0,37902,11.4,42204,86,0,-6640,-8533,8.6,3790.2
4853711597,1,0,0,0,16,15,15,0,0,0,0,60685,12.0,55000,1,0,22730,22000,0.1,6068.5,0,0,1,10,11,10,0,0,0,0,37955,7.2,33000,1,0,-22730,-22000,0.1,3795.5
4853698012,1,0,0,0,19,21,18,0,0,0,0,48775,10.0,47500,0,0,19435,19000,0.0,4877.5,0,0,1,14,12,12,0,0,0,0,29340,6.0,28500,0,0,-19435,-19000,0.0,2934.0
4853670087,1,0,0,0,13,20,14,0,0,0,0,45950,10.0,47500,0,0,17400,19000,0.0,4595.0,0,0,1,13,6,11,0,0,0,0,28550,6.0,28500,0,0,-17400,-19000,0.0,2855.0
4852714780,1,0,0,0,8,15,13,0,0,0,0,43850,10.0,47500,0,0,16000,19000,0.0,4385.0,0,0,1,13,6,7,0,0,0,0,27850,6.0,28500,0,0,-16000,-19000,0.0,2785.0
4852692434,1,44,3,0,10,17,12,0,0,0,0,60665,12.0,55000,1,0,22695,22000,0.1,6066.5,20,4,1,13,6,9,0,0,0,0,37970,7.2,33000,1,0,-22695,-22000,0.1,3797.0
4852499392,1,4,0,1,15,18,25,0,0,0,0,62350,12.0,55000,0,0,24790,22000,0.0,6235.0,24,0,0,15,12,5,0,0,0,0,37560,7.2,33000,1,0,-24790,-22000,0.1,3756.0
4852485591,1,31,0,0,22,18,22,0,0,0,0,47700,10.0,47500,0,0,19500,19000,0.0,4770.0,0,0,1,11,15,11,0,0,0,0,28200,6.0,28500,0,0,-19500,-19000,0.0,2820.0
4852473152,1,0,0,0,19,17,52,0,0,0,1,36635,11.0,39651,99,0,2113,2220,9.9,3663.5,0,0,1,17,19,40,0,0,0,0,34522,10.6,37431,75,0,-2113,-2220,7.5,3452.2
4851918139,1,13,0,0,2,5,1,0,0,0,0,13318,6.2,15357,165,44,-2220,-2361,20.9,1331.8,13,0,1,5,2,3,1,1,0,0,15538,6.8,17718,147,60,2220,2361,20.7,1553.8
4747165545,0,11,2,1,5,4,5,0,0,0,0,15657,7.0,18762,172,60,-82,920,23.2,1565.7,38,1,0,4,5,3,0,0,0,0,15739,6.8,17842,178,52,82,-920,23.0,1573.9
4747149425,0,13,2,0,8,10,4,1,1,0,0,15081,6.4,15844,168,40,-3818,-2323,20.8,1508.1,18,1,1,10,8,9,0,0,0,0,18899,6.8,18167,189,52,3818,2323,24.1,1889.9
4747130847,1,19,0,1,4,3,6,1,1,0,0,16778,7.0,18078,207,56,1650,1480,26.3,1677.8,133,3,0,3,4,4,0,0,0,0,15128,6.6,16598,162,60,-1650,-1480,22.2,1512.8
4747109882,0,23,2,0,3,8,1,0,0,0,0,14146,6.4,16252,194,52,-2699,-1425,24.6,1414.6,13,1,1,8,3,15,1,1,0,0,16845,7.0,17677,212,56,2699,1425,26.8,1684.5
4734417986,1,0,0,0,31,31,80,0,0,0,1,40599,12.0,46276,93,0,2588,1564,9.3,4059.9,0,0,1,31,31,68,0,0,0,0,38011,11.6,44712,94,0,-2588,-1564,9.4,3801.1
4734380689,0,24,0,1,30,27,69,0,0,0,0,38332,11.6,43967,84,0,-1108,-442,8.4,3833.2,0,0,0,27,30,57,0,0,0,0,39440,11.6,44409,83,0,1108,442,8.3,3944.0
4734355536,0,1,0,0,20,33,34,0,0,0,1,35387,10.8,38834,95,0,-3693,-3283,9.5,3538.7,0,0,1,33,20,82,0,0,0,0,39080,11.4,42117,110,0,3693,3283,11.0,3908.0
4733592264,0,7,1,0,0,4,0,0,0,0,0,11321,6.2,15842,156,40,-2765,-1245,19.6,1132.1,232,0,1,4,0,5,1,1,0,0,14086,6.6,17087,138,52,2765,1245,19.0,1408.6
4733559351,1,9,0,1,6,1,6,0,0,0,0,15708,7.0,18224,181,56,3452,2723,23.7,1570.8,10,1,0,1,6,2,0,0,0,0,12256,6.4,15501,137,48,-3452,-2723,18.5,1225.6
4733533908,1,19,0,1,7,3,4,0,0,0,0,16808,7.2,18814,164,60,3211,2991,22.4,1680.8,12,1,0,3,7,2,0,0,0,0,13597,6.4,15823,159,46,-3211,-2991,20.5,1359.7
4733343255,1,0,0,1,26,33,46,0,0,0,0,38504,11.4,42184,107,0,-919,-1782,10.7,3850.4,0,0,0,33,26,77,0,0,0,0,39423,11.6,43966,93,0,919,1782,9.3,3942.3
4732314282,0,2,0,1,26,17,75,0,0,0,1,38734,10.8,39479,87,0,3195,1757,8.7,3873.4,3,1,0,17,26,43,0,0,0,0,35539,10.8,37722,91,0,-3195,-1757,9.1,3553.9
4732291330,0,22,0,0,20,31,48,0,0,0,0,37268,11.2,41534,128,0,-2335,-3269,12.8,3726.8,0,41,1,31,20,76,0,0,0,0,39603,11.8,44803,91,0,2335,3269,9.1,3960.3
4732266642,0,0,0,0,13,20,19,0,0,0,0,33217,10.6,35871,94,0,-2049,-4568,9.4,3321.7,0,0,1,20,13,54,0,0,0,0,35266,11.0,40439,99,0,2049,4568,9.9,3526.6
4732232673,1,17,12,1,4,2,3,0,0,0,0,16067,6.8,17231,169,44,1200,347,21.3,1606.7,23,2,0,2,4,2,1,0,1,0,14867,6.6,16884,198,59,-1200,-347,25.7,1486.7
4731441348,1,11,0,1,23,18,62,0,0,0,1,37932,11.2,40504,97,0,3047,1846,9.7,3793.2,0,7,0,18,23,41,0,0,0,0,34885,10.8,38658,89,0,-3047,-1846,8.9,3488.5
4731406963,0,13,0,0,5,4,6,0,0,0,0,14230,6.6,17194,160,40,-784,815,20.0,1423.0,16,0,1,4,5,7,1,1,0,0,15014,6.6,16379,143,64,784,-815,20.7,1501.4
4728879031,1,5,1,1,8,5,5,0,0,0,0,16736,6.8,16987,202,52,84,-274,25.4,1673.6,7,0,0,5,8,5,0,0,0,0,16652,7.0,17261,187,56,-84,274,24.3,1665.2
4727753993,0,56,0,1,2,5,2,0,0,0,0,14530,6.8,17349,182,58,-1959,-1036,24.0,1453.0,13,4,0,5,2,5,1,1,0,0,16489,7.0,18385,203,48,1959,1036,25.1,1648.9
4833164851,0,16,0,0,4,20,15,0,0,0,1,28291,10.2,34540,81,59,-6951,-3675,14.0,2829.1,10,0,1,19,3,43,0,0,0,0,35242,11.0,38215,77,47,6951,3675,12.4,3524.2
4833137842,1,56,0,1,7,4,9,0,0,0,1,32928,11.0,38259,97,51,6345,5629,14.8,3292.8,11,1,0,3,6,7,0,0,0,0,26583,10.0,32630,65,44,-6345,-5629,10.9,2658.3
4833114939,0,13,0,1,12,9,21,0,0,0,0,31336,10.6,36131,91,43,-3398,-2786,13.4,3133.6,14,0,0,8,11,18,0,0,0,0,34734,10.8,38917,93,59,3398,2786,15.2,3473.4
4792022207,1,16,2,1,7,2,7,0,0,0,0,16619,6.8,18122,173,48,2740,1808,22.1,1661.9,16,1,0,2,7,1,1,1,0,0,13879,6.6,16314,138,56,-2740,-1808,19.4,1387.9
4792006550,0,0,0,0,7,29,13,0,0,0,1,31377,10.2,34006,67,0,-6175,-6638,6.7,3137.7,0,0,1,29,7,101,0,0,0,0,37552,10.8,40644,106,0,6175,6638,10.6,3755.2
4791351938,1,163,0,0,20,25,46,0,0,0,0,34674,10.4,37230,93,0,-2310,-4695,9.3,3467.4,0,0,1,25,20,64,0,0,0,0,36984,11.6,41925,84,0,2310,4695,8.4,3698.4
4791322231,1,0,0,1,27,22,78,0,0,0,1,38590,11.8,43236,107,0,4100,4369,10.7,3859.0,0,0,0,22,27,46,0,0,0,0,34490,11.0,38867,75,0,-4100,-4369,7.5,3449.0
4791064972,1,70,2,1,24,24,63,0,0,0,2,38594,11.2,40836,92,0,3672,1732,9.2,3859.4,11,0,0,24,24,43,0,0,0,0,34922,10.8,39104,58,0,-3672,-1732,5.8,3492.2
4791053738,0,1,0,1,27,27,76,0,0,0,0,37883,11.4,42641,84,0,-600,-1060,8.4,3788.3,0,0,0,27,27,74,0,0,0,0,38483,11.4,43701,96,0,600,1060,9.6,3848.3
4790783445,0,0,4,0,24,21,50,0,0,0,0,37273,11.0,38630,107,0,1659,-1312,10.7,3727.3,14,0,1,21,24,47,0,0,0,0,35614,11.0,39942,111,0,-1659,1312,11.1,3561.4
4790766231,1,9,0,0,17,22,49,0,0,0,2,35312,10.8,36951,97,0,-1249,-1408,9.7,3531.2,0,0,1,22,17,52,0,0,0,0,36561,10.8,38359,118,0,1249,1408,11.8,3656.1
4790738523,0,0,0,0,23,30,52,0,0,0,2,38427,11.2,42122,94,0,-3784,-4765,9.4,3842.7,234,0,1,30,23,75,0,0,0,0,42211,12.0,46887,115,0,3784,4765,11.5,4221.1
4790710392,1,0,1,1,32,19,83,0,0,0,1,41383,12.0,45322,95,0,5022,7854,9.5,4138.3,18,0,0,19,32,50,0,0,0,0,36361,10.8,37468,80,0,-5022,-7854,8.0,3636.1
4790693560,0,1,0,1,22,23,51,0,0,0,1,34443,10.6,38230,92,0,-2254,-2292,9.2,3444.3,32,0,0,23,22,60,0,0,0,0,36697,11.0,40522,86,0,2254,2292,8.6,3669.7
4790481606,0,0,0,0,20,31,48,0,0,0,0,36794,11.0,39471,82,0,-1899,-4780,8.2,3679.4,0,0,1,31,20,60,0,0,0,0,38693,11.6,44251,99,0,1899,4780,9.9,3869.3
4790349414,1,0,2,1,17,17,30,0,0,0,0,34807,10.8,38613,71,0,637,1566,7.1,3480.7,7,0,0,17,17,33,0,0,0,0,34170,10.6,37047,99,0,-637,-1566,9.9,3417.0
4789618644,0,9,0,1,2,7,0,0,0,0,0,14818,6.8,17240,175,56,-1895,-1878,23.1,1481.8,23,0,0,7,2,6,1,1,0,0,16713,7.0,19118,193,76,1895,1878,26.9,1671.3
4789581324,0,8,0,1,3,6,2,0,0,0,0,15441,7.2,18537,197,52,563,345,24.9,1544.1,12,0,0,5,2,3,1,1,0,0,14878,7.2,18192,179,52,-563,-345,23.1,1487.8
4789104903,1,0,0,1,27,17,86,0,0,0,0,38407,11.6,42880,99,0,5070,6389,9.9,3840.7,0,0,0,17,27,52,0,0,0,0,33337,10.6,36491,67,0,-5070,-6389,6.7,3333.7
4789089300,1,1,0,1,17,17,41,0,0,0,1,37281,11.0,40352,112,0,3258,3728,11.2,3728.1,0,0,0,17,17,49,0,0,0,0,34023,10.4,36624,69,0,-3258,-3728,6.9,3402.3
4856179633,0,86,0,0,16,23,45,0,0,0,1,35659,10.8,36647,98,0,-2456,-3725,9.8,3565.9,0,0,1,23,16,64,0,0,0,0,38115,11.0,40372,110,0,2456,3725,11.0,3811.5
4856150894,0,0,0,0,14,22,33,0,0,0,1,36106,10.6,38700,96,0,-340,-1641,9.6,3610.6,0,0,1,22,14,46,0,0,0,0,36446,11.0,40341,105,0,340,1641,10.5,3644.6
4856113534,1,0,0,1,22,20,61,0,0,0,1,35878,11.0,38447,99,0,-2079,-2363,9.9,3587.8,0,0,0,20,22,64,0,0,0,0,37957,11.0,40810,98,0,2079,2363,9.8,3795.7
4856038190,1,0,2,1,15,22,13,0,0,0,0,46660,10.0,47500,0,0,18030,19000,0.0,4666.0,28,1,0,12,5,13,0,0,0,0,28630,6.0,28500,3,0,-18030,-19000,0.3,2863.0
4856017941,1,29,0,1,18,20,12,0,0,0,0,46458,10.0,47500,8,0,15988,19000,0.8,4645.8,288,0,0,10,8,14,0,0,0,0,30470,6.0,28500,6,0,-15988,-19000,0.6,3047.0
4855849390,1,14,0,0,6,3,4,1,1,0,1,17881,7.0,18220,213,54,3043,1773,26.7,1788.1,12,1,1,3,6,5,0,0,0,0,14838,6.6,16447,194,52,-3043,-1773,24.6,1483.8
4855231940,1,0,0,0,17,16,17,0,0,0,0,62075,12.0,55000,0,0,25510,22000,0.0,6207.5,0,0,1,11,12,10,0,0,0,0,36565,7.2,33000,1,0,-25510,-22000,0.1,3656.5
4855200468,1,6,0,1,18,13,19,0,0,0,0,66550,12.0,55000,0,0,30400,22000,0.0,6655.0,0,0,0,7,12,8,0,0,0,0,36150,7.2,33000,0,0,-30400,-22000,0.0,3615.0
4855166668,1,234,0,1,18,16,15,0,0,0,0,47370,10.0,47500,0,0,17882,19000,0.0,4737.0,5,0,0,9,11,12,0,0,0,0,29488,6.0,28500,1,0,-17882,-19000,0.1,2948.8
4855093587,0,9,0,0,9,7,8,0,0,0,0,17144,6.6,16248,175,32,-634,-1117,20.7,1714.4,83,0,1,7,9,4,0,0,0,0,17778,6.6,17365,205,55,634,1117,26.0,1777.8
4855042097,1,52,2,1,6,7,3,0,0,0,0,15664,6.4,16820,174,32,302,-456,20.6,1566.4,30,0,0,7,6,7,0,0,0,0,15362,6.8,17276,153,40,-302,456,19.3,1536.2
4855008024,0,0,0,1,20,25,47,0,0,0,1,36541,11.0,38994,101,0,-510,-722,10.1,3654.1,0,0,0,25,20,71,0,0,0,0,37051,11.0,39716,105,0,510,722,10.5,3705.1
4853948878,1,622,0,1,15,20,15,0,0,0,0,46064,10.0,47500,0,0,24445,19000,0.0,4606.4,0,0,0,14,9,16,0,0,0,0,21619,6.0,28500,0,0,-24445,-19000,0.0,2161.9
4853916324,1,28,0,1,25,15,22,0,0,0,0,63403,12.0,55000,1,0,28303,22000,0.1,6340.3,0,0,0,4,14,7,0,0,0,0,35100,7.2,33000,0,0,-28303,-22000,0.0,3510.0
4853888603,1,0,0,0,24,10,22,0,0,0,0,64900,13.8,66500,1,0,28005,32000,0.1,6490.0,0,0,1,3,17,5,0,0,0,0,36895,7.4,34500,1,0,-28005,-32000,0.1,3689.5
4853863534,1,0,0,1,16,17,15,0,0,0,0,62700,12.2,56000,0,0,26200,23000,0.0,6270.0,0,0,0,12,11,9,0,0,0,0,36500,7.2,33000,0,0,-26200,-23000,0.0,3650.0
4847755575,1,13,1,1,6,6,1,1,1,0,0,16416,7.0,17993,161,67,-789,945,22.8,1641.6,15,2,0,6,6,4,0,0,0,0,17205,6.8,17048,182,43,789,-945,22.5,1720.5
4847700885,1,88,0,0,9,8,5,0,0,0,0,18742,7.2,19146,181,52,-375,243,23.3,1874.2,16,0,1,8,9,5,0,0,0,0,19117,7.2,18903,196,56,375,-243,25.2,1911.7
4846792872,1,11,1,0,10,11,5,0,0,0,0,17920,7.2,18810,184,48,-1364,91,23.2,1792.0,12,0,1,11,10,9,0,0,0,0,19284,7.2,18719,199,60,1364,-91,25.9,1928.4
4845850663,0,70,0,1,8,10,4,1,1,0,0,16413,6.6,17039,209,52,-897,-251,26.1,1641.3,21,0,0,10,8,9,0,0,0,0,17310,6.6,17290,159,49,897,251,20.8,1731.0
4857531107,0,14,1,0,1,7,0,0,0,0,0,12700,6.6,16002,167,48,-3179,-1130,21.5,1270.0,12,0,1,7,1,8,0,0,0,0,15879,6.6,17132,148,52,3179,1130,20.0,1587.9
4856431267,0,12,1,0,2,7,5,0,0,0,0,14442,6.6,16569,188,52,-2117,-1013,24.0,1444.2,10,0,1,7,2,8,0,0,0,0,16559,6.8,17582,187,48,2117,1013,23.5,1655.9
4856406944,1,16,1,1,13,6,17,0,0,0,0,19868,7.0,18082,186,52,3116,356,23.8,1986.8,13,0,0,6,13,5,0,0,0,0,16752,7.0,17726,155,64,-3116,-356,21.9,1675.2
4855905586,0,9,0,1,4,9,3,1,1,0,0,14153,5.8,13824,110,52,-3617,-4441,16.2,1415.3,6,0,0,9,4,10,0,0,0,0,17770,7.0,18265,169,64,3617,4441,23.3,1777.0
4855415419,0,13,0,1,1,4,1,0,0,0,0,12463,6.8,16017,145,44,-2808,-1829,18.9,1246.3,12,0,0,4,1,6,1,1,0,0,15271,6.8,17846,184,59,2808,1829,24.3,1527.1
4854916176,0,9,0,1,11,2,10,0,0,0,0,17985,6.6,16816,176,32,3883,326,20.8,1798.5,261,0,0,2,11,1,1,1,0,0,14102,6.6,16490,163,56,-3883,-326,21.9,1410.2
4854884981,1,14,1,1,6,4,3,0,0,0,0,15333,6.6,16337,163,30,2103,1148,19.3,1533.3,11,1,0,4,6,4,0,0,0,0,13230,6.4,15189,109,40,-2103,-1148,14.9,1323.0
4854282381,0,11,1,0,6,5,3,0,0,0,0,15279,6.8,16560,167,6,-589,-1320,17.3,1527.9,10,1,1,5,6,3,0,0,0,0,15868,7.0,17880,171,54,589,1320,22.5,1586.8
4851094308,0,12,2,1,12,7,9,0,0,0,0,18103,6.4,16408,158,40,1995,-709,19.8,1810.3,11,1,0,7,12,4,0,0,0,0,16108,6.6,17117,168,40,-1995,709,20.8,1610.8
4851062935,1,23,1,1,2,4,1,0,0,0,0,13748,6.8,16633,174,48,-1509,-1142,22.2,1374.8,9,0,0,4,2,3,0,0,0,0,15257,6.8,17775,185,56,1509,1142,24.1,1525.7
4851031874,0,11,0,1,2,6,3,0,0,0,0,13527,6.6,15780,173,44,-2725,-3299,21.7,1352.7,44,0,0,6,2,4,1,1,0,0,16252,7.0,19079,187,68,2725,3299,25.5,1625.2
4850976199,0,15,0,1,8,9,11,0,0,0,0,17530,6.6,15207,127,52,-1136,-1442,17.9,1753.0,17,0,0,9,8,12,0,0,0,0,18666,6.6,16649,168,52,1136,1442,22.0,1866.6
4850944514,0,15,1,1,5,4,2,0,0,0,0,14747,6.6,16879,182,48,-336,-11,23.0,1474.7,24,1,0,4,5,1,1,0,1,0,15083,6.6,16890,169,45,336,11,21.4,1508.3
4850886260,1,13,0,0,7,7,9,0,0,0,0,16676,6.4,15376,178,48,643,-461,22.6,1667.6,11,0,1,7,7,8,1,1,0,0,16033,6.2,15837,165,56,-643,461,22.1,1603.3
4850035319,0,136,0,0,10,7,9,0,0,0,0,17989,6.6,16357,180,42,871,176,22.2,1798.9,23,1,1,7,10,6,0,0,0,0,17118,6.6,16181,187,52,-871,-176,23.9,1711.8
4849187982,0,39,0,1,2,4,2,0,0,0,0,15185,7.0,17664,199,47,-922,-658,24.6,1518.5,10,19,0,4,2,2,0,0,0,0,16107,7.0,18322,213,56,922,658,26.9,1610.7
4848997660,0,15,1,0,2,7,0,0,0,0,0,13501,6.8,16907,171,44,-2596,-714,21.5,1350.1,13,0,1,7,2,6,0,0,0,0,16097,6.8,17621,189,48,2596,714,23.7,1609.7
4848109733,1,12,1,1,7,12,5,0,0,0,0,16954,6.8,16515,147,56,-2775,-2167,20.3,1695.4,78,0,0,12,7,8,0,0,0,0,19729,7.2,18682,206,64,2775,2167,27.0,1972.9
4848086859,1,12,1,1,8,2,5,0,0,0,0,17692,7.4,19520,196,64,5239,3889,26.0,1769.2,12,2,0,2,8,2,0,0,0,0,12453,6.4,15631,145,44,-5239,-3889,18.9,1245.3
4759974407,1,30,0,1,5,3,2,0,0,0,0,16258,7.2,19550,180,52,2756,1474,23.2,1625.8,6,9,0,2,4,0,0,0,0,0,13502,7.0,18076,135,52,-2756,-1474,18.7,1350.2
4747692264,1,12,0,0,0,0,0,1,1,0,0,12498,7.0,18315,122,52,-513,1999,17.4,1249.8,11,0,0,0,0,0,0,0,0,0,13011,6.4,16316,170,51,513,-1999,22.1,1301.1
4747673374,0,11,0,0,8,11,6,0,0,0,0,16065,6.4,16550,140,51,-4342,-1959,19.1,1606.5,9,0,1,11,8,11,0,0,0,0,20407,7.0,18509,188,36,4342,1959,22.4,2040.7
4732809012,0,15,2,0,5,11,5,0,0,0,0,15326,6.6,16337,169,44,-2015,-1193,21.3,1532.6,24,2,1,11,5,6,0,0,0,0,17341,6.8,17530,151,56,2015,1193,20.7,1734.1
4732769565,1,9,2,0,11,11,5,0,0,0,0,19000,6.8,18210,219,46,552,1614,26.5,1900.0,12,1,1,11,11,6,0,0,0,0,18448,6.6,16596,178,44,-552,-1614,22.2,1844.8
4732740839,1,16,1,0,4,3,3,0,0,0,0,16377,6.6,17399,209,60,2924,1671,26.9,1637.7,159,0,1,3,4,4,1,1,0,0,13453,6.2,15728,150,44,-2924,-1671,19.4,1345.3
4732663157,0,12,0,1,5,2,5,0,0,0,0,15531,6.8,17546,155,52,2162,308,20.7,1553.1,196,0,0,2,5,1,2,1,1,0,13369,6.8,17238,146,52,-2162,-308,19.8,1336.9
4700328998,0,11,0,1,3,3,4,1,1,0,0,14197,6.6,17017,135,60,-1035,-1439,19.5,1419.7,11,0,0,3,3,3,0,0,0,0,15232,7.0,18456,217,50,1035,1439,26.7,1523.2
4693953609,0,13,0,0,3,8,3,1,1,0,0,13284,6.4,15330,121,52,-3606,-2569,17.3,1328.4,59,3,1,8,3,6,0,0,0,0,16890,7.0,17899,162,48,3606,2569,21.0,1689.0
4693050147,1,30,0,1,9,0,6,1,0,1,0,17067,7.0,18259,169,40,4837,1522,20.9,1706.7,28,0,0,0,9,0,0,0,0,0,12230,6.6,16737,139,60,-4837,-1522,19.9,1223.0
4693037968,1,13,2,1,12,1,1,0,0,0,0,17344,7.0,18250,194,40,5314,3556,23.4,1734.4,11,1,0,0,11,0,0,0,0,0,12030,6.4,14694,127,36,-5314,-3556,16.3,1203.0
4692998042,0,62,11,1,7,3,8,0,0,0,0,16757,6.8,17490,148,48,730,-348,19.6,1675.7,34,0,0,3,7,3,1,1,0,0,16027,7.0,17838,180,64,-730,348,24.4,1602.7
4692982901,0,7,0,1,17,3,16,0,0,0,0,18556,6.6,16540,132,0,6969,3702,13.2,1855.6,0,0,0,3,17,0,0,0,0,0,11587,5.6,12838,81,0,-6969,-3702,8.1,1158.7
4692943725,1,19,2,1,12,2,5,0,0,0,0,21688,7.4,19999,218,55,8647,4829,27.3,2168.8,36,0,0,2,12,2,0,0,0,0,13041,6.2,15170,152,42,-8647,-4829,19.4,1304.1
4663556919,1,9,1,1,7,8,7,0,0,0,0,15368,6.4,15091,146,52,-1518,-2000,19.8,1536.8,19,0,0,8,7,11,0,0,0,0,16886,6.8,17091,157,48,1518,2000,20.5,1688.6
4663534741,1,14,2,1,8,3,8,1,1,0,0,16467,6.6,16435,194,36,3467,-336,23.0,1646.7,20,1,0,1,6,0,0,0,0,0,13000,6.6,16771,181,49,-3467,336,23.0,1300.0
4663471628,1,13,1,0,4,5,5,0,0,0,0,15486,7.0,18541,162,48,-467,1292,21.0,1548.6,13,2,1,5,4,3,0,0,0,0,15953,6.8,17249,190,44,467,-1292,23.4,1595.3
4663426579,0,13,13,0,3,11,0,0,0,0,0,14588,6.8,17227,176,56,-3487,-1045,23.2,1458.8,42,2,1,11,3,8,1,1,0,0,18075,7.0,18272,173,48,3487,1045,22.1,1807.5
4663385355,1,11,1,1,6,6,2,0,0,0,0,15040,6.8,16720,160,56,-873,265,21.6,1504.0,17,1,0,6,6,5,0,0,0,0,15913,6.6,16455,180,44,873,-265,22.4,1591.3
4662307854,0,0,0,0,27,30,74,0,0,0,1,39512,11.4,43356,94,0,1072,-808,9.4,3951.2,0,0,1,30,27,66,0,0,0,0,38440,11.6,44164,109,0,-1072,808,10.9,3844.0
4856351570,1,306,0,0,32,15,96,0,0,0,2,38892,11.4,41854,104,0,4028,4705,10.4,3889.2,8,0,1,15,32,41,0,0,0,0,34864,10.4,37149,87,0,-4028,-4705,8.7,3486.4
4856315590,1,89,0,1,19,27,39,0,0,0,0,35584,11.0,39928,102,0,-2070,-1959,10.2,3558.4,2,5,0,27,19,46,0,0,0,0,37654,11.4,41887,109,0,2070,1959,10.9,3765.4
4851956595,0,13,0,1,3,2,4,0,0,0,0,13562,6.4,15733,134,48,448,-1915,18.2,1356.2,7,0,0,2,3,1,0,0,0,0,13114,6.8,17648,151,52,-448,1915,20.3,1311.4
4851246708,1,17,3,1,3,4,2,0,0,0,0,14009,6.4,15454,157,43,-1096,-2178,20.0,1400.9,22,4,0,4,3,4,0,0,0,0,15105,6.8,17632,168,55,1096,2178,22.3,1510.5
4849091023,1,12,0,1,2,6,0,0,0,0,0,13974,6.4,16417,162,60,-899,-1011,22.2,1397.4,18,0,0,6,2,2,1,0,1,0,14873,6.8,17428,171,36,899,1011,20.7,1487.3
4848639372,1,0,0,0,21,22,58,0,0,0,1,35704,10.8,37483,68,0,-1839,-3562,6.8,3570.4,0,0,1,22,21,68,0,0,0,0,37543,11.2,41045,91,0,1839,3562,9.1,3754.3
4848623745,1,4,0,0,21,22,50,0,0,0,0,35693,10.8,39318,99,0,315,1527,9.9,3569.3,0,0,1,22,21,50,0,0,0,0,35378,10.6,37791,86,0,-315,-1527,8.6,3537.8
4848607821,1,0,0,0,24,17,70,0,0,0,1,37178,11.2,41652,101,0,1998,5273,10.1,3717.8,2,0,1,17,24,37,0,0,0,0,35180,10.4,36379,97,0,-1998,-5273,9.7,3518.0
4846177175,0,29,1,0,2,3,2,0,0,0,0,14122,7.0,17842,168,60,139,913,22.8,1412.2,13,9,1,3,2,3,0,0,0,0,13983,6.6,16929,145,47,-139,-913,19.2,1398.3
4846130405,1,53,1,1,4,0,5,0,0,0,0,15118,6.8,17798,155,60,2106,933,21.5,1511.8,16,0,0,0,4,0,0,0,0,0,13012,6.6,16865,165,44,-2106,-933,20.9,1301.2
4844974108,0,11,1,1,6,3,8,0,0,0,0,16162,6.8,17168,171,44,314,-750,21.5,1616.2,11,2,0,3,6,3,0,0,0,0,15848,6.8,17918,198,40,-314,750,23.8,1584.8
4844918852,0,9,1,1,6,1,2,0,0,0,0,15105,6.8,17480,178,36,1529,885,21.4,1510.5,15,0,0,1,6,0,0,0,0,0,13576,6.8,16595,186,72,-1529,-885,25.8,1357.6
4843418838,0,13,0,0,2,5,3,1,1,0,0,14389,6.8,17178,161,48,-1558,-835,20.9,1438.9,14,0,1,5,2,4,0,0,0,0,15947,7.0,18013,148,60,1558,835,20.8,1594.7
4843370564,0,9,1,0,2,6,0,0,0,0,0,15692,6.8,17785,184,52,-967,69,23.6,1569.2,17,0,1,6,2,4,1,1,0,0,16659,6.8,17716,206,40,967,-69,24.6,1665.9
4842476524,0,33,0,0,1,11,1,0,0,0,0,13673,6.4,15616,121,40,-3750,-2332,16.1,1367.3,30,0,1,11,1,9,0,0,0,0,17423,7.0,17948,143,52,3750,2332,19.5,1742.3
4842443573,1,9,0,1,7,4,5,1,1,0,0,15951,7.0,18000,174,60,1418,697,23.4,1595.1,13,0,0,4,7,3,0,0,0,0,14533,6.8,17303,163,52,-1418,-697,21.5,1453.3
4841462511,1,12,1,0,3,4,1,0,0,0,0,15097,6.8,17642,168,44,847,3031,21.2,1509.7,11,0,1,4,3,3,0,0,0,0,14250,6.4,14611,116,36,-847,-3031,15.2,1425.0
4841396547,0,8,0,1,7,5,6,0,0,0,0,16849,6.8,17607,184,48,-807,640,23.2,1684.9,14,0,0,5,7,6,0,0,0,0,17656,6.8,16967,172,48,807,-640,22.0,1765.6
4840297690,1,1,0,1,17,22,32,0,0,0,0,33904,10.6,36070,87,0,-3146,-4089,8.7,3390.4,0,0,0,22,17,63,0,0,0,0,37050,11.0,40159,106,0,3146,4089,10.6,3705.0
4840202943,1,11,0,1,3,0,2,0,0,0,0,14623,6.8,18344,157,60,2719,2603,21.7,1462.3,12,0,0,0,3,0,0,0,0,0,11904,6.4,15741,126,36,-2719,-2603,16.2,1190.4
4857326568,1,10,0,0,3,6,2,1,1,0,0,15180,6.6,16937,142,52,-17,-643,19.4,1518.0,9,0,1,6,3,1,0,0,0,0,15197,7.0,17580,198,40,17,643,23.8,1519.7
4855803246,0,46,2,0,1,2,0,0,0,0,0,13016,6.8,17302,182,52,-1454,-1021,23.4,1301.6,11,2,1,2,1,2,0,0,0,0,14470,7.0,18323,188,56,1454,1021,24.4,1447.0
4855754676,0,90,1,0,3,6,1,1,1,0,0,13661,6.8,16576,162,48,-1774,-747,21.0,1366.1,8,15,1,6,3,7,0,0,0,0,15435,6.8,17323,146,43,1774,747,18.9,1543.5
4855726955,0,83,2,0,3,5,1,0,0,0,0,14410,6.6,16791,214,40,-286,-385,25.4,1441.0,12,2,1,5,3,4,0,0,0,0,14696,6.8,17176,184,52,286,385,23.6,1469.6
4854716224,0,13,1,1,5,7,4,0,0,0,0,16021,6.8,17977,216,40,1498,1918,25.6,1602.1,92,1,0,7,5,5,0,0,0,0,14523,6.6,16059,145,48,-1498,-1918,19.3,1452.3
4854680133,0,72,3,0,1,5,1,1,1,0,0,14503,7.0,17338,212,56,-2208,-846,26.8,1450.3,14,1,1,5,1,3,0,0,0,0,16711,6.8,18184,214,52,2208,846,26.6,1671.1
4854629889,0,161,0,0,8,7,6,0,0,0,0,17232,6.8,16943,201,45,1762,-566,24.6,1723.2,62,1,1,7,8,1,1,1,0,0,15470,6.8,17509,182,63,-1762,566,24.5,1547.0
4854562029,1,70,1,0,3,7,3,1,1,0,0,14641,6.6,16948,164,52,-1736,-780,21.6,1464.1,12,1,1,7,3,5,0,0,0,0,16377,6.8,17728,176,60,1736,780,23.6,1637.7
4854531669,0,75,2,1,5,3,4,0,0,0,0,15618,7.0,18633,189,52,-913,998,24.1,1561.8,13,1,0,3,5,5,0,0,0,0,16531,7.0,17635,199,52,913,-998,25.1,1653.1
4839974518,1,38,2,0,4,5,3,1,1,0,0,15747,7.0,18782,198,60,334,1227,25.8,1574.7,71,11,1,5,4,4,0,0,0,0,15413,6.6,17555,218,48,-334,-1227,26.6,1541.3
4839919637,0,77,3,1,7,3,10,1,1,0,0,15601,7.0,17927,158,44,1711,1126,20.2,1560.1,20,2,0,3,7,2,0,0,0,0,13890,6.6,16801,151,48,-1711,-1126,19.9,1389.0
4836871877,0,36,2,0,2,10,0,0,0,0,0,12919,6.4,15399,157,40,-3375,-2296,19.7,1291.9,75,3,1,10,2,6,1,1,0,0,16294,6.8,17695,194,52,3375,2296,24.6,1629.4
4836701496,0,66,0,0,1,3,0,0,0,0,0,13568,6.8,17735,161,52,-1251,739,21.3,1356.8,31,0,1,3,1,2,0,0,0,0,14819,6.8,16996,175,48,1251,-739,22.3,1481.9
4836652576,0,11,8,0,1,3,0,0,0,0,0,12392,6.8,16796,148,52,-3078,-1525,20.0,1239.2,21,1,1,3,1,2,0,0,0,0,15470,7.0,18321,210,48,3078,1525,25.8,1547.0
4834044161,1,10,2,0,5,4,1,0,0,0,0,15039,6.8,17223,175,40,335,-24,21.5,1503.9,74,1,1,4,5,0,0,0,0,0,14704,6.8,17247,211,40,-335,24,25.1,1470.4
4834024307,1,13,2,0,1,2,0,0,0,0,0,15000,7.2,19103,201,68,2885,4535,26.9,1500.0,121,0,1,2,1,0,0,0,0,0,12115,5.8,14568,171,20,-2885,-4535,19.1,1211.5
4833975204,0,71,1,0,5,6,7,0,0,0,0,15304,6.4,15278,156,44,1034,1091,20.0,1530.4,15,1,1,6,5,6,0,0,0,0,14270,6.0,14187,114,40,-1034,-1091,15.4,1427.0
4832850612,0,75,0,1,3,3,2,0,0,0,0,14513,6.6,16548,196,44,-588,-268,24.0,1451.3,7,2,0,3,3,1,1,0,1,0,15101,6.8,16816,202,56,588,268,25.8,1510.1
4832817542,0,50,0,1,2,2,1,0,0,0,0,13614,7.0,18001,194,40,-1519,-1405,23.4,1361.4,74,0,0,2,2,2,0,0,0,0,15133,7.2,19406,211,72,1519,1405,28.3,1513.3
4831287647,1,71,1,1,2,0,1,1,1,0,0,14698,6.8,18447,207,57,874,215,26.4,1469.8,14,0,0,0,2,0,0,0,0,0,13824,6.6,18232,225,41,-874,-215,26.6,1382.4
4765510157,0,11,1,1,8,8,3,0,0,0,0,15688,6.6,16586,181,48,-1981,-844,22.9,1568.8,11,3,0,8,8,7,1,1,0,0,17669,6.8,17430,178,43,1981,844,22.1,1766.9
4765465811,0,118,1,0,1,5,0,0,0,0,0,14017,6.8,17142,169,56,-596,-386,22.5,1401.7,33,12,1,5,1,4,0,0,0,0,14613,6.8,17528,152,48,596,386,20.0,1461.3
4765136942,1,0,0,0,33,29,65,0,0,0,1,40326,12.0,45654,102,0,162,857,10.2,4032.6,0,0,1,29,33,63,0,0,0,0,40164,11.8,44797,107,0,-162,-857,10.7,4016.4
4765126127,0,6,0,0,3,5,0,0,0,0,0,14370,6.8,17497,173,64,-1019,457,23.7,1437.0,14,0,1,5,3,6,1,1,0,0,15389,6.8,17040,161,58,1019,-457,21.9,1538.9
4764795171,1,21,0,1,6,3,4,2,1,1,0,18083,6.8,18405,224,52,4547,2860,27.6,1808.3,68,0,0,3,6,2,0,0,0,0,13536,6.4,15545,142,44,-4547,-2860,18.6,1353.6
4764758538,1,12,0,0,4,4,2,1,1,0,0,15278,7.0,17109,177,64,1233,431,24.1,1527.8,13,0,1,4,4,3,0,0,0,0,14045,6.6,16678,149,60,-1233,-431,20.9,1404.5
4816901895,1,15,0,0,5,1,8,1,1,0,0,14865,6.4,15583,133,53,653,-1188,18.6,1486.5,5,1,1,1,5,0,0,0,0,0,14212,6.8,16771,148,52,-653,1188,20.0,1421.2
4815962157,0,10,0,1,5,9,7,0,0,0,0,14923,6.0,14006,151,36,-1918,-2956,18.7,1492.3,10,0,0,9,5,8,1,1,0,0,16841,6.8,16962,148,48,1918,2956,19.6,1684.1
4815929990,1,12,1,0,5,2,3,0,0,0,0,15150,6.8,17371,171,48,338,-298,21.9,1515.0,75,0,1,2,5,2,1,1,0,0,14812,7.0,17669,192,63,-338,298,25.5,1481.2
4815424679,0,11,0,0,5,4,2,0,0,0,0,14733,7.0,17535,161,52,53,247,21.3,1473.3,12,0,1,4,5,3,0,0,0,0,14680,6.8,17288,170,56,-53,-247,22.6,1468.0
4814943896,0,53,0,1,3,8,1,0,0,0,0,14388,6.6,17077,149,60,-1937,-1265,20.9,1438.8,65,0,0,8,3,4,1,1,0,0,16325,7.0,18342,172,72,1937,1265,24.4,1632.5
4814925841,0,11,13,0,3,8,2,0,0,0,0,14549,6.4,15952,120,52,-1490,-1854,17.2,1454.9,31,1,1,8,3,5,0,0,0,0,16039,7.0,17806,167,48,1490,1854,21.5,1603.9
4738533616,0,106,0,0,5,5,0,0,0,0,0,14523,6.6,16935,155,56,899,1987,21.1,1452.3,8,0,1,5,5,2,0,0,0,0,13624,6.4,14948,149,24,-899,-1987,17.3,1362.4
4738241304,1,64,4,0,1,3,0,1,0,1,0,13752,6.8,18361,191,56,-1773,741,24.7,1375.2,24,0,1,3,1,4,0,0,0,0,15525,6.8,17620,205,48,1773,-741,25.3,1552.5
4736755547,0,11,0,1,1,2,0,0,0,0,0,12241,6.4,16015,135,32,-2391,-1282,16.7,1224.1,10,2,0,1,0,1,0,0,0,0,14632,7.0,17297,195,52,2391,1282,24.7,1463.2
4736149270,0,10,0,1,7,4,11,0,0,0,0,15625,6.8,17948,179,40,1565,2711,21.9,1562.5,14,0,0,4,7,3,1,1,0,0,14060,6.2,15237,135,60,-1565,-2711,19.5,1406.0
4736129717,0,13,2,0,3,4,3,0,0,0,0,14521,6.4,16738,202,48,-1616,-835,25.0,1452.1,19,2,1,4,3,4,0,0,0,0,16137,6.6,17573,214,56,1616,835,27.0,1613.7
4733780628,0,13,0,0,0,7,0,0,0,0,0,13283,6.4,15779,147,44,-2349,-2938,19.1,1328.3,12,1,1,7,0,0,1,1,0,0,15632,7.4,18717,163,64,2349,2938,22.7,1563.2
4732672656,1,20,0,0,4,4,4,1,1,0,0,14579,6.6,16590,150,52,-1332,-772,20.2,1457.9,10,0,1,4,4,3,0,0,0,0,15911,6.8,17362,183,51,1332,772,23.4,1591.1
4731544040,0,2,0,0,2,4,0,0,0,0,0,12180,6.4,15867,133,28,-2520,40,16.1,1218.0,9,0,1,4,2,0,0,0,0,0,14700,6.4,15827,160,32,2520,-40,19.2,1470.0
4731470360,0,14,1,0,1,3,1,0,0,0,0,13083,6.2,15702,114,59,-715,-1740,17.3,1308.3,11,0,1,3,1,1,1,1,0,0,13798,6.8,17442,134,52,715,1740,18.6,1379.8
4730888289,0,9,2,0,4,7,4,0,0,0,0,14722,6.8,16868,175,36,-2002,-360,21.1,1472.2,21,2,1,7,4,5,1,0,1,0,16724,7.0,17228,174,40,2002,360,21.4,1672.4
4730854576,0,106,2,0,4,2,5,0,0,0,0,14294,6.6,16643,158,44,33,-666,20.2,1429.4,7,1,1,2,4,1,0,0,0,0,14261,6.6,17309,179,48,-33,666,22.7,1426.1
4730809064,0,12,1,1,1,4,0,0,0,0,0,12224,6.4,16176,128,56,-4081,-2052,18.4,1222.4,19,1,0,4,1,3,1,1,0,0,16305,7.0,18228,185,48,4081,2052,23.3,1630.5
4730782385,0,65,1,0,0,3,0,0,0,0,0,13350,6.6,16937,187,56,-1127,-1154,24.3,1335.0,20,2,1,3,0,4,0,0,0,0,14477,6.8,18091,171,48,1127,1154,21.9,1447.7
4729309192,1,12,0,0,3,1,3,0,0,0,0,14115,6.8,17040,167,36,-435,-499,20.3,1411.5,12,0,1,1,3,0,1,0,1,0,14550,7.0,17539,154,64,435,499,21.8,1455.0
4844248750,1,8,0,1,7,3,6,0,0,0,0,16764,7.2,18818,200,54,2255,904,25.4,1676.4,5,0,0,3,7,2,0,0,0,0,14509,6.8,17914,150,64,-2255,-904,21.4,1450.9
4835063511,0,11,0,0,5,11,6,0,0,0,0,16061,6.6,16557,168,38,-2046,-2558,20.6,1606.1,78,1,1,11,5,11,1,1,0,0,18107,7.2,19115,187,57,2046,2558,24.4,1810.7
4816207143,1,11,1,1,2,3,1,0,0,0,0,13850,6.8,17870,189,56,41,1649,24.5,1385.0,15,2,0,3,2,3,1,1,0,0,13809,6.6,16221,165,44,-41,-1649,20.9,1380.9
4816158396,0,12,0,0,2,8,2,0,0,0,0,13544,6.6,16342,144,56,-4256,-2343,20.0,1354.4,15,0,1,8,2,11,1,1,0,0,17800,7.0,18685,242,48,4256,2343,29.0,1780.0
4812978689,0,13,0,0,3,3,1,0,0,0,0,14105,6.4,16813,173,40,-202,230,21.3,1410.5,15,0,1,3,3,0,2,1,1,0,14307,6.6,16583,194,36,202,-230,23.0,1430.7
4812232113,0,14,0,1,4,2,7,1,1,0,0,14117,6.8,16632,161,56,22,-549,21.7,1411.7,12,2,0,2,4,1,0,0,0,0,14095,6.6,17181,189,52,-22,549,24.1,1409.5
4811195524,1,80,1,0,4,5,5,1,0,1,0,14594,6.6,15958,154,40,774,569,19.4,1459.4,28,0,1,5,4,5,0,0,0,0,13820,6.2,15389,137,48,-774,-569,18.5,1382.0
4810389925,0,14,1,0,4,7,3,0,0,0,0,14755,6.6,17005,160,56,-1888,-1992,21.6,1475.5,69,1,1,7,4,5,1,1,0,0,16643,7.0,18997,189,70,1888,1992,25.9,1664.3
4810358822,1,69,0,1,4,0,1,0,0,0,0,16199,7.2,19081,188,76,2906,2674,26.4,1619.9,16,1,0,0,4,0,0,0,0,0,13293,6.6,16407,175,44,-2906,-2674,21.9,1329.3
4807491828,1,9,1,1,7,3,4,0,0,0,0,17306,7.2,18901,205,72,2894,2673,27.7,1730.6,13,1,0,3,7,3,1,1,0,0,14412,6.4,16228,150,56,-2894,-2673,20.6,1441.2
4807411590,1,25,0,1,7,4,6,0,0,0,0,17165,6.8,17107,171,47,2990,478,21.8,1716.5,18,1,0,4,7,1,0,0,0,0,14175,6.8,16629,150,55,-2990,-478,20.5,1417.5
4782491542,0,9,1,1,5,14,4,0,0,0,0,14360,6.4,15342,171,48,-5674,-4240,21.9,1436.0,14,0,0,14,5,8,0,0,0,0,20034,7.2,19582,214,48,5674,4240,26.2,2003.4
4778134005,0,10,0,0,4,8,3,0,0,0,0,14237,6.6,16511,154,36,-3253,-2269,19.0,1423.7,46,0,1,8,4,5,1,1,0,0,17490,7.2,18780,213,60,3253,2269,27.3,1749.0
4778088487,0,13,1,0,3,6,3,0,0,0,0,15046,6.6,17469,188,51,-1274,-1153,23.9,1504.6,11,1,1,6,3,5,0,0,0,0,16320,7.2,18622,180,48,1274,1153,22.8,1632.0
4778058168,0,4,0,1,4,5,0,0,0,0,0,13613,6.6,16501,144,40,-4586,-3351,18.4,1361.3,6,0,0,5,4,4,0,0,0,0,18199,7.4,19852,215,60,4586,3351,27.5,1819.9
4778007715,0,50,0,0,3,6,2,0,0,0,0,15057,6.8,18030,206,52,-727,220,25.8,1505.7,13,2,1,6,3,6,1,1,0,0,15784,7.0,17810,180,48,727,-220,22.8,1578.4
4775057814,0,199,0,0,3,5,0,0,0,0,0,13814,6.6,17292,160,48,-2504,-1176,20.8,1381.4,7,0,1,5,3,4,0,0,0,0,16318,7.0,18468,187,68,2504,1176,25.5,1631.8
4772361174,1,12,2,1,1,1,1,0,0,0,0,13952,6.4,16804,180,44,-592,-310,22.4,1395.2,14,2,0,1,1,1,0,0,0,0,14544,6.8,17114,201,48,592,310,24.9,1454.4
4772285376,0,11,0,1,5,5,2,0,0,0,0,16055,6.6,17403,160,60,-851,-394,22.0,1605.5,13,0,0,5,5,2,0,0,0,0,16906,6.8,17797,163,48,851,394,21.1,1690.6
4765414676,1,77,1,0,8,2,7,0,0,0,0,17461,7.0,18000,204,56,4164,812,26.0,1746.1,10,2,1,2,8,1,0,0,0,0,13297,7.0,17188,174,44,-4164,-812,21.8,1329.7
4836919252,0,0,2,0,17,25,53,0,0,0,1,34777,10.8,37579,108,0,-4053,-3924,10.8,3477.7,6,0,1,25,17,91,0,0,0,0,38830,11.2,41503,104,0,4053,3924,10.4,3883.0
4836611145,0,88,0,0,29,27,81,0,0,0,1,38203,11.2,40893,111,0,626,-167,11.1,3820.3,0,0,1,27,29,64,0,0,0,0,37577,11.2,41060,106,0,-626,167,10.6,3757.7
4836594816,1,0,0,1,30,22,74,0,0,0,1,40279,11.2,42272,109,0,3426,2333,10.9,4027.9,0,0,0,22,30,50,0,0,0,0,36853,10.8,39939,85,0,-3426,-2333,8.5,3685.3
4836305631,0,0,0,1,25,27,42,0,0,0,1,36054,11.2,40055,104,0,-4069,-4114,10.4,3605.4,0,0,0,27,25,61,0,0,0,0,40123,11.8,44169,116,0,4069,4114,11.6,4012.3
4836304094,1,1,0,0,18,24,37,0,0,0,2,34399,10.2,35436,95,0,-4134,-6354,9.5,3439.9,24,0,1,24,18,57,0,0,0,0,38533,11.2,41790,109,0,4134,6354,10.9,3853.3
4836293275,1,0,0,1,20,20,50,0,0,0,1,37822,10.8,39508,101,0,2150,1459,10.1,3782.2,0,0,0,20,20,35,0,0,0,0,35672,11.0,38049,95,0,-2150,-1459,9.5,3567.2
4836280489,0,6,0,1,22,19,51,0,0,0,1,36521,11.0,40265,92,0,-493,-266,9.2,3652.1,0,0,0,19,22,42,0,0,0,0,37014,11.2,40531,99,0,493,266,9.9,3701.4
4836269486,0,0,0,0,8,18,17,0,0,0,0,31759,9.8,32795,81,0,-3048,-4632,8.1,3175.9,0,0,1,18,8,51,0,0,0,0,34807,10.6,37427,82,0,3048,4632,8.2,3480.7
4834371854,1,22,0,1,21,19,62,0,0,0,1,38637,11.4,40828,111,0,3206,3050,11.1,3863.7,0,2,0,19,21,34,0,0,0,0,35431,10.6,37778,99,0,-3206,-3050,9.9,3543.1
4834357585,1,77,0,0,26,18,70,0,0,0,1,38108,11.2,41619,109,0,4076,4399,10.9,3810.8,0,0,1,18,26,45,0,0,0,0,34032,10.8,37220,70,0,-4076,-4399,7.0,3403.2
4834347102,1,13,0,0,16,23,29,0,0,0,0,35037,11.0,38747,100,0,135,556,10.0,3503.7,0,4,1,23,16,63,0,0,0,0,34902,10.6,38191,93,0,-135,-556,9.3,3490.2
4833411035,0,18,0,1,18,21,37,0,0,0,1,35934,11.0,39304,110,0,-1316,-80,11.0,3593.4,0,1,0,21,18,56,0,0,0,0,37250,11.0,39384,118,0,1316,80,11.8,3725.0
4833392988,0,0,0,0,21,31,46,0,0,0,0,36614,11.4,41779,98,0,-2020,-2620,9.8,3661.4,0,0,1,31,21,75,0,0,0,0,38634,11.8,44399,99,0,2020,2620,9.9,3863.4
4833378500,0,0,0,0,25,31,56,0,0,0,0,37378,11.6,43029,92,0,-2770,-1333,9.2,3737.8,0,0,1,31,25,77,0,0,0,0,40148,11.8,44362,98,0,2770,1333,9.8,4014.8
4832494317,1,13,0,1,28,27,67,0,0,0,2,38291,11.0,41115,114,0,874,-588,11.4,3829.1,0,0,0,27,28,54,0,0,0,0,37417,11.2,41703,85,0,-874,588,8.5,3741.7
4832489478,0,0,0,0,27,32,64,0,0,0,1,38498,11.6,44052,90,0,-2732,-1162,9.0,3849.8,3,0,1,32,27,80,0,0,0,0,41230,12.0,45214,103,0,2732,1162,10.3,4123.0
4832483602,0,0,20,0,11,22,24,0,0,0,0,33749,10.6,36135,98,0,-1471,-2601,9.8,3374.9,22,0,1,22,11,56,0,0,0,0,35220,10.8,38736,118,0,1471,2601,11.8,3522.0
4832482109,0,0,0,0,22,26,63,0,0,0,1,36598,11.2,40907,96,0,-43,-97,9.6,3659.8,0,0,1,26,22,55,0,0,0,0,36641,11.2,41004,88,0,43,97,8.8,3664.1
4832476802,1,22,0,0,33,35,83,0,0,0,1,41614,11.8,44700,97,0,930,-2377,9.7,4161.4,0,20,1,35,33,93,0,0,0,0,40684,12.0,47077,85,0,-930,2377,8.5,4068.4
4857482865,1,0,0,0,18,15,16,0,0,0,0,45250,10.0,47500,0,0,16700,19000,0.0,4525.0,0,0,1,11,14,11,0,0,0,0,28550,6.0,28500,0,0,-16700,-19000,0.0,2855.0
4857456107,1,0,0,0,9,17,13,0,0,0,0,44200,10.0,47500,0,0,16000,19000,0.0,4420.0,0,0,1,13,5,10,0,0,0,0,28200,6.0,28500,0,0,-16000,-19000,0.0,2820.0
4857429685,1,0,0,1,9,19,12,0,0,0,0,52000,12.0,55000,1,0,18450,22000,0.1,5200.0,0,0,0,15,5,13,0,0,0,0,33550,7.2,33000,0,0,-18450,-22000,0.0,3355.0
4857399166,1,144,0,0,16,18,15,0,0,0,0,49256,12.0,55000,0,0,20688,22000,0.0,4925.6,0,0,1,11,9,10,0,0,0,0,28568,7.2,33000,0,0,-20688,-22000,0.0,2856.8
4857067091,1,26,2,0,18,20,14,0,0,0,0,48585,10.0,47500,5,0,18180,19000,0.5,4858.5,0,0,1,12,10,14,0,0,0,0,30405,6.0,28500,1,0,-18180,-19000,0.1,3040.5
4857012548,1,0,0,1,20,18,13,0,0,0,0,60956,12.0,55000,1,0,23406,22000,0.1,6095.6,0,0,0,8,10,16,0,0,0,0,37550,7.2,33000,5,0,-23406,-22000,0.5,3755.0
4856996440,1,4,0,1,19,13,11,0,0,0,0,46388,10.0,47500,0,0,17889,19000,0.0,4638.8,91,0,0,5,11,13,0,0,0,0,28499,6.0,28500,0,0,-17889,-19000,0.0,2849.9
4856981282,1,0,0,0,18,15,14,0,0,0,0,48110,10.0,47500,0,0,18845,19000,0.0,4811.0,0,0,1,9,12,12,0,0,0,0,29265,6.0,28500,0,0,-18845,-19000,0.0,2926.5
4856961403,1,2,0,1,10,19,10,0,0,0,0,44200,10.4,49000,0,0,14600,20500,0.0,4420.0,21,0,0,14,5,13,0,0,0,0,29600,6.0,28500,0,0,-14600,-20500,0.0,2960.0
4856946297,1,80,0,0,14,18,12,0,0,0,0,58236,12.0,55000,0,0,23702,22000,0.0,5823.6,0,0,1,11,7,12,0,0,0,0,34534,7.2,33000,1,0,-23702,-22000,0.1,3453.4
4856294947,1,6,0,1,15,17,21,0,0,0,0,61650,12.0,55000,0,0,24800,22000,0.0,6165.0,0,0,0,11,9,6,0,0,0,0,36850,7.2,33000,0,0,-24800,-22000,0.0,3685.0
4856260713,1,0,0,0,11,19,11,0,0,0,0,59900,12.4,57000,0,0,21275,24000,0.0,5990.0,4,0,1,12,4,14,0,0,0,0,38625,7.2,33000,1,0,-21275,-24000,0.1,3862.5
4856247980,1,31,1,1,18,18,18,0,0,0,0,54930,12.0,55000,3,0,21715,22000,0.3,5493.0,37,2,0,10,10,10,0,0,0,0,33215,7.2,33000,6,0,-21715,-22000,0.6,3321.5
4855298957,1,0,0,1,21,15,17,0,0,0,0,47000,10.2,48680,0,0,20200,20180,0.0,4700.0,2,0,0,5,11,7,0,0,0,0,26800,6.0,28500,0,0,-20200,-20180,0.0,2680.0
4855277966,1,8,0,1,16,21,14,0,0,0,0,60600,12.0,55000,0,0,21300,22000,0.0,6060.0,5,0,0,15,10,17,0,0,0,0,39300,7.2,33000,0,0,-21300,-22000,0.0,3930.0
4855248313,1,0,0,1,19,16,18,0,0,0,0,62796,12.0,55000,0,0,26281,18000,0.0,6279.6,0,0,0,9,12,5,0,0,0,0,36515,8.0,37000,0,0,-26281,-18000,0.0,3651.5
4855219613,1,0,0,1,22,21,20,0,0,0,0,63400,12.0,55000,7,0,26200,22000,0.7,6340.0,0,0,0,9,10,10,0,0,0,0,37200,7.2,33000,7,0,-26200,-22000,0.7,3720.0
4855202054,1,40,0,1,20,23,18,0,0,0,0,62350,13.0,62500,0,0,22700,25000,0.0,6235.0,11,0,0,14,11,15,0,0,0,0,39650,7.8,37500,0,0,-22700,-25000,0.0,3965.0
4855179181,1,5,0,1,22,9,23,0,0,0,0,64350,12.0,55000,0,0,29600,22000,0.0,6435.0,0,0,0,3,16,3,0,0,0,0,34750,7.2,33000,0,0,-29600,-22000,0.0,3475.0
4855146740,1,379,0,1,16,15,16,0,0,0,0,45966,10.0,47500,0,0,19506,19000,0.0,4596.6,0,0,0,8,9,7,0,0,0,0,26460,6.0,28500,0,0,-19506,-19000,0.0,2646.0
4857027174,1,10,1,0,6,10,4,0,0,0,0,16125,6.8,17271,176,40,-1925,-740,21.6,1612.5,177,1,1,10,6,7,0,0,0,0,18050,6.8,18011,162,48,1925,740,21.0,1805.0
4856440421,1,12,0,0,5,6,3,0,0,0,0,16108,7.0,17335,221,44,-156,-153,26.5,1610.8,14,0,1,6,5,9,0,0,0,0,16264,6.8,17488,164,59,156,153,22.3,1626.4
4856406406,0,14,0,0,2,5,2,1,1,0,0,13107,6.4,16734,170,36,-3089,-1625,20.6,1310.7,159,1,1,5,2,5,0,0,0,0,16196,7.2,18359,204,44,3089,1625,24.8,1619.6
4856357756,1,14,0,0,7,8,1,0,0,0,0,16498,6.8,18198,192,55,1768,1748,24.7,1649.8,12,0,1,8,7,7,0,0,0,0,14730,6.6,16450,124,44,-1768,-1748,16.8,1473.0
4856293494,0,114,0,1,2,3,2,1,1,0,0,15431,6.8,18355,172,56,846,1148,22.8,1543.1,12,0,0,3,2,3,0,0,0,0,14585,7.0,17207,148,60,-846,-1148,20.8,1458.5
4856245305,0,9,0,0,8,7,5,0,0,0,0,15601,7.0,17550,153,56,-147,-180,20.9,1560.1,17,0,1,6,7,7,1,1,0,0,15748,6.8,17730,175,48,147,180,22.3,1574.8
4856207527,0,11,0,1,5,5,1,1,1,0,0,14522,6.6,16776,164,60,293,230,22.4,1452.2,18,0,0,5,5,2,0,0,0,0,14229,6.4,16546,152,40,-293,-230,19.2,1422.9
4856143837,0,5,0,0,1,6,1,0,0,0,0,14037,6.8,17533,166,60,-1795,-720,22.6,1403.7,22,0,1,6,1,5,1,1,0,0,15832,6.8,18253,184,56,1795,720,24.0,1583.2
4856096462,1,11,0,0,1,4,0,0,0,0,0,13635,6.8,17300,171,62,-1847,-741,23.3,1363.5,9,2,1,4,1,4,0,0,0,0,15482,6.8,18041,154,54,1847,741,20.8,1548.2
4856039291,0,120,1,0,4,4,3,0,0,0,0,14876,6.8,16560,190,30,815,-1050,22.0,1487.6,12,0,1,4,4,2,1,1,0,0,14061,7.0,17610,159,58,-815,1050,21.7,1406.1
4856013158,0,14,0,0,3,8,3,0,0,0,0,13731,6.8,16899,180,48,-3131,-1938,22.8,1373.1,8,1,1,8,3,5,1,1,0,0,16862,7.0,18837,170,60,3131,1938,23.0,1686.2
4855961978,0,238,1,1,3,2,5,1,1,0,0,14854,6.6,17150,181,48,90,-609,22.9,1485.4,11,0,0,2,3,2,0,0,0,0,14764,7.0,17759,212,52,-90,609,26.4,1476.4
4855369034,1,17,2,1,10,1,12,1,1,0,0,17718,7.0,17944,222,44,4842,2443,26.6,1771.8,14,5,0,1,10,1,1,0,1,0,12876,6.2,15501,153,40,-4842,-2443,19.3,1287.6
4855329919,1,136,0,0,7,10,10,0,0,0,0,16068,6.2,15297,159,40,-1521,-1146,19.9,1606.8,16,0,1,10,7,11,1,1,0,0,17589,6.6,16443,143,60,1521,1146,20.3,1758.9
4855294100,1,24,0,1,12,5,16,1,1,0,0,18331,7.0,18228,173,61,4448,2992,23.4,1833.1,13,0,0,5,12,5,0,0,0,0,13883,6.2,15236,158,32,-4448,-2992,19.0,1388.3
4855121403,0,13,2,1,9,4,9,0,0,0,0,17713,6.8,17404,173,47,3076,1097,22.0,1771.3,249,1,0,4,9,0,1,1,0,0,14637,6.4,16307,181,56,-3076,-1097,23.7,1463.7
4855063576,0,32,2,0,2,8,1,0,0,0,0,13569,6.6,16643,180,38,-2855,-1685,21.8,1356.9,29,1,1,8,2,6,0,0,0,0,16424,7.0,18328,185,53,2855,1685,23.8,1642.4
4855004047,0,16,0,1,6,1,10,2,1,1,0,15902,6.6,15566,138,80,1544,-706,21.8,1590.2,12,0,0,1,6,0,0,0,0,0,14358,6.4,16272,207,40,-1544,706,24.7,1435.8
4854052985,0,14,3,1,4,4,5,0,0,0,0,16552,6.8,17956,216,56,1803,367,27.2,1655.2,12,2,0,4,4,1,0,0,0,0,14749,6.8,17589,216,44,-1803,-367,26.0,1474.9
4857339773,0,124,2,1,1,0,1,1,0,1,0,14458,7.0,17913,192,60,920,-29,25.2,1445.8,17,3,0,0,1,0,0,0,0,0,13538,6.8,17942,200,60,-920,29,26.0,1353.8
4856277101,0,16,0,1,3,1,5,1,1,0,0,14969,7.0,18855,186,60,1420,451,24.6,1496.9,9,1,0,1,3,1,0,0,0,0,13549,6.8,18404,197,56,-1420,-451,25.3,1354.9
4856225788,0,10,2,1,4,4,6,0,0,0,0,14603,6.8,16944,174,44,193,-830,21.8,1460.3,12,0,0,4,4,2,0,0,0,0,14410,6.8,17774,184,52,-193,830,23.6,1441.0
4856111782,0,16,0,0,3,1,1,1,1,0,0,14856,7.0,18853,218,56,873,1073,27.4,1485.6,7,1,1,1,3,2,0,0,0,0,13983,6.8,17780,207,64,-873,-1073,27.1,1398.3
4852842724,0,11,1,1,5,3,4,0,0,0,0,14850,6.6,17311,178,32,494,816,21.0,1485.0,11,2,0,3,5,3,0,0,0,0,14356,6.8,16495,172,44,-494,-816,21.6,1435.6
4852790462,1,51,0,1,10,2,3,0,0,0,0,16710,7.2,19233,176,56,2770,3519,23.2,1671.0,11,0,0,2,10,2,0,0,0,0,13940,6.2,15714,184,48,-2770,-3519,23.2,1394.0
4852494899,0,15,1,0,2,2,0,0,0,0,0,13808,6.8,16354,161,40,137,-365,20.1,1380.8,14,1,1,2,2,1,1,1,0,0,13671,6.6,16719,166,48,-137,365,21.4,1367.1
4852473815,0,11,2,0,5,10,4,0,0,0,0,14391,6.6,16367,134,48,-2698,-675,18.2,1439.1,188,2,1,10,5,8,0,0,0,0,17089,6.8,17042,191,55,2698,675,24.6,1708.9
4851698619,1,52,2,1,12,3,14,1,1,0,0,19721,7.2,19019,186,60,5070,3655,24.6,1972.1,15,1,0,3,12,4,0,0,0,0,14651,6.4,15364,145,48,-5070,-3655,19.3,1465.1
4850914619,0,11,1,1,7,2,6,1,1,0,0,15144,6.6,16253,158,40,937,-1227,19.8,1514.4,11,2,0,2,7,1,0,0,0,0,14207,6.8,17480,194,56,-937,1227,25.0,1420.7
4850875989,0,16,2,1,7,7,5,0,0,0,0,16341,6.6,17186,156,52,1320,1230,20.8,1634.1,13,3,0,7,7,3,1,1,0,0,15021,6.4,15956,176,48,-1320,-1230,22.4,1502.1
4850804872,0,9,1,0,2,3,1,0,0,0,0,14165,7.0,18181,177,44,-1457,-324,22.1,1416.5,9,0,1,3,2,1,1,1,0,0,15622,7.2,18505,201,60,1457,324,26.1,1562.2
4850759790,0,12,2,0,2,1,2,1,1,0,0,14744,7.0,17796,208,52,348,76,26.0,1474.4,12,3,1,1,2,1,0,0,0,0,14396,7.0,17720,177,52,-348,-76,22.9,1439.6
4838343423,1,16,0,0,3,6,1,0,0,0,0,15632,7.0,18063,204,67,106,1297,27.1,1563.2,10,1,1,6,3,4,0,0,0,0,15526,6.6,16766,182,44,-106,-1297,22.6,1552.6
4838070086,1,13,1,1,5,2,3,1,1,0,0,16647,6.8,17841,176,48,2749,2154,22.4,1664.7,10,0,0,2,5,2,0,0,0,0,13898,6.2,15687,174,48,-2749,-2154,22.2,1389.8
4838035184,1,14,1,1,11,5,10,1,1,0,0,17870,7.2,18670,174,62,2335,3380,23.6,1787.0,10,2,0,5,11,3,0,0,0,0,15535,6.4,15290,171,39,-2335,-3380,21.0,1553.5
4837099998,1,9,2,1,6,5,4,0,0,0,0,17216,7.0,18060,195,48,1486,882,24.3,1721.6,10,0,0,5,6,3,0,0,0,0,15730,6.8,17178,182,60,-1486,-882,24.2,1573.0
4834128072,1,11,0,1,4,5,3,1,1,0,0,14442,6.2,14591,172,40,553,-905,21.2,1444.2,12,0,0,5,4,4,0,0,0,0,13889,6.4,15496,151,48,-553,905,19.9,1388.9
4834080289,1,150,1,1,5,3,4,1,1,0,0,15271,6.6,17638,164,60,242,256,22.4,1527.1,14,0,0,3,5,2,0,0,0,0,15029,6.8,17382,195,51,-242,-256,24.6,1502.9
4855309448,0,15,1,0,11,12,9,0,0,0,0,19224,6.6,15968,161,46,1242,-1753,20.7,1922.4,13,0,1,12,11,9,1,1,0,0,17982,6.8,17721,136,60,-1242,1753,19.6,1798.2
4855274950,0,17,8,1,8,6,4,0,0,0,0,15981,6.8,16857,137,40,-323,-1145,17.7,1598.1,34,0,0,6,8,5,0,0,0,0,16304,7.2,18002,155,48,323,1145,20.3,1630.4
4855248108,1,0,0,1,18,20,20,0,0,0,0,64100,12.0,55000,0,0,26900,21000,0.0,6410.0,0,0,0,14,12,11,0,0,0,0,37200,7.4,34000,0,0,-26900,-21000,0.0,3720.0
4855214757,1,0,0,0,17,17,25,0,0,0,0,62700,12.0,55000,0,0,24800,18000,0.0,6270.0,0,0,1,14,14,6,0,0,0,0,37900,8.0,37000,0,0,-24800,-18000,0.0,3790.0
4855177511,1,0,0,0,19,17,21,0,0,0,0,48850,10.0,47500,2,0,20100,19000,0.2,4885.0,31,0,1,10,12,9,0,0,0,0,28750,6.0,28500,4,0,-20100,-19000,0.4,2875.0
4855155386,1,0,0,1,22,18,17,0,0,0,0,48400,10.0,47500,0,0,20200,19000,0.0,4840.0,0,0,0,8,12,9,0,0,0,0,28200,6.0,28500,0,0,-20200,-19000,0.0,2820.0
4854954880,1,13,0,1,10,4,7,1,0,1,0,17348,7.2,18089,162,56,2242,1997,21.8,1734.8,16,2,0,4,10,3,0,0,0,0,15106,6.6,16092,147,36,-2242,-1997,18.3,1510.6
4854927016,0,6,0,0,3,12,2,0,0,0,0,13680,6.4,15776,161,42,-5091,-2630,20.3,1368.0,11,0,1,12,3,7,0,0,0,0,18771,7.0,18406,142,54,5091,2630,19.6,1877.1
4851839706,1,78,2,0,9,12,7,0,0,0,0,17692,7.0,17974,184,36,1596,1054,22.0,1769.2,18,3,1,11,8,6,0,0,0,0,16096,6.8,16920,122,48,-1596,-1054,17.0,1609.6
4851794452,0,14,2,1,7,6,9,0,0,0,0,16746,6.6,16822,164,48,464,-1031,21.2,1674.6,10,0,0,6,7,2,0,0,0,0,16282,7.0,17853,182,44,-464,1031,22.6,1628.2
4851724638,0,18,13,0,1,4,1,0,0,0,0,13047,6.6,16519,165,64,-2024,-1597,22.9,1304.7,30,1,1,4,1,3,0,0,0,0,15071,7.0,18116,198,48,2024,1597,24.6,1507.1
4851047948,1,17,1,0,6,10,6,0,0,0,0,16343,6.6,16548,171,48,-982,-2013,21.9,1634.3,12,3,1,10,6,3,0,0,0,0,17325,7.0,18561,210,48,982,2013,25.8,1732.5
4850984902,1,14,0,1,7,5,8,1,1,0,0,15533,6.8,16668,139,44,-1303,-1837,18.3,1553.3,203,1,0,5,7,1,0,0,0,0,16836,7.0,18505,204,56,1303,1837,26.0,1683.6
4850954117,1,13,1,1,8,9,6,1,1,0,0,17999,6.4,16721,195,47,1225,266,24.2,1799.9,12,0,0,9,8,8,1,0,1,0,16774,6.4,16455,139,44,-1225,-266,18.3,1677.4
4850585650,0,114,0,1,5,3,2,0,0,0,0,13956,6.4,16109,130,44,-2677,-1971,17.4,1395.6,9,0,0,3,5,0,0,0,0,0,16633,7.0,18080,186,48,2677,1971,23.4,1663.3
4850571891,0,133,1,0,1,4,0,1,1,0,0,13542,6.6,17158,164,48,-1729,-1781,21.2,1354.2,12,7,1,4,1,2,0,0,0,0,15271,7.2,18939,157,68,1729,1781,22.5,1527.1
4849703280,1,12,0,0,5,5,4,0,0,0,0,16220,6.8,18792,187,56,1757,1881,24.3,1622.0,11,0,1,5,5,2,0,0,0,0,14463,6.6,16911,167,43,-1757,-1881,21.0,1446.3
4849654637,0,10,0,0,2,5,2,0,0,0,0,13744,6.8,17571,179,44,-1977,-396,22.3,1374.4,8,0,1,5,2,3,0,0,0,0,15721,6.8,17967,169,60,1977,396,22.9,1572.1
4849405867,1,17,0,0,7,3,6,1,1,0,0,15495,6.4,16631,148,60,1135,-7,20.8,1549.5,72,1,1,3,7,4,0,0,0,0,14360,6.4,16638,184,36,-1135,7,22.0,1436.0
4855783270,0,0,0,0,17,23,49,0,0,0,0,34211,10.4,37014,97,0,-4038,-4301,9.7,3421.1,0,0,1,23,17,60,0,0,0,0,38249,11.2,41315,110,0,4038,4301,11.0,3824.9
4853630879,1,113,0,1,21,23,56,0,0,0,0,32998,10.6,37443,53,0,-3134,-1208,5.3,3299.8,0,0,0,23,21,61,0,0,0,0,36132,10.8,38651,92,0,3134,1208,9.2,3613.2
4853614210,0,38,0,0,18,21,41,0,0,0,0,36782,11.0,39343,106,0,-923,95,10.6,3678.2,0,23,1,21,18,44,0,0,0,0,37705,11.2,39248,96,0,923,-95,9.6,3770.5
4853596221,0,0,0,0,7,22,9,0,0,0,1,33852,10.6,36193,107,0,-1462,-2145,10.7,3385.2,0,0,1,22,7,59,0,0,0,0,35314,11.0,38338,110,0,1462,2145,11.0,3531.4
4852579968,1,0,0,0,23,25,68,0,0,0,0,37566,11.4,41490,94,0,-27,1252,9.4,3756.6,0,0,1,25,23,72,0,0,0,0,37593,11.2,40238,85,0,27,-1252,8.5,3759.3
4852550590,1,0,0,0,12,7,26,0,0,0,0,32672,10.2,35001,95,0,1225,2571,9.5,3267.2,0,0,1,7,12,13,0,0,0,0,31447,10.0,32430,110,0,-1225,-2571,11.0,3144.7
4852535343,0,0,0,0,25,21,45,0,0,0,1,37101,11.2,42144,94,0,2144,4313,9.4,3710.1,0,0,1,21,25,48,0,0,0,0,34957,10.6,37831,85,0,-2144,-4313,8.5,3495.7
4851490612,0,0,0,0,24,42,49,0,0,0,2,38322,11.8,43395,106,0,-3894,-3054,10.6,3832.2,20,0,1,42,24,108,0,0,0,0,42216,12.0,46449,100,0,3894,3054,10.0,4221.6
4850557390,1,0,0,0,26,21,66,0,0,0,1,37263,11.6,41760,103,0,1983,2839,10.3,3726.3,0,0,1,21,26,58,0,0,0,0,35280,10.8,38921,88,0,-1983,-2839,8.8,3528.0
4849701245,0,15,0,0,23,27,58,0,0,0,0,36456,11.2,39749,99,0,129,-470,9.9,3645.6,0,2,1,27,23,65,0,0,0,0,36327,10.8,40219,98,0,-129,470,9.8,3632.7
4849690745,1,14,0,0,20,16,56,0,0,0,1,36571,10.8,39412,103,0,3350,4087,10.3,3657.1,0,0,1,16,20,40,0,0,0,0,33221,10.2,35325,90,0,-3350,-4087,9.0,3322.1
4849670742,0,34,0,1,25,25,73,0,0,0,0,36639,11.2,41441,98,0,-287,178,9.8,3663.9,34,0,0,25,25,64,0,0,0,0,36926,11.4,41263,105,0,287,-178,10.5,3692.6
4849647295,0,0,0,1,24,31,56,0,0,0,0,36970,11.2,41648,105,0,-1071,-2077,10.5,3697.0,0,0,0,31,24,87,0,0,0,0,38041,11.6,43725,80,0,1071,2077,8.0,3804.1
4845723221,1,0,0,1,23,23,39,0,0,0,0,35190,10.8,39038,112,0,-389,582,11.2,3519.0,0,0,0,23,23,56,0,0,0,0,35579,10.8,38456,86,0,389,-582,8.6,3557.9
4845712064,1,0,0,0,28,27,78,0,0,0,1,38486,11.0,41068,104,0,1287,-829,10.4,3848.6,0,0,1,27,28,62,0,0,0,0,37199,11.4,41897,89,0,-1287,829,8.9,3719.9
4841751515,1,77,0,0,26,32,68,0,0,0,0,38665,11.6,43524,102,0,345,-890,10.2,3866.5,0,0,1,32,26,64,0,0,0,0,38320,11.6,44414,86,0,-345,890,8.6,3832.0
4839623584,0,0,0,1,17,30,43,0,0,0,1,35922,10.8,39441,117,0,-3808,-5277,11.7,3592.2,139,0,0,30,17,70,0,0,0,0,39730,11.8,44718,95,0,3808,5277,9.5,3973.0
4838904402,1,3,0,1,27,24,84,0,0,0,1,38607,11.6,43791,101,0,2818,4456,10.1,3860.7,0,0,0,24,27,74,0,0,0,0,35789,11.0,39335,87,0,-2818,-4456,8.7,3578.9
4836706603,1,16,0,1,17,10,50,0,0,0,1,37737,10.8,39246,113,0,5269,3466,11.3,3773.7,29,3,0,10,17,28,0,0,0,0,32468,10.6,35780,85,0,-5269,-3466,8.5,3246.8
4836694092,1,84,5,1,23,35,57,0,0,0,1,36825,11.2,40115,114,0,-2897,-4746,11.4,3682.5,15,3,0,35,23,84,0,0,0,0,39722,11.8,44861,91,0,2897,4746,9.1,3972.2
4843174704,0,10,9,0,4,8,5,0,0,0,0,14651,6.4,15474,171,40,-2157,-2926,21.1,1465.1,29,0,1,8,4,4,0,0,0,0,16808,7.0,18400,206,52,2157,2926,25.8,1680.8
4843146142,1,9,0,0,5,3,6,1,1,0,0,15858,7.0,18298,191,52,394,1096,24.3,1585.8,11,0,1,3,5,2,0,0,0,0,15464,6.6,17202,212,51,-394,-1096,26.3,1546.4
4820746973,0,0,0,0,17,26,35,0,0,0,1,37491,10.8,39534,107,0,-151,123,10.7,3749.1,0,0,1,26,17,70,0,0,0,0,37642,10.8,39411,90,0,151,-123,9.0,3764.2
4813976742,0,9,1,1,4,6,1,0,0,0,0,15333,7.2,18759,226,60,-140,844,28.6,1533.3,11,0,0,5,3,7,0,0,0,0,15473,6.8,17915,201,52,140,-844,25.3,1547.3
4813951437,0,15,1,0,3,9,1,0,0,0,0,13398,6.2,15498,157,48,-4558,-2629,20.5,1339.8,13,3,1,9,3,11,1,1,0,0,17956,7.0,18127,190,60,4558,2629,25.0,1795.6
4813913602,1,10,3,0,9,5,6,0,0,0,0,18306,6.8,18127,224,60,2257,941,28.4,1830.6,10,2,1,5,9,5,0,0,0,0,16049,6.8,17186,225,47,-2257,-941,27.2,1604.9
4813054544,0,9,0,1,7,3,1,0,0,0,0,16093,7.0,18355,208,48,776,1037,25.6,1609.3,9,1,0,3,7,3,0,0,0,0,15317,6.8,17318,211,60,-776,-1037,27.1,1531.7
4813016706,1,16,0,1,4,3,4,0,0,0,0,15700,7.2,17848,189,56,948,-89,24.5,1570.0,6,1,0,3,4,1,0,0,0,0,14752,6.8,17937,196,52,-948,89,24.8,1475.2
4812990521,1,14,1,0,2,7,2,0,0,0,0,15293,7.0,17733,209,63,-2741,-776,27.2,1529.3,11,0,1,7,2,9,1,1,0,0,18034,7.0,18509,203,56,2741,776,25.9,1803.4
4812968260,0,15,2,1,6,8,7,0,0,0,0,16264,6.8,17366,197,56,-1884,-2727,25.3,1626.4,13,1,0,8,6,4,1,1,0,0,18148,7.4,20093,206,52,1884,2727,25.8,1814.8
4812928948,0,17,2,0,2,3,2,1,1,0,0,15606,7.0,19004,197,72,544,1298,26.9,1560.6,16,1,1,3,2,3,0,0,0,0,15062,6.6,17706,184,56,-544,-1298,24.0,1506.2
4796336463,0,13,1,0,5,12,4,0,0,0,0,14718,6.6,16928,166,52,-3594,-1439,21.8,1471.8,11,2,1,12,5,8,0,0,0,0,18312,7.0,18367,208,44,3594,1439,25.2,1831.2
4796319975,1,10,2,1,6,3,6,1,1,0,0,17518,7.2,18675,225,59,2816,1185,28.4,1751.8,23,1,0,3,6,2,0,0,0,0,14702,6.6,17490,198,48,-2816,-1185,24.6,1470.2
4791651924,0,11,0,1,5,1,2,0,0,0,0,15976,7.0,18519,176,52,1606,832,22.8,1597.6,10,0,0,1,5,0,0,0,0,0,14370,6.8,17687,219,52,-1606,-832,27.1,1437.0
4791631688,0,16,1,1,3,6,2,0,0,0,0,14318,6.6,16595,179,40,-1554,-1454,21.9,1431.8,11,1,0,6,3,2,1,1,0,0,15872,7.0,18049,184,60,1554,1454,24.4,1587.2
4791619854,0,277,0,1,1,5,0,1,1,0,0,12722,7.0,17150,154,44,-2766,-944,19.8,1272.2,8,0,0,5,1,4,0,0,0,0,15488,7.0,18094,162,62,2766,944,22.4,1548.8
4791607992,0,10,16,0,0,4,0,0,0,0,0,11653,6.8,16540,134,52,-4594,-1614,18.6,1165.3,34,0,1,4,0,2,0,0,0,0,16247,7.2,18154,211,56,4594,1614,26.7,1624.7
4791594066,1,13,0,0,3,3,2,1,1,0,0,15513,6.8,17643,211,47,1779,-248,25.8,1551.3,9,1,1,3,3,1,0,0,0,0,13734,6.6,17891,162,56,-1779,248,21.8,1373.4
4791541424,1,13,0,0,3,5,2,1,0,1,0,15678,6.8,18053,222,36,-170,-335,25.8,1567.8,9,2,1,5,3,5,1,1,0,0,15848,7.0,18388,143,48,170,335,19.1,1584.8
4804404045,1,16,1,1,3,1,4,1,1,0,1,17106,7.0,18187,182,68,5638,6931,25.0,1710.6,17,3,0,1,3,1,0,0,0,0,11468,5.0,11256,112,12,-5638,-6931,12.4,1146.8
4803684018,0,31,0,1,1,0,1,0,0,0,0,13550,6.8,17490,174,52,818,-349,22.6,1355.0,29,0,0,0,1,0,1,1,0,0,12732,7.0,17839,173,64,-818,349,23.7,1273.2
4803599258,0,396,0,1,2,5,1,1,1,0,0,14267,6.8,17631,190,55,-1018,-630,24.5,1426.7,9,0,0,5,2,5,0,0,0,0,15285,6.8,18261,144,60,1018,630,20.4,1528.5
4802641739,0,16,0,0,4,6,5,0,0,0,0,15223,6.4,15522,168,52,-1394,-409,22.0,1522.3,14,1,1,6,4,14,1,1,0,0,16617,6.4,15931,144,56,1394,409,20.0,1661.7
4802474449,1,10,0,0,7,7,4,0,0,0,0,15668,6.6,16247,117,47,-159,-372,16.4,1566.8,10,0,1,7,7,7,1,1,0,0,15827,6.6,16619,165,48,159,372,21.3,1582.7
4801825058,0,74,0,1,6,4,6,0,0,0,0,14860,6.2,15840,161,37,333,805,19.8,1486.0,11,0,0,4,6,6,0,0,0,0,14527,6.2,15035,131,36,-333,-805,16.7,1452.7
4801709075,0,14,1,1,5,4,3,1,1,0,0,15059,6.8,18126,181,56,1015,917,23.7,1505.9,10,0,0,4,5,1,0,0,0,0,14044,6.8,17209,151,48,-1015,-917,19.9,1404.4
4801663868,0,13,2,0,2,4,1,0,0,0,0,13766,6.6,15927,148,48,-1986,-1479,19.6,1376.6,14,2,1,4,2,6,0,0,0,0,15752,6.8,17406,172,58,1986,1479,23.0,1575.2
4798641693,0,12,0,0,3,5,1,0,0,0,0,14518,6.8,16853,124,56,104,816,18.0,1451.8,10,0,1,5,3,3,0,0,0,0,14414,6.4,16037,138,36,-104,-816,17.4,1441.4
4797054744,1,14,0,1,4,3,2,0,0,0,0,15168,7.2,18788,166,60,1072,2615,22.6,1516.8,9,1,0,3,4,3,1,1,0,0,14096,6.4,16173,180,40,-1072,-2615,22.0,1409.6
4797011845,1,153,1,0,5,8,6,0,0,0,0,15067,6.6,17160,147,52,-1159,-242,19.9,1506.7,11,0,1,8,5,3,1,1,0,0,16226,6.4,17402,171,60,1159,242,23.1,1622.6
4796914495,1,324,0,1,7,4,6,0,0,0,0,15869,6.6,16883,168,48,1999,1686,21.6,1586.9,12,1,0,4,7,3,1,1,0,0,13870,6.4,15197,139,44,-1999,-1686,18.3,1387.0
4794170985,1,13,3,1,6,7,11,0,0,0,0,16471,6.4,16370,193,48,1150,856,24.1,1647.1,17,1,0,7,6,10,2,1,1,0,15321,6.4,15514,161,42,-1150,-856,20.3,1532.1
4791284552,0,11,3,1,1,2,0,1,1,0,0,13705,6.8,17911,192,60,345,1131,25.2,1370.5,78,1,0,2,1,2,0,0,0,0,13360,6.6,16780,148,64,-345,-1131,21.2,1336.0
4790702380,0,31,0,1,4,7,3,1,0,1,0,14680,6.6,16640,160,52,-2511,-2574,21.2,1468.0,153,9,0,7,4,6,1,1,0,0,17191,7.2,19214,182,56,2511,2574,23.8,1719.1
4789820389,1,13,0,1,8,1,7,0,0,0,0,17692,7.2,18948,178,47,4929,2905,22.5,1769.2,205,0,0,1,8,1,0,0,0,0,12763,6.6,16043,151,56,-4929,-2905,20.7,1276.3
4788990427,0,14,0,1,4,7,3,0,0,0,0,13421,6.0,13978,106,52,-4475,-3619,15.8,1342.1,10,3,0,7,4,11,1,1,0,0,17896,6.8,17597,152,64,4475,3619,21.6,1789.6
4788957308,0,13,0,0,2,9,1,0,0,0,0,12455,6.2,15133,133,48,-4286,-2390,18.1,1245.5,12,0,1,9,2,10,1,1,0,0,16741,6.8,17523,163,52,4286,2390,21.5,1674.1
4788732122,0,25,1,1,5,2,4,0,0,0,0,15203,6.8,17767,167,48,-704,-944,21.5,1520.3,9,10,0,2,5,1,1,1,0,0,15907,7.2,18711,175,52,704,944,22.7,1590.7
4787877939,1,12,0,0,3,4,1,0,0,0,0,13845,6.6,16718,174,44,-1853,-1564,21.8,1384.5,63,0,1,4,3,4,0,0,0,0,15698,7.0,18282,170,58,1853,1564,22.8,1569.8
4844585242,0,93,1,1,28,27,49,0,0,0,2,37696,11.4,41984,93,0,-3086,-1330,9.3,3769.6,13,0,0,27,28,71,0,0,0,0,40782,11.4,43314,110,0,3086,1330,11.0,4078.2
4844580009,1,80,0,1,29,34,80,0,0,0,0,38751,11.8,44105,95,0,-2127,-1532,9.5,3875.1,34,0,0,34,29,82,0,0,0,0,40878,12.0,45637,94,0,2127,1532,9.4,4087.8
4844571417,1,68,2,1,6,6,11,0,0,0,1,32811,10.0,33222,118,0,1342,-246,11.8,3281.1,22,0,0,6,6,13,0,0,0,0,31469,10.0,33468,76,0,-1342,246,7.6,3146.9
4844569894,1,0,0,0,22,22,53,0,0,0,0,34885,10.8,38814,92,0,-704,-1397,9.2,3488.5,1,0,1,22,22,34,0,0,0,0,35589,10.8,40211,94,0,704,1397,9.4,3558.9
4844554650,1,24,3,1,32,15,62,0,0,0,0,37531,11.4,42989,92,0,3474,4268,9.2,3753.1,12,0,0,15,32,20,0,0,0,0,34057,11.0,38721,76,0,-3474,-4268,7.6,3405.7
4844549655,0,1,0,1,28,33,70,0,0,0,0,38950,11.6,43309,101,0,47,-2616,10.1,3895.0,0,0,0,33,28,80,0,0,0,0,38903,12.0,45925,109,0,-47,2616,10.9,3890.3
4844550157,0,29,0,0,19,31,39,0,0,0,0,34735,10.8,39286,68,0,-6186,-4442,6.8,3473.5,0,0,1,31,19,72,0,0,0,0,40921,11.8,43728,109,0,6186,4442,10.9,4092.1
4844540634,1,0,0,0,33,30,75,0,0,0,2,41514,11.8,44413,103,0,1317,382,10.3,4151.4,0,0,1,30,33,64,0,0,0,0,40197,11.8,44031,105,0,-1317,-382,10.5,4019.7
4844534463,0,68,0,1,19,24,62,0,0,0,1,35529,10.8,37847,74,0,-1388,-3319,7.4,3552.9,2,0,0,24,19,61,0,0,0,0,36917,11.2,41166,103,0,1388,3319,10.3,3691.7
4844526529,1,0,0,1,23,17,47,0,0,0,1,37349,11.4,41095,105,0,4589,4807,10.5,3734.9,0,0,0,16,22,29,0,0,0,0,32760,10.4,36288,101,0,-4589,-4807,10.1,3276.0
4844526781,0,20,0,0,17,28,34,0,0,0,2,34439,10.4,37002,76,0,-5666,-6058,7.6,3443.9,0,0,1,28,17,77,0,0,0,0,40105,11.8,43060,100,0,5666,6058,10.0,4010.5
4844516850,1,0,0,1,31,25,64,0,0,0,1,39020,11.4,43694,98,0,2441,3847,9.8,3902.0,0,0,0,25,31,55,0,0,0,0,36579,11.0,39847,89,0,-2441,-3847,8.9,3657.9
4844500660,1,84,0,0,36,36,78,0,0,0,1,41829,12.2,48385,91,0,1301,855,9.1,4182.9,0,0,1,36,36,80,0,0,0,0,40528,12.0,47530,75,0,-1301,-855,7.5,4052.8
4843608331,0,8,1,0,5,4,3,0,0,0,0,15582,7.0,17151,191,40,-587,147,23.1,1558.2,11,0,1,4,5,3,0,0,0,0,16169,6.6,17004,179,40,587,-147,21.9,1616.9
4843589358,1,11,10,0,5,4,2,0,0,0,0,14783,6.6,16726,153,36,319,-931,18.9,1478.3,26,1,1,4,5,1,0,0,0,0,14464,6.8,17657,147,40,-319,931,18.7,1446.4
4839435536,1,14,0,1,3,4,2,0,0,0,0,14726,6.6,17386,197,60,-53,30,25.7,1472.6,14,2,0,4,3,5,1,1,0,0,14779,6.6,17356,162,40,53,-30,20.2,1477.9
4839396779,1,16,1,0,9,8,6,0,0,0,0,16476,6.8,17111,166,48,-708,-1272,21.4,1647.6,17,2,1,8,9,3,0,0,0,0,17184,6.8,18383,182,64,708,1272,24.6,1718.4
4839360013,0,10,3,1,4,6,5,0,0,0,0,15523,7.0,17902,237,44,-713,-111,28.1,1552.3,17,0,0,6,4,14,0,0,0,0,16236,7.0,18013,226,56,713,111,28.2,1623.6
4837313493,0,10,1,0,5,10,4,0,0,0,0,16960,6.8,17468,214,40,-1110,-630,25.4,1696.0,11,0,1,10,5,9,0,0,0,0,18070,6.8,18098,189,60,1110,630,24.9,1807.0
4836288031,1,6,1,1,10,2,9,0,0,0,0,17638,7.0,18258,194,56,4061,1461,25.0,1763.8,10,0,0,2,10,0,1,1,0,0,13577,6.8,16797,179,58,-4061,-1461,23.7,1357.7
4850701304,0,19,11,1,6,3,8,1,1,0,0,16759,6.8,16957,191,56,1954,-392,24.7,1675.9,29,1,0,3,6,0,0,0,0,0,14805,6.6,17349,198,52,-1954,392,25.0,1480.5
4850666242,1,11,2,1,9,7,9,0,0,0,0,18857,7.2,17889,214,42,3124,1053,25.6,1885.7,107,2,0,7,9,4,0,0,0,0,15733,6.6,16836,190,56,-3124,-1053,24.6,1573.3
4846622467,1,11,2,0,8,5,1,0,0,0,0,15606,7.0,17707,201,44,271,460,24.5,1560.6,173,3,1,5,8,2,1,1,0,0,15335,6.8,17247,166,52,-271,-460,21.8,1533.5
4836566179,0,9,1,1,3,1,5,0,0,0,0,15198,6.8,18098,209,48,404,-45,25.7,1519.8,11,1,0,1,3,2,0,0,0,0,14794,6.8,18143,211,56,-404,45,26.7,1479.4
4824727187,1,6,0,1,15,19,18,0,0,0,0,34424,11.2,41165,104,63,-3333,26,16.7,3442.4,10,0,0,19,15,40,0,0,0,0,37757,11.4,41139,91,55,3333,-26,14.6,3775.7
4824703008,1,10,0,1,22,18,47,0,0,0,0,32296,11.2,41280,61,47,-4160,358,10.8,3229.6,181,0,0,17,21,18,0,0,0,0,36456,11.2,40922,91,59,4160,-358,15.0,3645.6
4824676173,0,7,0,0,21,24,44,0,0,0,0,35068,11.2,40598,73,52,-7754,-2205,12.5,3506.8,9,0,1,24,21,43,0,0,0,0,42822,11.6,42803,97,59,7754,2205,15.6,4282.2
4824652976,0,10,0,0,10,18,22,0,0,0,0,32236,10.4,35715,50,51,-5476,-7295,10.1,3223.6,11,0,1,18,10,46,0,0,0,0,37712,11.6,43010,60,75,5476,7295,13.5,3771.2
4817198719,1,47,0,0,5,16,8,0,0,0,1,32851,10.0,33427,76,44,591,-2162,12.0,3285.1,12,0,1,16,5,36,0,0,0,0,32260,10.4,35589,73,59,-591,2162,13.2,3226.0
4817184838,1,13,0,1,23,11,42,0,0,0,1,39618,12.0,45412,105,71,7901,8515,17.6,3961.8,13,0,0,11,23,23,0,0,0,0,31717,10.8,36897,86,51,-7901,-8515,13.7,3171.7
4817154567,1,15,0,1,13,6,15,0,0,0,0,33614,11.2,39124,112,63,4887,2007,17.5,3361.4,18,0,0,5,12,4,0,0,0,0,28727,10.8,37117,101,48,-4887,-2007,14.9,2872.7
4817131622,0,11,0,1,8,20,10,0,0,0,2,34826,11.2,40013,111,43,-5311,-5517,15.4,3482.6,194,0,0,19,7,29,0,0,0,0,40137,11.8,45530,117,71,5311,5517,18.8,4013.7
4817113231,1,21,0,0,19,11,48,0,0,0,0,37612,11.6,43014,75,63,4333,5796,13.8,3761.2,12,1,1,11,19,31,0,0,0,0,33279,10.6,37218,126,47,-4333,-5796,17.3,3327.9
4817100741,1,11,0,0,19,12,36,0,0,0,1,33829,11.2,39315,62,51,510,1862,11.3,3382.9,21,1,1,12,19,23,0,0,0,0,33319,10.8,37453,85,64,-510,-1862,14.9,3331.9
4811958105,1,13,11,1,18,9,41,0,0,0,0,35708,11.2,40429,99,66,5392,4777,16.5,3570.8,36,0,0,9,18,13,0,0,0,0,30316,10.4,35652,76,52,-5392,-4777,12.8,3031.6
4804153079,1,0,0,1,22,26,60,0,0,0,0,37908,11.2,40531,102,0,404,-3135,10.2,3790.8,0,0,0,26,22,61,0,0,0,0,37504,11.6,43666,105,0,-404,3135,10.5,3750.4
4804130005,0,9,0,1,17,19,51,0,0,0,0,34408,10.8,36876,100,0,6,-148,10.0,3440.8,2,0,0,19,17,53,0,0,0,0,34402,10.6,37024,108,0,-6,148,10.8,3440.2
4804119001,1,4,0,0,26,27,46,0,0,0,1,37337,11.2,41369,105,0,-524,-1137,10.5,3733.7,0,0,1,27,26,56,0,0,0,0,37861,11.4,42506,102,0,524,1137,10.2,3786.1
4804105453,0,0,1,1,24,22,65,0,0,0,0,35999,11.0,39198,97,0,-2585,-3770,9.7,3599.9,18,0,0,22,24,60,0,0,0,0,38584,11.6,42968,92,0,2585,3770,9.2,3858.4
4792715042,1,0,0,0,26,20,81,0,0,0,0,36827,11.4,41911,87,0,1662,3039,8.7,3682.7,0,0,1,20,26,49,0,0,0,0,35165,11.0,38872,87,0,-1662,-3039,8.7,3516.5
4854276456,0,0,0,0,13,12,37,0,0,0,0,35724,10.4,35609,105,0,3298,540,10.5,3572.4,0,0,1,12,13,31,0,0,0,0,32426,10.2,35069,108,0,-3298,-540,10.8,3242.6
4854258627,1,0,0,1,16,16,23,0,0,0,0,48845,12.0,55000,3,0,21595,22000,0.3,4884.5,0,0,0,10,10,4,0,0,0,0,27250,7.2,33000,2,0,-21595,-22000,0.2,2725.0
4854215312,1,15,0,1,4,1,3,0,0,0,0,16118,6.8,17992,209,52,3044,833,26.1,1611.8,11,0,0,1,4,0,1,0,1,0,13074,6.8,17159,168,56,-3044,-833,22.4,1307.4
4853009698,0,12,2,0,2,3,1,0,0,0,0,13806,6.6,17476,184,52,-1088,-569,23.6,1380.6,15,0,1,3,2,3,1,1,0,0,14894,7.0,18045,199,48,1088,569,24.7,1489.4
4852135942,0,11,0,0,15,16,42,0,0,0,0,34756,10.6,37325,85,0,1041,759,8.5,3475.6,5,1,1,16,15,44,0,0,0,0,33715,10.6,36566,81,0,-1041,-759,8.1,3371.5
4852110369,0,11,1,0,5,10,2,0,0,0,0,14557,6.6,16766,150,52,-3396,-1777,20.2,1455.7,12,0,1,10,5,4,0,0,0,0,17953,7.2,18543,212,52,3396,1777,26.4,1795.3
4851066882,0,0,0,1,19,20,57,0,0,0,0,35937,10.2,36172,104,0,-1308,-3301,10.4,3593.7,0,0,0,20,19,44,0,0,0,0,37245,10.8,39473,106,0,1308,3301,10.6,3724.5
4851036352,1,13,1,0,11,6,9,0,0,0,0,18493,6.8,17607,178,48,2341,1258,22.6,1849.3,36,2,1,6,11,8,0,0,0,0,16152,6.6,16349,194,60,-2341,-1258,25.4,1615.2
4847146345,1,7,1,0,0,2,0,0,0,0,0,13209,6.8,17219,179,52,-955,-1261,23.1,1320.9,14,0,1,2,0,3,0,0,0,0,14164,7.2,18480,174,60,955,1261,23.4,1416.4
4846790358,0,8,1,1,11,5,9,0,0,0,0,19833,7.6,19836,170,60,4438,2082,23.0,1983.3,12,0,0,5,11,3,0,0,0,0,15395,6.8,17754,150,52,-4438,-2082,20.2,1539.5
4846275415,1,11,2,1,6,4,6,0,0,0,0,16926,7.0,18390,194,64,173,-199,25.8,1692.6,13,2,0,4,6,3,1,0,1,0,16753,7.0,18589,202,60,-173,199,26.2,1675.3
4846127341,1,177,2,1,9,7,6,0,0,0,0,18435,7.2,18785,202,43,2528,3473,24.5,1843.5,14,1,0,7,9,9,0,0,0,0,15907,6.0,15312,173,52,-2528,-3473,22.5,1590.7
4846086130,1,19,1,1,6,1,8,1,1,0,0,16065,6.6,16810,209,44,4209,1415,25.3,1606.5,15,1,0,1,6,1,0,0,0,0,11856,6.2,15395,142,40,-4209,-1415,18.2,1185.6
4845674193,0,10,1,0,1,6,1,0,0,0,0,13700,6.4,15475,152,32,-2240,-1659,18.4,1370.0,11,0,1,6,1,5,1,1,0,0,15940,6.4,17134,172,58,2240,1659,23.0,1594.0
4845655354,0,10,0,0,0,3,0,0,0,0,0,12102,6.4,16339,157,48,-3099,-2139,20.5,1210.2,82,0,1,3,0,1,1,1,0,0,15201,7.0,18478,209,56,3099,2139,26.5,1520.1
4845644992,1,64,0,1,7,2,2,1,1,0,0,16227,6.8,17924,182,52,3356,2168,23.4,1622.7,5,0,0,2,7,1,0,0,0,0,12871,6.4,15756,128,35,-3356,-2168,16.3,1287.1
4845589916,0,11,1,0,0,3,0,1,1,0,0,12523,6.4,15598,150,60,-2044,-2170,21.0,1252.3,10,0,1,3,0,1,0,0,0,0,14567,7.0,17768,190,48,2044,2170,23.8,1456.7
4845565575,1,8,0,1,4,4,4,1,0,1,0,15803,7.0,18552,195,60,906,1068,25.5,1580.3,14,0,0,4,4,1,0,0,0,0,14897,6.6,17484,206,52,-906,-1068,25.8,1489.7
4845555153,0,0,0,0,24,24,69,0,0,0,1,36100,11.0,39615,97,0,-2184,-2184,9.7,3610.0,21,0,1,24,24,69,0,0,0,0,38284,11.6,41799,95,0,2184,2184,9.5,3828.4
4845549927,0,7,0,1,13,23,25,0,0,0,1,34124,10.6,36772,80,0,-2326,-2597,8.0,3412.4,0,0,0,23,13,62,0,0,0,0,36450,11.0,39369,110,0,2326,2597,11.0,3645.0
4855270203,1,12,0,1,7,4,5,0,0,0,0,15652,6.8,16910,151,32,1514,1151,18.3,1565.2,18,1,0,4,7,2,0,0,0,0,14138,6.6,15759,152,52,-1514,-1151,20.4,1413.8
4855211588,1,10,0,0,3,2,4,0,0,0,0,15866,7.0,18022,198,44,1150,-178,24.2,1586.6,50,0,1,2,3,1,0,0,0,0,14716,7.0,18200,232,52,-1150,178,28.4,1471.6
4849716157,1,10,0,1,7,2,4,1,1,0,0,16244,7.0,18237,168,47,2329,1330,21.5,1624.4,14,1,0,2,7,1,0,0,0,0,13915,6.6,16907,172,44,-2329,-1330,21.6,1391.5
4849696822,1,19,0,0,4,3,3,1,1,0,0,16258,6.6,16908,198,52,2011,1404,25.0,1625.8,119,0,1,3,4,2,0,0,0,0,14247,6.4,15504,145,40,-2011,-1404,18.5,1424.7
4849680038,0,14,1,0,2,12,3,0,0,0,1,11663,5.0,10629,102,28,-8090,-6731,13.0,1166.3,11,0,1,12,2,12,0,0,0,0,19753,6.8,17360,178,44,8090,6731,22.2,1975.3
4848270964,0,52,0,1,6,9,5,1,1,0,0,14016,6.2,15234,142,36,-2036,-613,17.8,1401.6,12,0,0,9,6,5,0,0,0,0,16052,6.2,15847,153,36,2036,613,18.9,1605.2
4848253557,1,11,2,1,9,3,4,0,0,0,0,16592,6.8,17514,196,58,-72,306,25.4,1659.2,16,2,0,3,9,4,1,1,0,0,16664,6.8,17208,165,61,72,-306,22.6,1666.4
4848242821,0,130,0,1,5,4,3,1,1,0,0,15208,6.8,17017,170,56,-1394,-1760,22.6,1520.8,13,1,0,4,5,3,0,0,0,0,16602,7.0,18777,191,72,1394,1760,26.3,1660.2
4847266233,1,59,0,1,7,2,3,1,1,0,0,15292,7.0,17417,147,48,1972,1023,19.5,1529.2,9,0,0,2,7,1,0,0,0,0,13320,6.6,16394,149,48,-1972,-1023,19.7,1332.0
4847248076,1,34,1,1,2,0,2,0,0,0,0,14496,6.6,17506,184,48,1815,1504,23.2,1449.6,32,2,0,0,2,0,1,1,0,0,12681,6.8,16002,172,55,-1815,-1504,22.7,1268.1
4847221850,0,16,2,0,6,6,5,1,1,0,0,16430,6.4,15981,165,52,-233,-2121,21.7,1643.0,12,2,1,6,6,2,1,0,1,0,16663,7.0,18102,193,48,233,2121,24.1,1666.3
4845481205,1,12,1,1,13,1,12,1,1,0,0,17718,6.8,16936,148,52,5301,2353,20.0,1771.8,11,1,0,1,13,2,0,0,0,0,12417,6.4,14583,99,37,-5301,-2353,13.6,1241.7
4845469065,1,10,1,1,5,6,2,0,0,0,0,14155,6.2,15907,156,48,-681,-664,20.4,1415.5,11,0,0,6,5,5,1,1,0,0,14836,6.8,16571,140,20,681,664,16.0,1483.6
4845448694,1,16,2,0,2,4,0,1,1,0,0,13881,6.8,17036,180,52,-233,643,23.2,1388.1,12,0,1,4,2,5,0,0,0,0,14114,6.6,16393,161,48,233,-643,20.9,1411.4
4845445876,0,15,1,1,5,9,2,1,1,0,0,13929,6.4,16584,140,60,-2828,-1483,20.0,1392.9,13,1,0,8,4,7,0,0,0,0,16757,7.0,18067,170,52,2828,1483,22.2,1675.7
4845425445,0,12,2,1,4,2,2,0,0,0,0,14037,6.2,14730,115,56,1095,-1149,17.1,1403.7,14,2,0,2,4,2,1,1,0,0,12942,6.2,15879,171,44,-1095,1149,21.5,1294.2
4842562135,1,21,0,1,3,0,1,1,1,0,0,14802,6.8,17227,172,46,921,-270,21.8,1480.2,13,1,0,0,3,0,0,0,0,0,13881,6.8,17497,171,53,-921,270,22.4,1388.1
4842522930,1,13,2,0,8,7,7,1,1,0,0,16298,6.2,15537,153,36,480,-999,18.9,1629.8,15,1,1,7,8,7,0,0,0,0,15818,6.4,16536,164,39,-480,999,20.3,1581.8
4857391655,1,60,2,1,22,16,26,0,0,0,0,49385,10.0,47500,5,0,22230,19000,0.5,4938.5,0,1,0,12,18,6,0,0,0,0,27155,6.0,28500,0,0,-22230,-19000,0.0,2715.5
4857374361,1,0,0,1,20,15,26,0,0,0,0,63750,12.2,56000,0,0,27600,23000,0.0,6375.0,4,0,0,10,15,4,0,0,0,0,36150,7.2,33000,0,0,-27600,-23000,0.0,3615.0
4857342708,1,176,0,1,16,14,17,0,0,0,0,47810,10.0,47500,0,0,20280,19000,0.0,4781.0,176,0,0,8,10,7,0,0,0,0,27530,6.0,28500,0,0,-20280,-19000,0.0,2753.0
4857305632,1,0,4,0,16,22,10,0,0,0,0,46370,10.0,47500,2,0,17455,17820,0.2,4637.0,31,1,1,12,6,13,0,0,0,0,28915,6.2,29680,0,0,-17455,-17820,0.0,2891.5
4857278951,1,0,0,1,14,14,12,0,0,0,0,45600,10.2,48680,0,0,18100,20180,0.0,4560.0,5,0,0,11,11,6,0,0,0,0,27500,6.0,28500,0,0,-18100,-20180,0.0,2750.0
4857258750,1,44,0,1,14,19,19,0,0,0,0,47445,12.0,55000,1,0,18155,22000,0.1,4744.5,7,0,0,13,8,8,0,0,0,0,29290,7.2,33000,4,0,-18155,-22000,0.4,2929.0
4857221671,1,5,0,1,23,16,20,0,0,0,0,47000,12.0,55000,0,0,18800,22000,0.0,4700.0,0,0,0,8,15,10,0,0,0,0,28200,7.2,33000,0,0,-18800,-22000,0.0,2820.0
4856449922,1,36,0,0,14,21,20,0,0,0,0,46416,10.0,47500,1,0,18150,19000,0.1,4641.6,256,0,1,14,7,11,0,0,0,0,28266,6.0,28500,1,0,-18150,-19000,0.1,2826.6
4856422639,1,2,1,1,13,13,11,0,0,0,0,46680,10.0,47500,1,0,19390,19000,0.1,4668.0,33,3,0,7,7,8,0,0,0,0,27290,6.0,28500,5,0,-19390,-19000,0.5,2729.0
4856408858,1,0,0,1,23,17,20,0,0,0,0,64100,12.0,55000,9,0,27600,22000,0.9,6410.0,0,0,0,9,15,4,0,0,0,0,36500,7.2,33000,4,0,-27600,-22000,0.4,3650.0
4856377688,1,5,0,0,18,19,24,0,0,0,0,62700,12.0,55000,0,0,24800,22000,0.0,6270.0,13,0,1,13,12,9,0,0,0,0,37900,7.2,33000,0,0,-24800,-22000,0.0,3790.0
4856359327,1,1,0,0,14,19,16,0,0,0,0,46515,10.0,47500,0,0,17831,17820,0.0,4651.5,0,0,1,15,10,11,0,0,0,0,28684,6.2,29680,0,0,-17831,-17820,0.0,2868.4
4856338773,1,66,1,0,15,20,16,0,0,0,0,46030,10.0,47500,3,0,17445,19000,0.3,4603.0,0,7,1,14,9,10,0,0,0,0,28585,6.0,28500,0,0,-17445,-19000,0.0,2858.5
4856315784,1,0,0,0,23,18,31,0,0,0,0,63790,13.0,62500,0,0,26918,28000,0.0,6379.0,0,0,1,11,16,6,0,0,0,0,36872,7.4,34500,0,0,-26918,-28000,0.0,3687.2
4856279200,1,35,0,1,23,15,23,0,0,0,0,64220,12.0,55000,1,0,28395,18000,0.1,6422.0,0,0,0,6,14,5,0,0,0,0,35825,8.0,37000,0,0,-28395,-18000,0.0,3582.5
4856242987,1,21,0,1,15,21,15,0,0,0,0,49450,10.0,47500,0,0,20200,19000,0.0,4945.0,0,0,0,14,8,11,0,0,0,0,29250,6.0,28500,0,0,-20200,-19000,0.0,2925.0
4856214151,1,0,0,1,12,23,19,0,0,0,0,61351,12.0,55000,0,0,22751,21000,0.0,6135.1,0,0,0,17,6,12,0,0,0,0,38600,7.4,34000,0,0,-22751,-21000,0.0,3860.0
4856184500,1,0,0,1,21,18,18,0,0,0,0,47499,10.0,47500,0,0,19649,19000,0.0,4749.9,0,0,0,7,10,7,0,0,0,0,27850,6.0,28500,0,0,-19649,-19000,0.0,2785.0
4850925698,1,28,1,0,5,3,4,0,0,0,0,17183,7.2,18847,210,68,2610,1736,27.8,1718.3,16,0,1,3,5,3,0,0,0,0,14573,6.8,17111,179,60,-2610,-1736,23.9,1457.3
4850797341,0,18,0,1,8,3,7,0,0,0,0,16341,6.6,17008,194,28,213,-446,22.2,1634.1,10,0,0,3,8,4,0,0,0,0,16128,6.6,17454,181,56,-213,446,23.7,1612.8
4856312257,0,0,2,1,14,22,37,0,0,0,1,34402,10.6,36635,92,0,-2404,-3496,9.2,3440.2,17,0,0,22,14,58,0,0,0,0,36806,11.0,40131,112,0,2404,3496,11.2,3680.6
4856272437,0,17,0,1,24,28,60,0,0,0,2,37178,11.0,39393,109,0,-2889,-4783,10.9,3717.8,0,1,0,28,24,68,0,0,0,0,40067,11.8,44176,121,0,2889,4783,12.1,4006.7
4856232417,0,1,0,1,18,21,44,0,0,0,0,34534,10.4,36600,104,0,-3894,-4318,10.4,3453.4,0,0,0,21,18,54,0,0,0,0,38428,11.2,40918,107,0,3894,4318,10.7,3842.8
4853999637,1,13,1,0,5,3,0,0,0,0,0,16573,7.2,19413,206,60,1073,1860,26.6,1657.3,7,2,1,3,5,4,0,0,0,0,15500,6.8,17553,167,60,-1073,-1860,22.7,1550.0
4852332761,1,0,0,1,18,21,48,0,0,0,0,36023,11.2,39839,102,0,-875,1586,10.2,3602.3,0,0,0,21,18,53,0,0,0,0,36898,10.6,38253,93,0,875,-1586,9.3,3689.8
4852324886,1,11,0,0,11,14,30,0,0,0,0,32023,10.0,33243,91,0,-416,-1058,9.1,3202.3,90,2,1,14,11,38,0,0,0,0,32439,10.2,34301,99,0,416,1058,9.9,3243.9
4852288315,1,7,1,0,1,3,0,0,0,0,0,15571,7.0,18778,221,56,1283,2379,27.7,1557.1,15,0,1,3,1,2,0,0,0,0,14288,6.4,16399,173,56,-1283,-2379,22.9,1428.8
4850401720,1,3,0,1,45,21,126,0,0,0,2,43211,12.2,47525,105,0,8121,9609,10.5,4321.1,25,0,0,21,45,44,0,0,0,0,35090,10.6,37916,55,0,-8121,-9609,5.5,3509.0
4850391467,0,41,0,1,25,27,56,0,0,0,0,36266,11.2,41148,74,0,-2564,-775,7.4,3626.6,0,4,0,27,25,63,0,0,0,0,38830,11.4,41923,103,0,2564,775,10.3,3883.0
4847950030,0,21,1,1,3,4,4,0,0,0,0,13840,6.6,16937,159,48,-1993,-1356,20.7,1384.0,238,2,0,4,3,3,1,1,0,0,15833,7.0,18293,188,60,1993,1356,24.8,1583.3
4847911972,0,17,4,0,1,3,0,0,0,0,0,13864,6.6,17386,183,68,-1696,-1512,25.1,1386.4,13,4,1,3,1,1,0,0,0,0,15560,7.0,18898,234,60,1696,1512,29.4,1556.0
4847406515,1,0,0,0,29,21,85,0,0,0,1,39978,11.8,45068,108,0,2968,4777,10.8,3997.8,0,0,1,21,29,47,0,0,0,0,37010,11.0,40291,90,0,-2968,-4777,9.0,3701.0
4845582493,0,101,2,0,2,4,3,0,0,0,0,14412,6.8,17500,194,56,-699,-744,25.0,1441.2,13,2,1,4,2,3,2,1,1,0,15111,7.0,18244,180,56,699,744,23.6,1511.1
4838880179,1,103,0,1,24,25,56,0,0,0,1,38430,11.4,40848,92,0,1339,768,9.2,3843.0,0,0,0,25,24,72,0,0,0,0,37091,11.0,40080,81,0,-1339,-768,8.1,3709.1
4836485594,1,0,4,1,26,24,61,0,0,0,0,39969,11.6,42639,101,0,3902,2032,10.1,3996.9,14,0,0,24,26,57,0,0,0,0,36067,11.0,40607,95,0,-3902,-2032,9.5,3606.7
4835084808,0,0,2,1,27,28,64,0,0,0,2,39056,11.6,43231,88,0,-2227,-655,8.8,3905.6,32,0,0,28,27,52,0,0,0,0,41283,11.6,43886,104,0,2227,655,10.4,4128.3
4829422121,0,68,4,0,13,18,40,0,0,0,1,33985,10.2,34644,110,0,-4218,-4591,11.0,3398.5,15,0,1,18,13,48,0,0,0,0,38203,10.8,39235,124,0,4218,4591,12.4,3820.3
4829393738,0,9,0,0,21,35,44,0,0,0,1,37286,11.6,42687,103,0,-4040,-1856,10.3,3728.6,0,0,1,35,21,90,0,0,0,0,41326,11.6,44543,110,0,4040,1856,11.0,4132.6
4829372009,1,0,0,1,27,32,70,0,0,0,0,38349,11.4,42765,102,0,26,-1001,10.2,3834.9,3,0,0,32,27,79,0,0,0,0,38323,11.4,43766,84,0,-26,1001,8.4,3832.3
4829352096,0,0,3,0,26,23,48,0,0,0,0,35620,11.0,40962,77,0,-1052,411,7.7,3562.0,13,0,1,23,26,53,0,0,0,0,36672,11.0,40551,93,0,1052,-411,9.3,3667.2
4728920684,1,11,0,0,2,4,1,1,1,0,0,15029,6.8,18196,174,64,493,981,23.8,1502.9,96,0,1,4,2,3,0,0,0,0,14536,6.8,17215,177,44,-493,-981,22.1,1453.6
4728900167,1,15,1,0,4,5,3,0,0,0,0,16298,6.6,17049,169,48,1143,340,21.7,1629.8,8,0,1,5,4,2,0,0,0,0,15155,6.6,16709,172,47,-1143,-340,21.9,1515.5
4728593293,1,6,0,0,18,22,47,0,0,0,0,36172,11.2,39806,99,0,-228,303,9.9,3617.2,0,0,1,22,18,51,0,0,0,0,36400,11.0,39503,103,0,228,-303,10.3,3640.0
4727381765,1,126,0,1,28,27,68,0,0,0,0,38314,11.2,41648,93,0,535,-48,9.3,3831.4,3,2,0,27,28,74,0,0,0,0,37779,11.4,41696,107,0,-535,48,10.7,3777.9
4727367313,1,21,1,1,16,24,39,0,0,0,0,36404,11.0,38576,99,0,-1023,-1370,9.9,3640.4,15,2,0,24,16,70,0,0,0,0,37427,11.0,39946,74,0,1023,1370,7.4,3742.7
4726271492,0,0,0,0,17,30,39,0,0,0,1,34667,10.6,37775,78,0,-6643,-6012,7.8,3466.7,0,0,1,30,17,80,0,0,0,0,41310,11.6,43787,122,0,6643,6012,12.2,4131.0
4726269774,1,0,0,1,25,14,67,0,0,0,1,37780,11.2,42365,115,0,4296,5906,11.5,3778.0,0,0,0,14,25,20,0,0,0,0,33484,10.6,36459,90,0,-4296,-5906,9.0,3348.4
4725615187,1,0,0,1,14,17,22,0,0,0,0,61650,12.0,55000,0,0,24100,22000,0.0,6165.0,0,0,0,12,9,8,0,0,0,0,37550,7.2,33000,0,0,-24100,-22000,0.0,3755.0
4725584360,1,0,0,0,17,16,19,0,0,0,0,62700,12.0,55000,0,0,24800,22000,0.0,6270.0,41,0,1,8,9,9,0,0,0,0,37900,7.2,33000,0,0,-24800,-22000,0.0,3790.0
4725519953,1,0,0,1,30,27,87,0,0,0,0,40200,12.0,45092,109,0,2410,1415,10.9,4020.0,0,0,0,27,30,59,0,0,0,0,37790,11.4,43677,84,0,-2410,-1415,8.4,3779.0
4725259214,0,34,0,1,19,19,45,0,0,0,2,38261,10.8,39293,128,0,2585,218,12.8,3826.1,0,4,0,19,19,44,0,0,0,0,35676,11.0,39075,103,0,-2585,-218,10.3,3567.6
4725236715,0,0,0,1,25,26,59,0,0,0,0,38285,11.4,42273,100,0,194,-87,10.0,3828.5,0,0,0,26,25,73,0,0,0,0,38091,11.4,42360,79,0,-194,87,7.9,3809.1
4725064293,1,1,0,0,17,17,12,0,0,0,0,61954,12.0,55000,0,0,23333,22000,0.0,6195.4,50,0,1,9,9,11,0,0,0,0,38621,7.2,33000,0,0,-23333,-22000,0.0,3862.1
4725059083,1,0,0,0,10,20,12,0,0,0,0,59846,12.0,55000,0,0,21596,22000,0.0,5984.6,0,0,1,14,4,12,0,0,0,0,38250,7.2,33000,0,0,-21596,-22000,0.0,3825.0
4725044652,1,7,0,1,14,12,18,0,0,0,0,47500,10.0,47500,0,0,20000,19000,0.0,4750.0,7,0,0,9,11,4,0,0,0,0,27500,6.0,28500,0,0,-20000,-19000,0.0,2750.0
4724412277,1,0,0,0,13,16,18,0,0,0,0,62150,12.0,55000,1,0,25482,22000,0.1,6215.0,216,0,1,11,8,8,0,0,0,0,36668,7.2,33000,0,0,-25482,-22000,0.0,3666.8
4724388421,1,0,0,0,10,17,14,0,0,0,0,59550,12.0,55000,0,0,21300,22000,0.0,5955.0,0,0,1,13,6,11,0,0,0,0,38250,7.2,33000,0,0,-21300,-22000,0.0,3825.0
4724361657,1,0,0,1,15,13,18,0,0,0,0,63086,12.0,55000,0,0,25416,22000,0.0,6308.6,7,0,0,7,9,9,0,0,0,0,37670,7.2,33000,0,0,-25416,-22000,0.0,3767.0
4724351083,1,0,0,0,13,14,17,0,0,0,0,61694,12.0,55000,0,0,23794,21000,0.0,6169.4,0,0,1,10,9,8,0,0,0,0,37900,7.4,34000,0,0,-23794,-21000,0.0,3790.0
4724336831,1,0,0,1,19,16,14,0,0,0,0,62933,12.0,55000,0,0,25033,22000,0.0,6293.3,13,0,0,8,11,13,0,0,0,0,37900,7.2,33000,0,0,-25033,-22000,0.0,3790.0
4829716102,1,8,2,0,5,4,5,0,0,0,0,16735,7.2,18493,189,52,1616,1020,24.1,1673.5,14,0,1,4,5,2,0,0,0,0,15119,6.8,17473,195,60,-1616,-1020,25.5,1511.9
4829672817,1,30,0,0,4,4,2,0,0,0,0,14749,6.8,18255,187,60,719,2785,24.7,1474.9,14,6,1,4,4,7,1,1,0,0,14030,6.4,15470,126,52,-719,-2785,17.8,1403.0
4829619518,0,15,0,0,1,4,0,1,1,0,0,13549,6.8,17683,184,60,-1879,147,24.4,1354.9,11,0,1,4,1,2,0,0,0,0,15428,6.8,17536,186,48,1879,-147,23.4,1542.8
4829575584,0,9,4,0,1,5,1,0,0,0,0,14516,6.4,16251,173,40,-1226,-238,21.3,1451.6,16,0,1,5,1,4,0,0,0,0,15742,6.6,16489,190,35,1226,238,22.5,1574.2
4827721251,0,7,0,0,4,2,2,0,0,0,0,15175,6.8,18115,205,44,224,641,24.9,1517.5,9,0,1,2,4,1,0,0,0,0,14951,6.8,17474,216,48,-224,-641,26.4,1495.1
4825137727,0,16,0,0,6,4,3,0,0,0,0,14569,6.4,16222,137,44,-821,-693,18.1,1456.9,215,2,1,4,6,3,0,0,0,0,15390,6.6,16915,180,44,821,693,22.4,1539.0
4823193360,1,11,1,1,2,0,3,0,0,0,0,14758,7.0,18620,195,64,519,161,25.9,1475.8,9,0,0,0,2,0,1,1,0,0,14239,6.8,18459,223,56,-519,-161,27.9,1423.9
4817499440,0,6,0,0,7,11,1,0,0,0,0,13651,6.2,15822,155,45,-3509,-298,20.0,1365.1,73,1,1,9,5,13,0,0,0,0,17160,6.2,16120,135,63,3509,298,19.8,1716.0
4815633164,0,12,0,1,10,24,19,0,0,0,0,32505,10.6,35177,53,63,-2645,-6482,11.6,3250.5,13,0,0,23,9,41,0,0,0,0,35150,11.2,41659,91,51,2645,6482,14.2,3515.0
4815622389,1,8,4,0,15,8,28,0,0,0,0,29837,10.2,32913,59,43,2012,1377,10.2,2983.7,33,0,1,8,15,16,0,0,0,0,27825,9.6,31536,86,36,-2012,-1377,12.2,2782.5
4815605502,1,96,0,1,12,6,16,0,0,0,0,30293,10.4,33753,77,47,3171,3730,12.4,3029.3,8,0,0,6,12,13,0,0,0,0,27122,9.6,30023,48,47,-3171,-3730,9.5,2712.2
4815588126,0,13,0,1,5,4,3,0,0,0,0,15269,6.8,17080,179,44,74,-745,22.3,1526.9,12,2,0,4,5,4,0,0,0,0,15195,7.0,17825,178,60,-74,745,23.8,1519.5
4815570809,0,49,0,1,3,1,1,0,0,0,0,15439,7.4,18902,194,60,1271,1213,25.4,1543.9,9,2,0,1,3,0,0,0,0,0,14168,6.8,17689,223,48,-1271,-1213,27.1,1416.8
4815427604,0,54,3,1,8,3,10,1,1,0,0,16375,6.6,16893,164,56,1941,-325,22.0,1637.5,14,1,0,3,8,1,0,0,0,0,14434,7.0,17218,186,56,-1941,325,24.2,1443.4
4815115748,1,11,1,0,3,9,0,0,0,0,0,12573,6.2,15794,106,59,-2902,-552,16.5,1257.3,10,1,1,8,2,4,1,0,1,0,15475,6.6,16346,155,36,2902,552,19.1,1547.5
4814936320,1,9,0,0,4,4,2,0,0,0,0,15455,7.0,18768,186,52,-440,948,23.8,1545.5,12,0,1,4,4,3,0,0,0,0,15895,7.0,17820,178,48,440,-948,22.6,1589.5
4814834666,1,8,0,1,9,8,7,1,1,0,0,18618,7.2,18702,189,76,2773,2631,26.5,1861.8,134,0,0,8,9,8,0,0,0,0,15845,6.6,16071,152,41,-2773,-2631,19.3,1584.5
4814821753,0,13,0,0,5,5,1,0,0,0,0,12629,6.2,15930,133,36,-2516,-7,16.9,1262.9,12,0,1,5,5,7,1,1,0,0,15145,6.6,15937,138,56,2516,7,19.4,1514.5
4813667839,0,14,0,1,4,2,2,0,0,0,0,13834,6.6,16015,150,48,-1628,-1696,19.8,1383.4,14,0,0,2,4,2,0,0,0,0,15462,6.8,17711,177,48,1628,1696,22.5,1546.2
4813065124,1,11,2,1,8,5,8,0,0,0,0,16842,6.8,17786,189,44,1746,1355,23.3,1684.2,8,0,0,5,8,5,0,0,0,0,15096,6.4,16431,154,44,-1746,-1355,19.8,1509.6
4849212483,1,15,0,0,7,7,6,0,0,0,0,15317,6.6,17335,146,52,-835,305,19.8,1531.7,11,1,1,7,7,7,0,0,0,0,16152,6.6,17030,180,52,835,-305,23.2,1615.2
4849168239,1,17,2,1,12,4,14,0,0,0,0,18611,6.8,17829,187,54,3109,848,24.1,1861.1,12,2,0,4,12,3,0,0,0,0,15502,6.8,16981,201,44,-3109,-848,24.5,1550.2
4849127362,0,11,1,1,3,2,3,0,0,0,0,15753,7.2,18949,220,52,626,-88,27.2,1575.3,11,1,0,2,3,1,1,1,0,0,15127,7.0,19037,217,72,-626,88,28.9,1512.7
4849089314,1,10,1,0,8,2,6,0,0,0,0,16763,6.8,18428,201,68,2255,1581,26.9,1676.3,11,0,1,2,8,2,0,0,0,0,14508,6.6,16847,189,44,-2255,-1581,23.3,1450.8
4848841517,1,18,2,1,6,3,11,0,0,0,0,15805,6.4,16899,143,60,311,-1258,20.3,1580.5,15,4,0,3,6,3,0,0,0,0,15494,7.0,18157,194,48,-311,1258,24.2,1549.4
4846812635,1,15,0,0,8,8,6,0,0,0,0,16965,6.8,16544,217,32,-1213,-1186,24.9,1696.5,9,1,1,8,8,6,0,0,0,0,18178,6.8,17730,193,48,1213,1186,24.1,1817.8
4846777980,1,38,1,1,4,5,2,0,0,0,0,16717,7.2,18334,212,52,1103,-671,26.4,1671.7,35,1,0,5,4,1,0,0,0,0,15614,7.0,19005,205,76,-1103,671,28.1,1561.4
4844418419,0,16,0,0,6,10,6,0,0,0,0,14706,6.6,16756,158,44,-3037,-1136,20.2,1470.6,23,3,1,10,6,7,0,0,0,0,17743,6.8,17892,217,41,3037,1136,25.8,1774.3
4844372856,0,11,0,0,4,5,3,0,0,0,0,16019,6.8,17699,209,48,560,183,25.7,1601.9,17,0,1,5,4,4,0,0,0,0,15459,6.8,17516,172,51,-560,-183,22.3,1545.9
4844321630,1,10,1,0,7,7,6,0,0,0,0,16800,6.4,16059,172,48,315,-1225,22.0,1680.0,25,1,1,7,7,8,0,0,0,0,16485,6.8,17284,179,54,-315,1225,23.3,1648.5
4844286920,1,6,1,0,6,4,6,1,1,0,0,16492,7.0,18646,217,56,1614,1336,27.3,1649.2,27,0,1,3,5,2,0,0,0,0,14878,6.8,17310,189,60,-1614,-1336,24.9,1487.8
4844195048,0,10,1,1,6,8,8,0,0,0,0,15372,6.4,15873,194,35,-1636,-2531,22.9,1537.2,8,1,0,8,6,4,0,0,0,0,17008,7.0,18404,207,54,1636,2531,26.1,1700.8
4844152000,1,49,3,0,8,4,6,0,0,0,0,18446,7.0,18742,184,64,3158,3223,24.8,1844.6,78,0,1,4,8,3,1,1,0,0,15288,6.4,15519,159,54,-3158,-3223,21.3,1528.8
4844111877,0,12,1,1,9,5,7,0,0,0,0,16970,6.6,17062,199,44,1504,540,24.3,1697.0,12,1,0,5,9,6,1,1,0,0,15466,6.6,16522,171,60,-1504,-540,23.1,1546.6
4842533871,1,14,1,0,2,3,2,0,0,0,0,14219,6.4,16784,193,40,-2374,-2291,23.3,1421.9,14,0,1,3,2,3,0,0,0,0,16593,7.2,19075,216,72,2374,2291,28.8,1659.3
4842489630,1,39,2,1,6,2,7,0,0,0,0,16394,6.8,17491,190,68,2036,-686,25.8,1639.4,45,1,0,2,6,1,0,0,0,0,14358,7.0,18177,184,50,-2036,686,23.4,1435.8
4842411290,1,11,0,1,5,7,4,1,1,0,0,16768,7.0,18265,222,64,140,90,28.6,1676.8,14,0,0,7,5,6,0,0,0,0,16628,7.0,18175,204,48,-140,-90,25.2,1662.8
4842374474,0,220,0,0,3,13,4,0,0,0,0,14623,6.6,16800,165,52,-4747,-1592,21.7,1462.3,12,0,1,13,3,15,0,0,0,0,19370,6.8,18392,188,40,4747,1592,22.8,1937.0
4841344441,1,123,1,0,5,8,2,0,0,0,0,14587,6.2,16159,148,48,-2117,-2256,19.6,1458.7,21,0,1,8,5,4,0,0,0,0,16704,7.0,18415,173,54,2117,2256,22.7,1670.4
4841290643,0,12,1,0,9,7,9,0,0,0,0,17162,7.0,17008,197,55,23,-287,25.2,1716.2,35,1,1,7,9,5,0,0,0,0,17139,7.0,17295,189,61,-23,287,25.0,1713.9
4857614083,0,0,0,1,24,29,48,0,0,0,0,35315,11.0,40137,86,0,-2404,-393,8.6,3531.5,33,0,0,29,24,75,0,0,0,0,37719,11.0,40530,98,0,2404,393,9.8,3771.9
4857579480,1,9,1,0,3,5,4,1,1,0,1,15889,6.6,16912,195,52,855,-1078,24.7,1588.9,11,0,1,5,3,2,0,0,0,0,15034,7.2,17990,161,64,-855,1078,22.5,1503.4
4857551938,0,7,0,0,10,3,9,1,1,0,0,18298,7.0,19206,181,55,3241,2072,23.6,1829.8,15,0,1,3,10,0,0,0,0,0,15057,6.8,17134,200,56,-3241,-2072,25.6,1505.7
4857512280,0,13,0,1,3,4,0,1,0,1,0,14281,6.8,17227,175,52,101,1084,22.7,1428.1,13,2,0,4,3,2,0,0,0,0,14180,6.6,16143,163,44,-101,-1084,20.7,1418.0
4857470904,1,11,0,0,1,1,1,0,0,0,0,14819,7.0,18363,190,64,962,991,25.4,1481.9,11,0,1,1,1,1,0,0,0,0,13857,6.6,17372,184,60,-962,-991,24.4,1385.7
4857438730,0,12,2,0,2,6,3,0,0,0,0,14907,6.2,15234,147,48,-2399,-2007,19.5,1490.7,19,0,1,6,2,5,0,0,0,0,17306,7.0,17241,178,68,2399,2007,24.6,1730.6
4857348856,0,9,1,0,7,6,7,0,0,0,0,16374,7.0,17334,183,48,996,1914,23.1,1637.4,13,0,1,6,7,6,1,0,1,0,15378,6.2,15420,165,52,-996,-1914,21.7,1537.8
4857319254,0,0,1,1,29,24,82,0,0,0,1,39044,11.4,41587,106,0,-496,391,10.6,3904.4,16,0,0,24,29,60,0,0,0,0,39540,11.4,41196,107,0,496,-391,10.7,3954.0
4857286416,1,0,0,0,23,18,20,0,0,0,0,48768,10.0,47500,0,0,22306,19000,0.0,4876.8,216,0,1,6,11,11,0,0,0,0,26462,6.0,28500,0,0,-22306,-19000,0.0,2646.2
4857273764,1,0,0,0,15,16,18,0,0,0,0,47375,10.0,47500,1,0,19525,19000,0.1,4737.5,0,0,1,10,9,12,0,0,0,0,27850,6.0,28500,0,0,-19525,-19000,0.0,2785.0
4856836582,1,16,1,0,5,4,1,2,1,1,0,15492,7.0,17610,184,56,-102,70,24.0,1549.2,9,0,1,4,5,2,0,0,0,0,15594,6.8,17540,195,68,102,-70,26.3,1559.4
4856820392,0,90,1,0,1,7,1,0,0,0,0,15688,6.6,17703,185,47,-1551,-178,23.2,1568.8,11,1,1,7,1,8,1,1,0,0,17239,7.2,17881,205,60,1551,178,26.5,1723.9
4856810025,1,11,1,1,3,5,3,0,0,0,0,14314,6.6,16383,177,48,-1620,-2066,22.5,1431.4,10,0,0,5,3,2,0,0,0,0,15934,7.0,18449,222,60,1620,2066,28.2,1593.4
4856797981,0,0,0,0,18,19,35,0,0,0,1,36636,11.0,40469,116,0,-184,134,11.6,3663.6,0,0,1,19,18,44,0,0,0,0,36820,11.0,40335,103,0,184,-134,10.3,3682.0
4856783195,0,0,0,0,20,28,52,0,0,0,1,35465,10.8,37357,91,0,-4055,-4929,9.1,3546.5,0,0,1,28,20,89,0,0,0,0,39520,11.4,42286,105,0,4055,4929,10.5,3952.0
4856774099,0,0,0,0,18,42,32,0,0,0,0,35736,10.8,38582,86,0,-6378,-7837,8.6,3573.6,0,0,1,42,18,106,0,0,0,0,42114,12.0,46419,106,0,6378,7837,10.6,4211.4
4856765888,0,0,0,1,25,29,53,0,0,0,1,37644,11.6,42579,82,0,-1568,-788,8.2,3764.4,3,0,0,29,25,54,0,0,0,0,39212,11.4,43367,108,0,1568,788,10.8,3921.2
4856757736,1,0,0,0,22,22,59,0,0,0,0,35733,11.0,38905,114,0,-973,-125,11.4,3573.3,0,0,1,22,22,67,0,0,0,0,36706,10.6,39030,82,0,973,125,8.2,3670.6
4856748840,0,5,0,0,30,26,70,0,0,0,0,37854,11.8,43788,96,0,-1265,139,9.6,3785.4,0,0,1,26,30,58,0,0,0,0,39119,11.8,43649,117,0,1265,-139,11.7,3911.9
4856731631,0,0,0,0,13,21,28,0,0,0,1,34086,10.4,35183,88,0,-1839,-3438,8.8,3408.6,25,0,1,21,13,66,0,0,0,0,35925,11.0,38621,91,0,1839,3438,9.1,3592.5
4857264428,0,9,0,0,3,7,2,0,0,0,0,14681,6.6,16580,138,56,-1564,923,19.4,1468.1,16,0,1,7,3,9,0,0,0,0,16245,6.2,15657,166,48,1564,-923,21.4,1624.5
4855735661,0,27,1,1,7,3,12,0,0,0,0,17027,7.0,17467,193,40,3356,928,23.3,1702.7,9,1,0,3,7,3,1,1,0,0,13671,6.4,16539,155,56,-3356,-928,21.1,1367.1
4852528462,0,11,0,0,1,3,0,0,0,0,0,13489,6.8,17114,177,42,-2845,-1067,21.9,1348.9,6,2,1,3,1,3,1,1,0,0,16334,7.0,18181,221,52,2845,1067,27.3,1633.4
4851400465,0,9,7,0,1,5,1,0,0,0,0,13878,7.0,17407,119,49,-1228,-759,16.8,1387.8,22,1,1,5,1,3,1,1,0,0,15106,7.0,18166,188,54,1228,759,24.2,1510.6
4851383744,0,8,0,0,2,4,1,0,0,0,0,13826,6.8,17245,145,52,330,1169,19.7,1382.6,11,0,1,4,2,1,0,0,0,0,13496,6.4,16076,135,43,-330,-1169,17.8,1349.6
4850327232,1,8,2,0,3,6,2,0,0,0,0,13812,6.6,16263,169,52,-1055,971,22.1,1381.2,140,0,1,6,3,5,1,1,0,0,14867,6.4,15292,149,48,1055,-971,19.7,1486.7
4850313452,0,206,0,1,4,6,2,0,0,0,0,14082,6.8,16931,161,46,-1045,-602,20.7,1408.2,17,1,0,6,4,4,1,1,0,0,15127,6.8,17533,160,56,1045,602,21.6,1512.7
4849941032,1,83,1,0,2,2,3,0,0,0,0,14236,6.8,18228,174,52,1413,1040,22.6,1423.6,11,1,1,2,2,1,1,1,0,0,12823,6.6,17188,130,56,-1413,-1040,18.6,1282.3
4848811396,0,10,0,1,4,7,2,0,0,0,0,14443,6.6,16809,162,56,-455,-267,21.8,1444.3,10,0,0,7,4,2,0,0,0,0,14898,6.6,17076,140,48,455,267,18.8,1489.8
4847798712,1,14,0,0,4,4,1,0,0,0,0,14512,6.6,16369,167,44,-468,-686,21.1,1451.2,13,0,1,4,4,4,0,0,0,0,14980,6.8,17055,172,45,468,686,21.7,1498.0
4847359222,1,13,2,1,11,8,4,0,0,0,0,16206,6.4,15284,134,40,460,2230,17.4,1620.6,9,0,0,8,11,8,0,0,0,0,15746,5.6,13054,105,39,-460,-2230,14.4,1574.6
4847351971,1,18,2,1,9,3,5,0,0,0,0,16861,6.8,18416,174,44,3696,2751,21.8,1686.1,10,1,0,3,9,2,0,0,0,0,13165,6.4,15665,139,44,-3696,-2751,18.3,1316.5
4846768802,1,12,0,0,3,4,5,0,0,0,0,14003,6.6,16588,140,52,302,79,19.2,1400.3,13,0,1,4,3,1,1,1,0,0,13701,6.4,16509,166,38,-302,-79,20.4,1370.1
4845799884,1,9,1,1,3,5,2,0,0,0,0,15290,7.0,18305,173,52,627,1472,22.5,1529.0,408,0,0,5,3,3,1,1,0,0,14663,6.8,16833,173,40,-627,-1472,21.3,1466.3
4844021321,0,13,0,1,1,6,1,1,1,0,0,13908,6.6,17505,158,40,-2196,-1272,19.8,1390.8,13,0,0,6,1,4,0,0,0,0,16104,7.0,18777,178,52,2196,1272,23.0,1610.4
4843989459,1,11,0,1,6,6,3,1,1,0,0,17660,7.0,18563,184,56,3074,2691,24.0,1766.0,8,0,0,6,6,4,0,0,0,0,14586,6.4,15872,135,47,-3074,-2691,18.2,1458.6
4843966976,1,6,0,0,3,7,1,0,0,0,0,12880,6.0,15042,146,20,-2891,-3381,16.6,1288.0,6,0,1,7,3,2,1,1,0,0,15771,6.8,18423,152,60,2891,3381,21.2,1577.1
4841776279,0,10,0,1,8,6,5,0,0,0,0,16848,6.8,17011,167,44,2675,1179,21.1,1684.8,11,0,0,6,8,0,0,0,0,0,14173,6.4,15832,145,32,-2675,-1179,17.7,1417.3
4841067586,1,220,0,1,4,5,1,1,1,0,0,14571,7.2,18091,166,48,520,1077,21.4,1457.1,72,0,0,4,3,3,0,0,0,0,14051,6.6,17014,160,48,-520,-1077,20.8,1405.1
4841030631,0,25,0,1,4,6,0,0,0,0,0,13336,6.6,16838,154,48,-1084,-924,20.2,1333.6,8,12,0,6,4,2,0,0,0,0,14420,6.6,17762,152,51,1084,924,20.3,1442.0
4855102899,1,0,0,1,13,18,12,0,0,0,0,60600,12.0,55000,6,0,22000,22000,0.6,6060.0,0,0,0,12,7,13,0,0,0,0,38600,7.2,33000,4,0,-22000,-22000,0.4,3860.0
4855070858,0,0,0,0,15,24,40,0,0,0,0,34494,10.4,36189,87,0,-2249,-3356,8.7,3449.4,0,0,1,24,15,70,0,0,0,0,36743,11.0,39545,112,0,2249,3356,11.2,3674.3
4855031600,0,0,2,1,11,11,31,0,0,0,1,32759,10.2,34727,88,0,-881,-261,8.8,3275.9,6,0,0,11,11,25,0,0,0,0,33640,10.2,34988,105,0,881,261,10.5,3364.0
4851932769,1,0,0,1,24,19,48,0,0,0,1,38286,11.4,42866,121,0,2979,3569,12.1,3828.6,0,0,0,18,23,43,0,0,0,0,35307,10.8,39297,90,0,-2979,-3569,9.0,3530.7
4851887233,1,68,0,0,26,22,73,0,0,0,0,38243,11.6,43226,85,0,2608,3497,8.5,3824.3,0,0,1,22,26,49,0,0,0,0,35635,11.0,39729,73,0,-2608,-3497,7.3,3563.5
4851858215,1,24,0,1,34,16,103,0,0,0,0,39469,11.8,45336,102,0,3783,6417,10.2,3946.9,0,1,0,16,34,32,0,0,0,0,35686,10.8,38919,98,0,-3783,-6417,9.8,3568.6
4851817821,1,0,0,0,27,18,75,0,0,0,0,36868,11.0,41410,101,0,847,976,10.1,3686.8,0,0,1,18,27,39,0,0,0,0,36021,11.0,40434,91,0,-847,-976,9.1,3602.1
4851769151,1,0,0,1,39,24,114,0,0,0,0,39866,12.0,45200,92,0,3060,3565,9.2,3986.6,0,0,0,24,39,56,0,0,0,0,36806,11.4,41635,91,0,-3060,-3565,9.1,3680.6
4851742245,0,0,0,0,21,24,46,0,0,0,0,34982,10.8,38457,90,0,-1010,-890,9.0,3498.2,0,0,1,24,21,64,0,0,0,0,35992,11.0,39347,107,0,1010,890,10.7,3599.2
4851712467,1,0,0,0,18,19,37,0,0,0,0,34143,10.8,38733,90,0,-878,324,9.0,3414.3,0,0,1,19,18,51,0,0,0,0,35021,10.8,38409,92,0,878,-324,9.2,3502.1
4848910513,1,0,1,1,17,18,45,0,0,0,1,34788,10.8,37002,111,0,1263,-959,11.1,3478.8,2,0,0,18,17,44,0,0,0,0,33525,10.8,37961,83,0,-1263,959,8.3,3352.5
4848143661,1,18,0,0,26,26,79,0,0,0,0,37802,11.0,40555,101,0,876,566,10.1,3780.2,0,7,1,26,26,70,0,0,0,0,36926,11.0,39989,112,0,-876,-566,11.2,3692.6
4848131811,1,0,0,1,23,17,56,0,0,0,1,37748,11.2,41761,109,0,3566,5194,10.9,3774.8,0,0,0,17,23,35,0,0,0,0,34182,10.6,36567,79,0,-3566,-5194,7.9,3418.2
4845236021,1,0,0,1,19,19,50,0,0,0,0,35327,10.4,36864,101,0,314,-2510,10.1,3532.7,10,0,0,19,19,47,0,0,0,0,35013,11.0,39374,85,0,-314,2510,8.5,3501.3
4845212236,1,1,0,1,27,20,76,0,0,0,1,37793,10.8,39630,97,0,574,590,9.7,3779.3,37,0,0,20,27,52,0,0,0,0,37219,10.6,39040,85,0,-574,-590,8.5,3721.9
4845186982,0,0,0,0,18,20,40,0,0,0,1,35749,10.6,36549,83,0,-1050,-1748,8.3,3574.9,0,0,1,20,18,61,0,0,0,0,36799,10.8,38297,100,0,1050,1748,10.0,3679.9
4845167867,0,268,0,0,14,16,17,0,0,0,2,32143,10.4,36229,69,0,-3738,-1709,6.9,3214.3,19,0,1,16,14,31,0,0,0,0,35881,10.8,37938,113,0,3738,1709,11.3,3588.1
4843546804,0,2,0,1,15,26,32,0,0,0,0,36465,11.4,40995,102,0,-498,-2006,10.2,3646.5,0,0,0,26,15,64,0,0,0,0,36963,11.6,43001,100,0,498,2006,10.0,3696.3
4843523787,0,0,3,0,26,27,53,0,0,0,0,37401,11.2,40244,92,0,-1099,-3071,9.2,3740.1,24,0,1,27,26,80,0,0,0,0,38500,11.6,43315,92,0,1099,3071,9.2,3850.0
4841368617,1,0,0,0,19,16,47,0,0,0,0,35693,11.2,40942,74,0,2066,4914,7.4,3569.3,0,0,1,16,19,51,0,0,0,0,33627,10.4,36028,90,0,-2066,-4914,9.0,3362.7
4857290113,1,70,1,1,2,2,2,1,1,0,0,14858,6.6,17056,215,44,582,-314,25.9,1485.8,16,0,0,2,2,2,0,0,0,0,14276,6.8,17370,193,50,-582,314,24.3,1427.6
4857244206,0,16,0,0,7,9,4,0,0,0,0,14823,6.4,16272,144,44,-1795,-2846,18.8,1482.3,11,0,1,9,7,2,0,0,0,0,16618,7.2,19118,155,80,1795,2846,23.5,1661.8
4857192523,0,12,1,0,0,10,0,0,0,0,0,12703,6.4,15743,145,52,-4205,-1969,19.7,1270.3,15,1,1,10,0,8,1,1,0,0,16908,6.8,17712,152,60,4205,1969,21.2,1690.8
4856440328,1,11,0,0,7,8,2,1,1,0,0,15733,7.0,18153,173,48,-722,1745,22.1,1573.3,15,0,1,8,7,5,0,0,0,0,16455,6.8,16408,139,48,722,-1745,18.7,1645.5
4856400534,0,13,0,0,4,7,6,1,0,1,0,14015,6.2,15679,123,52,-1112,-1559,17.5,1401.5,14,0,1,7,4,5,1,1,0,0,15127,6.8,17238,160,52,1112,1559,21.2,1512.7
4855503296,1,0,0,0,9,15,12,0,0,0,0,58850,12.0,55000,0,0,21300,22000,0.0,5885.0,0,0,1,13,7,9,0,0,0,0,37550,7.2,33000,0,0,-21300,-22000,0.0,3755.0
4855494965,1,0,0,1,7,19,7,0,0,0,0,39871,10.0,47500,0,0,11321,19000,0.0,3987.1,0,0,0,15,3,14,0,0,0,0,28550,6.0,28500,0,0,-11321,-19000,0.0,2855.0
4854944640,0,0,0,1,26,22,74,0,0,0,0,37307,11.2,42392,81,0,-1833,148,8.1,3730.7,0,0,0,22,26,47,0,0,0,0,39140,11.6,42244,100,0,1833,-148,10.0,3914.0
4854925866,0,0,0,1,11,21,24,0,0,0,1,33054,10.0,34529,92,0,-5093,-5179,9.2,3305.4,0,0,0,21,11,65,0,0,0,0,38147,11.0,39708,109,0,5093,5179,10.9,3814.7
4854896702,1,3,0,1,13,11,34,0,0,0,1,36660,10.8,38026,108,0,4353,2663,10.8,3666.0,0,2,0,11,13,26,0,0,0,0,32307,10.2,35363,91,0,-4353,-2663,9.1,3230.7
4854852662,1,0,0,1,18,14,21,0,0,0,0,50101,10.4,49000,0,0,21901,20500,0.0,5010.1,2,0,0,10,14,7,0,0,0,0,28200,6.0,28500,0,0,-21901,-20500,0.0,2820.0
4854841163,1,15,0,1,19,19,22,0,0,0,0,71746,13.8,64000,0,0,25526,22000,0.0,7174.6,0,0,0,12,12,10,0,0,0,0,46220,9.0,42000,0,0,-25526,-22000,0.0,4622.0
4854820762,1,10,0,1,21,15,29,0,0,0,0,63400,12.0,55000,0,0,26900,22000,0.0,6340.0,0,0,0,10,16,5,0,0,0,0,36500,7.2,33000,0,0,-26900,-22000,0.0,3650.0
4854800903,1,0,0,1,30,14,25,0,0,0,0,66200,13.0,62500,0,0,31000,28000,0.0,6620.0,0,0,0,1,17,4,0,0,0,0,35200,7.4,34500,2,0,-31000,-28000,0.2,3520.0
4854731845,1,0,2,1,18,20,12,0,0,0,0,62010,12.0,55000,0,0,23024,22000,0.0,6201.0,40,1,0,10,8,13,0,0,0,0,38986,7.2,33000,15,0,-23024,-22000,1.5,3898.6
4854699687,1,173,0,1,16,21,20,0,0,0,0,61730,12.0,55000,3,0,22765,22000,0.3,6173.0,0,3,0,14,9,15,0,0,0,0,38965,7.2,33000,0,0,-22765,-22000,0.0,3896.5
4854391776,1,0,0,1,17,18,13,0,0,0,0,62740,12.0,55000,0,0,24840,22000,0.0,6274.0,0,0,0,9,8,10,0,0,0,0,37900,7.2,33000,0,0,-24840,-22000,0.0,3790.0
4854383033,1,24,3,1,12,23,14,0,0,0,0,61040,12.0,55000,3,0,22065,22000,0.3,6104.0,0,5,0,18,7,10,0,0,0,0,38975,7.2,33000,0,0,-22065,-22000,0.0,3897.5
4854374017,1,0,0,0,13,21,15,0,0,0,0,45600,10.0,47500,0,0,24400,19000,0.0,4560.0,0,0,1,12,4,9,0,0,0,0,21200,6.0,28500,0,0,-24400,-19000,0.0,2120.0
4854349484,1,20,0,1,13,17,14,0,0,0,0,48910,10.0,47500,7,0,20255,19000,0.7,4891.0,0,0,0,11,7,11,0,0,0,0,28655,6.0,28500,5,0,-20255,-19000,0.5,2865.5
4855524133,0,8,0,0,20,21,48,0,0,0,0,36252,11.0,39625,107,0,1525,-362,10.7,3625.2,0,2,1,21,20,52,0,0,0,0,34727,11.0,39987,94,0,-1525,362,9.4,3472.7
4855507600,1,90,0,0,20,26,31,0,0,0,0,35741,11.2,40790,97,0,-1501,-815,9.7,3574.1,0,0,1,26,20,59,0,0,0,0,37242,11.4,41605,103,0,1501,815,10.3,3724.2
4805825833,1,20,1,1,4,4,3,0,0,0,0,14814,6.8,17928,184,48,-380,-109,23.2,1481.4,11,2,0,4,4,4,0,0,0,0,15194,7.0,18037,202,60,380,109,26.2,1519.4
4804849123,0,74,1,0,2,4,2,0,0,0,0,14558,6.8,17832,188,52,-1045,-699,24.0,1455.8,20,1,1,4,2,3,0,0,0,0,15603,7.0,18531,209,56,1045,699,26.5,1560.3
4802250082,0,20,1,0,4,2,3,0,0,0,0,14120,6.4,15815,139,40,-598,-1370,17.9,1412.0,11,1,1,2,4,3,0,0,0,0,14718,6.8,17185,161,48,598,1370,20.9,1471.8
4802235568,0,7,0,0,5,14,1,1,1,0,0,14158,6.4,15790,122,43,-5833,-3039,16.5,1415.8,117,0,1,14,5,11,0,0,0,0,19991,7.0,18829,177,52,5833,3039,22.9,1999.1
4802081084,1,185,2,0,7,5,7,0,0,0,0,16605,6.6,16358,161,48,972,-271,20.9,1660.5,9,1,1,5,7,5,0,0,0,0,15633,6.6,16629,176,40,-972,271,21.6,1563.3
4802054523,1,13,0,1,2,1,2,1,1,0,0,14572,7.0,18722,202,66,2205,2026,26.8,1457.2,134,0,0,1,2,0,0,0,0,0,12367,6.4,16696,156,40,-2205,-2026,19.6,1236.7
4802034887,0,12,2,1,9,8,5,0,0,0,0,16404,6.4,16020,176,40,-295,1318,21.6,1640.4,16,3,0,8,9,12,1,1,0,0,16699,6.2,14702,128,44,295,-1318,17.2,1669.9
4801999528,0,12,1,1,2,5,1,0,0,0,0,12961,6.4,15592,147,44,-2211,-565,19.1,1296.1,13,3,0,5,2,4,1,1,0,0,15172,6.4,16157,179,44,2211,565,22.3,1517.2
4801971971,1,11,1,0,2,3,0,0,0,0,0,14390,6.8,18458,208,52,-421,-444,26.0,1439.0,14,0,1,3,2,2,0,0,0,0,14811,7.2,18902,210,64,421,444,27.4,1481.1
4801932148,1,12,0,1,7,3,1,0,0,0,0,15066,6.8,17429,184,43,2038,1373,22.7,1506.6,16,1,0,3,7,1,0,0,0,0,13028,6.6,16056,145,44,-2038,-1373,18.9,1302.8
4801899288,1,81,0,1,5,4,5,1,1,0,0,16244,7.0,17733,179,60,1917,491,23.9,1624.4,9,1,0,4,5,4,0,0,0,0,14327,6.6,17242,180,31,-1917,-491,21.1,1432.7
4801857530,0,23,1,0,6,7,3,1,1,0,0,15330,6.8,17744,150,60,-1150,-36,21.0,1533.0,12,3,1,7,6,7,0,0,0,0,16480,6.8,17780,197,48,1150,36,24.5,1648.0
4801542691,1,10,1,1,7,5,4,0,0,0,0,17437,6.8,17298,176,44,1846,293,22.0,1743.7,15,1,0,5,7,7,1,1,0,0,15591,6.8,17005,186,48,-1846,-293,23.4,1559.1
4801310218,0,11,0,0,2,4,0,0,0,0,0,13283,6.4,16337,120,60,-1149,-427,18.0,1328.3,15,1,1,4,2,2,1,1,0,0,14432,6.8,16764,188,56,1149,427,24.4,1443.2
4801269724,1,16,0,1,4,9,4,0,0,0,0,14250,6.6,16456,155,51,-1895,274,20.6,1425.0,38,2,0,9,4,7,0,0,0,0,16145,6.6,16182,153,36,1895,-274,18.9,1614.5
4801246076,1,77,1,1,7,0,5,0,0,0,0,15898,6.8,17678,139,64,3702,1905,20.3,1589.8,10,1,0,0,7,0,1,1,0,0,12196,6.2,15773,171,28,-3702,-1905,19.9,1219.6
4801201895,0,19,0,0,8,5,5,0,0,0,0,15242,5.8,14746,122,32,-1377,450,15.4,1524.2,13,0,1,5,8,4,0,0,0,0,16619,6.2,14296,129,46,1377,-450,17.5,1661.9
4800229111,1,13,2,0,10,11,6,0,0,0,0,17159,6.4,16387,195,24,-186,331,21.9,1715.9,16,1,1,11,10,12,0,0,0,0,17345,6.4,16056,136,36,186,-331,17.2,1734.5
4834423231,1,30,1,1,4,0,1,1,1,0,0,16604,7.2,18745,204,58,4300,2724,26.2,1660.4,10,9,0,0,4,0,0,0,0,0,12304,6.6,16021,159,49,-4300,-2724,20.8,1230.4
4771371938,1,13,1,1,14,4,16,0,0,0,0,17215,5.8,13984,127,32,3651,1238,15.9,1721.5,117,0,0,4,14,6,0,0,0,0,13564,5.6,12746,130,26,-3651,-1238,15.6,1356.4
4768268861,1,14,0,1,8,4,5,0,0,0,0,17772,6.8,18230,177,48,3973,2620,22.5,1777.2,62,1,0,4,8,1,0,0,0,0,13799,6.4,15610,137,40,-3973,-2620,17.7,1379.9
4765589084,0,11,0,0,6,3,9,1,1,0,0,16218,6.4,16836,154,60,2051,-738,21.4,1621.8,14,0,1,3,6,1,0,0,0,0,14167,7.0,17574,181,52,-2051,738,23.3,1416.7
4764657647,0,7,1,0,5,11,2,0,0,0,0,13981,6.4,15456,150,44,-4655,-1228,19.4,1398.1,7,0,1,11,5,8,0,0,0,0,18636,6.4,16684,201,36,4655,1228,23.7,1863.6
4764196509,0,13,0,1,2,4,3,0,0,0,0,13959,6.4,16248,179,40,-969,-677,21.9,1395.9,41,0,0,4,2,4,0,0,0,0,14928,6.8,16925,159,40,969,677,19.9,1492.8
4764158206,0,10,0,1,5,5,5,0,0,0,0,15179,6.6,17384,183,40,-650,-1156,22.3,1517.9,17,0,0,5,5,2,1,1,0,0,15829,7.0,18540,166,56,650,1156,22.2,1582.9
4764134573,0,12,3,1,3,6,4,0,0,0,0,15633,6.6,17314,209,56,-529,-1908,26.5,1563.3,14,1,0,6,3,4,1,1,0,0,16162,7.2,19222,201,64,529,1908,26.5,1616.2
4764106608,1,247,0,0,8,10,7,1,1,0,0,16543,6.4,15795,141,44,-2313,-3001,18.5,1654.3,9,0,1,10,8,7,0,0,0,0,18856,7.0,18796,190,48,2313,3001,23.8,1885.6
4764068512,1,9,1,0,11,6,7,2,1,1,0,17285,6.8,17480,187,40,3416,666,22.7,1728.5,11,1,1,4,9,3,0,0,0,0,13869,6.6,16814,149,48,-3416,-666,19.7,1386.9
4764027185,1,13,2,0,2,7,0,1,1,0,0,14136,6.8,17232,179,68,-1174,1946,24.7,1413.6,13,1,1,7,2,10,0,0,0,0,15310,6.4,15286,164,16,1174,-1946,18.0,1531.0
4763988658,1,13,0,1,10,3,3,1,1,0,0,18136,7.0,18436,169,64,4956,2615,23.3,1813.6,9,1,0,3,10,2,0,0,0,0,13180,6.6,15821,165,36,-4956,-2615,20.1,1318.0
4763946177,0,12,1,1,9,1,8,0,0,0,0,17333,6.4,16884,193,36,4295,1056,22.9,1733.3,10,1,0,1,9,0,1,1,0,0,13038,6.4,15828,167,52,-4295,-1056,21.9,1303.8
4763896484,0,12,1,0,0,5,0,0,0,0,0,13686,6.2,15843,163,59,-2717,-1660,22.2,1368.6,10,1,1,5,0,4,0,0,0,0,16403,6.8,17503,165,52,2717,1660,21.7,1640.3
4763235376,0,11,1,1,5,5,8,0,0,0,0,15828,6.4,16134,151,43,999,-823,19.4,1582.8,42,0,0,5,5,9,1,1,0,0,14829,6.8,16957,134,52,-999,823,18.6,1482.9
4763212608,1,12,0,0,7,6,2,0,0,0,0,15809,6.8,17629,184,49,313,2343,23.3,1580.9,6,1,1,6,7,5,0,0,0,0,15496,6.2,15286,140,50,-313,-2343,19.0,1549.6
4758067533,0,9,0,1,4,2,1,0,0,0,0,15826,7.0,17639,171,72,-121,-457,24.3,1582.6,12,0,0,2,4,3,1,1,0,0,15947,7.0,18096,213,60,121,457,27.3,1594.7
4758013561,0,13,1,0,1,5,0,0,0,0,0,14231,6.6,16687,182,44,-2395,-1879,22.6,1423.1,9,0,1,5,1,2,0,0,0,0,16626,7.0,18566,143,68,2395,1879,21.1,1662.6
4742225205,0,72,1,1,4,3,3,0,0,0,0,14773,6.8,17873,172,44,438,111,21.6,1477.3,13,2,0,3,4,2,0,0,0,0,14335,6.8,17762,212,56,-438,-111,26.8,1433.5
4696339202,1,14,1,0,5,3,3,1,1,0,0,16254,6.6,16630,159,48,1050,17,20.7,1625.4,75,0,1,3,5,2,0,0,0,0,15204,6.6,16613,178,52,-1050,-17,23.0,1520.4
4743812904,1,295,1,0,7,10,5,1,1,0,0,15901,6.4,15877,147,54,-1736,-1577,20.1,1590.1,14,1,1,10,7,3,0,0,0,0,17637,6.6,17454,142,48,1736,1577,19.0,1763.7
4743778830,1,16,1,1,9,3,6,1,1,0,0,16903,7.0,18419,183,55,3246,3039,23.8,1690.3,13,0,0,3,9,3,0,0,0,0,13657,6.4,15380,138,52,-3246,-3039,19.0,1365.7
4740632492,0,8,0,1,5,5,2,1,0,1,0,14101,6.4,16121,150,34,-2393,-2799,18.4,1410.1,77,1,0,5,5,3,1,1,0,0,16494,7.2,18920,197,64,2393,2799,26.1,1649.4
4740465850,1,10,8,1,5,8,4,1,1,0,0,14771,6.8,16324,170,59,-2089,-2345,22.9,1477.1,144,0,0,8,5,6,0,0,0,0,16860,7.0,18669,185,48,2089,2345,23.3,1686.0
4740430355,0,14,1,1,6,4,4,0,0,0,0,16335,6.6,16598,158,52,1900,-183,21.0,1633.5,18,1,0,4,6,8,1,1,0,0,14435,6.4,16781,158,64,-1900,183,22.2,1443.5
4739784043,0,11,0,1,6,6,4,1,0,1,0,15179,6.4,16687,153,48,-1291,-1818,20.1,1517.9,11,0,0,6,6,4,0,0,0,0,16470,7.0,18505,204,56,1291,1818,26.0,1647.0
4739515766,1,71,0,0,7,5,5,0,0,0,0,16252,6.8,17017,166,51,-537,324,21.7,1625.2,12,0,1,5,7,3,1,1,0,0,16789,6.6,16693,169,36,537,-324,20.5,1678.9
4739487793,1,12,1,1,4,2,8,1,1,0,0,14264,6.4,15973,144,48,-315,-432,19.2,1426.4,13,0,0,2,4,3,0,0,0,0,14579,6.8,16405,170,40,315,432,21.0,1457.9
4739268486,0,15,0,0,6,6,2,0,0,0,0,14948,6.4,15367,120,48,-1694,-1448,16.8,1494.8,13,2,1,6,6,5,0,0,0,0,16642,6.8,16815,165,56,1694,1448,22.1,1664.2
4739253438,0,105,0,0,2,9,0,0,0,0,0,15064,6.8,17009,216,44,-2802,-2837,26.0,1506.4,10,1,1,9,2,1,0,0,0,0,17866,7.2,19846,212,68,2802,2837,28.0,1786.6
4739083068,1,12,1,1,4,2,3,0,0,0,0,15873,7.0,18637,170,56,3457,3003,22.6,1587.3,11,1,0,2,4,0,1,1,0,0,12416,6.2,15634,137,59,-3457,-3003,19.6,1241.6
4739051490,0,8,0,1,8,6,6,0,0,0,0,15709,7.0,18118,176,32,212,-156,20.8,1570.9,22,0,0,6,8,2,1,1,0,0,15497,7.2,18274,193,56,-212,156,24.9,1549.7
4739023551,1,12,1,0,2,6,0,0,0,0,0,13565,6.4,16102,160,24,-2431,-1171,18.4,1356.5,14,0,1,6,2,5,1,1,0,0,15996,6.8,17273,158,56,2431,1171,21.4,1599.6
4636947818,1,13,4,1,6,5,10,0,0,0,0,16286,6.6,16146,195,40,606,-1067,23.5,1628.6,54,0,0,5,6,8,2,1,1,0,15680,6.8,17213,167,60,-606,1067,22.7,1568.0
4625788832,0,15,1,0,3,3,3,0,0,0,0,13271,6.6,16969,159,56,-1038,-1066,21.5,1327.1,26,0,1,3,3,4,1,1,0,0,14309,7.0,18035,160,60,1038,1066,22.0,1430.9
4625725825,1,18,1,1,2,1,0,0,0,0,0,13916,6.8,17215,171,53,462,267,22.4,1391.6,14,0,0,1,2,0,0,0,0,0,13454,6.8,16948,159,51,-462,-267,21.0,1345.4
4607152832,0,15,11,1,6,9,6,0,0,0,0,14513,6.6,16038,153,40,-2422,-724,19.3,1451.3,44,4,0,9,6,7,0,0,0,0,16935,6.4,16762,159,44,2422,724,20.3,1693.5
4607107501,1,13,2,1,9,7,3,1,1,0,0,16456,7.0,16897,166,60,162,44,22.6,1645.6,9,1,0,7,9,3,0,0,0,0,16294,6.8,16853,180,68,-162,-44,24.8,1629.4
4607078977,0,12,2,1,4,6,3,0,0,0,0,14956,6.4,15878,138,44,-1940,-1996,18.2,1495.6,12,2,0,6,4,3,1,1,0,0,16896,6.8,17874,162,48,1940,1996,21.0,1689.6
4836162932,1,13,0,1,5,3,6,0,0,0,0,16317,6.8,17696,180,40,1156,-120,22.0,1631.7,14,2,0,3,5,4,1,1,0,0,15161,7.0,17816,162,56,-1156,120,21.8,1516.1
4836028613,0,10,0,0,3,11,3,1,1,0,0,13641,6.2,14909,135,48,-4641,-3358,18.3,1364.1,13,2,1,11,3,10,0,0,0,0,18282,7.0,18267,202,44,4641,3358,24.6,1828.2
4835865626,0,18,0,0,1,4,0,0,0,0,0,11738,6.2,15213,133,43,-4210,-1057,17.6,1173.8,15,1,1,4,1,4,0,0,0,0,15948,6.2,16270,181,36,4210,1057,21.7,1594.8
4835832346,1,14,0,1,4,3,5,1,0,1,0,15252,7.0,17845,188,52,1469,1465,24.0,1525.2,13,1,0,3,4,4,1,1,0,0,13783,6.4,16380,182,58,-1469,-1465,24.0,1378.3
4835777010,1,11,0,1,3,1,2,1,0,1,0,15787,7.2,18824,217,64,2189,1042,28.1,1578.7,13,1,0,1,3,1,0,0,0,0,13598,6.8,17782,174,72,-2189,-1042,24.6,1359.8
4835721997,0,11,0,1,10,5,8,0,0,0,0,17574,6.8,16755,183,42,2079,403,22.5,1757.4,13,0,0,5,10,7,0,0,0,0,15495,6.8,16352,138,49,-2079,-403,18.7,1549.5
4835689029,0,11,0,0,5,11,5,0,0,0,0,14777,6.4,16039,164,40,-3343,-2982,20.4,1477.7,9,1,1,11,5,6,1,1,0,0,18120,7.2,19021,208,60,3343,2982,26.8,1812.0
4835660942,1,15,1,1,3,2,3,1,0,1,0,15226,6.6,17114,174,40,2398,13,21.4,1522.6,121,0,0,2,3,0,1,1,0,0,12828,6.6,17101,144,62,-2398,-13,20.6,1282.8
4227008153,0,0,0,1,13,12,35,0,0,0,1,33556,10.2,35344,86,0,1044,-1418,8.6,3355.6,0,0,0,12,13,13,0,0,0,0,32512,10.4,36762,89,0,-1044,1418,8.9,3251.2
4222933873,1,0,0,0,11,14,28,0,0,0,2,34238,10.6,37049,112,0,2450,1361,11.2,3423.8,0,0,1,14,11,21,0,0,0,0,31788,10.4,35688,74,0,-2450,-1361,7.4,3178.8
4205067869,1,0,0,1,18,14,50,0,0,0,1,37020,11.0,39430,101,0,5164,3922,10.1,3702.0,4,0,0,14,18,30,0,0,0,0,31856,10.0,35508,78,0,-5164,-3922,7.8,3185.6
4205047201,0,0,0,0,12,21,17,0,0,0,2,32315,10.4,37619,73,0,-4881,-3450,7.3,3231.5,0,0,1,21,12,47,0,0,0,0,37196,11.4,41069,109,0,4881,3450,10.9,3719.6
4204206681,1,5,0,0,15,11,28,0,0,0,1,35122,10.4,37442,121,0,3075,2266,12.1,3512.2,0,1,1,11,15,24,0,0,0,0,32047,10.4,35176,83,0,-3075,-2266,8.3,3204.7
4204171599,0,0,0,0,13,14,29,0,0,0,0,33025,10.6,36475,86,0,341,661,8.6,3302.5,0,0,1,14,13,19,0,0,0,0,32684,10.4,35814,109,0,-341,-661,10.9,3268.4
4204156692,0,16,0,0,9,20,23,0,0,0,1,30820,9.8,33041,109,0,-5080,-5561,10.9,3082.0,0,5,1,20,9,60,0,0,0,0,35900,11.0,38602,113,0,5080,5561,11.3,3590.0
4204130950,0,0,0,1,25,27,64,0,0,0,1,35937,11.2,39692,87,0,-3136,-4540,8.7,3593.7,22,0,0,27,25,63,0,0,0,0,39073,11.4,44232,112,0,3136,4540,11.2,3907.3
4157857820,0,29,0,0,2,11,2,0,0,0,0,14199,6.6,16337,195,48,-3653,-3035,24.3,1419.9,33,0,1,11,2,7,0,0,0,0,17852,7.4,19372,204,52,3653,3035,25.6,1785.2
4753063171,1,12,0,1,8,6,7,0,0,0,0,16291,7.0,18385,150,64,999,1065,21.4,1629.1,64,0,0,6,8,1,0,0,0,0,15292,6.8,17320,188,36,-999,-1065,22.4,1529.2
4753019401,1,85,0,0,5,5,6,1,1,0,0,15604,7.0,17593,147,56,1003,-136,20.3,1560.4,9,0,1,5,5,0,0,0,0,0,14601,7.0,17729,165,48,-1003,136,21.3,1460.1
4749448286,0,20,9,1,7,7,5,1,1,0,0,15656,6.6,17287,177,40,-661,-776,21.7,1565.6,34,0,0,6,6,3,0,0,0,0,16317,7.0,18063,190,56,661,776,24.6,1631.7
4749428667,0,11,0,0,6,6,6,0,0,0,0,14590,5.8,13892,132,39,-1620,-3332,17.1,1459.0,7,0,1,6,6,4,0,0,0,0,16210,6.8,17224,186,43,1620,3332,22.9,1621.0
4741938218,1,10,1,1,5,6,5,0,0,0,0,16721,6.8,17560,170,48,-10,-568,21.8,1672.1,219,1,0,6,5,6,0,0,0,0,16731,7.0,18128,192,56,10,568,24.8,1673.1
4741913743,1,11,3,0,3,4,1,0,0,0,0,15029,6.8,17564,158,48,-1004,-1337,20.6,1502.9,10,1,1,4,3,2,0,0,0,0,16033,7.0,18901,228,68,1004,1337,29.6,1603.3
4741807838,0,27,3,1,3,2,1,0,0,0,0,14475,6.6,17179,168,51,-118,-355,21.9,1447.5,13,2,0,2,3,3,1,1,0,0,14593,6.8,17534,171,56,118,355,22.7,1459.3
4736758604,1,17,0,0,4,1,2,0,0,0,0,15114,7.0,17944,201,48,2180,1042,24.9,1511.4,11,0,1,1,4,2,0,0,0,0,12934,6.8,16902,157,44,-2180,-1042,20.1,1293.4
4735306428,0,12,2,1,5,2,4,0,0,0,0,15086,6.8,16952,152,52,2097,1174,20.4,1508.6,13,0,0,2,5,1,0,0,0,0,12989,6.4,15778,144,48,-2097,-1174,19.2,1298.9
4735284780,1,15,0,1,3,2,4,0,0,0,0,14207,6.8,17788,166,56,192,-483,22.2,1420.7,12,0,0,2,3,2,0,0,0,0,14015,6.8,18271,176,52,-192,483,22.8,1401.5
4734811855,1,13,10,0,4,4,2,1,1,0,0,15578,7.0,18634,243,44,591,1863,28.7,1557.8,28,2,1,4,4,3,0,0,0,0,14987,6.6,16771,193,48,-591,-1863,24.1,1498.7
4734769600,0,13,0,0,8,7,4,0,0,0,0,15949,6.6,16504,156,44,-977,-803,20.0,1594.9,14,1,1,7,8,5,0,0,0,0,16926,6.8,17307,185,56,977,803,24.1,1692.6
4734197782,1,36,3,1,9,3,9,1,0,1,0,18456,6.8,17364,194,68,4109,1123,26.2,1845.6,20,5,0,3,9,2,0,0,0,0,14347,6.6,16241,175,35,-4109,-1123,21.0,1434.7
4734158506,1,7,0,1,4,3,2,1,1,0,0,15064,6.8,18607,152,52,-390,707,20.4,1506.4,5,1,0,3,4,4,0,0,0,0,15454,6.8,17900,188,48,390,-707,23.6,1545.4
4733826383,0,54,1,1,1,1,1,0,0,0,0,14646,7.2,19209,209,43,-227,119,25.2,1464.6,18,1,0,1,1,1,1,1,0,0,14873,7.0,19090,203,60,227,-119,26.3,1487.3
4733805746,1,14,2,1,8,2,6,0,0,0,0,17069,7.0,17934,175,56,3510,1597,23.1,1706.9,226,1,0,2,8,1,0,0,0,0,13559,6.4,16337,173,44,-3510,-1597,21.7,1355.9
4733765249,1,11,3,1,3,2,2,1,1,0,0,14334,6.6,16358,142,44,331,-174,18.6,1433.4,228,0,0,2,3,1,0,0,0,0,14003,6.6,16532,195,36,-331,174,23.1,1400.3
4732703703,0,44,5,0,5,3,4,0,0,0,0,14162,5.8,14800,150,23,-1143,-2567,17.3,1416.2,36,0,1,3,5,1,1,1,0,0,15305,6.8,17367,192,56,1143,2567,24.8,1530.5
4731540721,1,54,0,0,17,12,14,0,0,0,0,63450,12.0,55000,1,0,26200,21000,0.1,6345.0,2,0,1,6,11,6,0,0,0,0,37250,7.4,34000,1,0,-26200,-21000,0.1,3725.0
4857621599,1,15,0,0,17,13,18,0,0,0,0,61650,12.0,55000,0,0,24800,22000,0.0,6165.0,1,0,1,10,14,8,0,0,0,0,36850,7.2,33000,0,0,-24800,-22000,0.0,3685.0
4857419556,1,0,0,1,22,16,18,0,0,0,0,64187,13.0,62500,2,0,27687,25000,0.2,6418.7,0,0,0,7,13,11,0,0,0,0,36500,7.8,37500,0,0,-27687,-25000,0.0,3650.0
4856617011,1,0,3,1,16,17,12,0,0,0,0,45615,10.0,47500,0,0,17240,19000,0.0,4561.5,26,0,0,6,5,13,0,0,0,0,28375,6.0,28500,9,0,-17240,-19000,0.9,2837.5
4856599520,1,0,0,0,14,17,13,0,0,0,0,45172,10.0,47500,0,0,16972,19000,0.0,4517.2,0,0,1,11,8,12,0,0,0,0,28200,6.0,28500,0,0,-16972,-19000,0.0,2820.0
4855524535,1,6,0,0,17,18,16,0,0,0,0,46375,10.0,47500,1,0,18040,19000,0.1,4637.5,0,0,1,11,10,10,0,0,0,0,28335,6.0,28500,3,0,-18040,-19000,0.3,2833.5
4855172103,0,38,2,0,4,5,6,0,0,0,0,14452,6.6,16914,162,56,-1884,-2514,21.8,1445.2,30,1,1,5,4,5,1,1,0,0,16336,7.2,19428,219,64,1884,2514,28.3,1633.6
4855099078,0,13,0,0,2,5,1,0,0,0,0,14604,6.6,16095,170,48,-1791,-1404,21.8,1460.4,14,2,1,5,2,5,1,1,0,0,16395,6.8,17499,184,52,1791,1404,23.6,1639.5
4848811113,1,11,0,1,5,6,6,0,0,0,0,15086,6.6,17499,161,46,-270,-239,20.7,1508.6,207,0,0,6,5,4,1,1,0,0,15356,6.6,17738,166,46,270,239,21.2,1535.6
4848764277,1,25,0,0,6,5,2,1,1,0,0,15866,6.8,17667,154,56,1263,914,21.0,1586.6,10,2,1,5,6,3,0,0,0,0,14603,6.6,16753,169,36,-1263,-914,20.5,1460.3
4846960118,0,10,1,1,5,2,5,1,1,0,0,15050,6.8,17457,188,48,136,374,23.6,1505.0,13,2,0,2,5,3,0,0,0,0,14914,6.8,17083,201,72,-136,-374,27.3,1491.4
4846914903,1,13,2,1,3,0,1,0,0,0,0,15170,7.2,18854,215,56,1361,1407,27.1,1517.0,11,2,0,0,3,0,0,0,0,0,13809,7.0,17447,204,48,-1361,-1407,25.2,1380.9
4846291859,0,13,0,0,3,6,1,0,0,0,0,12412,6.4,16103,139,44,-4339,-2684,18.3,1241.2,8,0,1,6,3,3,0,0,0,0,16751,7.0,18787,214,48,4339,2684,26.2,1675.1
4842529439,1,12,0,0,5,17,6,0,0,0,0,30289,10.4,35687,80,47,-4285,-6240,12.7,3028.9,12,0,1,17,5,31,0,0,0,0,34574,11.2,41927,93,67,4285,6240,16.0,3457.4
4838420333,1,8,0,0,2,3,0,0,0,0,0,14036,7.0,18328,196,72,601,2201,26.8,1403.6,8,0,1,3,2,2,0,0,0,0,13435,6.6,16127,141,44,-601,-2201,18.5,1343.5
4838376591,0,10,3,0,6,7,5,1,1,0,0,16156,6.8,17731,179,64,258,1067,24.3,1615.6,70,1,1,7,6,1,0,0,0,0,15898,6.2,16664,180,40,-258,-1067,22.0,1589.8
4838321378,1,13,1,1,1,1,1,0,0,0,0,14210,6.8,17854,183,54,79,-216,23.7,1421.0,15,1,0,1,1,1,0,0,0,0,14131,7.0,18070,210,64,-79,216,27.4,1413.1
4823222260,1,18,0,0,9,8,14,0,0,0,0,26981,10.0,33238,47,59,517,467,10.6,2698.1,26,0,1,8,9,24,0,0,0,0,26464,10.2,32771,39,51,-517,-467,9.0,2646.4
4823205447,0,10,1,0,17,18,34,0,0,0,1,36684,11.2,39885,98,59,-1047,730,15.7,3668.4,75,0,1,18,17,39,0,0,0,0,37731,10.8,39155,96,59,1047,-730,15.5,3773.1
4823188707,1,29,0,1,13,17,22,0,0,0,0,36928,11.0,38604,37,51,2835,1467,8.8,3692.8,10,1,0,17,13,37,0,0,0,0,34093,10.6,37137,55,48,-2835,-1467,10.3,3409.3
4823175941,0,0,0,0,14,26,34,0,0,0,0,33373,10.4,35450,88,0,-4098,-4706,8.8,3337.3,25,0,1,26,14,62,0,0,0,0,37471,11.0,40156,88,0,4098,4706,8.8,3747.1
4812217803,0,15,2,1,5,3,5,0,0,0,0,15354,6.8,17203,192,32,1871,513,22.4,1535.4,10,1,0,3,5,1,1,0,1,0,13483,6.6,16690,165,48,-1871,-513,21.3,1348.3
4812190031,0,10,1,1,6,5,3,1,1,0,0,16052,6.8,17282,156,56,1267,573,21.2,1605.2,10,1,0,5,6,2,0,0,0,0,14785,6.6,16709,135,56,-1267,-573,19.1,1478.5
4758090194,1,126,1,0,4,6,3,1,1,0,0,15437,6.8,16952,200,52,-1823,-1226,25.2,1543.7,13,1,1,6,4,5,0,0,0,0,17260,7.0,18178,182,60,1823,1226,24.2,1726.0
4745426057,0,22,1,0,2,3,0,0,0,0,0,12381,6.2,15226,134,44,-2976,-3608,17.8,1238.1,14,13,1,3,2,2,0,0,0,0,15357,7.4,18834,200,72,2976,3608,27.2,1535.7
4745383026,1,15,1,0,3,3,3,0,0,0,0,14020,6.6,17099,183,56,-1126,-508,23.9,1402.0,15,3,1,3,3,5,1,0,1,0,15146,6.8,17607,184,52,1126,508,23.6,1514.6
4745342242,0,13,1,1,2,3,3,0,0,0,0,14141,6.4,15696,164,48,44,-987,21.2,1414.1,12,0,0,3,2,3,1,1,0,0,14097,6.4,16683,153,56,-44,987,20.9,1409.7
4745321072,0,10,1,0,1,5,1,0,0,0,0,13179,6.2,15508,130,41,-2219,-1424,17.1,1317.9,11,1,1,5,1,3,0,0,0,0,15398,6.4,16932,179,44,2219,1424,22.3,1539.8
4738648941,0,13,2,1,5,13,7,1,1,0,0,15327,6.6,16461,155,36,-3560,-2003,19.1,1532.7,12,1,0,13,5,14,1,0,1,0,18887,7.0,18464,142,79,3560,2003,22.1,1888.7
4738318506,1,12,2,0,5,8,6,1,1,0,0,15312,6.4,15932,172,52,-1751,-2314,22.4,1531.2,12,0,1,8,5,5,0,0,0,0,17063,7.0,18246,215,43,1751,2314,25.8,1706.3
4738292247,0,25,0,0,10,7,8,0,0,0,0,17835,7.0,18049,176,42,1656,1139,21.8,1783.5,9,2,1,7,10,7,1,1,0,0,16179,6.8,16910,161,53,-1656,-1139,21.4,1617.9
4738252597,1,12,0,1,5,3,3,1,1,0,0,15833,6.8,17534,155,56,2026,1244,21.1,1583.3,11,0,0,2,4,2,0,0,0,0,13807,6.6,16290,163,40,-2026,-1244,20.3,1380.7
4733604860,1,30,1,0,1,4,1,0,0,0,0,13867,7.2,18056,195,56,-1452,858,25.1,1386.7,9,2,1,4,1,3,2,1,1,0,15319,6.8,17198,182,56,1452,-858,23.8,1531.9
4733556421,0,67,2,0,2,5,1,1,1,0,0,13722,6.8,17041,170,64,-1393,-284,23.4,1372.2,8,3,1,5,2,4,0,0,0,0,15115,6.8,17325,156,48,1393,284,20.4,1511.5
4731401052,0,15,1,0,0,10,0,0,0,0,0,12080,6.4,15721,153,56,-5157,-2556,20.9,1208.0,22,3,1,10,0,4,1,1,0,0,17237,7.0,18277,178,60,5157,2556,23.8,1723.7
4729993471,1,7,3,1,3,0,3,1,1,0,0,15442,7.0,18476,214,48,2434,1247,26.2,1544.2,34,2,0,0,3,0,0,0,0,0,13008,6.6,17229,192,64,-2434,-1247,25.6,1300.8
4729952397,1,9,1,1,1,1,0,1,1,0,0,12063,6.6,16951,126,44,-596,1584,17.0,1206.3,18,0,0,1,1,0,0,0,0,0,12659,6.2,15367,152,48,596,-1584,20.0,1265.9
4726993702,1,22,3,1,3,0,6,0,0,0,0,14936,6.8,17200,207,55,1431,-393,26.2,1493.6,11,0,0,0,3,0,0,0,0,0,13505,6.8,17593,194,52,-1431,393,24.6,1350.5
4726945399,0,68,2,0,3,6,2,0,0,0,0,14877,6.6,16335,154,44,-1201,-1418,19.8,1487.7,16,1,1,6,3,8,0,0,0,0,16078,6.8,17753,202,56,1201,1418,25.8,1607.8
4726683291,1,20,2,1,6,3,6,1,0,1,0,16637,7.0,17929,208,60,3234,1141,26.8,1663.7,13,2,0,3,6,2,0,0,0,0,13403,6.6,16788,144,44,-3234,-1141,18.8,1340.3
4856906688,0,14,1,0,3,5,0,0,0,0,0,14423,6.8,17510,179,52,-93,-540,23.1,1442.3,11,0,1,5,3,1,0,0,0,0,14516,6.8,18050,144,52,93,540,19.6,1451.6
4856881698,1,13,2,1,5,6,3,0,0,0,0,15148,6.8,17998,169,42,850,1174,21.1,1514.8,11,0,0,6,5,2,0,0,0,0,14298,6.6,16824,158,48,-850,-1174,20.6,1429.8
4855954546,1,14,0,1,7,2,3,0,0,0,0,15908,6.8,18047,172,50,2094,153,22.2,1590.8,7,0,0,2,7,2,0,0,0,0,13814,6.8,17894,160,44,-2094,-153,20.4,1381.4
4855383774,1,9,0,1,6,3,3,1,1,0,0,16175,6.8,17765,211,44,1995,1505,25.5,1617.5,13,0,0,3,6,3,0,0,0,0,14180,6.6,16260,153,56,-1995,-1505,20.9,1418.0
4855336223,1,44,1,1,10,4,15,1,1,0,0,16847,7.2,18547,170,52,2587,1452,22.2,1684.7,34,2,0,3,9,2,0,0,0,0,14260,6.8,17095,154,68,-2587,-1452,22.2,1426.0
4855290162,1,20,0,1,6,2,4,1,1,0,0,15415,7.0,18678,161,48,2915,1501,20.9,1541.5,13,1,0,2,6,0,0,0,0,0,12500,6.6,17177,160,44,-2915,-1501,20.4,1250.0
4855253160,1,16,3,1,11,2,9,0,0,0,0,18128,6.8,18162,176,48,5215,3715,22.4,1812.8,13,0,0,2,11,3,0,0,0,0,12913,6.0,14447,118,40,-5215,-3715,15.8,1291.3
4855206626,1,39,1,1,4,1,0,0,0,0,0,15877,7.0,17812,169,49,1938,673,21.8,1587.7,34,1,0,1,4,0,1,1,0,0,13939,6.6,17139,190,40,-1938,-673,23.0,1393.9
4854689917,0,12,0,1,4,7,1,0,0,0,0,13883,6.8,17029,152,47,-2857,-865,19.9,1388.3,11,1,0,7,4,9,0,0,0,0,16740,7.0,17894,171,62,2857,865,23.3,1674.0
4853469276,0,13,0,0,3,2,1,0,0,0,0,14259,6.8,17969,185,53,-469,1260,23.8,1425.9,11,1,1,2,3,2,0,0,0,0,14728,6.8,16709,167,44,469,-1260,21.1,1472.8
4853435503,1,14,0,0,3,5,3,0,0,0,0,15059,6.8,17700,137,54,-828,-329,19.1,1505.9,20,1,1,5,3,5,0,0,0,0,15887,7.0,18029,177,49,828,329,22.6,1588.7
4853396197,1,9,2,0,3,8,6,0,0,0,0,14372,6.8,16746,166,40,-2924,-2806,20.6,1437.2,12,0,1,8,3,4,0,0,0,0,17296,7.4,19552,204,60,2924,2806,26.4,1729.6
4851491474,0,12,1,1,3,7,4,1,1,0,0,15046,6.8,17048,170,44,-497,-601,21.4,1504.6,12,1,0,7,3,4,0,0,0,0,15543,6.8,17649,150,60,497,601,21.0,1554.3
4851471736,0,10,3,0,0,2,0,0,0,0,0,11733,6.4,14770,136,36,-2379,-3311,17.2,1173.3,15,1,1,2,0,0,0,0,0,0,14112,7.0,18081,173,60,2379,3311,23.3,1411.2
4851372396,0,8,0,1,5,6,2,0,0,0,0,13382,6.8,17731,128,48,-1747,-750,17.6,1338.2,10,0,0,6,5,4,1,1,0,0,15129,7.2,18481,152,56,1747,750,20.8,1512.9
4842863661,1,12,1,1,9,3,3,0,0,0,0,15987,7.0,18423,168,52,1956,885,22.0,1598.7,8,0,0,3,9,2,0,0,0,0,14031,6.6,17538,185,48,-1956,-885,23.3,1403.1
4842847126,1,13,0,1,5,10,4,0,0,0,0,14845,6.2,15172,161,40,-1793,-2421,20.1,1484.5,8,2,0,10,5,5,0,0,0,0,16638,6.8,17593,150,59,1793,2421,20.9,1663.8
4836700227,0,14,2,1,6,4,5,0,0,0,0,15670,6.8,16841,127,48,-254,-542,17.5,1567.0,11,0,0,4,6,4,0,0,0,0,15924,6.6,17383,169,52,254,542,22.1,1592.4
4836672293,0,16,0,1,4,3,1,0,0,0,0,13972,6.8,17157,144,44,-994,-1213,18.8,1397.2,8,0,0,3,4,1,0,0,0,0,14966,7.0,18370,194,56,994,1213,25.0,1496.6
4836081611,1,13,9,1,3,5,0,0,0,0,0,13455,6.6,16595,135,56,-1710,-1052,19.1,1345.5,34,0,0,5,3,3,0,0,0,0,15165,6.8,17647,188,52,1710,1052,24.0,1516.5
4830296978,0,14,0,0,1,7,1,0,0,0,0,13018,6.8,17369,171,30,-2905,-2182,20.1,1301.8,10,0,1,7,1,5,0,0,0,0,15923,7.4,19551,152,68,2905,2182,22.0,1592.3
4830261602,0,15,1,0,3,5,3,0,0,0,0,15004,6.8,17196,173,48,-274,697,22.1,1500.4,14,0,1,5,3,3,0,0,0,0,15278,6.4,16499,145,56,274,-697,20.1,1527.8
4830231572,1,19,2,0,5,6,4,0,0,0,0,17006,6.8,17683,210,48,1424,574,25.8,1700.6,17,1,1,6,5,4,0,0,0,0,15582,7.0,17109,151,52,-1424,-574,20.3,1558.2
4829687906,1,14,0,1,2,0,3,0,0,0,0,14041,6.4,16677,180,58,753,-14,23.8,1404.1,7,2,0,0,2,0,0,0,0,0,13288,6.4,16691,198,46,-753,14,24.4,1328.8
4829630323,1,10,1,1,2,2,2,0,0,0,0,14539,6.2,16184,190,52,-8,-894,24.2,1453.9,87,0,0,2,2,1,1,1,0,0,14547,6.6,17078,199,48,8,894,24.7,1454.7
4829482774,1,16,1,0,2,1,3,1,1,0,0,13899,6.8,17539,167,48,-782,-334,21.5,1389.9,50,1,1,1,2,1,0,0,0,0,14681,6.8,17873,207,56,782,334,26.3,1468.1
4829448018,1,78,1,1,7,2,5,0,0,0,0,16615,7.0,18645,199,52,2532,1295,25.1,1661.5,12,0,0,2,7,0,1,1,0,0,14083,7.0,17350,180,60,-2532,-1295,24.0,1408.3
4829397405,0,8,1,1,3,4,3,0,0,0,0,14300,6.6,17088,154,52,-1853,-1616,20.6,1430.0,13,0,0,4,3,5,0,0,0,0,16153,7.2,18704,190,56,1853,1616,24.6,1615.3
4828876233,1,15,1,1,1,8,0,0,0,0,0,13211,7.0,17509,183,52,-2364,1240,23.5,1321.1,10,2,0,8,1,6,0,0,0,0,15575,6.4,16269,180,4,2364,-1240,18.4,1557.5
4828845053,1,15,2,1,6,3,3,1,1,0,0,14978,6.8,17967,161,56,527,655,21.7,1497.8,9,2,0,3,6,0,0,0,0,0,14451,7.0,17312,182,52,-527,-655,23.4,1445.1
4825385625,1,10,12,1,2,2,0,1,1,0,0,14565,7.0,19185,177,64,1360,1495,24.1,1456.5,218,1,0,2,2,1,0,0,0,0,13205,6.8,17690,168,41,-1360,-1495,20.9,1320.5
4812517256,0,53,1,1,6,4,4,0,0,0,0,14337,6.4,16015,147,36,-1260,-1738,18.3,1433.7,12,0,0,4,6,2,0,0,0,0,15597,7.0,17753,156,60,1260,1738,21.6,1559.7
4782884815,0,15,1,1,2,4,1,1,1,0,0,14468,6.4,15761,158,48,73,-435,20.6,1446.8,13,2,0,4,2,2,0,0,0,0,14395,6.4,16196,158,52,-73,435,21.0,1439.5
4776540759,0,0,0,1,17,23,45,0,0,0,0,35597,10.8,39007,100,0,813,-193,10.0,3559.7,5,0,0,23,17,50,0,0,0,0,34784,10.6,39200,86,0,-813,193,8.6,3478.4
4853874241,0,16,1,1,3,5,2,1,1,0,0,14535,6.8,17271,189,46,-236,548,23.5,1453.5,9,0,0,5,3,4,0,0,0,0,14771,6.4,16723,170,42,236,-548,21.2,1477.1
4853833668,0,10,3,0,2,7,1,0,0,0,0,14840,6.6,15784,129,44,-1949,-1092,17.3,1484.0,11,0,1,7,2,6,1,1,0,0,16789,6.8,16876,191,48,1949,1092,23.9,1678.9
4852978754,0,13,1,0,0,3,0,0,0,0,0,12682,6.2,14594,156,36,-1763,-1730,19.2,1268.2,10,3,1,3,0,2,1,1,0,0,14445,6.6,16324,173,52,1763,1730,22.5,1444.5
4852929540,0,16,0,0,4,7,4,0,0,0,0,13842,6.4,14832,134,40,-3292,-3497,17.4,1384.2,15,0,1,7,4,5,0,0,0,0,17134,6.8,18329,198,56,3292,3497,25.4,1713.4
4852873659,0,104,1,0,4,6,2,0,0,0,0,14165,6.4,16291,168,40,-4515,-2370,20.8,1416.5,8,2,1,6,4,7,1,1,0,0,18680,7.2,18661,218,48,4515,2370,26.6,1868.0
4852716069,1,14,1,0,5,7,4,0,0,0,0,16104,7.0,17791,169,44,-530,302,21.3,1610.4,20,0,1,7,5,6,0,0,0,0,16634,6.8,17489,179,36,530,-302,21.5,1663.4
4851691185,0,8,0,0,4,3,3,0,0,0,0,13853,6.2,15171,169,48,-1379,-1646,21.7,1385.3,11,1,1,2,3,3,1,1,0,0,15232,6.6,16817,161,56,1379,1646,21.7,1523.2
4850985898,1,185,1,0,8,4,8,0,0,0,0,16296,7.0,17356,168,48,2189,516,21.6,1629.6,11,0,1,4,8,6,0,0,0,0,14107,6.8,16840,150,52,-2189,-516,20.2,1410.7
4850787222,0,9,0,1,1,6,0,0,0,0,0,12870,6.4,15854,161,40,-2338,-660,20.1,1287.0,12,0,0,6,1,6,0,0,0,0,15208,6.6,16514,175,52,2338,660,22.7,1520.8
4850753481,1,18,0,1,6,4,1,0,0,0,0,14744,6.8,17146,176,32,719,485,20.8,1474.4,9,0,0,4,6,1,0,0,0,0,14025,6.8,16661,170,50,-719,-485,22.0,1402.5
4847851647,0,9,0,0,5,9,0,0,0,0,0,12953,6.6,15942,132,48,-3028,-1417,18.0,1295.3,11,0,1,8,4,6,1,1,0,0,15981,6.8,17359,167,60,3028,1417,22.7,1598.1
4847824857,1,10,2,1,5,2,1,0,0,0,0,15107,7.0,18506,185,48,2201,1332,23.3,1510.7,15,0,0,2,5,0,0,0,0,0,12906,6.8,17174,157,56,-2201,-1332,21.3,1290.6
4845317930,1,22,1,1,8,5,9,0,0,0,0,17439,6.8,18495,186,52,2501,3143,23.8,1743.9,23,1,0,5,8,4,0,0,0,0,14938,6.2,15352,180,36,-2501,-3143,21.6,1493.8
4844154679,1,76,1,0,3,6,4,0,0,0,0,14971,7.0,17210,186,48,-828,166,23.4,1497.1,21,0,1,6,3,9,0,0,0,0,15799,6.8,17044,188,52,828,-166,24.0,1579.9
4844119650,1,75,1,0,2,4,1,1,1,0,0,14422,6.6,17440,205,48,-477,1487,25.3,1442.2,15,3,1,4,2,4,0,0,0,0,14899,6.4,15953,173,44,477,-1487,21.7,1489.9
4841517818,1,12,0,0,4,9,4,0,0,0,0,14982,6.6,16207,158,64,-808,-108,22.2,1498.2,8,0,1,9,4,5,0,0,0,0,15790,6.4,16315,144,40,808,108,18.4,1579.0
4840954610,0,185,0,1,9,8,16,0,0,0,0,15831,6.4,15814,163,44,-1271,-324,20.7,1583.1,12,1,0,8,9,4,1,1,0,0,17102,6.6,16138,192,40,1271,324,23.2,1710.2
4840218619,1,16,2,0,3,4,2,1,0,1,0,13892,6.8,17052,152,56,-300,-608,20.8,1389.2,18,0,1,3,2,1,1,1,0,0,14192,6.8,17660,178,52,300,608,23.0,1419.2
4840089294,0,14,0,1,7,5,5,0,0,0,0,15377,6.8,16914,162,40,-383,-1722,20.2,1537.7,14,0,0,4,6,2,1,1,0,0,15760,6.8,18636,186,60,383,1722,24.6,1576.0
4838246585,1,16,0,1,7,7,10,1,1,0,0,16402,6.8,17067,172,57,2210,2058,22.9,1640.2,10,1,0,7,7,4,0,0,0,0,14192,6.2,15009,147,34,-2210,-2058,18.1,1419.2
4780299082,1,10,2,1,2,2,1,0,0,0,0,16001,7.2,19206,224,68,1562,646,29.2,1600.1,10,0,0,2,2,1,0,0,0,0,14439,6.8,18560,214,60,-1562,-646,27.4,1443.9
4776865631,1,14,3,1,8,1,7,0,0,0,0,17343,6.6,16864,209,36,3413,-688,24.5,1734.3,9,3,0,1,8,0,0,0,0,0,13930,7.0,17552,214,48,-3413,688,26.2,1393.0
4774728471,0,8,2,1,6,7,2,0,0,0,0,14626,6.6,15714,177,40,-2290,-729,21.7,1462.6,20,0,0,7,6,10,0,0,0,0,16916,6.6,16443,180,48,2290,729,22.8,1691.6
4774706338,1,9,3,0,5,6,3,0,0,0,0,15549,7.2,17877,175,52,-341,1433,22.7,1554.9,29,0,1,6,5,5,1,1,0,0,15890,6.8,16444,195,59,341,-1433,25.4,1589.0
4769555542,1,16,2,0,9,6,3,0,0,0,0,16227,7.0,17071,163,44,1021,287,20.7,1622.7,9,1,1,6,9,2,0,0,0,0,15206,6.6,16784,185,44,-1021,-287,22.9,1520.6
4769530068,0,10,0,0,4,5,1,0,0,0,0,15714,6.8,17771,215,52,-876,-914,26.7,1571.4,19,2,1,5,4,7,1,1,0,0,16590,7.2,18685,218,72,876,914,29.0,1659.0
4786725774,0,13,0,1,7,1,6,0,0,0,0,16589,7.2,18619,215,60,2413,1257,27.5,1658.9,15,0,0,1,7,0,1,1,0,0,14176,6.8,17362,184,60,-2413,-1257,24.4,1417.6
4786696482,1,19,2,1,5,1,5,2,1,1,0,16975,7.0,18527,222,69,2330,2096,29.1,1697.5,16,1,0,1,5,1,0,0,0,0,14645,6.4,16431,196,54,-2330,-2096,25.0,1464.5
4786679021,0,14,1,1,3,4,2,0,0,0,0,14839,7.0,18174,191,60,-1370,-1251,25.1,1483.9,11,3,0,4,3,3,2,1,1,0,16209,7.0,19425,219,72,1370,1251,29.1,1620.9
4786655322,0,12,2,0,2,8,2,0,0,0,0,14722,6.6,17215,187,60,-1719,-422,24.7,1472.2,20,3,1,8,2,8,1,1,0,0,16441,7.0,17637,168,52,1719,422,22.0,1644.1
4786050489,1,15,0,1,4,3,3,1,1,0,0,15136,7.0,17355,189,60,-472,-1145,24.9,1513.6,6,0,0,3,4,3,0,0,0,0,15608,7.0,18500,230,60,472,1145,29.0,1560.8
4786028813,1,8,0,1,13,7,13,1,1,0,0,19824,7.0,18180,214,55,3936,2588,26.9,1982.4,9,0,0,7,13,6,0,0,0,0,15888,6.4,15592,164,48,-3936,-2588,21.2,1588.8
4785977662,0,13,1,0,7,10,2,1,1,0,0,15315,6.4,15962,150,52,-3974,-2235,20.2,1531.5,11,1,1,10,7,9,0,0,0,0,19289,7.0,18197,200,52,3974,2235,25.2,1928.9
4566750474,0,257,9,0,15,22,17,0,0,0,4,35408,9.8,32794,213,20,-4859,-1594,23.3,3540.8,48,0,1,22,15,23,1,1,0,0,40267,10.0,34388,220,8,4859,1594,22.8,4026.7
4566734548,0,39,1,1,15,31,25,1,1,0,3,35063,10.0,32446,176,53,-10164,-5178,22.9,3506.3,57,0,0,31,15,32,0,0,0,0,45227,10.6,37624,232,50,10164,5178,28.2,4522.7
4566092395,1,60,0,0,29,28,22,0,0,0,1,43959,10.4,36278,223,12,3608,2428,23.5,4395.9,24,0,1,28,29,33,1,1,0,0,40351,10.0,33850,189,39,-3608,-2428,22.8,4035.1
4566052508,0,27,1,1,28,24,27,0,0,0,3,42902,10.8,37928,227,21,5423,1620,24.8,4290.2,22,0,0,24,28,26,0,0,0,0,37479,10.4,36308,176,8,-5423,-1620,18.4,3747.9
4565695766,1,23,0,0,17,13,17,0,0,0,1,37186,9.8,31173,210,24,2726,-1,23.4,3718.6,22,0,1,13,17,13,0,0,0,0,34460,9.6,31174,219,10,-2726,1,22.9,3446.0
4565684946,0,19,1,0,10,23,10,1,1,0,1,31157,9.6,31208,206,20,-9412,-4161,22.6,3115.7,19,0,1,23,10,29,0,0,0,0,40569,10.6,35369,213,56,9412,4161,26.9,4056.9
4565666351,1,20,0,0,35,16,50,1,1,0,4,47015,9.8,33237,235,16,12824,1747,25.1,4701.5,21,0,1,16,35,29,0,0,0,0,34191,9.8,31490,142,14,-12824,-1747,15.6,3419.1
4565187906,1,16,0,1,28,15,30,0,0,0,2,39319,10.0,32622,192,12,5649,2909,20.4,3931.9,23,1,0,15,28,16,1,1,0,0,33670,9.4,29713,176,24,-5649,-2909,20.0,3367.0
4565152809,0,18,18,0,9,17,3,0,0,0,3,27378,9.4,30817,186,4,-11470,-4019,19.0,2737.8,54,2,1,17,9,18,0,0,0,0,38848,10.4,34836,265,23,11470,4019,28.8,3884.8
4565124060,1,40,1,1,20,20,20,0,0,0,3,35468,10.0,32939,158,12,-4490,18,17.0,3546.8,19,0,0,20,20,22,0,0,0,0,39958,10.0,32921,193,32,4490,-18,22.5,3995.8
4565101238,0,17,0,1,17,21,12,0,0,0,4,33862,10.0,32179,136,16,-7751,-492,15.2,3386.2,14,0,0,21,17,15,0,0,0,0,41613,9.8,32671,231,20,7751,492,25.1,4161.3
4565080156,0,15,0,1,19,17,17,0,0,0,2,32005,9.8,31969,158,0,-8333,-4207,15.8,3200.5,17,0,0,17,19,20,1,1,0,0,40338,10.2,36176,241,24,8333,4207,26.5,4033.8
4845234840,0,0,0,1,24,28,54,0,0,0,1,38161,11.2,41602,100,0,593,-517,10.0,3816.1,0,0,0,28,24,84,0,0,0,0,37568,11.4,42119,100,0,-593,517,10.0,3756.8
4844040747,1,0,0,1,23,23,66,0,0,0,0,36753,11.4,41138,95,0,493,232,9.5,3675.3,0,0,0,23,23,64,0,0,0,0,36260,11.4,40906,86,0,-493,-232,8.6,3626.0
4842077542,0,19,0,1,29,25,70,0,0,0,1,41609,12.2,45797,118,0,3363,2420,11.8,4160.9,0,1,0,25,29,65,0,0,0,0,38246,11.6,43377,75,0,-3363,-2420,7.5,3824.6
4840914217,1,0,0,0,16,13,46,0,0,0,0,33806,10.4,36470,83,0,-357,-508,8.3,3380.6,83,0,1,13,16,29,0,0,0,0,34163,10.4,36978,97,0,357,508,9.7,3416.3
4839975264,0,1,0,1,20,15,58,0,0,0,0,34498,10.6,37033,103,0,315,-198,10.3,3449.8,8,0,0,15,20,47,0,0,0,0,34183,10.6,37231,96,0,-315,198,9.6,3418.3
4839389935,0,0,0,1,20,29,42,0,0,0,0,36239,11.4,41309,84,0,-1903,-2090,8.4,3623.9,0,0,0,29,20,69,0,0,0,0,38142,11.6,43399,98,0,1903,2090,9.8,3814.2
4838730414,1,85,0,1,24,19,64,0,0,0,1,37061,11.2,40216,106,0,2826,3543,10.6,3706.1,0,0,0,19,24,46,0,0,0,0,34235,10.4,36673,81,0,-2826,-3543,8.1,3423.5
4838709682,1,13,0,1,27,21,60,0,0,0,0,36396,11.2,40883,78,0,835,1795,7.8,3639.6,0,4,0,21,27,45,0,0,0,0,35561,11.0,39088,103,0,-835,-1795,10.3,3556.1
4838380263,1,0,0,1,32,21,69,0,0,0,1,38314,11.8,43749,95,0,2021,1683,9.5,3831.4,0,0,0,21,32,44,0,0,0,0,36293,11.2,42066,92,0,-2021,-1683,9.2,3629.3
4838346489,0,0,0,0,24,29,65,0,0,0,1,37626,11.2,40525,105,0,326,-2467,10.5,3762.6,0,0,1,29,24,53,0,0,0,0,37300,11.6,42992,91,0,-326,2467,9.1,3730.0
4832947333,0,25,0,0,19,25,48,0,0,0,1,34885,10.8,39054,94,0,-3211,-2859,9.4,3488.5,0,0,1,25,19,62,0,0,0,0,38096,11.4,41913,90,0,3211,2859,9.0,3809.6
4832933056,0,0,0,1,26,28,80,0,0,0,2,38164,11.4,41580,92,0,-1873,-3075,9.2,3816.4,0,0,0,28,26,74,0,0,0,0,40037,11.8,44655,108,0,1873,3075,10.8,4003.7
4832551148,0,0,3,0,20,28,42,0,0,0,0,37331,10.8,39773,97,0,114,-3967,9.7,3733.1,30,0,1,28,20,67,0,0,0,0,37217,11.8,43740,88,0,-114,3967,8.8,3721.7
4832376684,0,26,0,0,22,20,53,0,0,0,0,35064,10.8,38750,84,0,-52,859,8.4,3506.4,0,1,1,20,22,47,0,0,0,0,35116,10.6,37891,83,0,52,-859,8.3,3511.6
4832367215,0,0,0,0,21,36,60,0,0,0,1,35940,10.8,39784,87,0,-4032,-4230,8.7,3594.0,0,0,1,36,21,89,0,0,0,0,39972,11.8,44014,86,0,4032,4230,8.6,3997.2
4832083939,0,0,0,1,15,26,41,0,0,0,2,34480,10.6,36619,88,0,-2652,-4811,8.8,3448.0,0,0,0,26,15,50,0,0,0,0,37132,11.2,41430,104,0,2652,4811,10.4,3713.2
4831550688,1,15,0,1,6,4,3,1,1,0,0,14916,6.8,17147,171,44,1048,175,21.5,1491.6,35,1,0,4,6,7,0,0,0,0,13868,6.8,16972,150,48,-1048,-175,19.8,1386.8
4831538266,1,24,0,1,22,14,66,0,0,0,0,36554,11.2,40438,100,0,2600,4402,10.0,3655.4,0,3,0,14,22,29,0,0,0,0,33954,10.4,36036,97,0,-2600,-4402,9.7,3395.4
4828581115,0,14,1,0,3,3,3,0,0,0,0,14811,6.6,16886,192,32,-603,-235,22.4,1481.1,16,2,1,3,3,3,1,1,0,0,15414,6.6,17121,206,52,603,235,25.8,1541.4
4833405429,0,43,1,0,4,7,5,0,0,0,0,14362,6.0,14669,154,40,-1124,-1776,19.4,1436.2,9,4,1,7,4,2,1,1,0,0,15486,6.2,16445,182,51,1124,1776,23.3,1548.6
4833389019,1,10,0,1,4,2,2,0,0,0,0,15516,7.0,18000,200,56,1646,16,25.6,1551.6,10,2,0,2,4,0,0,0,0,0,13870,6.8,17984,176,44,-1646,-16,22.0,1387.0
4832483537,0,9,0,1,6,7,4,0,0,0,0,16855,7.0,17677,186,64,-766,-1189,25.0,1685.5,10,0,0,7,6,5,1,1,0,0,17621,7.0,18866,190,40,766,1189,23.0,1762.1
4832474325,0,141,0,0,4,4,2,0,0,0,0,15322,6.6,16944,166,56,449,-413,22.2,1532.2,7,1,1,4,4,1,0,0,0,0,14873,6.8,17357,179,44,-449,413,22.3,1487.3
4832383879,1,13,0,1,17,12,26,0,0,0,1,33470,10.8,36929,95,59,3186,2256,15.4,3347.0,14,0,0,12,17,13,0,0,0,0,30284,10.2,34673,83,59,-3186,-2256,14.2,3028.4
4826014093,1,53,0,0,4,6,5,0,0,0,0,14456,7.0,17478,179,56,-601,-176,23.5,1445.6,7,0,1,6,4,3,1,1,0,0,15057,6.8,17654,163,48,601,176,21.1,1505.7
4825999851,0,13,1,0,5,9,4,0,0,0,0,14414,6.8,16558,164,40,-1979,-1532,20.4,1441.4,25,1,1,8,4,4,1,1,0,0,16393,7.0,18090,187,48,1979,1532,23.5,1639.3
4825977138,1,10,0,1,4,4,0,0,0,0,1,15464,6.8,17509,170,53,524,1362,22.3,1546.4,12,0,0,4,4,4,1,1,0,0,14940,6.4,16147,182,70,-524,-1362,25.2,1494.0
4825963444,1,10,0,1,9,6,6,0,0,0,0,17099,7.2,18593,188,52,2033,1817,24.0,1709.9,16,0,0,6,9,4,1,1,0,0,15066,6.6,16776,173,48,-2033,-1817,22.1,1506.6
4825938008,1,0,0,0,13,24,28,0,0,0,0,33629,10.6,37201,103,0,-2177,-2732,10.3,3362.9,16,0,1,24,13,56,0,0,0,0,35806,11.0,39933,95,0,2177,2732,9.5,3580.6
4825926081,0,0,0,0,14,30,37,0,0,0,1,32962,10.2,36232,92,0,-5856,-6064,9.2,3296.2,0,0,1,30,14,56,0,0,0,0,38818,11.4,42296,124,0,5856,6064,12.4,3881.8
4825884683,0,212,2,1,3,5,5,0,0,0,0,15201,6.6,16667,195,50,76,-10,24.5,1520.1,8,1,0,5,3,8,1,1,0,0,15125,6.8,16677,175,48,-76,10,22.3,1512.5
4825859200,0,15,0,0,6,4,6,0,0,0,0,16506,7.0,18502,201,44,1338,357,24.5,1650.6,11,2,1,4,6,3,1,1,0,0,15168,6.8,18145,194,56,-1338,-357,25.0,1516.8
4777431291,1,10,1,1,7,4,9,1,1,0,0,18077,6.6,16898,194,47,2983,-242,24.1,1807.7,120,0,0,3,6,2,0,0,0,0,15094,6.8,17140,164,56,-2983,242,22.0,1509.4
4777420686,0,25,0,0,3,6,3,0,0,0,0,14705,6.2,14759,162,36,-1927,-2683,19.8,1470.5,10,0,1,6,3,6,0,0,0,0,16632,6.8,17442,180,42,1927,2683,22.2,1663.2
4777411031,0,71,0,1,2,2,0,0,0,0,0,12858,6.4,15407,135,60,-3476,-2938,19.5,1285.8,12,0,0,2,2,2,2,1,1,0,16334,7.2,18345,237,64,3476,2938,30.1,1633.4
4773560419,0,11,0,0,5,10,2,0,0,0,0,16385,7.0,18491,197,60,-1644,1447,25.7,1638.5,16,1,1,10,5,6,1,1,0,0,18029,6.8,17044,189,52,1644,-1447,24.1,1802.9
4770099773,1,11,1,0,9,8,11,1,1,0,0,17969,6.6,16242,177,48,1192,-705,22.5,1796.9,9,2,1,8,9,7,0,0,0,0,16777,6.8,16947,197,48,-1192,705,24.5,1677.7
4770091736,1,12,2,1,5,3,3,1,1,0,0,16135,7.0,17402,187,42,527,174,22.9,1613.5,10,1,0,3,5,2,0,0,0,0,15608,6.8,17228,187,60,-527,-174,24.7,1560.8
4768328968,1,16,4,0,10,9,11,0,0,0,0,18052,6.6,17273,187,40,895,1053,22.7,1805.2,196,1,1,9,10,15,1,1,0,0,17157,6.6,16220,174,56,-895,-1053,23.0,1715.7
4857588968,1,16,1,1,11,2,12,0,0,0,0,18519,6.8,17651,170,64,2223,-382,23.4,1851.9,11,1,0,2,11,2,0,0,0,0,16296,6.8,18033,235,51,-2223,382,28.6,1629.6
4857557933,1,10,1,1,5,2,4,1,1,0,0,15844,6.8,17382,222,56,1535,-58,27.8,1584.4,33,1,0,2,5,1,0,0,0,0,14309,6.8,17440,191,52,-1535,58,24.3,1430.9
4854347509,1,3,0,1,24,23,54,0,0,0,1,37172,11.0,40709,104,0,509,683,10.4,3717.2,0,0,0,23,24,52,0,0,0,0,36663,11.2,40026,90,0,-509,-683,9.0,3666.3
4854336227,1,0,0,1,25,11,73,0,0,0,0,35950,11.0,40473,105,0,2577,4299,10.5,3595.0,0,0,0,11,25,22,0,0,0,0,33373,10.2,36174,95,0,-2577,-4299,9.5,3337.3
4854195184,0,11,1,1,4,8,4,0,0,0,0,14767,6.0,15195,158,44,-1118,-2153,20.2,1476.7,9,1,0,8,4,6,1,1,0,0,15885,6.4,17348,165,60,1118,2153,22.5,1588.5
4853209557,1,0,0,1,26,25,63,0,0,0,1,38407,11.6,43558,104,0,1976,2147,10.4,3840.7,251,0,0,25,26,66,0,0,0,0,36431,11.2,41411,72,0,-1976,-2147,7.2,3643.1
4853204044,0,98,0,0,4,5,3,0,0,0,0,15973,6.8,17773,213,56,-1443,85,26.9,1597.3,11,1,1,5,4,3,1,1,0,0,17416,7.0,17688,205,44,1443,-85,24.9,1741.6
4853172050,0,13,0,0,4,1,2,1,1,0,0,15471,7.4,19528,185,80,799,1758,26.5,1547.1,10,0,1,1,4,0,0,0,0,0,14672,6.8,17770,210,55,-799,-1758,26.5,1467.2
4853150495,0,11,0,1,1,4,1,0,0,0,0,14870,6.8,18196,208,60,-1252,282,26.8,1487.0,9,3,0,4,1,5,1,1,0,0,16122,7.0,17914,207,56,1252,-282,26.3,1612.2
4852151546,0,3,0,1,24,30,59,0,0,0,1,35968,11.2,40414,100,0,-3332,-3116,10.0,3596.8,0,0,0,30,24,70,0,0,0,0,39300,11.4,43530,94,0,3332,3116,9.4,3930.0
4852141366,1,0,0,1,21,22,49,0,0,0,1,37328,11.2,40650,88,0,766,2130,8.8,3732.8,310,0,0,22,21,45,0,0,0,0,36562,10.8,38520,109,0,-766,-2130,10.9,3656.2
4852128313,0,13,0,1,12,10,24,0,0,0,0,32550,10.0,34528,106,0,19,-124,10.6,3255.0,0,6,0,10,12,27,0,0,0,0,32531,10.2,34652,111,0,-19,124,11.1,3253.1
4852120772,1,90,3,1,12,14,28,0,0,0,1,36432,10.8,38501,108,0,1768,1757,10.8,3643.2,14,0,0,14,12,30,0,0,0,0,34664,10.6,36744,106,0,-1768,-1757,10.6,3466.4
4851155223,0,0,0,1,26,18,52,0,0,0,0,36333,11.4,41044,103,0,1425,1421,10.3,3633.3,0,0,0,18,26,37,0,0,0,0,34908,10.8,39623,93,0,-1425,-1421,9.3,3490.8
4851141733,1,87,2,1,26,16,74,0,0,0,0,35630,11.0,40318,107,0,1105,3714,10.7,3563.0,22,0,0,16,26,40,0,0,0,0,34525,10.6,36604,112,0,-1105,-3714,11.2,3452.5
4851130580,0,198,4,0,26,29,66,0,0,0,0,39199,11.4,43266,110,0,1397,1957,11.0,3919.9,16,0,1,29,26,81,0,0,0,0,37802,11.0,41309,104,0,-1397,-1957,10.4,3780.2
4851114440,0,0,0,0,17,17,48,0,0,0,0,35056,10.4,36618,96,0,696,-89,9.6,3505.6,0,0,1,17,17,44,0,0,0,0,34360,10.6,36707,106,0,-696,89,10.6,3436.0
4850824194,0,11,3,0,5,2,3,0,0,0,0,15805,6.8,17193,208,56,823,680,26.4,1580.5,12,2,1,2,5,2,1,1,0,0,14982,6.4,16513,184,56,-823,-680,24.0,1498.2
4850799930,0,12,0,1,3,5,6,1,1,0,0,13595,6.4,15761,147,56,-2177,-1649,20.3,1359.5,8,1,0,5,3,5,0,0,0,0,15772,7.0,17410,198,60,2177,1649,25.8,1577.2
4837996044,0,10,2,0,6,9,6,0,0,0,0,14728,6.6,16442,129,52,-1973,-1503,18.1,1472.8,10,1,1,9,6,6,1,1,0,0,16701,7.0,17945,192,40,1973,1503,23.2,1670.1
4811312532,1,0,0,0,14,16,40,0,0,0,1,35180,10.6,36615,98,0,235,-20,9.8,3518.0,18,0,1,16,14,52,0,0,0,0,34945,10.4,36635,92,0,-235,20,9.2,3494.5
4811282879,1,0,0,0,18,28,34,0,0,0,0,35453,11.0,39673,95,0,-2854,-3413,9.5,3545.3,0,0,1,28,18,76,0,0,0,0,38307,11.4,43086,82,0,2854,3413,8.2,3830.7
4807350300,1,13,0,1,3,3,1,1,0,1,0,13864,6.4,16036,163,56,-505,-982,21.9,1386.4,9,1,0,3,3,2,0,0,0,0,14369,6.8,17018,142,56,505,982,19.8,1436.9
4807301111,0,13,0,0,5,8,3,0,0,0,0,15977,6.8,16904,181,52,-1102,-1035,23.3,1597.7,10,1,1,8,5,7,0,0,0,0,17079,7.0,17939,195,40,1102,1035,23.5,1707.9
4807267827,1,0,0,1,34,23,86,0,0,0,0,39764,12.0,45836,101,0,3078,5583,10.1,3976.4,0,0,0,23,34,54,0,0,0,0,36686,10.8,40253,91,0,-3078,-5583,9.1,3668.6
4805385487,0,10,2,0,1,6,1,0,0,0,0,12812,6.2,15462,136,52,-3161,-1953,18.8,1281.2,16,2,1,6,1,5,1,1,0,0,15973,7.0,17415,190,44,3161,1953,23.4,1597.3
4805342228,0,70,1,1,3,2,2,0,0,0,0,14380,7.0,17287,185,48,105,-655,23.3,1438.0,11,1,0,2,3,1,1,1,0,0,14275,6.8,17942,213,60,-105,655,27.3,1427.5
4800716919,0,0,0,1,23,22,42,0,0,0,0,37216,11.2,41452,92,0,-447,848,9.2,3721.6,0,0,0,22,23,45,0,0,0,0,37663,11.0,40604,97,0,447,-848,9.7,3766.3
4792345177,1,0,0,0,16,19,47,0,0,0,1,33979,10.4,35394,109,0,-1800,-2174,10.9,3397.9,108,0,1,19,16,44,0,0,0,0,35779,10.6,37568,113,0,1800,2174,11.3,3577.9
4792328393,1,0,0,1,26,16,64,0,0,0,1,38102,11.0,41223,112,0,4571,5527,11.2,3810.2,0,0,0,16,26,35,0,0,0,0,33531,10.4,35696,85,0,-4571,-5527,8.5,3353.1
4789680851,0,13,1,0,4,5,3,0,0,0,0,14203,6.8,16650,176,60,-745,-901,23.6,1420.3,81,1,1,5,4,2,1,1,0,0,14948,6.6,17551,169,58,745,901,22.7,1494.8
4789630046,1,10,0,1,4,4,1,0,0,0,0,15350,6.8,17746,209,52,954,430,26.1,1535.0,11,2,0,4,4,1,0,0,0,0,14396,6.8,17316,164,60,-954,-430,22.4,1439.6
4787524171,1,114,2,0,8,4,5,1,1,0,0,16067,6.6,16159,157,44,1710,-344,20.1,1606.7,12,0,1,4,8,2,0,0,0,0,14357,6.6,16503,162,36,-1710,344,19.8,1435.7
4787504081,0,16,0,1,2,5,1,0,0,0,0,14105,6.6,16510,158,41,108,-341,19.9,1410.5,227,1,0,5,2,1,0,0,0,0,13997,6.6,16851,143,52,-108,341,19.5,1399.7
4787483296,0,9,0,1,25,20,53,0,0,0,1,36856,11.2,41106,82,0,549,1781,8.2,3685.6,0,2,0,20,25,44,0,0,0,0,36307,11.0,39325,98,0,-549,-1781,9.8,3630.7
4785984821,0,36,0,1,21,26,55,0,0,0,2,36493,11.2,40269,96,0,-2553,-1115,9.6,3649.3,11,17,0,26,21,64,0,0,0,0,39046,11.4,41384,90,0,2553,1115,9.0,3904.6
4785965509,0,0,0,0,18,32,38,0,0,0,2,35487,11.0,40704,85,0,-4582,-1638,8.5,3548.7,2,0,1,32,18,67,0,0,0,0,40069,11.6,42342,116,0,4582,1638,11.6,4006.9
4775667383,1,7,0,1,6,8,6,0,0,0,0,15702,6.6,16687,154,52,-1742,-1433,20.6,1570.2,8,0,0,8,6,6,0,0,0,0,17444,6.8,18120,189,59,1742,1433,24.8,1744.4
4775652135,1,11,0,0,9,5,12,1,1,0,0,16935,6.6,16486,116,56,1674,-516,17.2,1693.5,272,0,1,5,9,2,0,0,0,0,15261,6.6,17002,155,44,-1674,516,19.9,1526.1
4755664681,0,11,3,1,8,3,9,1,1,0,0,17514,6.8,17899,200,36,3083,1846,23.6,1751.4,11,1,0,3,8,3,0,0,0,0,14431,6.4,16053,169,52,-3083,-1846,22.1,1443.1
4755659072,1,9,2,0,9,6,9,1,0,1,0,18776,6.8,17072,166,52,2244,780,21.8,1877.6,14,1,1,6,9,7,0,0,0,0,16532,6.4,16292,166,47,-2244,-780,21.3,1653.2
4755641186,0,35,1,1,6,3,7,1,1,0,0,16052,6.6,16743,176,56,2053,699,23.2,1605.2,11,20,0,3,6,4,0,0,0,0,13999,6.4,16044,162,52,-2053,-699,21.4,1399.9
4755627980,0,79,1,1,4,13,5,0,0,0,0,13114,6.0,14502,108,36,-5850,-3925,14.4,1311.4,15,5,0,13,4,14,0,0,0,0,18964,7.0,18427,203,48,5850,3925,25.1,1896.4
4692277965,0,12,0,1,8,6,4,1,1,0,0,15832,6.8,17187,164,43,531,388,20.7,1583.2,10,1,0,5,7,3,0,0,0,0,15301,6.4,16799,151,47,-531,-388,19.8,1530.1
4692260934,1,12,1,0,3,4,2,0,0,0,0,16374,7.0,18570,191,63,1328,1705,25.4,1637.4,12,1,1,4,3,4,1,1,0,0,15046,6.6,16865,190,44,-1328,-1705,23.4,1504.6
4692190467,1,23,3,0,7,5,8,1,1,0,0,17166,7.2,18457,184,60,2441,2512,24.4,1716.6,193,2,1,5,7,4,1,0,1,0,14725,6.6,15945,139,52,-2441,-2512,19.1,1472.5
4692173290,0,11,0,0,1,7,1,1,1,0,0,12432,6.2,15060,144,48,-5383,-2512,19.2,1243.2,10,0,1,7,1,8,0,0,0,0,17815,6.8,17572,161,55,5383,2512,21.6,1781.5
4692165854,1,41,0,0,9,4,9,1,1,0,0,16742,6.6,16747,155,60,2489,856,21.5,1674.2,13,1,1,4,9,1,0,0,0,0,14253,6.4,15891,123,48,-2489,-856,17.1,1425.3
4692152850,1,7,1,1,5,3,3,0,0,0,0,15563,6.8,18036,161,52,1320,246,21.3,1556.3,13,1,0,3,5,0,0,0,0,0,14243,6.8,17790,157,48,-1320,-246,20.5,1424.3
4692138752,0,12,1,1,4,4,2,1,1,0,0,15494,6.8,17248,190,40,-527,-1216,23.0,1549.4,15,1,0,4,4,2,0,0,0,0,16021,7.0,18464,184,60,527,1216,24.4,1602.1
4691439728,1,11,0,0,6,7,5,1,0,1,0,16208,7.2,17883,182,68,641,2276,25.0,1620.8,135,0,1,7,6,7,1,1,0,0,15567,6.2,15607,152,44,-641,-2276,19.6,1556.7
4691151237,1,12,1,0,10,7,8,0,0,0,0,17402,6.6,16445,156,64,324,98,22.0,1740.2,8,1,1,7,10,7,0,0,0,0,17078,6.6,16347,176,32,-324,-98,20.8,1707.8
4691143214,0,10,0,1,8,7,6,0,0,0,0,16346,6.6,16412,156,45,-905,-1394,20.1,1634.6,13,1,0,7,8,7,0,0,0,0,17251,7.0,17806,166,51,905,1394,21.7,1725.1
4691140848,0,12,0,0,6,6,0,0,0,0,0,14518,6.4,16208,181,40,-2169,738,22.1,1451.8,95,1,1,6,6,6,0,0,0,0,16687,6.4,15470,139,40,2169,-738,17.9,1668.7
4691078109,0,17,2,0,2,7,2,0,0,0,0,14231,6.2,14981,154,53,-2825,-2175,20.7,1423.1,24,2,1,7,2,8,1,1,0,0,17056,6.8,17156,201,48,2825,2175,24.9,1705.6
4691051287,0,11,0,0,1,9,0,0,0,0,0,13016,6.4,15916,153,56,-4393,-2305,20.9,1301.6,14,0,1,9,1,5,0,0,0,0,17409,6.8,18221,155,48,4393,2305,20.3,1740.9
4691024188,1,13,0,0,5,4,2,1,1,0,0,15978,6.6,17886,180,52,1286,2390,23.2,1597.8,11,1,1,4,5,4,0,0,0,0,14692,6.2,15496,157,40,-1286,-2390,19.7,1469.2
4855843632,1,11,14,1,6,2,4,1,1,0,0,16573,7.2,19435,177,52,2136,1232,22.9,1657.3,30,1,0,2,6,1,0,0,0,0,14437,6.8,18203,203,52,-2136,-1232,25.5,1443.7
4855814935,1,11,0,1,6,1,9,0,0,0,0,16182,6.6,16825,190,48,2412,18,23.8,1618.2,10,0,0,1,6,1,1,0,1,0,13770,6.6,16807,188,43,-2412,-18,23.1,1377.0
4855773298,0,12,0,0,5,6,6,0,0,0,0,14386,6.6,16470,173,50,-1914,-588,22.3,1438.6,12,0,1,6,5,5,0,0,0,0,16300,6.6,17058,179,56,1914,588,23.5,1630.0
4855757249,1,0,0,1,22,20,24,0,0,0,0,65500,12.0,55000,0,0,27552,22000,0.0,6550.0,0,0,0,10,12,12,0,0,0,0,37948,7.2,33000,0,0,-27552,-22000,0.0,3794.8
4855743950,1,0,0,1,20,13,19,0,0,0,0,47805,10.0,47500,3,0,19540,19000,0.3,4780.5,0,0,0,8,15,8,0,0,0,0,28265,6.0,28500,1,0,-19540,-19000,0.1,2826.5
4855729348,1,270,0,0,21,13,23,0,0,0,0,48484,10.0,47500,4,0,20956,19000,0.4,4848.4,0,0,1,5,13,6,0,0,0,0,27528,6.0,28500,0,0,-20956,-19000,0.0,2752.8
4855717017,1,26,0,1,23,15,18,0,0,0,0,62700,12.0,55000,0,0,25497,22000,0.0,6270.0,0,0,0,6,14,12,0,0,0,0,37203,7.2,33000,1,0,-25497,-22000,0.1,3720.3
4848507855,1,13,2,1,10,7,9,0,0,0,0,17539,6.8,17480,175,32,1490,1474,20.7,1753.9,13,1,0,7,10,6,0,0,0,0,16049,6.6,16006,159,40,-1490,-1474,19.9,1604.9
4848478617,0,159,0,0,2,4,4,0,0,0,0,13606,6.4,15778,147,52,-955,-1459,19.9,1360.6,12,3,1,4,2,2,1,1,0,0,14561,6.8,17237,186,48,955,1459,23.4,1456.1
4848462189,1,17,3,1,6,7,6,1,1,0,0,18207,6.8,18047,185,48,2290,699,23.3,1820.7,23,1,0,7,6,3,0,0,0,0,15917,6.6,17348,182,52,-2290,-699,23.4,1591.7
4848097543,0,10,0,1,5,5,3,0,0,0,0,14930,6.8,17202,160,56,-1375,431,21.6,1493.0,12,0,0,5,5,4,1,0,1,0,16305,6.6,16771,194,44,1375,-431,23.8,1630.5
4848049448,0,12,12,0,2,3,1,0,0,0,0,14067,6.8,17402,167,56,-910,-496,22.3,1406.7,29,1,1,3,2,5,0,0,0,0,14977,6.8,17898,150,48,910,496,19.8,1497.7
4841054535,1,36,1,0,4,3,2,1,1,0,0,15944,7.0,18472,177,67,1036,721,24.4,1594.4,9,8,1,3,4,0,0,0,0,0,14908,6.8,17751,168,52,-1036,-721,22.0,1490.8
4841038074,0,8,1,1,3,8,4,0,0,0,0,13762,6.0,14718,149,40,-2667,-2728,18.9,1376.2,17,1,0,8,3,9,1,1,0,0,16429,6.8,17446,177,54,2667,2728,23.1,1642.9
4840806114,1,13,0,1,13,1,9,0,0,0,0,18962,7.0,17725,162,0,8901,5637,16.2,1896.2,209,2,0,1,13,0,0,0,0,0,10061,5.2,12088,80,0,-8901,-5637,8.0,1006.1
4419389890,0,13,1,0,2,8,1,1,1,0,0,14330,6.4,16692,184,48,-1780,-1913,23.2,1433.0,20,1,1,8,2,8,0,0,0,0,16110,6.8,18605,153,48,1780,1913,20.1,1611.0
4399956885,1,10,17,0,4,4,1,1,1,0,0,15733,7.2,18695,197,69,978,1001,26.6,1573.3,40,1,1,4,4,0,0,0,0,0,14755,6.6,17694,180,42,-978,-1001,22.2,1475.5
4358488388,0,13,2,0,3,8,1,1,1,0,0,12835,6.4,15986,135,55,-4207,-2900,19.0,1283.5,11,1,1,8,3,5,0,0,0,0,17042,7.2,18886,174,52,4207,2900,22.6,1704.2
4358481990,1,9,3,1,6,3,2,1,1,0,0,14787,6.6,17137,181,61,565,559,24.2,1478.7,14,1,0,3,6,2,0,0,0,0,14222,6.6,16578,159,46,-565,-559,20.5,1422.2
4354777315,0,18,2,0,1,3,1,0,0,0,0,12764,6.4,15890,120,44,-995,-1144,16.4,1276.4,11,3,1,3,1,1,0,0,0,0,13759,6.6,17034,135,44,995,1144,17.9,1375.9
4854593513,1,13,0,0,15,23,15,0,0,0,0,45950,10.0,47500,0,0,17400,19000,0.0,4595.0,0,0,1,14,6,12,0,0,0,0,28550,6.0,28500,0,0,-17400,-19000,0.0,2855.0
4850985087,1,0,0,1,30,28,67,0,0,0,0,39018,12.0,45796,107,0,-1125,868,10.7,3901.8,12,0,0,28,30,70,0,0,0,0,40143,11.8,44928,113,0,1125,-868,11.3,4014.3
4848867920,0,14,0,1,7,2,9,0,0,0,0,16411,6.2,15428,160,48,3025,-738,20.8,1641.1,14,0,0,2,7,2,1,1,0,0,13386,6.2,16166,177,44,-3025,738,22.1,1338.6
4848819628,1,55,0,1,6,5,7,0,0,0,0,16908,6.4,16212,186,40,1673,357,22.6,1690.8,13,2,0,5,6,5,0,0,0,0,15235,6.6,15855,167,48,-1673,-357,21.5,1523.5
4848774730,1,47,3,0,7,4,7,0,0,0,0,16642,7.2,18134,212,44,2436,912,25.6,1664.2,12,16,1,4,7,1,1,1,0,0,14206,6.8,17222,152,60,-2436,-912,21.2,1420.6
4848019165,1,14,1,1,8,7,4,1,1,0,0,17440,7.2,18205,176,60,932,1358,23.6,1744.0,14,0,0,7,8,6,0,0,0,0,16508,6.6,16847,167,40,-932,-1358,20.7,1650.8
4847688413,0,10,1,0,7,7,5,0,0,0,0,14674,6.2,15832,127,52,-2553,-1774,17.9,1467.4,13,1,1,7,7,6,1,1,0,0,17227,6.8,17606,203,48,2553,1774,25.1,1722.7
4847662698,0,21,2,0,2,12,1,0,0,0,0,13041,6.6,16221,158,43,-5218,-2613,20.1,1304.1,8,3,1,12,2,9,0,0,0,0,18259,7.0,18834,205,44,5218,2613,24.9,1825.9
4847641658,1,13,0,1,5,3,4,0,0,0,0,15809,6.8,17815,206,44,1123,408,25.0,1580.9,9,0,0,3,5,3,0,0,0,0,14686,6.6,17407,179,60,-1123,-408,23.9,1468.6
4847627842,0,16,0,0,4,10,4,0,0,0,0,15320,6.4,16030,155,48,-2642,-2659,20.3,1532.0,8,1,1,10,4,5,0,0,0,0,17962,7.2,18689,196,52,2642,2659,24.8,1796.2
4847505416,0,13,0,0,5,4,2,0,0,0,0,15847,7.0,18082,182,60,568,-791,24.2,1584.7,46,1,1,4,5,2,1,1,0,0,15279,7.2,18873,179,67,-568,791,24.6,1527.9
4846153960,1,10,0,1,4,2,3,0,0,0,0,15655,6.8,18016,196,60,1952,1445,25.6,1565.5,14,0,0,2,4,2,0,0,0,0,13703,6.6,16571,145,52,-1952,-1445,19.7,1370.3
4845004256,1,16,0,0,2,4,2,0,0,0,0,13440,6.6,16617,148,41,-1039,-1364,18.9,1344.0,11,2,1,4,2,2,0,0,0,0,14479,6.8,17981,184,58,1039,1364,24.2,1447.9
4844399509,1,15,0,0,3,2,4,0,0,0,0,15342,6.8,16742,150,44,2083,286,19.4,1534.2,11,1,1,2,3,0,0,0,0,0,13259,6.6,16456,139,56,-2083,-286,19.5,1325.9
4843528368,1,13,0,1,5,6,8,0,0,0,0,14905,6.4,16676,182,39,-1624,-939,22.1,1490.5,14,0,0,6,5,11,0,0,0,0,16529,7.0,17615,195,48,1624,939,24.3,1652.9
4843491882,0,16,2,1,10,6,6,0,0,0,0,16248,7.0,17552,185,40,462,-791,22.5,1624.8,75,1,0,4,8,1,0,0,0,0,15786,6.8,18343,196,60,-462,791,25.6,1578.6
4841104185,0,12,0,0,5,6,2,0,0,0,0,14323,6.8,17230,140,56,-1200,-594,19.6,1432.3,12,0,1,5,4,3,0,0,0,0,15523,6.8,17824,145,40,1200,594,18.5,1552.3
4840114783,1,18,4,1,5,1,4,0,0,0,0,16489,7.0,18626,223,52,3414,1191,27.5,1648.9,22,1,0,1,5,2,0,0,0,0,13075,6.8,17435,135,64,-3414,-1191,19.9,1307.5
4857518879,1,0,0,0,15,14,18,0,0,0,0,47000,10.0,47500,0,0,18800,19000,0.0,4700.0,0,0,1,10,11,4,0,0,0,0,28200,6.0,28500,0,0,-18800,-19000,0.0,2820.0
4857495523,1,0,0,1,19,16,21,0,0,0,0,63050,12.0,55000,0,0,26200,22000,0.0,6305.0,0,0,0,10,13,7,0,0,0,0,36850,7.2,33000,0,0,-26200,-22000,0.0,3685.0
4857471657,1,3,0,0,15,19,12,0,0,0,0,62000,12.0,55000,0,0,23400,22000,0.0,6200.0,0,0,1,12,8,13,0,0,0,0,38600,7.2,33000,0,0,-23400,-22000,0.0,3860.0
4857452931,1,0,0,1,22,11,19,0,0,0,0,47700,10.0,47500,0,0,21600,19000,0.0,4770.0,0,0,0,4,15,6,0,0,0,0,26100,6.0,28500,0,0,-21600,-19000,0.0,2610.0
4856613839,1,0,0,1,19,14,25,0,0,0,0,47205,12.0,55000,3,0,16875,22000,0.3,4720.5,0,0,0,9,14,7,0,0,0,0,30330,7.2,33000,0,0,-16875,-22000,0.0,3033.0
4856598452,1,0,0,1,20,23,22,0,0,0,0,65207,12.0,55000,0,0,26954,22000,0.0,6520.7,98,0,0,15,12,14,0,0,0,0,38253,7.2,33000,0,2,-26954,-22000,0.2,3825.3
4856591735,1,0,0,1,21,21,13,0,0,0,0,62000,12.6,59500,0,0,21631,22000,0.0,6200.0,17,0,0,11,11,16,0,0,0,0,40369,7.8,37500,0,0,-21631,-22000,0.0,4036.9
4856578197,1,0,0,1,21,19,15,0,0,0,0,62751,12.0,55000,0,0,24797,22000,0.0,6275.1,0,0,0,8,10,11,0,0,0,0,37954,7.2,33000,0,0,-24797,-22000,0.0,3795.4
4856563147,1,352,0,1,13,15,14,0,0,0,0,46650,10.0,47775,0,0,18800,19275,0.0,4665.0,0,0,0,10,8,10,0,0,0,0,27850,6.0,28500,0,0,-18800,-19275,0.0,2785.0
4855508309,1,3,0,0,28,25,56,0,0,0,1,39206,11.6,42997,100,0,2558,1115,10.0,3920.6,0,0,1,25,28,54,0,0,0,0,36648,11.2,41882,102,0,-2558,-1115,10.2,3664.8
4855494288,1,13,1,1,7,3,8,0,0,0,0,18694,7.2,18900,182,52,3598,177,23.4,1869.4,15,0,0,3,7,1,0,0,0,0,15096,7.0,18723,215,60,-3598,-177,27.5,1509.6
4855484900,1,0,0,1,21,17,18,0,0,0,0,62375,12.0,55000,1,0,19875,22000,0.1,6237.5,0,0,0,9,13,11,0,0,0,0,42500,7.2,33000,3,0,-19875,-22000,0.3,4250.0
4855470864,1,3,0,0,16,27,17,0,0,0,0,46650,10.0,47500,0,0,16700,19000,0.0,4665.0,2,0,1,16,5,15,0,0,0,0,29950,6.0,28500,0,0,-16700,-19000,0.0,2995.0
4855444476,1,0,0,1,16,15,18,0,0,0,0,48125,10.0,47500,0,0,19565,19000,0.0,4812.5,0,0,0,13,14,7,0,0,0,0,28560,6.0,28500,0,0,-19565,-19000,0.0,2856.0
4855428516,1,0,0,0,20,24,24,0,0,0,0,65852,13.0,62500,0,0,26902,25000,0.0,6585.2,0,0,1,16,12,13,0,0,0,0,38950,7.8,37500,0,0,-26902,-25000,0.0,3895.0
4855412281,1,0,0,0,19,17,18,0,0,0,0,63825,12.0,55000,3,0,27675,22000,0.3,6382.5,49,0,1,8,10,10,0,0,0,0,36150,7.2,33000,0,0,-27675,-22000,0.0,3615.0
4855397810,1,1,0,1,13,16,16,0,0,0,0,46060,10.0,47500,0,0,16810,19000,0.0,4606.0,0,0,0,13,10,9,0,0,0,0,29250,6.0,28500,0,0,-16810,-19000,0.0,2925.0
4855367643,1,0,0,1,18,16,19,0,0,0,0,63750,12.0,55000,0,0,26200,22000,0.0,6375.0,0,0,0,9,11,6,0,0,0,0,37550,7.2,33000,0,0,-26200,-22000,0.0,3755.0
4855353783,1,0,0,1,18,20,22,0,0,0,0,62740,12.8,61000,0,0,25540,25000,0.0,6274.0,0,0,0,12,10,11,0,0,0,0,37200,7.6,36000,0,0,-25540,-25000,0.0,3720.0
4855328380,1,46,2,1,27,20,25,0,0,0,0,64865,12.6,59500,17,0,27275,22000,1.7,6486.5,8,8,0,9,16,14,0,0,0,0,37590,7.8,37500,0,0,-27275,-22000,0.0,3759.0
4856434784,0,18,0,0,1,2,0,1,1,0,0,14330,7.2,18856,185,72,60,1836,25.7,1433.0,14,1,1,2,1,3,0,0,0,0,14270,6.8,17020,183,44,-60,-1836,22.7,1427.0
4856355426,0,163,1,0,1,4,1,0,0,0,0,12786,6.8,16592,154,47,-3231,-559,20.1,1278.6,18,2,1,4,1,3,0,0,0,0,16017,6.8,17151,191,40,3231,559,23.1,1601.7
4856095912,1,1,0,0,23,16,56,0,0,0,0,35530,11.0,38321,98,0,1124,2571,9.8,3553.0,0,0,1,16,23,39,0,0,0,0,34406,10.4,35750,90,0,-1124,-2571,9.0,3440.6
4856057566,1,0,0,0,28,22,66,0,0,0,0,36444,11.2,40697,106,0,-33,835,10.6,3644.4,0,0,1,22,28,63,0,0,0,0,36477,11.0,39862,105,0,33,-835,10.5,3647.7
4856034249,1,72,0,1,27,18,63,0,0,0,1,38683,11.4,42715,116,0,3634,4852,11.6,3868.3,252,0,0,18,27,50,0,0,0,0,35049,10.8,37863,108,0,-3634,-4852,10.8,3504.9
4855476630,1,13,0,0,6,2,3,1,0,1,0,16454,7.0,18377,172,52,2757,2005,22.4,1645.4,8,1,1,2,6,1,0,0,0,0,13697,6.6,16372,196,32,-2757,-2005,22.8,1369.7
4855461720,0,15,0,0,3,4,1,0,0,0,0,13994,6.4,17014,164,52,-1799,-1573,21.6,1399.4,8,1,1,4,3,2,0,0,0,0,15793,7.0,18587,218,60,1799,1573,27.8,1579.3
4855433933,0,28,1,0,5,6,3,0,0,0,0,14707,6.8,18143,166,49,-1793,-165,21.5,1470.7,10,9,1,6,5,6,1,1,0,0,16500,7.0,18308,203,58,1793,165,26.1,1650.0
4855387665,0,10,0,0,5,1,5,0,0,0,0,15371,6.8,17090,144,54,1240,-912,19.8,1537.1,11,0,1,1,5,1,0,0,0,0,14131,6.8,18002,172,60,-1240,912,23.2,1413.1
4854205909,1,11,1,1,6,3,5,1,1,0,0,15244,6.8,17644,169,48,1128,453,21.7,1524.4,9,0,0,3,6,0,0,0,0,0,14116,6.8,17191,177,52,-1128,-453,22.9,1411.6
4854152274,0,11,0,0,2,4,1,0,0,0,0,14526,7.0,18818,176,44,159,1111,22.0,1452.6,11,1,1,4,2,2,0,0,0,0,14367,7.0,17707,162,64,-159,-1111,22.6,1436.7
4853014343,1,23,0,0,16,18,17,0,0,0,0,63050,12.8,61000,0,0,24790,25000,0.0,6305.0,12,1,1,12,10,12,0,0,0,0,38260,7.6,36000,1,0,-24790,-25000,0.1,3826.0
4852986576,1,1,0,1,27,23,18,0,0,0,0,48050,10.0,47500,0,0,20200,19000,0.0,4805.0,41,0,0,9,13,13,0,0,0,0,27850,6.0,28500,0,0,-20200,-19000,0.0,2785.0
4852951734,1,0,0,0,16,18,13,0,0,0,0,44550,10.0,47500,0,0,16700,19000,0.0,4455.0,0,0,1,9,7,11,0,0,0,0,27850,6.0,28500,0,0,-16700,-19000,0.0,2785.0
4852041789,1,72,0,1,6,2,7,1,1,0,0,16288,7.0,18274,205,52,2828,1216,25.7,1628.8,9,14,0,1,5,0,0,0,0,0,13460,6.6,17058,170,60,-2828,-1216,23.0,1346.0
4852007065,1,16,0,0,1,3,0,0,0,0,0,13019,6.8,17945,181,60,-2008,-956,24.1,1301.9,192,0,1,3,1,2,1,1,0,0,15027,6.8,18901,170,56,2008,956,22.6,1502.7
4851956241,0,249,1,0,4,3,4,0,0,0,0,14860,6.8,17551,176,35,-64,-712,21.1,1486.0,11,0,1,3,4,4,0,0,0,0,14924,7.0,18263,195,52,64,712,24.7,1492.4
4839828200,0,50,1,0,10,21,15,0,0,0,1,29643,10.2,34593,72,48,-6588,-6800,12.0,2964.3,11,0,1,21,10,50,0,0,0,0,36231,11.4,41393,72,65,6588,6800,13.7,3623.1
4824897190,1,11,1,1,18,11,37,0,0,0,0,39506,11.4,42118,76,85,10652,8583,16.1,3950.6,7,0,0,11,18,29,0,0,0,0,28854,10.2,33535,73,26,-10652,-8583,9.9,2885.4
4824870599,1,15,0,0,22,20,45,0,0,0,1,32252,10.6,37067,65,47,565,68,11.2,3225.2,3,0,1,20,22,38,0,0,0,0,31687,10.8,36999,70,47,-565,-68,11.7,3168.7
4857273478,0,0,0,0,11,13,30,0,0,0,0,33908,10.6,36235,95,0,1783,823,9.5,3390.8,0,0,1,13,11,27,0,0,0,0,32125,10.2,35412,74,0,-1783,-823,7.4,3212.5
4857247102,0,0,0,1,30,28,75,0,0,0,0,37697,11.6,43362,90,0,-1125,461,9.0,3769.7,0,0,0,28,30,54,0,0,0,0,38822,11.4,42901,94,0,1125,-461,9.4,3882.2
4856503313,0,0,0,1,34,28,86,0,0,0,0,39201,11.4,43559,105,0,183,-642,10.5,3920.1,0,0,0,28,34,70,0,0,0,0,39018,11.8,44201,103,0,-183,642,10.3,3901.8
4856453606,1,0,13,1,23,17,56,0,0,0,0,38535,11.2,41040,98,0,4405,4993,9.8,3853.5,20,0,0,17,23,37,0,0,0,0,34130,10.4,36047,100,0,-4405,-4993,10.0,3413.0
4856437818,1,14,0,1,34,15,87,0,0,0,1,39130,11.8,44336,99,0,5092,7381,9.9,3913.0,0,2,0,15,34,29,0,0,0,0,34038,10.4,36955,78,0,-5092,-7381,7.8,3403.8
4855110179,0,17,1,1,5,3,6,0,0,0,0,15589,6.8,17817,182,60,921,1166,24.2,1558.9,12,0,0,3,5,2,0,0,0,0,14668,6.4,16651,184,42,-921,-1166,22.6,1466.8
4855072087,0,70,2,0,3,7,5,0,0,0,0,14607,6.6,17213,178,56,-2734,-647,23.4,1460.7,23,11,1,7,3,10,1,1,0,0,17341,6.8,17860,210,52,2734,647,26.2,1734.1
4855034789,1,13,1,0,3,4,3,0,0,0,0,15399,7.2,17594,212,56,594,13,26.8,1539.9,12,0,1,4,3,5,0,0,0,0,14805,6.8,17581,194,44,-594,-13,23.8,1480.5
4853945224,0,19,0,0,13,24,27,0,0,0,1,33171,10.6,37144,67,0,-5460,-4653,6.7,3317.1,0,11,1,24,13,57,0,0,0,0,38631,11.4,41797,118,0,5460,4653,11.8,3863.1
4853888243,1,239,0,1,4,5,4,0,0,0,0,14200,6.2,15176,170,39,-238,-1540,20.9,1420.0,83,2,0,5,4,3,0,0,0,0,14438,6.8,16716,184,34,238,1540,21.8,1443.8
4849864550,0,29,1,0,4,6,5,0,0,0,0,15286,6.6,17377,179,60,-256,456,23.9,1528.6,6,10,1,6,4,7,0,0,0,0,15542,6.4,16921,189,32,256,-456,22.1,1554.2
4849821923,0,15,5,1,15,5,12,0,0,0,0,20319,7.0,18636,206,40,5440,3177,24.6,2031.9,18,2,0,5,15,3,0,0,0,0,14879,6.2,15459,157,32,-5440,-3177,18.9,1487.9
4849767216,1,34,1,0,1,8,0,0,0,0,0,13957,6.4,17203,201,56,-2430,-429,25.7,1395.7,11,8,1,8,1,4,1,1,0,0,16387,7.0,17632,158,68,2430,429,22.6,1638.7
4845990001,1,26,0,1,28,21,82,0,0,0,0,39148,11.6,42387,104,0,1790,2527,10.4,3914.8,34,18,0,21,28,56,0,0,0,0,37358,11.0,39860,102,0,-1790,-2527,10.2,3735.8
4845952883,1,19,10,0,6,2,8,0,0,0,0,15188,6.6,17417,185,49,1193,63,23.4,1518.8,36,1,1,2,6,3,0,0,0,0,13995,6.8,17354,184,52,-1193,-63,23.6,1399.5
4845133012,0,0,0,0,23,36,50,0,0,0,2,36313,11.0,40035,79,0,-10227,-9270,7.9,3631.3,0,0,1,36,23,94,0,0,0,0,46540,12.6,49305,126,0,10227,9270,12.6,4654.0
4845046712,1,12,1,1,7,3,8,1,1,0,0,16772,6.6,16834,182,40,3121,1348,22.2,1677.2,9,0,0,3,7,5,0,0,0,0,13651,6.0,15486,171,44,-3121,-1348,21.5,1365.1
4845001806,1,0,0,0,17,16,46,0,0,0,2,34372,10.6,37638,96,0,1169,1453,9.6,3437.2,0,0,1,16,17,25,0,0,0,0,33203,10.2,36185,86,0,-1169,-1453,8.6,3320.3
4844183644,1,25,0,0,23,14,52,0,0,0,0,36107,11.2,41706,113,0,982,5965,11.3,3610.7,0,0,1,14,23,37,0,0,0,0,35125,10.4,35741,102,0,-982,-5965,10.2,3512.5
4857509825,1,7,0,1,22,20,12,0,0,0,0,45950,10.0,47500,0,0,17375,19000,0.0,4595.0,0,0,0,8,10,15,0,0,0,0,28575,6.0,28500,1,0,-17375,-19000,0.1,2857.5
4857481358,1,15,0,0,26,34,55,0,0,0,0,37747,11.0,41268,100,0,-2193,-2485,10.0,3774.7,1,0,1,34,26,81,0,0,0,0,39940,11.6,43753,112,0,2193,2485,11.2,3994.0
4856191592,0,82,0,1,13,19,34,0,0,0,0,34693,10.2,36357,104,0,-2220,-4788,10.4,3469.3,0,0,0,19,13,48,0,0,0,0,36913,11.4,41145,119,0,2220,4788,11.9,3691.3
4856163897,1,28,2,1,18,14,14,0,0,0,0,47185,10.0,47500,7,0,20330,19000,0.7,4718.5,7,1,0,7,11,7,0,0,0,0,26855,6.0,28500,2,0,-20330,-19000,0.2,2685.5
4855218198,0,14,2,0,7,6,3,1,1,0,0,15747,6.2,16190,189,32,-1312,-2370,22.1,1574.7,13,2,1,6,7,7,0,0,0,0,17059,7.0,18560,190,56,1312,2370,24.6,1705.9
4855171201,1,0,0,0,17,17,27,0,0,0,0,34840,10.6,37695,110,0,736,-325,11.0,3484.0,82,0,1,17,17,43,0,0,0,0,34104,10.6,38020,106,0,-736,325,10.6,3410.4
4854652022,1,12,0,1,24,16,59,0,0,0,1,36002,11.0,39956,109,0,1591,3007,10.9,3600.2,0,1,0,16,24,23,0,0,0,0,34411,10.4,36949,112,0,-1591,-3007,11.2,3441.1
4854621471,1,0,0,0,28,34,71,0,0,0,0,38675,11.8,42617,105,0,-1772,-2331,10.5,3867.5,0,0,1,34,28,97,0,0,0,0,40447,12.0,44948,107,0,1772,2331,10.7,4044.7
4853808483,0,0,0,1,22,26,54,0,0,0,1,36909,11.0,39702,105,0,-1891,-1508,10.5,3690.9,0,0,0,26,22,56,0,0,0,0,38800,11.2,41210,102,0,1891,1508,10.2,3880.0
4853786480,1,1,0,1,31,21,80,0,0,0,1,40307,11.8,43512,115,0,4211,4267,11.5,4030.7,27,0,0,21,31,54,0,0,0,0,36096,11.0,39245,86,0,-4211,-4267,8.6,3609.6
4853766326,1,0,0,0,22,16,21,0,0,0,0,63753,12.0,55000,1,0,27603,18000,0.1,6375.3,87,0,1,8,14,10,0,0,0,0,36150,8.0,37000,0,0,-27603,-18000,0.0,3615.0
4853747314,1,3,0,1,21,13,27,0,0,0,0,63400,13.0,62500,0,0,26888,25000,0.0,6340.0,0,0,0,9,17,3,0,0,0,0,36512,7.8,37500,0,0,-26888,-25000,0.0,3651.2
4853724570,1,2,0,0,17,16,15,0,0,0,0,47214,10.4,49000,3,0,19576,20500,0.3,4721.4,19,0,1,8,9,13,0,0,0,0,27638,6.0,28500,1,0,-19576,-20500,0.1,2763.8
4853702663,1,0,0,1,17,17,20,0,0,0,0,46650,10.0,47500,0,0,18800,19000,0.0,4665.0,5,0,0,9,9,7,0,0,0,0,27850,6.0,28500,0,0,-18800,-19000,0.0,2785.0
4852027689,1,0,0,1,27,21,81,0,0,0,1,38980,11.6,43490,111,0,3353,4709,11.1,3898.0,0,0,0,21,27,49,0,0,0,0,35627,10.8,38781,83,0,-3353,-4709,8.3,3562.7
4852016934,1,0,0,0,24,23,60,0,0,0,0,37787,11.2,40458,106,0,1952,236,10.6,3778.7,0,0,1,23,24,63,0,0,0,0,35835,11.2,40222,90,0,-1952,-236,9.0,3583.5
4851982538,1,0,4,1,16,15,47,0,0,0,1,34932,10.8,37649,113,0,1744,1914,11.3,3493.2,19,0,0,15,16,40,0,0,0,0,33188,10.2,35735,83,0,-1744,-1914,8.3,3318.8
4851958572,1,0,0,0,40,31,86,0,0,0,1,41041,12.0,46678,97,0,232,1819,9.7,4104.1,0,0,1,31,40,63,0,0,0,0,40809,12.0,44859,107,0,-232,-1819,10.7,4080.9
4851055284,1,0,0,1,26,30,71,0,0,0,1,39088,11.4,41673,127,0,378,-1335,12.7,3908.8,0,0,0,30,26,63,0,0,0,0,38710,11.6,43008,85,0,-378,1335,8.5,3871.0
4857560519,0,14,3,0,3,7,2,0,0,0,0,13767,6.4,15734,170,39,-2491,-2831,20.9,1376.7,14,4,1,7,3,3,1,1,0,0,16258,7.2,18565,172,43,2491,2831,21.5,1625.8
4857536433,0,0,0,0,27,22,55,0,0,0,1,39333,11.6,43834,99,0,3205,5710,9.9,3933.3,2,0,1,22,27,46,0,0,0,0,36128,10.8,38124,88,0,-3205,-5710,8.8,3612.8
4857356951,0,22,0,1,25,22,76,0,0,0,0,39381,11.2,40596,96,0,2082,-109,9.6,3938.1,0,9,0,22,25,58,0,0,0,0,37299,11.2,40705,105,0,-2082,109,10.5,3729.9
4856980371,1,0,0,1,26,31,68,0,0,0,0,37339,11.6,43375,87,0,-887,-119,8.7,3733.9,9,0,0,31,26,75,0,0,0,0,38226,11.6,43494,107,0,887,119,10.7,3822.6
4856519833,1,131,0,0,31,18,74,0,0,0,1,39368,11.2,41438,109,0,5216,2978,10.9,3936.8,0,0,1,18,31,36,0,0,0,0,34152,10.8,38460,81,0,-5216,-2978,8.1,3415.2
4856490213,0,0,0,1,17,15,36,0,0,0,1,36205,11.0,38974,104,0,1949,2948,10.4,3620.5,0,0,0,15,17,34,0,0,0,0,34256,10.4,36026,100,0,-1949,-2948,10.0,3425.6
4855704755,0,0,0,0,17,35,31,0,0,0,1,37288,11.4,42030,93,0,-5116,-4479,9.3,3728.8,0,0,1,35,17,101,0,0,0,0,42404,12.0,46509,95,0,5116,4479,9.5,4240.4
4855107455,1,0,0,0,22,18,48,0,0,0,0,34591,11.2,40441,101,0,-782,2670,10.1,3459.1,0,0,1,18,22,44,0,0,0,0,35373,11.0,37771,111,0,782,-2670,11.1,3537.3
4854139373,1,9,11,1,4,3,1,0,0,0,0,15170,6.8,17377,179,64,718,869,24.3,1517.0,35,0,0,3,4,5,0,0,0,0,14452,6.6,16508,142,44,-718,-869,18.6,1445.2
4854088964,0,24,0,1,16,21,33,0,0,0,1,34680,10.4,36209,106,0,-2608,-3355,10.6,3468.0,0,1,0,21,16,55,0,0,0,0,37288,11.0,39564,110,0,2608,3355,11.0,3728.8
4854050168,0,0,0,1,26,33,45,0,0,0,0,36292,11.4,41790,64,0,-3818,-3435,6.4,3629.2,1,0,0,33,26,82,0,0,0,0,40110,11.8,45225,107,0,3818,3435,10.7,4011.0
4853621963,0,83,0,0,21,22,33,0,0,0,0,36123,11.2,39962,116,0,-32,-189,11.6,3612.3,5,0,1,22,21,40,0,0,0,0,36155,11.0,40151,95,0,32,189,9.5,3615.5
4853437049,0,0,0,0,24,28,46,0,0,0,0,36073,11.2,41167,81,0,-4868,-2404,8.1,3607.3,0,0,1,28,24,67,0,0,0,0,40941,11.6,43571,120,0,4868,2404,12.0,4094.1
4852403603,0,16,0,0,21,35,39,0,0,0,1,35268,11.2,39983,87,0,-4921,-4879,8.7,3526.8,0,6,1,35,21,90,0,0,0,0,40189,11.8,44862,118,0,4921,4879,11.8,4018.9
4849143915,0,0,0,1,15,14,28,0,0,0,1,35740,10.4,36984,106,0,1822,-1326,10.6,3574.0,0,0,0,14,15,27,0,0,0,0,33918,10.6,38310,82,0,-1822,1326,8.2,3391.8
4849123049,0,0,0,1,19,21,53,0,0,0,2,37615,10.8,38009,113,0,-231,-1650,11.3,3761.5,0,0,0,21,19,56,0,0,0,0,37846,11.0,39659,91,0,231,1650,9.1,3784.6
4846125517,1,0,0,1,31,17,73,0,0,0,1,38774,11.4,42421,102,0,2986,3132,10.2,3877.4,0,0,0,17,31,44,0,0,0,0,35788,11.0,39289,83,0,-2986,-3132,8.3,3578.8
4845670339,0,0,0,0,28,23,71,0,0,0,0,39899,11.6,45102,95,0,4143,4665,9.5,3989.9,0,0,1,23,28,52,0,0,0,0,35756,11.0,40437,95,0,-4143,-4665,9.5,3575.6
4845214228,0,0,0,0,20,18,59,0,0,0,0,35559,10.8,38043,86,0,509,673,8.6,3555.9,8,0,1,18,20,54,0,0,0,0,35050,10.6,37370,104,0,-509,-673,10.4,3505.0
4769096583,0,13,0,0,3,11,0,0,0,0,0,13326,6.4,15826,159,40,-5975,-3710,19.9,1332.6,14,1,1,11,3,9,1,1,0,0,19301,7.4,19536,181,64,5975,3710,24.5,1930.1
4765390761,0,16,0,0,6,4,1,1,1,0,0,15240,6.8,16600,168,60,-79,492,22.8,1524.0,10,0,1,4,6,2,0,0,0,0,15319,6.4,16108,176,52,79,-492,22.8,1531.9
4765354612,1,11,0,1,7,3,5,1,1,0,0,16702,6.8,17087,166,49,3024,1319,21.5,1670.2,12,1,0,3,7,2,1,0,1,0,13678,6.4,15768,139,56,-3024,-1319,19.5,1367.8
4761937795,1,17,2,0,11,5,5,0,0,0,0,17755,7.2,19453,185,56,2727,1916,24.1,1775.5,10,1,1,5,11,1,1,0,1,0,15028,7.0,17537,173,52,-2727,-1916,22.5,1502.8
4761910769,0,8,4,0,10,2,8,0,0,0,0,18309,6.8,18396,188,44,4974,3452,23.2,1830.9,13,1,1,2,10,2,1,0,1,0,13335,6.2,14944,126,68,-4974,-3452,19.4,1333.5
4856251574,1,11,0,1,6,1,7,1,1,0,0,15714,7.0,18077,206,55,1877,613,26.1,1571.4,8,0,0,1,6,0,0,0,0,0,13837,6.8,17464,200,48,-1877,-613,24.8,1383.7
4856202072,1,78,14,0,1,3,1,0,0,0,0,13975,6.8,17770,182,44,201,1558,22.6,1397.5,27,1,1,3,1,2,0,0,0,0,13774,6.4,16212,160,56,-201,-1558,21.6,1377.4
4855154551,1,9,0,1,6,4,4,0,0,0,0,15541,7.0,17525,156,64,1499,497,22.0,1554.1,9,0,0,4,6,0,0,0,0,0,14042,6.6,17028,155,40,-1499,-497,19.5,1404.2
4853400441,1,10,0,0,5,6,4,0,0,0,0,13744,6.0,14356,137,37,-1916,-3421,17.4,1374.4,4,0,1,6,5,2,0,0,0,0,15660,6.8,17777,169,68,1916,3421,23.7,1566.0
4796941069,0,11,2,0,3,9,1,0,0,0,0,12542,6.2,15219,148,40,-4881,-3973,18.8,1254.2,10,0,1,8,2,5,1,1,0,0,17423,7.2,19192,169,64,4881,3973,23.3,1742.3
4796901846,1,6,1,0,4,5,4,0,0,0,0,14722,6.8,17433,186,56,-563,-137,24.2,1472.2,13,1,1,5,4,5,0,0,0,0,15285,7.0,17570,171,48,563,137,21.9,1528.5
4796837158,1,11,0,1,3,6,3,0,0,0,0,13720,6.6,16225,164,48,-2085,-1346,21.2,1372.0,164,1,0,6,3,4,1,1,0,0,15805,6.8,17571,171,48,2085,1346,21.9,1580.5
4796794550,1,76,0,1,5,4,3,1,1,0,0,15383,6.8,17358,180,41,1462,888,22.1,1538.3,10,0,0,4,5,2,0,0,0,0,13921,6.6,16470,152,60,-1462,-888,21.2,1392.1
4796737099,0,12,1,0,2,2,2,0,0,0,0,14020,6.4,15607,157,58,-149,595,21.5,1402.0,33,0,1,2,2,2,0,0,0,0,14169,6.2,15012,170,4,149,-595,17.4,1416.9
4796706636,0,13,1,0,5,2,3,0,0,0,0,15745,7.0,18269,191,72,1935,2559,26.3,1574.5,16,1,1,2,5,3,0,0,0,0,13810,6.6,15710,163,36,-1935,-2559,19.9,1381.0
4796684841,0,60,0,0,4,7,5,0,0,0,0,13506,6.6,16447,150,39,-2713,-1982,18.9,1350.6,100,0,1,7,4,3,0,0,0,0,16219,6.8,18429,178,56,2713,1982,23.4,1621.9
4795688457,0,13,13,1,5,5,4,1,1,0,0,15625,7.0,18098,171,64,354,1523,23.5,1562.5,37,6,0,5,5,4,0,0,0,0,15271,6.4,16575,171,52,-354,-1523,22.3,1527.1
4795667611,0,12,1,0,0,2,0,0,0,0,0,13556,6.6,16398,173,48,-1845,-1510,22.1,1355.6,127,2,1,2,0,1,0,0,0,0,15401,6.6,17908,206,56,1845,1510,26.2,1540.1
4786637535,0,16,1,0,7,9,4,1,1,0,0,14785,6.4,15885,141,56,-2385,-2032,19.7,1478.5,11,0,1,9,7,8,0,0,0,0,17170,6.8,17917,189,44,2385,2032,23.3,1717.0
4786622195,0,13,2,1,7,4,5,0,0,0,0,14496,6.4,15742,145,40,-949,-3770,18.5,1449.6,11,1,0,4,7,3,0,0,0,0,15445,7.0,19512,173,60,949,3770,23.3,1544.5
4779802366,0,12,0,0,0,4,0,0,0,0,0,12596,6.4,16068,138,52,-3246,-2787,19.0,1259.6,15,2,1,4,0,2,1,1,0,0,15842,7.2,18855,201,72,3246,2787,27.3,1584.2
4779774427,1,12,0,1,5,3,0,0,0,0,0,14172,7.0,17707,170,56,-936,-1181,22.6,1417.2,8,2,0,2,4,1,1,1,0,0,15108,7.2,18888,164,61,936,1181,22.5,1510.8
4779723707,0,20,0,0,1,4,1,0,0,0,0,13063,6.6,16546,138,48,-824,-870,18.6,1306.3,10,1,1,4,1,2,1,1,0,0,13887,6.8,17416,126,52,824,870,17.8,1388.7
4779664592,0,11,2,0,3,3,1,0,0,0,0,13605,6.6,16758,162,52,-1524,-1262,21.4,1360.5,14,1,1,3,3,2,0,0,0,0,15129,6.6,18020,178,44,1524,1262,22.2,1512.9
4779611058,1,263,3,1,9,2,5,1,1,0,0,16735,6.8,16433,139,52,3203,470,19.1,1673.5,12,0,0,2,9,1,0,0,0,0,13532,6.6,15963,147,44,-3203,-470,19.1,1353.2
4857360957,1,12,0,1,3,4,2,0,0,0,0,14442,6.6,16771,181,35,1261,608,21.6,1444.2,16,1,0,4,3,0,1,1,0,0,13181,6.2,16163,141,40,-1261,-608,18.1,1318.1
4857314802,0,11,2,1,6,3,3,0,0,0,0,16348,7.4,18797,177,56,3089,2482,23.3,1634.8,10,1,0,3,6,0,0,0,0,0,13259,6.6,16315,154,44,-3089,-2482,19.8,1325.9
4856641137,1,4,0,0,6,12,3,0,0,0,0,15186,6.2,14627,147,0,-1047,847,14.7,1518.6,0,0,1,12,6,10,0,0,0,0,16233,6.0,13780,139,0,1047,-847,13.9,1623.3
4856628099,1,4,0,0,8,6,4,0,0,0,0,15617,6.2,15724,124,48,1145,711,17.2,1561.7,1,0,1,6,8,7,0,0,0,0,14472,6.2,15013,145,0,-1145,-711,14.5,1447.2
4856016907,0,10,0,0,1,7,0,0,0,0,0,14796,6.8,17726,202,60,-1445,-63,26.2,1479.6,16,2,1,7,1,4,1,1,0,0,16241,6.8,17789,158,52,1445,63,21.0,1624.1
4855980587,0,12,1,0,1,5,1,0,0,0,0,13679,6.6,16517,171,56,-1961,-1396,22.7,1367.9,57,1,1,5,1,2,0,0,0,0,15640,6.8,17913,165,72,1961,1396,23.7,1564.0
4855916817,0,10,1,1,2,1,1,0,0,0,0,12580,6.4,15319,127,52,-691,-577,17.9,1258.0,13,1,0,1,2,0,0,0,0,0,13271,6.4,15896,146,44,691,577,19.0,1327.1
4855852211,1,7,0,0,7,9,6,0,0,0,0,16274,6.4,15567,165,0,841,1228,16.5,1627.4,6,0,1,9,7,8,0,0,0,0,15433,6.0,14339,132,0,-841,-1228,13.2,1543.3
4855827728,0,12,2,0,6,6,5,0,0,0,0,15062,7.0,18103,167,44,-452,-832,21.1,1506.2,13,1,1,5,5,0,0,0,0,0,15514,7.0,18935,221,56,452,832,27.7,1551.4
4855797690,1,14,2,1,8,1,7,1,1,0,0,16241,7.0,17989,167,56,2227,-71,22.3,1624.1,9,2,0,1,8,0,0,0,0,0,14014,6.8,18060,199,44,-2227,71,24.3,1401.4
4855769490,0,10,2,1,7,2,7,0,0,0,0,16828,6.8,16966,207,52,2182,-60,25.9,1682.8,9,0,0,2,7,2,0,0,0,0,14646,6.6,17026,161,52,-2182,60,21.3,1464.6
4855330187,1,22,0,0,6,7,6,0,0,0,0,16298,6.6,16974,168,52,1366,243,22.0,1629.8,11,2,1,7,6,3,0,0,0,0,14932,6.6,16731,144,52,-1366,-243,19.6,1493.2
4854973630,1,27,1,0,13,15,14,0,0,0,0,45005,10.0,47500,4,0,16805,19000,0.4,4500.5,0,0,1,9,7,8,0,0,0,0,28200,6.0,28500,0,0,-16805,-19000,0.0,2820.0
4854906045,1,11,1,1,2,7,0,0,0,0,0,14118,6.0,14797,182,36,-1500,-2267,21.8,1411.8,15,3,0,7,2,4,0,0,0,0,15618,6.6,17064,178,44,1500,2267,22.2,1561.8
4854844474,1,16,2,0,9,11,8,0,0,0,0,16609,6.2,15745,130,32,-1794,-272,16.2,1660.9,13,3,1,11,9,9,1,1,0,0,18403,6.6,16017,130,48,1794,272,17.8,1840.3
4854810581,1,15,1,1,8,3,4,0,0,0,0,16121,6.8,17714,166,52,2033,1758,21.8,1612.1,11,0,0,3,8,1,0,0,0,0,14088,6.4,15956,128,52,-2033,-1758,18.0,1408.8
4757349422,1,205,1,1,8,5,6,0,0,0,0,16301,6.8,17179,170,52,272,-136,22.2,1630.1,12,2,0,5,8,5,0,0,0,0,16029,6.6,17315,184,55,-272,136,23.9,1602.9
4757317073,1,9,1,1,13,3,9,0,0,0,1,20724,7.4,19374,178,56,6992,3856,23.4,2072.4,11,0,0,3,13,5,0,0,0,0,13732,6.4,15518,150,48,-6992,-3856,19.8,1373.2
4757277049,1,6,1,1,2,5,0,0,0,0,0,15119,7.0,18026,170,60,1931,4125,23.0,1511.9,12,0,0,5,2,2,0,0,0,0,13188,5.6,13901,116,40,-1931,-4125,15.6,1318.8
4752950119,1,13,0,0,3,4,2,1,1,0,0,14516,6.8,17135,165,56,-709,-1014,22.1,1451.6,13,3,1,4,3,4,0,0,0,0,15225,7.0,18149,187,52,709,1014,23.9,1522.5
4857579824,0,9,0,0,3,5,3,0,0,0,0,14464,7.0,17780,184,64,-830,500,24.8,1446.4,11,1,1,5,3,6,0,0,0,0,15294,6.6,17280,192,56,830,-500,24.8,1529.4
4857542009,1,8,1,0,3,4,4,0,0,0,0,15120,6.8,17787,205,48,-371,-844,25.3,1512.0,8,1,1,4,3,2,0,0,0,0,15491,7.0,18631,206,51,371,844,25.7,1549.1
4857507187,1,14,2,1,4,2,0,0,0,0,0,14218,6.8,17328,191,52,763,668,24.3,1421.8,11,1,0,1,3,1,0,0,0,0,13455,6.8,16660,174,44,-763,-668,21.8,1345.5
4857452590,1,9,2,1,1,2,0,0,0,0,0,14621,6.8,18369,239,60,-82,-296,29.9,1462.1,9,1,0,2,1,1,0,0,0,0,14703,7.2,18665,200,47,82,296,24.7,1470.3
4856588524,1,76,0,1,5,4,3,0,0,0,0,16807,7.2,18463,190,64,1725,698,25.4,1680.7,14,0,0,4,5,2,0,0,0,0,15082,6.8,17765,191,52,-1725,-698,24.3,1508.2
4856566699,1,19,2,1,3,0,2,0,0,0,0,16056,7.4,19323,219,58,3516,3024,27.7,1605.6,14,0,0,0,3,0,0,0,0,0,12540,6.6,16299,156,52,-3516,-3024,20.8,1254.0
4856548965,0,27,3,0,3,4,2,0,0,0,0,14505,6.8,17612,160,59,-1449,-627,21.9,1450.5,13,1,1,4,3,7,1,1,0,0,15954,6.8,18239,216,56,1449,627,27.2,1595.4
4856514534,0,33,1,0,3,5,2,0,0,0,0,14296,7.0,17494,175,59,-2738,-992,23.4,1429.6,13,12,1,5,3,3,0,0,0,0,17034,7.2,18486,213,48,2738,992,26.1,1703.4
4856487235,1,110,0,1,4,2,5,1,1,0,0,15705,6.8,16869,197,52,822,-214,24.9,1570.5,11,1,0,2,4,4,0,0,0,0,14883,6.8,17083,177,56,-822,214,23.3,1488.3
4856443127,1,13,0,1,3,6,5,0,0,0,0,14952,6.8,16888,210,44,-529,-1087,25.4,1495.2,15,0,0,6,3,5,1,1,0,0,15481,7.0,17975,173,64,529,1087,23.7,1548.1
4855401007,1,16,0,0,12,18,12,0,0,0,0,45250,10.0,47500,0,0,16700,19000,0.0,4525.0,0,0,1,12,6,13,0,0,0,0,28550,6.0,28500,0,0,-16700,-19000,0.0,2855.0
4851943524,0,12,0,1,4,2,7,0,0,0,0,16849,7.2,19327,222,60,756,776,28.2,1684.9,12,0,0,2,4,1,0,0,0,0,16093,7.0,18551,221,66,-756,-776,28.7,1609.3
4851903597,0,10,1,1,1,11,1,0,0,0,0,14724,6.4,16559,179,48,-3770,-2510,22.7,1472.4,9,1,0,11,1,8,0,0,0,0,18494,7.2,19069,191,48,3770,2510,23.9,1849.4
4851866013,1,15,0,0,7,2,3,0,0,0,0,16982,7.0,19139,226,42,2020,1526,26.8,1698.2,9,2,1,2,7,2,0,0,0,0,14962,6.8,17613,176,52,-2020,-1526,22.8,1496.2
4849231007,0,14,0,1,4,3,2,1,1,0,0,15876,7.0,18280,209,64,1369,471,27.3,1587.6,10,0,0,3,4,3,0,0,0,0,14507,7.0,17809,176,60,-1369,-471,23.6,1450.7
4849192718,1,24,1,0,9,6,11,0,0,0,0,16111,6.2,15700,164,48,-876,-876,21.2,1611.1,14,0,1,6,9,7,0,0,0,0,16987,6.8,16576,157,44,876,876,20.1,1698.7
4849160215,0,12,0,1,6,3,8,0,0,0,0,16390,7.0,18099,195,72,2025,1478,26.7,1639.0,9,0,0,3,6,2,0,0,0,0,14365,6.6,16621,177,52,-2025,-1478,22.9,1436.5
4846228981,0,12,0,1,8,7,8,0,0,0,0,18244,7.0,18811,215,48,1309,-185,26.3,1824.4,74,0,0,7,8,6,1,1,0,0,16935,7.2,18996,198,60,-1309,185,25.8,1693.5
4846181734,0,14,1,0,2,6,2,1,1,0,0,13399,6.4,15798,183,38,-2949,-1190,22.1,1339.9,12,0,1,6,2,6,0,0,0,0,16348,6.8,16988,212,55,2949,1190,26.7,1634.8
4846151155,1,14,0,0,4,5,4,0,0,0,0,15090,6.8,17984,173,56,-311,84,22.9,1509.0,12,0,1,5,4,2,0,0,0,0,15401,6.8,17900,190,52,311,-84,24.2,1540.1
4857231137,1,11,0,1,8,7,7,0,0,0,0,16876,6.8,17419,198,52,2613,2505,25.0,1687.6,9,0,0,7,8,5,0,0,0,0,14263,6.4,14914,103,44,-2613,-2505,14.7,1426.3
4857197803,1,12,0,1,13,6,4,1,1,0,0,18180,7.0,19119,180,60,3195,1902,24.0,1818.0,9,0,0,5,12,4,0,0,0,0,14985,6.8,17217,147,48,-3195,-1902,19.5,1498.5
4857162648,1,11,1,1,5,1,3,0,0,0,0,17127,7.2,19810,233,51,2695,1737,28.4,1712.7,15,0,0,1,5,1,1,0,1,0,14432,7.0,18073,212,60,-2695,-1737,27.2,1443.2
4856267932,0,14,0,0,8,7,6,0,0,0,1,16310,5.6,14040,135,49,-3266,-4628,18.4,1631.0,15,3,1,7,8,8,0,0,0,0,19576,7.2,18668,227,47,3266,4628,27.4,1957.6
4856223764,1,9,2,1,9,5,5,0,0,0,0,16997,7.2,18535,203,48,1141,1045,25.1,1699.7,9,1,0,5,9,5,0,0,0,0,15856,6.8,17490,149,56,-1141,-1045,20.5,1585.6
4856183401,0,73,3,0,6,3,11,0,0,0,0,15526,7.0,17948,164,32,-1120,-1269,19.6,1552.6,13,2,1,3,6,3,1,1,0,0,16646,7.2,19217,212,52,1120,1269,26.4,1664.6
4847977621,1,9,1,1,6,2,10,1,1,0,0,16707,7.0,19246,203,64,3046,1264,26.7,1670.7,29,0,0,2,6,1,0,0,0,0,13661,6.8,17982,184,56,-3046,-1264,24.0,1366.1
4847953089,0,12,0,0,5,5,4,0,0,0,0,14403,6.8,16718,134,52,-337,-940,18.6,1440.3,6,0,1,5,5,3,1,1,0,0,14740,6.8,17658,171,52,337,940,22.3,1474.0
4846015030,1,16,0,1,6,1,5,1,1,0,0,14498,6.6,15754,129,32,-171,-1529,16.1,1449.8,16,1,0,1,6,1,0,0,0,0,14669,6.6,17283,188,40,171,1529,22.8,1466.9
4845976256,0,14,1,1,5,3,4,0,0,0,0,14782,6.6,16481,132,40,1081,-1026,17.2,1478.2,11,1,0,3,5,1,0,0,0,0,13701,6.8,17507,162,40,-1081,1026,20.2,1370.1
4845942385,0,12,0,0,1,5,0,0,0,0,0,12308,6.8,16348,144,40,-2877,-1385,18.4,1230.8,14,2,1,5,1,2,0,0,0,0,15185,7.0,17733,186,44,2877,1385,23.0,1518.5
4845918505,0,16,3,0,3,11,2,0,0,0,0,14370,6.4,15629,162,48,-3829,-2054,21.0,1437.0,15,1,1,11,3,7,0,0,0,0,18199,7.2,17683,188,40,3829,2054,22.8,1819.9
4843369552,1,16,1,0,6,4,6,0,0,0,0,15622,7.2,18102,168,60,-50,540,22.8,1562.2,11,2,1,4,6,2,1,1,0,0,15672,6.6,17562,184,64,50,-540,24.8,1567.2
4843319704,0,15,2,0,2,4,3,1,1,0,0,14250,6.8,17707,190,48,-741,323,23.8,1425.0,16,0,1,4,2,2,0,0,0,0,14991,6.8,17384,174,56,741,-323,23.0,1499.1
4843274981,1,12,0,0,1,3,1,0,0,0,0,14406,7.0,18520,195,60,39,151,25.5,1440.6,13,0,1,3,1,1,0,0,0,0,14367,7.0,18369,207,56,-39,-151,26.3,1436.7
4843210344,1,16,0,0,1,4,0,0,0,0,0,13458,7.0,18076,156,56,371,490,21.2,1345.8,10,0,1,4,1,1,0,0,0,0,13087,7.0,17586,162,32,-371,-490,19.4,1308.7
4840225664,0,12,2,0,3,10,6,0,0,0,0,13946,6.6,16174,166,44,-4273,-2028,21.0,1394.6,10,0,1,10,3,16,0,0,0,0,18219,7.0,18202,202,51,4273,2028,25.3,1821.9
4840193369,1,12,0,1,6,2,7,1,1,0,0,17390,6.8,17261,208,44,4588,1970,25.2,1739.0,13,0,0,2,6,2,0,0,0,0,12802,6.4,15291,131,52,-4588,-1970,18.3,1280.2
4840162184,1,14,2,1,4,3,2,0,0,0,0,14528,6.8,17624,179,48,-342,-661,22.7,1452.8,12,0,0,2,3,1,0,0,0,0,14870,7.2,18285,226,52,342,661,27.8,1487.0
4806667518,0,10,0,0,1,8,1,0,0,0,0,13987,6.8,17127,196,48,-2971,-2137,24.4,1398.7,8,0,1,8,1,4,1,1,0,0,16958,7.2,19264,221,64,2971,2137,28.5,1695.8
4806653791,0,12,0,1,4,7,1,0,0,0,0,14028,6.6,16658,158,56,-1852,-1548,21.4,1402.8,16,2,0,7,4,3,1,1,0,0,15880,7.2,18206,201,56,1852,1548,25.7,1588.0
4806621414,1,13,1,0,12,5,9,1,1,0,0,18790,7.2,18265,167,58,3018,845,22.5,1879.0,17,2,1,5,12,0,0,0,0,0,15772,6.8,17420,193,40,-3018,-845,23.3,1577.2
4803878621,0,98,2,1,4,6,1,0,0,0,0,14673,7.0,18111,184,50,-1913,-124,23.4,1467.3,13,1,0,6,4,4,0,0,0,0,16586,6.8,18235,190,45,1913,124,23.5,1658.6
4803848180,1,6,2,0,8,8,4,0,0,0,0,16276,6.8,17750,186,56,40,-444,24.2,1627.6,13,0,1,7,7,2,0,0,0,0,16236,7.0,18194,178,64,-40,444,24.2,1623.6
4802985731,1,11,4,0,6,5,3,0,0,0,0,15730,7.2,18089,191,40,1125,582,23.1,1573.0,16,2,1,5,6,2,0,0,0,0,14605,6.8,17507,173,32,-1125,-582,20.5,1460.5
4802947730,1,13,0,0,3,7,1,0,0,0,0,14070,6.4,16715,173,48,-1797,-1578,22.1,1407.0,10,0,1,7,3,2,0,0,0,0,15867,7.0,18293,171,56,1797,1578,22.7,1586.7
4802921613,1,16,0,1,4,2,2,0,0,0,0,15636,7.2,18945,195,52,1521,1022,24.7,1563.6,12,0,0,2,4,1,0,0,0,0,14115,6.8,17923,175,44,-1521,-1022,21.9,1411.5
4802892553,0,14,0,0,3,11,1,0,0,0,0,14126,6.8,17414,179,48,-3161,-665,22.7,1412.6,7,0,1,11,3,7,0,0,0,0,17287,7.0,18079,184,56,3161,665,24.0,1728.7
4800607067,0,13,1,0,3,3,1,0,0,0,0,15069,7.2,18925,209,44,354,1200,25.3,1506.9,11,0,1,3,3,3,0,0,0,0,14715,7.0,17725,194,51,-354,-1200,24.5,1471.5
4800573764,1,15,1,1,4,3,1,0,0,0,0,14473,6.8,17896,187,56,1252,543,24.3,1447.3,15,0,0,3,4,0,0,0,0,0,13221,6.6,17353,172,44,-1252,-543,21.6,1322.1
4800547832,1,20,0,0,0,4,0,0,0,0,0,13669,6.8,16616,189,48,-1127,-1253,23.7,1366.9,11,0,1,4,0,4,1,1,0,0,14796,6.8,17869,159,64,1127,1253,22.3,1479.6
4799430846,0,10,0,0,2,4,0,0,0,0,0,13730,6.8,17028,152,40,-486,1655,19.2,1373.0,11,0,1,4,2,3,1,1,0,0,14216,6.2,15373,154,64,486,-1655,21.8,1421.6
4798984739,1,14,16,0,2,2,1,0,0,0,0,14541,7.0,18537,173,60,538,1319,23.3,1454.1,28,0,1,2,2,2,0,0,0,0,14003,6.6,17218,167,47,-538,-1319,21.4,1400.3
4798947415,0,13,0,1,2,2,3,1,0,1,0,13686,6.8,18527,154,56,-841,376,21.0,1368.6,16,2,0,2,2,0,0,0,0,0,14527,6.8,18151,206,56,841,-376,26.2,1452.7
4798909493,0,22,0,0,2,8,1,0,0,0,0,14222,6.8,17096,149,48,-2241,-709,19.7,1422.2,10,0,1,8,2,7,0,0,0,0,16463,7.0,17805,163,44,2241,709,20.7,1646.3
4798053718,1,9,2,0,4,5,5,0,0,0,0,14328,6.6,15609,155,32,-2419,-2651,18.7,1432.8,6,0,1,5,4,3,0,0,0,0,16747,7.0,18260,205,48,2419,2651,25.3,1674.7
4798024812,1,13,1,0,3,1,4,1,1,0,0,14330,6.8,17162,170,52,190,-344,22.2,1433.0,8,1,1,1,3,1,0,0,0,0,14140,6.8,17506,208,52,-190,344,26.0,1414.0
4797983499,1,11,1,1,3,1,0,0,0,0,0,13315,6.6,17012,150,44,296,-217,19.4,1331.5,14,1,0,1,3,0,0,0,0,0,13019,6.8,17229,146,40,-296,217,18.6,1301.9
4795349052,0,13,0,1,9,7,10,0,0,0,0,16445,6.6,15692,146,52,1710,187,19.8,1644.5,13,0,0,7,9,6,0,0,0,0,14735,6.2,15505,135,28,-1710,-187,16.3,1473.5
4853732684,1,0,0,1,22,16,26,0,0,0,0,64100,12.0,55000,0,0,26200,22000,0.0,6410.0,5,0,0,10,16,10,0,0,0,0,37900,7.2,33000,0,0,-26200,-22000,0.0,3790.0
4853718550,1,0,0,1,16,27,14,0,0,0,0,60600,12.0,55000,12,0,21300,22000,1.2,6060.0,0,0,0,17,6,17,0,0,0,0,39300,7.2,33000,6,0,-21300,-22000,0.6,3930.0
4853687369,0,15,1,1,2,7,2,0,0,0,0,14898,6.4,15792,182,32,-2216,-3403,21.4,1489.8,11,0,0,7,2,0,1,0,1,0,17114,7.0,19195,221,48,2216,3403,26.9,1711.4
4853638769,0,47,0,1,1,5,0,0,0,0,0,13726,6.6,16681,179,58,-2089,-1591,23.7,1372.6,12,1,0,5,1,7,0,0,0,0,15815,7.0,18272,210,56,2089,1591,26.6,1581.5
4853547910,1,176,1,1,7,1,3,1,1,0,0,15470,6.4,16705,186,64,3196,936,25.0,1547.0,9,2,0,0,6,0,0,0,0,0,12274,6.2,15769,168,32,-3196,-936,20.0,1227.4
4852524490,1,33,1,0,16,11,14,0,0,0,0,46900,10.0,47500,9,0,19665,19000,0.9,4690.0,0,0,1,7,12,8,0,0,0,0,27235,6.0,28500,1,0,-19665,-19000,0.1,2723.5
4849531099,1,72,0,1,8,4,3,1,1,0,0,16959,7.0,18454,218,48,3123,1947,26.6,1695.9,10,1,0,4,8,3,0,0,0,0,13836,6.4,16507,169,52,-3123,-1947,22.1,1383.6
4844456977,1,92,1,1,5,5,4,0,0,0,0,14374,6.8,16723,131,60,-1800,-1058,19.1,1437.4,16,5,0,5,5,3,0,0,0,0,16174,6.8,17781,170,56,1800,1058,22.6,1617.4
4839406575,1,0,0,0,23,26,60,0,0,0,0,37063,11.0,41108,82,0,709,118,8.2,3706.3,0,0,1,26,23,43,0,0,0,0,36354,11.2,40990,81,0,-709,-118,8.1,3635.4
4838328357,1,24,5,0,22,9,61,0,0,0,0,34948,11.0,38783,109,0,2907,4387,10.9,3494.8,22,4,1,9,22,15,0,0,0,0,32041,10.0,34396,97,0,-2907,-4387,9.7,3204.1
4837894721,1,51,1,0,9,8,7,0,0,0,0,17481,7.0,18021,185,48,1681,573,23.3,1748.1,15,2,1,8,9,4,0,0,0,0,15800,6.6,17448,192,44,-1681,-573,23.6,1580.0
4837791086,1,0,0,1,27,23,73,0,0,0,0,38970,11.4,42379,85,0,2109,2808,8.5,3897.0,5,0,0,23,27,61,0,0,0,0,36861,10.8,39571,74,0,-2109,-2808,7.4,3686.1
4837730036,1,12,1,0,6,8,5,0,0,0,0,16763,6.8,17641,193,52,-1400,179,24.5,1676.3,11,2,1,8,6,9,0,0,0,0,18163,6.8,17462,166,44,1400,-179,21.0,1816.3
4837709307,0,8,0,0,0,2,0,0,0,0,0,13886,6.8,17271,193,44,-1749,-275,23.7,1388.6,19,1,1,2,0,2,1,0,1,0,15635,6.8,17546,175,48,1749,275,22.3,1563.5
4837688543,1,65,0,0,33,21,104,0,0,0,1,38827,11.4,42548,92,0,3203,2858,9.2,3882.7,0,0,1,21,33,42,0,0,0,0,35624,11.0,39690,72,0,-3203,-2858,7.2,3562.4
4836923684,1,10,2,0,4,3,4,0,0,0,0,15810,7.2,18351,190,68,1182,686,25.8,1581.0,10,1,1,3,4,2,0,0,0,0,14628,7.0,17665,157,64,-1182,-686,22.1,1462.8
4836890952,1,68,1,1,5,4,5,1,1,0,0,16202,6.8,17660,164,48,1716,1165,21.2,1620.2,15,0,0,4,5,2,0,0,0,0,14486,6.4,16495,170,52,-1716,-1165,22.2,1448.6
4836291635,1,11,0,0,2,4,2,0,0,0,0,14444,7.0,18537,213,52,-67,2120,26.5,1444.4,13,0,1,4,2,4,0,0,0,0,14511,6.6,16417,163,48,67,-2120,21.1,1451.1
4836255889,0,24,1,0,2,9,4,0,0,0,0,14556,6.6,16303,164,52,-1994,-1725,21.6,1455.6,18,1,1,9,2,7,0,0,0,0,16550,6.6,18028,163,44,1994,1725,20.7,1655.0
4836237070,0,9,7,0,8,6,7,0,0,0,0,15493,6.6,16781,140,36,-970,-1256,17.6,1549.3,35,0,1,6,8,4,0,0,0,0,16463,6.8,18037,194,72,970,1256,26.6,1646.3
4845302109,0,13,1,0,5,3,3,0,0,0,0,14337,7.0,17845,139,52,76,1380,19.1,1433.7,11,0,1,3,5,3,1,1,0,0,14261,6.8,16465,153,68,-76,-1380,22.1,1426.1
4844397218,1,110,1,0,1,1,2,2,1,1,0,14963,6.8,17920,202,56,-73,-917,25.8,1496.3,12,0,1,1,1,1,0,0,0,0,15036,7.0,18837,181,56,73,917,23.7,1503.6
4843488389,0,11,0,0,0,1,0,0,0,0,0,12444,6.6,16709,157,50,-1567,-893,20.7,1244.4,11,0,1,1,0,0,1,1,0,0,14011,6.6,17602,197,45,1567,893,24.2,1401.1
4841381536,1,34,1,1,8,3,7,1,1,0,0,17818,7.0,18365,170,44,4097,2119,21.4,1781.8,32,1,0,3,8,4,0,0,0,0,13721,6.6,16246,150,43,-4097,-2119,19.3,1372.1
4841347642,0,14,0,1,7,7,4,0,0,0,0,15067,6.4,15881,135,40,-3883,-3003,17.5,1506.7,312,2,0,7,7,4,1,1,0,0,18950,7.0,18884,232,44,3883,3003,27.6,1895.0
4839233892,0,14,0,1,7,6,7,0,0,0,0,15239,6.6,16519,146,51,-1599,-2120,19.7,1523.9,83,0,0,6,7,1,0,0,0,0,16838,7.2,18639,204,57,1599,2120,26.1,1683.8
4837167991,0,19,0,1,2,3,1,0,0,0,0,14123,6.8,17310,140,33,-816,-121,17.3,1412.3,10,0,0,3,2,1,0,0,0,0,14939,6.8,17431,182,46,816,121,22.8,1493.9
4837120823,0,15,0,0,6,6,3,1,1,0,0,15078,6.8,17067,118,48,-854,-24,16.6,1507.8,14,0,1,6,6,5,0,0,0,0,15932,6.6,17091,169,64,854,24,23.3,1593.2
4837057703,0,9,1,0,4,3,6,0,0,0,0,14255,6.6,16358,157,32,-2197,-1770,18.9,1425.5,23,3,1,3,4,2,0,0,0,0,16452,6.6,18128,186,52,2197,1770,23.8,1645.2
4836138905,1,76,3,1,7,3,4,1,1,0,0,16401,7.4,19016,193,48,2423,1871,24.1,1640.1,15,0,0,3,7,2,0,0,0,0,13978,6.8,17145,175,48,-2423,-1871,22.3,1397.8
4836093671,1,22,0,0,4,4,4,0,0,0,0,15336,6.6,16766,206,0,-344,-1261,20.6,1533.6,4,0,1,4,4,3,1,1,0,0,15680,7.0,18027,157,56,344,1261,21.3,1568.0
4835037990,0,14,1,0,2,4,2,1,1,0,0,13805,6.4,16246,152,32,-3709,-2766,18.4,1380.5,12,0,1,4,2,4,1,0,1,0,17514,7.0,19012,210,59,3709,2766,26.9,1751.4
4834134835,1,17,0,1,4,7,5,0,0,0,0,14575,6.6,16863,146,52,-213,38,19.8,1457.5,9,0,0,7,4,5,1,1,0,0,14788,6.8,16825,147,48,213,-38,19.5,1478.8
4834077217,1,13,5,0,4,3,4,1,1,0,0,14106,6.2,15688,187,52,-604,-1050,23.9,1410.6,12,2,1,3,4,3,0,0,0,0,14710,6.8,16738,197,36,604,1050,23.3,1471.0
4833703898,0,13,0,1,4,7,4,0,0,0,0,15261,6.8,16774,159,44,-2057,-2433,20.3,1526.1,167,2,0,7,4,6,1,1,0,0,17318,7.0,19207,192,48,2057,2433,24.0,1731.8
4833301110,1,12,2,1,4,4,4,1,0,1,0,15505,6.8,17516,176,44,1254,-202,22.0,1550.5,10,1,0,4,4,2,0,0,0,0,14251,6.8,17718,158,60,-1254,202,21.8,1425.1
4833253555,0,10,0,1,3,11,0,0,0,0,0,13896,6.4,15350,134,51,-3735,-2398,18.5,1389.6,22,1,0,11,3,6,1,1,0,0,17631,7.0,17748,169,52,3735,2398,22.1,1763.1
4832310674,1,10,3,0,5,7,9,1,1,0,0,15412,6.4,16113,171,44,-608,-982,21.5,1541.2,14,1,1,7,5,9,0,0,0,0,16020,6.8,17095,159,56,608,982,21.5,1602.0
4831471126,0,11,0,0,1,4,1,0,0,0,0,13341,6.4,15580,186,50,-2367,-3895,23.6,1334.1,12,1,1,4,1,2,0,0,0,0,15708,7.2,19475,229,68,2367,3895,29.7,1570.8
4830650053,0,17,1,1,9,3,6,0,0,0,0,18255,7.0,18409,182,68,3457,1702,25.0,1825.5,9,0,0,3,9,3,0,0,0,0,14798,6.8,16707,146,32,-3457,-1702,17.8,1479.8
4843968796,0,12,0,0,18,30,40,0,0,0,1,33911,10.4,36385,99,0,-5691,-6720,9.9,3391.1,0,3,1,30,18,93,0,0,0,0,39602,11.6,43105,112,0,5691,6720,11.2,3960.2
4838538290,1,11,5,0,6,9,7,0,0,0,0,15934,6.8,17165,159,56,-1562,-987,21.5,1593.4,97,0,1,9,6,8,1,1,0,0,17496,7.2,18152,167,64,1562,987,23.1,1749.6
4838516245,1,171,4,0,5,5,4,1,1,0,0,16219,7.0,17922,225,48,793,706,27.3,1621.9,15,0,1,5,5,3,0,0,0,0,15426,6.8,17216,189,48,-793,-706,23.7,1542.6
4838026321,1,0,0,1,21,18,45,0,0,0,1,37080,11.4,41672,106,0,2424,3256,10.6,3708.0,0,0,0,18,21,46,0,0,0,0,34656,11.0,38416,106,0,-2424,-3256,10.6,3465.6
4836279915,1,8,0,0,6,6,10,0,0,0,0,17212,6.6,17996,151,48,608,536,19.9,1721.2,19,0,1,6,6,3,1,1,0,0,16604,6.8,17460,159,40,-608,-536,19.9,1660.4
4836251244,0,32,0,0,7,2,7,0,0,0,0,16000,7.0,17474,165,40,2063,495,20.5,1600.0,29,1,1,2,7,2,0,0,0,0,13937,6.6,16979,170,52,-2063,-495,22.2,1393.7
4836227893,0,9,0,0,4,10,2,0,0,0,0,14690,6.4,16278,165,44,-1817,-1097,20.9,1469.0,8,0,1,10,4,5,1,1,0,0,16507,6.8,17375,141,63,1817,1097,20.4,1650.7
4836151336,1,12,1,0,3,3,2,0,0,0,0,14525,6.6,17401,159,44,732,1024,20.3,1452.5,22,3,1,3,3,1,1,1,0,0,13793,6.4,16377,157,52,-732,-1024,20.9,1379.3
4835364366,0,12,1,1,9,6,10,1,1,0,0,16219,6.0,13556,126,44,-568,-2937,17.0,1621.9,13,0,0,6,9,2,1,0,1,0,16787,6.4,16493,145,48,568,2937,19.3,1678.7
4834405919,0,13,0,1,5,10,2,0,0,0,0,14054,6.6,16107,117,36,-3539,-2355,15.3,1405.4,18,0,0,10,5,7,1,1,0,0,17593,7.2,18462,169,52,3539,2355,22.1,1759.3
4834402822,0,11,14,0,3,4,3,0,0,0,0,13228,6.6,15827,162,44,-2815,-2959,20.6,1322.8,29,0,1,4,3,1,0,0,0,0,16043,7.2,18786,193,56,2815,2959,24.9,1604.3
4834366363,1,10,1,0,4,3,4,0,0,0,0,14857,6.8,17653,181,48,1093,350,22.9,1485.7,15,1,1,3,4,1,1,1,0,0,13764,7.0,17303,181,36,-1093,-350,21.7,1376.4
4834334918,0,17,1,0,5,13,4,0,0,0,0,16785,6.8,16824,163,44,-2160,-1761,20.7,1678.5,19,2,1,13,5,10,1,1,0,0,18945,7.4,18585,140,56,2160,1761,19.6,1894.5
4833439908,1,24,0,0,13,4,7,1,1,0,0,17514,6.6,16978,112,64,4543,4251,17.6,1751.4,0,1,1,4,13,2,0,0,0,0,12971,5.6,12727,126,0,-4543,-4251,12.6,1297.1
4833423539,1,16,3,0,6,2,3,0,0,0,0,17652,6.8,18667,237,44,3869,3400,28.1,1765.2,90,3,1,2,6,4,0,0,0,0,13783,6.0,15267,161,50,-3869,-3400,21.1,1378.3
4833402628,1,12,1,0,3,8,3,0,0,0,0,14076,6.4,15727,142,52,-2663,-2440,19.4,1407.6,10,1,1,8,3,4,1,1,0,0,16739,7.0,18167,194,48,2663,2440,24.2,1673.9
4831588380,1,16,0,1,9,5,10,0,0,0,0,16522,6.6,16477,165,51,2092,156,21.6,1652.2,17,0,0,5,9,4,1,1,0,0,14430,6.6,16321,173,44,-2092,-156,21.7,1443.0
4831582786,0,10,2,1,4,7,1,0,0,0,0,14213,6.6,16160,137,56,-2382,-1344,19.3,1421.3,10,1,0,7,4,7,0,0,0,0,16595,6.8,17504,131,44,2382,1344,17.5,1659.5
4830785217,1,21,0,0,34,15,86,0,0,0,1,38249,11.4,43079,87,0,2935,6310,8.7,3824.9,0,1,1,15,34,38,0,0,0,0,35314,10.6,36769,96,0,-2935,-6310,9.6,3531.4
4830782794,1,22,0,0,15,18,35,0,0,0,1,36360,10.8,38551,91,0,1225,1023,9.1,3636.0,0,5,1,18,15,47,0,0,0,0,35135,10.8,37528,111,0,-1225,-1023,11.1,3513.5
4837093068,1,12,1,0,1,2,0,1,1,0,0,13711,6.8,17986,172,51,149,347,22.3,1371.1,15,0,1,2,1,2,0,0,0,0,13562,6.8,17639,162,56,-149,-347,21.8,1356.2
4837008449,1,8,1,0,0,5,0,1,1,0,0,13007,6.8,17256,165,48,-2935,-651,21.3,1300.7,262,0,1,5,0,3,0,0,0,0,15942,7.0,17907,193,52,2935,651,24.5,1594.2
4832060814,0,11,1,1,4,5,5,0,0,0,0,16247,6.6,16827,162,52,1804,460,21.4,1624.7,17,0,0,5,4,4,1,1,0,0,14443,6.6,16367,151,54,-1804,-460,20.5,1444.3
4830661984,1,13,1,0,8,8,6,0,0,0,0,17320,6.8,17083,140,68,-145,-566,20.8,1732.0,24,0,1,8,8,8,0,0,0,0,17465,6.8,17649,157,43,145,566,20.0,1746.5
4830637178,0,13,0,0,0,3,0,0,0,0,0,12730,6.4,16205,152,56,-1899,-2426,20.8,1273.0,11,1,1,3,0,2,0,0,0,0,14629,7.0,18631,180,60,1899,2426,24.0,1462.9
4830598614,1,8,3,1,9,4,6,0,0,0,0,17158,7.2,18368,166,68,3327,2363,23.4,1715.8,13,0,0,4,9,1,1,0,1,0,13831,6.4,16005,128,46,-3327,-2363,17.4,1383.1
4830556763,1,14,0,0,8,6,10,1,1,0,0,16620,6.4,16701,144,60,1676,-199,20.4,1662.0,10,0,1,6,8,5,0,0,0,0,14944,6.6,16900,158,47,-1676,199,20.5,1494.4
4830502899,0,13,0,0,5,7,3,0,0,0,0,15119,7.0,19078,188,36,-1156,1150,22.4,1511.9,12,0,1,7,5,8,1,1,0,0,16275,6.8,17928,161,60,1156,-1150,22.1,1627.5
4829950045,1,13,1,1,12,4,7,0,0,0,1,18836,7.2,18528,155,60,4664,3567,21.5,1883.6,14,0,0,4,12,4,0,0,0,0,14172,6.2,14961,166,48,-4664,-3567,21.4,1417.2
4829851691,1,17,0,0,2,4,0,0,0,0,0,13641,6.6,16830,171,56,-617,-429,22.7,1364.1,12,2,1,4,2,0,0,0,0,0,14258,6.8,17259,188,36,617,429,22.4,1425.8
4829324708,0,20,1,1,2,5,1,0,0,0,0,14203,7.0,18260,153,52,-1159,494,20.5,1420.3,11,0,0,5,2,3,1,1,0,0,15362,6.6,17766,183,48,1159,-494,23.1,1536.2
4829317783,1,11,0,1,7,4,7,1,1,0,0,15638,7.0,17451,135,56,1168,-80,19.1,1563.8,122,0,0,4,7,2,0,0,0,0,14470,6.8,17531,156,52,-1168,80,20.8,1447.0
4829289543,1,17,1,0,3,6,2,0,0,0,0,14033,6.6,16810,150,52,102,3328,20.2,1403.3,11,0,1,6,3,5,0,0,0,0,13931,5.4,13482,117,4,-102,-3328,12.1,1393.1
4827600044,1,10,3,0,0,3,0,0,0,0,0,12968,7.0,17903,208,55,-2799,-401,26.3,1296.8,14,1,1,3,0,2,0,0,0,0,15767,7.2,18304,219,57,2799,401,27.6,1576.7
4827483823,0,13,1,1,8,5,6,0,0,0,0,16453,6.6,16914,169,40,2611,-42,20.9,1645.3,74,1,0,4,7,3,0,0,0,0,13842,6.6,16956,159,60,-2611,42,21.9,1384.2
4824008499,1,11,1,0,5,5,3,0,0,0,1,14438,6.6,15862,127,49,-1092,-1241,17.6,1443.8,11,0,1,5,5,0,0,0,0,0,15530,7.0,17103,172,38,1092,1241,21.0,1553.0
4823951798,1,14,0,1,5,3,8,0,0,0,0,17101,7.0,18092,173,59,1552,-103,23.2,1710.1,7,1,0,3,5,1,0,0,0,0,15549,6.8,18195,219,48,-1552,103,26.7,1554.9
4823899391,0,14,0,1,2,0,0,0,0,0,0,14711,7.0,18121,204,48,1388,-568,25.2,1471.1,11,0,0,0,2,0,1,1,0,0,13323,7.0,18689,155,52,-1388,568,20.7,1332.3
4740529097,0,153,1,0,4,5,3,1,0,1,0,14440,6.6,16871,136,56,16,535,19.2,1444.0,13,1,1,5,4,6,1,1,0,0,14424,6.4,16336,135,40,-16,-535,17.5,1442.4
4735441662,1,164,1,1,9,4,5,1,1,0,0,14047,6.8,16917,107,48,-1072,1039,15.5,1404.7,11,2,0,4,9,4,0,0,0,0,15119,6.4,15878,179,36,1072,-1039,21.5,1511.9
4735391713,1,16,0,1,3,2,1,0,0,0,0,14415,7.2,17729,178,60,974,706,23.8,1441.5,13,1,0,2,3,4,0,0,0,0,13441,6.6,17023,178,24,-974,-706,20.2,1344.1
4734399210,0,21,1,0,4,7,6,0,0,0,0,15668,6.6,16744,183,54,1520,382,23.7,1566.8,12,1,1,7,4,1,0,0,0,0,14148,6.6,16362,141,52,-1520,-382,19.3,1414.8
4734379939,1,81,2,0,3,2,4,0,0,0,0,14170,6.6,16296,172,52,1016,-193,22.4,1417.0,16,0,1,2,3,0,1,1,0,0,13154,6.6,16489,156,48,-1016,193,20.4,1315.4
4733533614,0,25,0,0,0,3,0,0,0,0,0,11061,6.6,16121,117,42,-4283,-2167,15.9,1106.1,8,0,1,3,0,5,0,0,0,0,15344,7.0,18288,202,64,4283,2167,26.6,1534.4
4733527981,1,50,0,1,19,11,16,0,0,0,0,63050,12.0,55000,0,0,26900,22000,0.0,6305.0,0,0,0,5,13,4,0,0,0,0,36150,7.2,33000,0,0,-26900,-22000,0.0,3615.0
4733401615,0,46,0,1,4,2,1,1,1,0,0,13506,6.4,16583,132,56,-708,51,18.8,1350.6,6,1,0,2,4,2,1,0,1,0,14214,6.6,16532,165,48,708,-51,21.3,1421.4
4254068731,1,186,2,0,3,8,1,0,0,0,0,15110,7.0,17839,200,49,390,1867,24.9,1511.0,15,1,1,8,3,8,1,1,0,0,14720,6.2,15972,116,64,-390,-1867,18.0,1472.0
4253539689,0,18,0,1,1,2,0,0,0,0,0,12502,6.4,16494,138,46,-2173,-1528,18.4,1250.2,10,0,0,2,1,2,1,0,1,0,14675,7.2,18022,216,52,2173,1528,26.8,1467.5
4253497305,0,12,0,1,8,7,9,0,0,0,0,15590,6.2,15571,194,12,250,-2501,20.6,1559.0,11,1,0,7,8,3,1,1,0,0,15340,7.0,18072,149,52,-250,2501,20.1,1534.0
4253336250,0,13,3,0,3,6,2,0,0,0,0,13220,6.4,16668,147,56,-2888,-2206,20.3,1322.0,11,1,1,6,3,4,1,1,0,0,16108,7.2,18874,172,44,2888,2206,21.6,1610.8
4253314502,0,19,0,1,6,3,5,0,0,0,0,15869,6.8,17689,172,44,1997,111,21.6,1586.9,75,2,0,3,6,0,0,0,0,0,13872,6.8,17578,133,52,-1997,-111,18.5,1387.2
4253303133,1,52,2,1,6,2,3,1,1,0,0,14545,6.6,16383,123,50,1117,294,17.3,1454.5,17,3,0,2,6,2,0,0,0,0,13428,6.6,16089,168,36,-1117,-294,20.4,1342.8
4252563959,0,117,1,0,5,14,3,0,0,0,0,13630,6.2,14495,128,26,-4441,-3498,15.4,1363.0,10,1,1,14,5,17,1,1,0,0,18071,7.0,17993,141,58,4441,3498,19.9,1807.1
4251545893,1,17,0,0,3,3,3,2,1,1,0,13074,6.6,16406,131,32,-387,-26,16.3,1307.4,11,0,1,3,3,1,0,0,0,0,13461,6.4,16432,151,56,387,26,20.7,1346.1
4251550684,0,8,0,0,2,4,1,0,0,0,0,12162,6.4,15790,115,41,-1878,-1125,15.6,1216.2,24,0,1,4,2,5,0,0,0,0,14040,6.6,16915,146,44,1878,1125,19.0,1404.0
4729110920,0,0,0,0,20,27,35,0,0,0,1,37387,11.0,40727,97,0,-1133,-359,9.7,3738.7,0,0,1,27,20,73,0,0,0,0,38520,11.2,41086,96,0,1133,359,9.6,3852.0
4727851421,1,17,0,1,8,3,6,1,1,0,0,17567,7.0,18381,179,56,3255,2097,23.5,1756.7,9,2,0,3,8,2,0,0,0,0,14312,6.4,16284,175,56,-3255,-2097,23.1,1431.2
4727794530,0,14,0,1,3,1,3,1,0,1,0,14908,6.6,16753,201,68,493,-57,26.9,1490.8,14,0,0,1,3,2,0,0,0,0,14415,6.4,16810,179,48,-493,57,22.7,1441.5
4727765089,1,0,0,1,21,17,49,0,0,0,0,36753,11.2,41122,103,0,1050,2041,10.3,3675.3,0,0,0,17,21,32,0,0,0,0,35703,10.6,39081,93,0,-1050,-2041,9.3,3570.3
4726801917,1,0,0,1,18,17,17,0,0,0,0,64100,12.0,55000,6,0,24800,22000,0.6,6410.0,0,0,0,10,11,7,0,0,0,0,39300,7.2,33000,1,0,-24800,-22000,0.1,3930.0
4726750681,0,10,2,0,4,8,3,0,0,0,0,16130,6.6,17079,175,51,-2333,-1970,22.6,1613.0,14,2,1,8,4,6,0,0,0,0,18463,7.4,19049,219,60,2333,1970,27.9,1846.3
4726706614,1,17,2,1,4,0,6,1,1,0,0,16495,7.0,18554,223,76,2434,1083,29.9,1649.5,21,3,0,0,4,0,0,0,0,0,14061,6.8,17471,247,46,-2434,-1083,29.3,1406.1
4726644497,0,9,1,1,5,4,4,1,1,0,0,15393,6.8,17258,196,48,-96,-670,24.4,1539.3,13,2,0,3,4,2,0,0,0,0,15489,6.8,17928,210,40,96,670,25.0,1548.9
4726620998,1,0,0,1,27,24,46,0,0,0,1,39112,11.2,42694,100,0,1457,94,10.0,3911.2,0,0,0,24,27,58,0,0,0,0,37655,11.6,42600,103,0,-1457,-94,10.3,3765.5
4726362820,1,0,0,1,31,16,90,0,0,0,0,40295,11.8,44032,90,0,5180,4924,9.0,4029.5,0,0,0,16,31,37,0,0,0,0,35115,11.0,39108,93,0,-5180,-4924,9.3,3511.5
4726328502,0,37,4,0,27,23,63,0,0,0,0,37270,11.2,41085,117,0,765,2963,11.7,3727.0,15,7,1,23,27,52,0,0,0,0,36505,10.8,38122,86,0,-765,-2963,8.6,3650.5
4723247146,1,12,1,1,4,6,2,0,0,0,0,16542,6.8,17462,187,48,1574,2157,23.5,1654.2,12,3,0,6,4,7,0,0,0,0,14968,6.2,15305,153,44,-1574,-2157,19.7,1496.8
4723208736,1,21,0,0,23,27,61,0,0,0,0,36188,11.0,40311,101,0,-157,1121,10.1,3618.8,0,20,1,27,23,71,0,0,0,0,36345,11.0,39190,75,0,157,-1121,7.5,3634.5
4722635921,1,17,3,0,10,6,6,1,1,0,0,18549,7.0,17999,200,44,1628,1486,24.4,1854.9,14,2,1,6,10,13,1,0,1,0,16921,6.6,16513,141,44,-1628,-1486,18.5,1692.1
4722595984,1,4,0,1,20,25,48,0,0,0,2,36853,10.8,38935,75,0,-1040,-2849,7.5,3685.3,0,0,0,25,20,68,0,0,0,0,37893,11.4,41784,97,0,1040,2849,9.7,3789.3
4722580362,1,25,0,1,22,14,59,0,0,0,0,35635,10.8,37936,101,0,1890,1845,10.1,3563.5,0,7,0,14,22,31,0,0,0,0,33745,10.4,36091,122,0,-1890,-1845,12.2,3374.5
4722571986,1,0,2,1,15,10,38,0,0,0,1,36621,10.8,37707,129,0,4124,4252,12.9,3662.1,11,0,0,10,15,22,0,0,0,0,32497,10.0,33455,92,0,-4124,-4252,9.2,3249.7
4721845646,1,0,0,1,20,20,17,0,0,0,0,61460,13.2,62000,2,0,22840,19500,0.2,6146.0,39,0,0,8,8,16,0,0,0,0,38620,9.0,42500,0,0,-22840,-19500,0.0,3862.0
4753476993,0,10,0,1,8,6,16,1,1,0,0,15868,6.4,16098,161,56,428,-1004,21.7,1586.8,122,0,0,6,8,3,0,0,0,0,15440,6.4,17102,161,59,-428,1004,22.0,1544.0
4753455664,0,8,12,1,6,8,2,0,0,0,0,14214,6.4,15978,154,52,-4365,-2797,20.6,1421.4,98,0,0,8,6,5,1,1,0,0,18579,7.4,18775,179,48,4365,2797,22.7,1857.9
4753436484,0,189,0,0,3,7,3,1,1,0,0,13996,6.8,17320,173,52,-2898,925,22.5,1399.6,8,0,1,7,3,6,1,0,1,0,16894,6.4,16395,165,48,2898,-925,21.3,1689.4
4743235849,0,14,0,0,4,8,2,0,0,0,0,14164,6.4,15122,156,52,-4261,-3693,20.8,1416.4,85,0,1,8,4,8,1,1,0,0,18425,7.2,18815,166,68,4261,3693,23.4,1842.5
4738241779,1,41,1,1,7,5,7,1,1,0,0,15867,7.2,18510,155,72,1593,797,22.7,1586.7,9,11,0,5,7,2,0,0,0,0,14274,6.8,17713,177,40,-1593,-797,21.7,1427.4
4738211889,0,13,1,0,5,6,1,0,0,0,0,15392,6.8,17872,158,46,-1264,1431,20.4,1539.2,13,0,1,6,5,6,1,1,0,0,16656,6.6,16441,186,60,1264,-1431,24.6,1665.6
4738193835,1,18,3,0,11,8,8,0,0,0,0,18426,6.8,17026,190,52,2171,1195,24.2,1842.6,8,2,1,8,11,4,0,0,0,0,16255,6.6,15831,145,48,-2171,-1195,19.3,1625.5
4738160856,1,53,0,1,4,0,2,0,0,0,0,13572,6.6,17702,154,60,810,1292,21.4,1357.2,11,0,0,0,4,0,1,1,0,0,12762,6.6,16410,151,60,-810,-1292,21.1,1276.2
4738118418,0,14,1,0,3,3,2,1,1,0,0,14406,6.6,16829,176,40,-1740,-1633,21.6,1440.6,10,1,1,3,3,3,1,0,1,0,16146,7.2,18462,149,52,1740,1633,20.1,1614.6
4495631941,1,233,0,0,3,6,5,1,1,0,0,13215,6.2,15112,132,44,-2377,-2892,17.6,1321.5,19,1,1,6,3,3,0,0,0,0,15592,7.2,18004,152,60,2377,2892,21.2,1559.2
4495596007,0,11,1,0,0,6,0,0,0,0,0,12372,6.4,16039,134,44,-4011,-1973,17.8,1237.2,11,2,1,6,0,4,2,1,1,0,16383,7.2,18012,160,56,4011,1973,21.6,1638.3
4495561038,1,12,0,1,6,1,3,1,0,1,0,15244,6.4,16315,158,54,2555,1578,21.2,1524.4,95,0,0,1,6,2,1,1,0,0,12689,6.2,14737,121,38,-2555,-1578,15.9,1268.9
4487759498,0,65,0,0,15,30,30,0,0,0,1,33540,10.2,35249,87,0,-5114,-5273,8.7,3354.0,0,0,1,30,15,69,0,0,0,0,38654,11.0,40522,113,0,5114,5273,11.3,3865.4
4484497782,0,12,0,0,2,6,1,0,0,0,0,13029,6.2,14918,152,46,-1587,-1705,19.8,1302.9,180,0,1,6,2,4,0,0,0,0,14616,6.6,16623,157,38,1587,1705,19.5,1461.6
4484456417,0,6,0,0,5,8,1,0,0,0,0,14649,6.6,16645,167,36,-3684,-927,20.3,1464.9,13,1,1,8,5,5,0,0,0,0,18333,6.8,17572,167,60,3684,927,22.7,1833.3
4484406590,0,10,0,0,2,4,0,0,0,0,0,12986,6.8,16548,170,44,-3430,-2544,21.4,1298.6,11,1,1,3,1,3,1,1,0,0,16416,7.2,19092,183,56,3430,2544,23.9,1641.6
4481531841,0,298,1,0,5,7,3,0,0,0,0,14079,6.6,17041,119,56,-1799,259,17.5,1407.9,13,0,1,7,5,8,0,0,0,0,15878,6.8,16782,145,48,1799,-259,19.3,1587.8
4476562864,0,12,0,0,6,9,2,1,0,1,0,15553,7.0,18300,152,52,-277,20,20.4,1555.3,73,1,1,9,6,3,0,0,0,0,15830,7.0,18280,136,64,277,-20,20.0,1583.0
4453547978,0,11,3,1,7,4,6,0,0,0,0,15204,6.6,17205,145,44,-380,140,18.9,1520.4,12,2,0,4,7,3,1,1,0,0,15584,6.8,17065,147,48,380,-140,19.5,1558.4
4452744983,0,27,1,0,2,6,2,0,0,0,0,13758,6.8,16837,146,52,-1687,-531,19.8,1375.8,7,11,1,6,2,4,0,0,0,0,15445,6.8,17368,157,45,1687,531,20.2,1544.5
4748266333,1,22,13,0,27,31,61,0,0,0,2,39041,11.0,40928,93,0,-1137,-2843,9.3,3904.1,27,0,1,30,26,81,0,0,0,0,40178,11.6,43771,111,0,1137,2843,11.1,4017.8
4748243833,1,24,0,0,11,15,30,0,0,0,0,32993,10.2,35105,104,0,-1017,-2853,10.4,3299.3,103,25,1,15,11,35,0,0,0,0,34010,10.6,37958,90,0,1017,2853,9.0,3401.0
4736695851,0,14,1,0,4,4,2,0,0,0,0,14850,6.8,16687,148,32,-485,191,18.0,1485.0,14,2,1,4,4,2,1,1,0,0,15335,6.4,16496,194,48,485,-191,24.2,1533.5
4734776782,0,0,0,1,34,23,87,0,0,0,0,40094,11.4,43748,116,0,2380,1359,11.6,4009.4,8,0,0,23,34,49,0,0,0,0,37714,11.4,42389,120,0,-2380,-1359,12.0,3771.4
4734747225,1,0,0,1,30,19,77,0,0,0,0,38681,11.4,43882,95,0,2214,2695,9.5,3868.1,0,0,0,19,30,47,0,0,0,0,36467,11.2,41187,108,0,-2214,-2695,10.8,3646.7
4734489075,0,15,3,0,0,2,0,0,0,0,0,11911,6.2,15501,160,44,-4757,-2751,20.4,1191.1,19,3,1,2,0,2,0,0,0,0,16668,7.2,18252,223,68,4757,2751,29.1,1666.8
4734437373,0,35,0,1,6,3,10,0,0,0,0,14748,6.2,14847,148,44,450,-1816,19.2,1474.8,8,0,0,3,6,1,0,0,0,0,14298,6.6,16663,163,60,-450,1816,22.3,1429.8
4733495801,1,13,2,1,6,2,5,1,1,0,0,15080,6.6,16192,149,52,1086,-54,20.1,1508.0,14,0,0,2,6,1,0,0,0,0,13994,6.4,16246,164,62,-1086,54,22.6,1399.4
4733451795,0,22,0,0,2,9,0,0,0,0,0,13297,6.8,16824,189,48,-3793,-1290,23.7,1329.7,9,1,1,9,2,8,0,0,0,0,17090,7.0,18114,197,32,3793,1290,22.9,1709.0
4733395213,1,11,2,1,5,3,3,1,1,0,0,15152,6.6,17130,141,68,1112,-81,20.9,1515.2,14,4,0,3,5,2,0,0,0,0,14040,6.8,17211,184,44,-1112,81,22.8,1404.0
4733362053,1,9,1,1,6,6,7,0,0,0,0,15528,6.8,17700,169,32,-1178,-812,20.1,1552.8,21,0,0,6,6,5,0,0,0,0,16706,7.0,18512,197,44,1178,812,24.1,1670.6
4732489500,1,15,0,1,10,5,5,0,0,0,0,19308,6.8,18818,204,67,4299,3010,27.1,1930.8,87,0,0,5,10,6,0,0,0,0,15009,6.4,15808,135,40,-4299,-3010,17.5,1500.9
4732464848,1,14,0,1,5,2,3,1,1,0,0,14680,6.6,16486,175,40,903,-572,21.5,1468.0,23,1,0,2,5,1,0,0,0,0,13777,6.8,17058,160,44,-903,572,20.4,1377.7
4732399664,1,15,0,0,4,8,2,0,0,0,0,15086,6.8,17880,169,45,-599,1432,21.4,1508.6,11,1,1,8,4,6,0,0,0,0,15685,6.8,16448,146,52,599,-1432,19.8,1568.5
4723599024,1,36,3,0,20,17,20,0,0,0,0,63265,12.0,55000,8,0,26280,22000,0.8,6326.5,8,1,1,9,12,7,0,0,0,0,36985,7.2,33000,0,0,-26280,-22000,0.0,3698.5
4723578092,1,29,0,1,15,13,13,0,0,0,0,46650,10.6,50500,0,0,18800,22000,0.0,4665.0,0,0,0,9,11,7,0,0,0,0,27850,6.0,28500,0,0,-18800,-22000,0.0,2785.0
4723560112,1,21,2,0,14,21,14,0,0,0,0,59920,12.0,55000,2,0,21310,20000,0.2,5992.0,27,1,1,12,5,16,0,0,0,0,38610,7.6,35000,1,0,-21310,-20000,0.1,3861.0
4723541408,1,84,4,0,14,22,20,0,0,0,0,62555,12.6,59500,8,0,23438,22000,0.8,6255.5,73,3,1,15,7,13,0,0,0,0,39117,7.8,37500,8,0,-23438,-22000,0.8,3911.7
4723507480,0,0,20,1,20,24,57,0,0,0,0,35288,10.6,36985,99,0,-1179,-3432,9.9,3528.8,17,0,0,24,20,50,0,0,0,0,36467,11.4,40417,90,0,1179,3432,9.0,3646.7
4723477701,0,0,0,0,20,25,58,0,0,0,1,36778,11.2,40307,98,0,-1019,-444,9.8,3677.8,0,0,1,25,20,54,0,0,0,0,37797,11.2,40751,88,0,1019,444,8.8,3779.7
4856573138,1,0,0,1,20,15,21,0,0,0,0,62350,12.4,57000,0,0,26200,24000,0.0,6235.0,0,0,0,10,15,8,0,0,0,0,36150,7.2,33000,0,0,-26200,-24000,0.0,3615.0
4856554691,0,14,0,0,4,8,3,1,1,0,0,12842,6.6,16794,133,60,-2731,-517,19.3,1284.2,13,0,1,7,3,8,0,0,0,0,15573,6.8,17311,191,32,2731,517,22.3,1557.3
4855901407,0,11,0,1,3,5,1,0,0,0,0,14961,6.8,17738,195,60,-283,770,25.5,1496.1,11,1,0,5,3,5,0,0,0,0,15244,6.6,16968,156,52,283,-770,20.8,1524.4
4855871981,0,84,1,0,3,4,1,0,0,0,0,15043,7.2,18012,217,44,-481,-110,26.1,1504.3,12,1,1,4,3,2,1,1,0,0,15524,6.8,18122,202,60,481,110,26.2,1552.4
4855838958,1,12,3,1,5,3,2,1,0,1,0,15553,7.2,18033,199,64,1029,929,26.3,1555.3,165,1,0,3,5,2,0,0,0,0,14524,6.6,17104,193,40,-1029,-929,23.3,1452.4
4855798930,1,11,0,0,4,7,3,0,0,0,0,14642,7.0,18152,197,56,-1944,137,25.3,1464.2,225,0,1,7,4,12,1,1,0,0,16586,6.8,18015,220,27,1944,-137,24.7,1658.6
4855758780,0,17,1,1,4,3,1,1,1,0,0,14541,6.8,17075,179,44,-396,-450,22.3,1454.1,148,4,0,3,4,2,0,0,0,0,14937,6.8,17525,217,44,396,450,26.1,1493.7
4855733307,1,130,1,1,8,2,4,0,0,0,0,16810,7.0,17749,223,32,2393,2242,25.5,1681.0,13,1,0,2,8,2,0,0,0,0,14417,6.2,15507,153,52,-2393,-2242,20.5,1441.7
4855543326,0,10,2,0,1,6,1,1,1,0,0,13320,6.4,16481,178,48,-3280,-791,22.6,1332.0,16,2,1,6,1,5,0,0,0,0,16600,6.8,17272,204,28,3280,791,23.2,1660.0
4855531870,0,9,0,0,6,4,5,0,0,0,0,16675,6.8,17751,200,47,1571,527,24.7,1667.5,410,1,1,4,6,6,1,1,0,0,15104,7.0,17224,176,48,-1571,-527,22.4,1510.4
4855517956,1,185,0,1,10,0,6,1,1,0,0,16464,6.8,17903,178,41,4514,3264,21.9,1646.4,7,1,0,0,10,0,0,0,0,0,11950,6.0,14639,161,25,-4514,-3264,18.6,1195.0
4855502862,0,10,0,0,2,11,0,0,0,0,0,12222,6.2,14437,120,44,-5464,-3574,16.4,1222.2,218,1,1,11,2,6,0,0,0,0,17686,7.0,18011,201,31,5464,3574,23.2,1768.6
4854103801,0,15,12,1,5,4,4,0,0,0,0,14383,6.0,15577,163,12,-428,-2313,17.5,1438.3,32,4,0,4,5,2,1,1,0,0,14811,6.8,17890,186,54,428,2313,24.0,1481.1
4854011894,0,83,2,1,5,2,5,1,1,0,0,14288,6.4,15296,133,48,-149,-3159,18.1,1428.8,10,2,0,2,5,2,0,0,0,0,14437,7.2,18455,213,44,149,3159,25.7,1443.7
4851188151,1,191,1,1,8,3,9,1,1,0,0,15807,7.2,18105,163,36,1965,1476,19.9,1580.7,8,0,0,3,8,1,0,0,0,0,13842,6.6,16629,191,28,-1965,-1476,21.9,1384.2
4851175075,0,129,0,0,9,10,11,0,0,0,0,15873,6.2,14644,142,32,-533,902,17.4,1587.3,10,0,1,10,9,11,0,0,0,0,16406,6.0,13742,121,28,533,-902,14.9,1640.6
4851155278,0,12,1,1,2,4,0,0,0,0,0,14589,7.0,18233,237,46,-1567,34,28.3,1458.9,11,1,0,3,1,4,1,1,0,0,16156,7.0,18199,244,55,1567,-34,29.9,1615.6
4851129440,1,15,5,1,5,3,1,0,0,0,0,13380,6.4,14958,143,24,148,-616,16.7,1338.0,34,4,0,3,5,1,1,1,0,0,13232,6.4,15574,135,48,-148,616,18.3,1323.2
4851103856,1,11,0,1,5,2,8,1,1,0,0,15344,7.0,17338,203,47,2099,-80,25.0,1534.4,18,0,0,2,5,4,0,0,0,0,13245,6.8,17418,138,48,-2099,80,18.6,1324.5
4833066011,0,263,1,0,2,6,0,0,0,0,0,14628,6.6,17761,166,40,655,1220,20.6,1462.8,21,0,1,6,2,1,1,1,0,0,13973,6.6,16541,140,44,-655,-1220,18.4,1397.3
4857195381,0,18,0,1,3,4,3,0,0,0,0,13472,6.8,17230,121,52,-1123,-1176,17.3,1347.2,21,0,0,4,3,1,1,1,0,0,14595,7.0,18406,188,48,1123,1176,23.6,1459.5
4855747728,1,14,0,1,4,6,1,0,0,0,0,14651,6.8,17169,147,56,317,108,20.3,1465.1,11,0,0,6,4,2,0,0,0,0,14334,6.8,17061,146,44,-317,-108,19.0,1433.4
4854014171,0,17,2,0,1,7,1,0,0,0,0,13373,6.4,15888,153,55,-2435,-1893,20.8,1337.3,11,1,1,7,1,3,1,1,0,0,15808,7.0,17781,182,40,2435,1893,22.2,1580.8
4853967672,1,12,0,1,4,1,1,0,0,0,0,14621,6.8,17504,166,44,3278,2032,21.0,1462.1,16,0,0,1,4,1,0,0,0,0,11343,6.2,15472,118,32,-3278,-2032,15.0,1134.3
4853745371,1,25,2,0,5,2,5,0,0,0,0,16348,6.8,18033,216,55,2683,1402,27.1,1634.8,8,2,1,2,5,1,0,0,0,0,13665,6.6,16631,177,44,-2683,-1402,22.1,1366.5
4852731731,1,8,0,0,3,5,3,1,1,0,0,13145,6.4,16367,168,36,-1563,-422,20.4,1314.5,21,0,1,5,3,8,0,0,0,0,14708,6.8,16789,162,52,1563,422,21.4,1470.8
4852603920,1,25,2,0,4,4,4,1,1,0,0,14808,6.8,18122,178,64,779,158,24.2,1480.8,15,2,1,4,4,0,0,0,0,0,14029,6.8,17964,169,56,-779,-158,22.5,1402.9
4850012002,0,11,0,0,3,6,1,0,0,0,0,14224,6.6,17060,174,48,-1499,72,22.2,1422.4,9,0,1,6,3,5,0,0,0,0,15723,6.6,16988,167,40,1499,-72,20.7,1572.3
4848501198,0,26,0,0,3,6,2,0,0,0,0,13690,5.6,13758,171,5,-1484,-2320,17.6,1369.0,76,16,1,6,3,6,1,1,0,0,15174,6.4,16078,166,56,1484,2320,22.2,1517.4
4847941274,1,8,0,0,3,5,3,0,0,0,0,13315,6.4,16150,164,44,-1433,-1498,20.8,1331.5,9,0,1,5,3,0,1,1,0,0,14748,6.8,17648,170,56,1433,1498,22.6,1474.8
4847784782,0,14,0,0,4,5,5,0,0,0,0,15306,6.8,17036,166,56,-1463,-627,22.2,1530.6,28,1,1,5,4,5,0,0,0,0,16769,6.8,17663,184,52,1463,627,23.6,1676.9
4847730126,1,11,0,0,16,5,17,0,0,0,0,20203,6.6,17233,183,44,6288,3388,22.7,2020.3,7,0,1,5,16,9,1,0,1,0,13915,5.8,13845,105,56,-6288,-3388,16.1,1391.5
4846845166,0,6,1,0,4,7,2,0,0,0,0,14460,6.4,15885,175,48,-1876,-2126,22.3,1446.0,14,0,1,7,4,3,1,1,0,0,16336,7.0,18011,168,68,1876,2126,23.6,1633.6
4846052471,1,21,1,1,7,1,3,0,0,0,0,16645,7.0,18721,207,64,3505,1432,27.1,1664.5,13,0,0,1,7,0,0,0,0,0,13140,6.8,17289,173,52,-3505,-1432,22.5,1314.0
4844998261,0,15,1,1,5,5,5,0,0,0,0,14957,6.6,16952,141,48,-2412,-1124,18.9,1495.7,319,2,0,5,5,4,1,1,0,0,17369,7.2,18076,200,54,2412,1124,25.4,1736.9
4843975299,0,140,7,0,3,5,3,1,1,0,0,13825,6.4,16808,171,44,-1781,-1581,21.5,1382.5,31,0,1,5,3,2,0,0,0,0,15606,7.0,18389,186,52,1781,1581,23.8,1560.6
4842938340,0,15,1,0,4,4,3,0,0,0,0,14771,7.0,17594,191,43,-691,-306,23.4,1477.1,20,0,1,4,4,4,0,0,0,0,15462,7.0,17900,175,60,691,306,23.5,1546.2
4842415917,0,14,1,1,7,5,7,0,0,0,0,15592,6.4,15886,148,52,86,-406,20.0,1559.2,25,0,0,5,7,5,1,1,0,0,15506,6.4,16292,163,40,-86,406,20.3,1550.6
4841193648,0,17,1,0,5,7,6,1,1,0,0,15743,6.4,16309,162,52,-243,54,21.4,1574.3,10,0,1,7,5,9,0,0,0,0,15986,6.6,16255,196,38,243,-54,23.4,1598.6
4840963270,0,11,1,0,0,4,0,0,0,0,0,13341,6.6,17084,161,48,-1761,-610,20.9,1334.1,11,1,1,4,0,3,0,0,0,0,15102,7.0,17694,182,36,1761,610,21.8,1510.2
4856308668,1,12,1,1,6,4,2,0,0,0,0,17145,7.0,18080,169,48,3279,3273,21.7,1714.5,9,0,0,4,6,4,0,0,0,0,13866,6.2,14807,139,36,-3279,-3273,17.5,1386.6
4842356202,1,11,2,1,7,4,4,0,0,0,0,15213,6.8,17642,166,60,1899,1051,22.6,1521.3,15,0,0,4,7,0,0,0,0,0,13314,6.6,16591,156,56,-1899,-1051,21.2,1331.4
4839910512,0,45,0,1,8,14,8,0,0,0,0,18528,6.4,15910,153,32,-1767,-887,18.5,1852.8,18,22,0,14,8,10,0,0,0,0,20295,7.0,16797,149,48,1767,887,19.7,2029.5
4839866129,1,20,1,1,5,4,2,0,0,0,0,14733,7.0,18491,169,65,492,1507,23.4,1473.3,11,0,0,4,5,2,0,0,0,0,14241,7.0,16984,187,48,-492,-1507,23.5,1424.1
4839837612,0,8,0,0,2,4,1,1,1,0,0,13334,6.8,17500,180,44,-1754,-773,22.4,1333.4,73,1,1,4,2,2,0,0,0,0,15088,7.0,18273,179,64,1754,773,24.3,1508.8
4838150162,0,13,2,1,3,9,2,0,0,0,0,14123,6.6,15980,166,48,-2710,-603,21.4,1412.3,74,0,0,9,3,10,1,1,0,0,16833,6.6,16583,152,48,2710,603,20.0,1683.3
4838094801,1,9,0,0,8,7,3,1,1,0,0,16347,7.0,18009,160,60,1290,2992,22.0,1634.7,124,2,1,7,8,4,0,0,0,0,15057,6.2,15017,136,47,-1290,-2992,18.3,1505.7
4838022267,1,15,0,1,8,4,3,1,1,0,0,14607,6.8,17305,156,32,-36,652,18.8,1460.7,7,0,0,4,8,1,1,0,1,0,14643,6.6,16653,187,40,36,-652,22.7,1464.3
4837944677,1,10,0,0,7,5,8,1,1,0,0,16428,6.8,17384,161,48,808,206,20.9,1642.8,11,0,1,5,7,2,1,0,1,0,15620,7.0,17178,155,40,-808,-206,19.5,1562.0
4837902561,0,9,0,0,2,11,2,1,1,0,0,14474,6.6,16593,148,44,-4128,-1655,19.2,1447.4,11,0,1,11,2,15,0,0,0,0,18602,7.0,18248,207,44,4128,1655,25.1,1860.2
4837867501,1,14,2,1,7,9,7,1,1,0,0,14924,6.2,15111,155,36,-1627,-1777,19.1,1492.4,40,1,0,9,7,6,0,0,0,0,16551,6.8,16888,150,51,1627,1777,20.1,1655.1
4836174058,0,12,2,1,6,4,2,0,0,0,0,16252,6.8,17858,196,40,1723,3180,23.6,1625.2,279,0,0,4,6,4,0,0,0,0,14529,6.2,14678,135,42,-1723,-3180,17.7,1452.9
4836132095,1,15,1,1,6,2,7,1,1,0,0,16519,7.0,17292,204,52,2549,523,25.6,1651.9,13,1,0,2,6,2,0,0,0,0,13970,6.6,16769,164,52,-2549,-523,21.6,1397.0
4836085379,1,12,3,0,3,8,3,0,0,0,0,14918,6.4,16249,169,68,-2233,-1963,23.7,1491.8,15,0,1,8,3,8,0,0,0,0,17151,7.0,18212,182,64,2233,1963,24.6,1715.1
4835901794,1,16,0,1,5,1,6,0,0,0,0,14423,6.6,16249,123,48,1704,1012,17.1,1442.3,14,0,0,1,5,1,0,0,0,0,12719,6.4,15237,147,53,-1704,-1012,20.0,1271.9
4835853426,0,53,0,0,0,3,0,0,0,0,0,13173,6.8,17657,213,48,-1944,148,26.1,1317.3,14,1,1,3,0,3,1,1,0,0,15117,6.8,17509,184,55,1944,-148,23.9,1511.7
4835825954,1,15,1,1,11,5,7,0,0,0,0,17816,7.0,17557,168,52,3585,2090,22.0,1781.6,8,0,0,4,10,2,0,0,0,0,14231,6.4,15467,164,32,-3585,-2090,19.6,1423.1
4835791234,1,95,2,0,4,3,2,0,0,0,0,15356,6.8,17568,183,56,2274,2758,23.9,1535.6,14,5,1,3,4,4,1,1,0,0,13082,6.2,14810,142,40,-2274,-2758,18.2,1308.2
4835766546,1,14,0,1,11,2,9,0,0,0,0,16378,6.4,16352,187,39,3646,1702,22.6,1637.8,15,2,0,2,11,1,0,0,0,0,12732,6.4,14650,146,48,-3646,-1702,19.4,1273.2
4835739320,1,6,1,0,6,9,4,0,0,0,0,15762,6.2,14643,150,44,-889,-2200,19.4,1576.2,9,1,1,9,6,6,0,0,0,0,16651,6.4,16843,155,31,889,2200,18.6,1665.1
4856995099,1,118,0,0,4,1,7,1,1,0,0,15553,6.8,17621,213,44,3414,2221,25.7,1555.3,14,0,1,1,4,0,0,0,0,0,12139,6.2,15400,110,48,-3414,-2221,15.8,1213.9
4855974057,0,11,1,0,1,3,1,1,1,0,0,13406,6.8,17877,171,56,-1165,108,22.7,1340.6,14,1,1,3,1,2,0,0,0,0,14571,6.8,17769,156,51,1165,-108,20.7,1457.1
4855892421,0,12,9,1,8,6,10,1,0,1,0,17628,6.8,17186,183,56,1209,777,23.9,1762.8,35,1,0,6,8,5,0,0,0,0,16419,6.6,16409,184,52,-1209,-777,23.6,1641.9
4855614826,1,11,0,0,3,5,2,1,0,1,0,16261,7.0,18558,196,60,1359,2192,25.6,1626.1,64,1,1,5,3,5,0,0,0,0,14902,6.4,16366,170,44,-1359,-2192,21.4,1490.2
4855595027,1,14,6,1,4,7,3,0,0,0,0,14885,6.6,16324,210,44,-1017,879,25.4,1488.5,14,2,0,7,4,9,1,1,0,0,15902,6.2,15445,164,36,1017,-879,20.0,1590.2
4855587001,1,14,0,1,8,2,5,0,0,0,0,17044,7.0,17628,190,46,3089,4152,23.6,1704.4,8,0,0,2,8,1,0,0,0,0,13955,5.8,13476,143,45,-3089,-4152,18.8,1395.5
4854790405,0,7,1,1,6,8,4,0,0,0,0,15156,6.8,18054,189,48,-1368,-645,23.7,1515.6,8,0,0,8,6,5,1,1,0,0,16524,7.2,18699,202,56,1368,645,25.8,1652.4
4854751722,0,13,2,0,6,6,8,0,0,0,0,15331,7.0,17363,183,36,-514,-197,21.9,1533.1,14,2,1,6,6,7,0,0,0,0,15845,6.6,17560,173,56,514,197,22.9,1584.5
4854731755,0,8,0,0,4,3,1,0,0,0,0,14669,7.0,17863,180,36,-969,872,21.6,1466.9,269,0,1,3,4,3,0,0,0,0,15638,6.6,16991,159,52,969,-872,21.1,1563.8
4854696656,0,13,0,1,5,4,0,0,0,0,0,13409,6.6,15709,107,52,-1081,-1152,15.9,1340.9,7,0,0,4,5,2,1,1,0,0,14490,6.6,16861,178,48,1081,1152,22.6,1449.0
4854446683,0,10,0,1,4,1,6,0,0,0,0,15949,6.6,16435,193,40,748,-1071,23.3,1594.9,84,0,0,1,4,0,0,0,0,0,15201,6.8,17506,219,56,-748,1071,27.5,1520.1
4854445761,0,18,0,1,2,1,3,0,0,0,0,12926,6.8,16127,147,48,-632,-1502,19.5,1292.6,16,1,0,1,2,0,0,0,0,0,13558,7.0,17629,176,60,632,1502,23.6,1355.8
4853325335,0,13,0,1,3,2,4,0,0,0,0,13488,6.6,16360,141,47,-1635,-1688,18.8,1348.8,123,1,0,2,3,0,0,0,0,0,15123,7.0,18048,229,38,1635,1688,26.7,1512.3
4853313138,0,8,1,1,5,8,4,0,0,0,0,15880,6.6,16681,158,60,-2098,-842,21.8,1588.0,130,0,0,8,5,8,0,0,0,0,17978,6.8,17523,206,39,2098,842,24.5,1797.8
4853295448,0,14,1,0,8,8,2,0,0,0,0,17024,7.2,18173,178,48,-164,-492,22.6,1702.4,24,0,1,8,8,2,0,0,0,0,17188,7.4,18665,193,52,164,492,24.5,1718.8
4853285576,1,29,1,1,7,0,4,0,0,0,0,17636,7.2,20001,219,72,5341,4248,29.1,1763.6,9,18,0,0,7,0,0,0,0,0,12295,6.4,15753,143,52,-5341,-4248,19.5,1229.5
4851118367,1,18,2,0,1,1,0,0,0,0,0,14738,7.0,18195,222,48,1591,1458,27.0,1473.8,19,0,1,1,1,0,1,1,0,0,13147,6.6,16737,163,52,-1591,-1458,21.5,1314.7
4851087540,1,7,1,1,6,1,8,1,1,0,0,15957,7.2,19350,206,60,2028,2254,26.6,1595.7,14,0,0,1,6,0,0,0,0,0,13929,6.8,17096,213,64,-2028,-2254,27.7,1392.9
4851074452,0,12,1,0,0,2,0,0,0,0,0,12364,5.8,14159,166,40,-3723,-3668,20.6,1236.4,13,1,1,2,0,1,1,1,0,0,16087,6.8,17827,247,56,3723,3668,30.3,1608.7
4851034600,1,9,0,1,5,4,4,0,0,0,0,16214,7.0,18457,204,40,851,-54,24.4,1621.4,12,0,0,4,5,3,0,0,0,0,15363,6.8,18511,204,51,-851,54,25.5,1536.3
4850998402,0,10,1,1,1,4,0,0,0,0,0,13889,7.0,17550,210,64,-2135,-1242,27.4,1388.9,14,0,0,4,1,3,0,0,0,0,16024,7.0,18792,187,53,2135,1242,24.0,1602.4
4846871869,0,12,1,1,6,2,2,1,1,0,0,16150,6.8,17232,167,56,1370,927,22.3,1615.0,9,0,0,2,6,2,0,0,0,0,14780,6.6,16305,175,44,-1370,-927,21.9,1478.0
4846822172,0,10,9,0,2,6,2,0,0,0,0,13295,6.6,16426,166,56,-3222,-2120,22.2,1329.5,95,1,1,6,2,6,1,1,0,0,16517,7.0,18546,205,52,3222,2120,25.7,1651.7
4846783794,1,79,2,0,4,5,5,0,0,0,0,15061,6.8,16802,175,55,-794,820,23.0,1506.1,13,1,1,5,4,6,0,0,0,0,15855,6.8,15982,150,52,794,-820,20.2,1585.5
4846758808,1,52,1,0,5,4,3,0,0,0,0,16189,6.8,17749,173,48,1563,719,22.1,1618.9,22,0,1,4,5,4,1,1,0,0,14626,6.6,17030,155,56,-1563,-719,21.1,1462.6
4846665569,0,14,1,1,6,9,4,0,0,0,0,15310,6.4,16573,174,36,-2122,-1255,21.0,1531.0,11,2,0,9,6,7,1,1,0,0,17432,7.0,17828,161,56,2122,1255,21.7,1743.2
4846645524,0,11,1,0,4,7,2,0,0,0,0,14419,6.6,16456,158,44,-2988,-2905,20.2,1441.9,12,2,1,7,4,5,1,1,0,0,17407,7.2,19361,193,64,2988,2905,25.7,1740.7
4846611498,0,12,1,0,1,2,1,0,0,0,0,13161,6.6,16294,156,39,-1476,-1810,19.5,1316.1,14,0,1,2,1,2,0,0,0,0,14637,7.0,18104,197,60,1476,1810,25.7,1463.7
4840059883,0,11,2,0,8,5,4,0,0,0,0,15994,6.8,17574,161,56,-908,540,21.7,1599.4,15,3,1,5,8,3,0,0,0,0,16902,6.6,17034,156,52,908,-540,20.8,1690.2
4840033454,0,13,1,0,5,6,0,0,0,0,0,14829,6.8,17410,189,48,-1444,-283,23.7,1482.9,14,0,1,6,5,4,1,1,0,0,16273,6.8,17693,150,48,1444,283,19.8,1627.3
4840006873,0,10,0,1,8,10,9,1,1,0,0,17210,6.4,15398,150,48,348,1734,19.8,1721.0,13,0,0,10,8,9,0,0,0,0,16862,5.8,13664,104,52,-348,-1734,15.6,1686.2
4839958671,0,9,0,0,0,5,0,0,0,0,0,12449,6.4,17248,152,40,-3396,-1020,19.2,1244.9,14,0,1,5,0,2,1,1,0,0,15845,7.0,18268,191,48,3396,1020,23.9,1584.5
4839917172,0,5,0,0,26,25,80,0,0,0,1,37485,10.8,40462,94,0,-3006,-2048,9.4,3748.5,0,0,1,25,26,56,0,0,0,0,40491,11.4,42510,104,0,3006,2048,10.4,4049.1
4839900959,1,2,0,1,23,15,52,0,0,0,1,36336,10.6,39197,107,0,992,1196,10.7,3633.6,0,1,0,15,23,34,0,0,0,0,35344,10.8,38001,84,0,-992,-1196,8.4,3534.4
4839882238,0,17,0,0,33,30,83,0,0,0,1,39988,11.6,43558,110,0,-8,-361,11.0,3998.8,0,2,1,30,33,55,0,0,0,0,39996,11.8,43919,100,0,8,361,10.0,3999.6
4839864436,1,18,0,1,28,28,80,0,0,0,1,38004,11.0,41757,107,0,-356,-200,10.7,3800.4,3,2,0,28,28,71,0,0,0,0,38360,11.4,41957,107,0,356,200,10.7,3836.0
4782932445,1,9,3,1,6,1,4,1,0,1,0,16122,6.8,17414,164,40,2368,2951,20.4,1612.2,13,1,0,1,6,1,0,0,0,0,13754,6.2,14463,132,48,-2368,-2951,18.0,1375.4
4782929168,1,32,1,0,0,0,0,0,0,0,0,15821,6.8,18003,215,37,4001,768,25.2,1582.1,7,16,0,0,0,0,0,0,0,0,11820,6.8,17235,125,53,-4001,-768,17.8,1182.0
4782904574,1,15,3,0,7,10,6,0,0,0,0,16562,6.6,16666,171,64,-1735,-1421,23.5,1656.2,13,2,1,10,7,12,0,0,0,0,18297,7.0,18087,179,68,1735,1421,24.7,1829.7
4782898057,0,11,0,0,0,7,0,0,0,0,0,11535,6.6,16177,145,44,-6260,-3236,18.9,1153.5,16,0,1,7,0,9,1,1,0,0,17795,7.2,19413,224,60,6260,3236,28.4,1779.5
4782877988,0,13,0,0,3,5,4,1,1,0,0,14174,6.8,17113,182,36,-1424,-2260,21.8,1417.4,11,0,1,5,3,3,1,0,1,0,15598,7.0,19373,213,56,1424,2260,26.9,1559.8
4762239511,0,9,1,1,7,3,4,1,1,0,0,15730,6.8,16983,159,54,1900,195,21.3,1573.0,14,1,0,3,7,2,0,0,0,0,13830,6.4,16788,175,38,-1900,-195,21.3,1383.0
4762214003,0,7,0,1,5,11,0,1,1,0,0,13962,6.8,16663,133,80,-5011,-1484,21.3,1396.2,9,0,0,11,5,9,0,0,0,0,18973,7.2,18147,192,44,5011,1484,23.6,1897.3
4762135451,1,28,2,0,10,6,8,0,0,0,0,18583,7.2,18525,208,52,2541,2497,26.0,1858.3,9,3,1,6,10,4,0,0,0,0,16042,6.6,16028,171,48,-2541,-2497,21.9,1604.2
4762084351,1,10,1,0,3,6,2,0,0,0,0,14413,7.0,17468,179,48,-468,493,22.7,1441.3,9,0,1,6,3,3,0,0,0,0,14881,6.6,16975,198,36,468,-493,23.4,1488.1
4762057116,1,83,1,1,6,2,1,1,1,0,0,17070,6.8,18371,230,56,3083,3217,28.6,1707.0,117,0,0,2,6,4,0,0,0,0,13987,6.2,15154,138,50,-3083,-3217,18.8,1398.7
4762009365,0,9,1,1,3,5,2,0,0,0,0,14440,6.6,16593,140,52,-1586,-1416,19.2,1444.0,12,0,0,5,3,0,0,0,0,0,16026,6.8,18009,176,64,1586,1416,24.0,1602.6
4761964516,0,10,1,0,3,4,0,0,0,0,0,14146,6.6,17256,175,52,-1041,-849,22.7,1414.6,73,2,1,4,3,1,0,0,0,0,15187,7.0,18105,192,56,1041,849,24.8,1518.7
4761948726,0,4,0,0,1,5,2,1,1,0,0,14414,6.4,16471,161,47,-1300,-1467,20.8,1441.4,451,0,1,5,1,3,0,0,0,0,15714,6.8,17938,193,48,1300,1467,24.1,1571.4
4745814717,1,12,0,0,5,6,5,0,0,0,0,15447,6.8,17376,164,52,-458,968,21.6,1544.7,8,1,1,6,5,7,1,1,0,0,15905,6.6,16408,190,44,458,-968,23.4,1590.5
4745795240,1,10,2,1,9,5,9,0,0,0,0,18010,6.4,16035,154,40,2850,1574,19.4,1801.0,14,2,0,5,9,4,0,0,0,0,15160,6.2,14461,170,36,-2850,-1574,20.6,1516.0
4745774054,0,83,0,0,1,6,0,0,0,0,0,13336,6.4,15967,155,48,-3716,-2779,20.3,1333.6,5,1,1,6,1,4,1,1,0,0,17052,7.0,18746,198,48,3716,2779,24.6,1705.2
4745377635,1,10,0,0,2,3,2,1,1,0,0,13080,5.8,14484,149,48,-3294,-3318,19.7,1308.0,18,0,1,3,2,3,0,0,0,0,16374,7.0,17802,184,44,3294,3318,22.8,1637.4
4557911984,0,10,0,1,5,6,7,1,0,1,0,16739,7.0,18187,200,44,1299,1735,24.4,1673.9,10,3,0,6,5,3,1,1,0,0,15440,6.4,16452,192,44,-1299,-1735,23.6,1544.0
4557893945,0,28,1,0,4,4,2,0,0,0,0,13254,6.6,16446,123,47,-1681,-666,17.0,1325.4,9,17,1,4,4,2,0,0,0,0,14935,6.6,17112,165,36,1681,666,20.1,1493.5
4549841071,1,28,2,0,8,6,8,1,1,0,0,15974,6.6,17027,148,60,697,-297,20.8,1597.4,113,1,1,5,7,3,0,0,0,0,15277,6.6,17324,144,44,-697,297,18.8,1527.7
4848139479,0,15,1,1,7,3,3,1,1,0,0,15170,6.6,17396,212,40,1208,-58,25.2,1517.0,11,1,0,2,6,0,0,0,0,0,13962,6.8,17454,163,51,-1208,58,21.4,1396.2
4848115686,0,13,0,1,4,6,0,1,1,0,0,14322,6.6,16569,150,56,-537,867,20.6,1432.2,159,0,0,6,4,2,0,0,0,0,14859,6.4,15702,204,28,537,-867,23.2,1485.9
4848071035,0,151,0,0,5,4,3,0,0,0,0,15157,6.6,16129,176,40,251,-354,21.6,1515.7,13,0,1,4,5,2,0,0,0,0,14906,6.6,16483,163,52,-251,354,21.5,1490.6
4848003617,0,14,0,1,1,4,1,0,0,0,0,14114,6.6,17135,182,36,-343,-725,21.8,1411.4,14,1,0,4,1,1,0,0,0,0,14457,7.0,17860,142,56,343,725,19.8,1445.7
4826852848,1,15,1,0,3,6,5,1,1,0,0,14676,6.8,17442,179,48,-539,-506,22.7,1467.6,37,1,1,6,3,8,0,0,0,0,15215,7.0,17948,159,40,539,506,19.9,1521.5
4826804680,1,8,0,0,5,5,4,0,0,0,0,15991,6.6,16448,190,28,1904,962,21.8,1599.1,7,0,1,5,5,2,0,0,0,0,14087,6.2,15486,130,32,-1904,-962,16.2,1408.7
4826747130,0,28,0,1,5,2,5,0,0,0,0,15066,6.6,17077,150,54,1966,879,20.4,1506.6,35,0,0,2,5,1,1,1,0,0,13100,6.4,16198,137,54,-1966,-879,19.1,1310.0
4825873176,1,7,9,1,8,1,6,0,0,0,0,15871,7.0,17375,140,52,2875,-270,19.2,1587.1,30,1,0,1,8,0,0,0,0,0,12996,6.8,17645,176,51,-2875,270,22.7,1299.6
4820586932,0,32,0,1,4,10,4,0,0,0,0,13426,6.2,15344,115,38,-3658,-2604,15.3,1342.6,10,0,0,9,3,8,0,0,0,0,17084,7.0,17948,144,44,3658,2604,18.8,1708.4
4820035544,1,36,0,0,2,3,2,1,1,0,0,14536,6.6,17409,156,40,722,489,19.6,1453.6,19,1,1,3,2,0,0,0,0,0,13814,6.6,16920,181,52,-722,-489,23.3,1381.4
4820011171,0,12,0,1,3,1,3,0,0,0,0,14214,7.0,17616,155,58,1148,384,21.3,1421.4,32,0,0,1,3,2,0,0,0,0,13066,6.6,17232,162,37,-1148,-384,19.9,1306.6
4819975350,0,15,0,0,7,7,5,1,1,0,0,15701,6.8,16882,158,48,-1320,-787,20.6,1570.1,38,0,1,7,7,6,0,0,0,0,17021,6.8,17669,158,52,1320,787,21.0,1702.1
4819936314,1,36,0,0,1,4,1,1,0,1,0,14342,7.0,17651,196,56,87,298,25.2,1434.2,8,4,1,4,1,2,0,0,0,0,14255,6.8,17353,167,36,-87,-298,20.3,1425.5
4819896511,0,59,1,1,5,5,1,0,0,0,0,14950,7.0,17875,146,46,-601,1035,19.2,1495.0,32,1,0,5,5,4,0,0,0,0,15551,6.8,16840,163,34,601,-1035,19.7,1555.1
4819852095,0,35,2,0,4,5,3,0,0,0,0,13230,6.8,16676,138,44,-1616,-707,18.2,1323.0,20,0,1,5,4,4,0,0,0,0,14846,6.8,17383,158,32,1616,707,19.0,1484.6
4819775551,0,11,0,0,5,5,3,1,0,1,0,15442,6.6,16902,196,44,384,-550,24.0,1544.2,18,1,1,5,5,2,0,0,0,0,15058,7.0,17452,176,46,-384,550,22.2,1505.8
4818076080,1,195,9,1,7,2,12,0,0,0,0,15306,6.2,15883,156,39,1379,-1328,19.5,1530.6,35,1,0,2,7,2,0,0,0,0,13927,6.8,17211,194,52,-1379,1328,24.6,1392.7
4815127027,1,15,4,1,5,5,0,0,0,0,0,14839,6.6,16919,163,48,-704,-1080,21.1,1483.9,33,0,0,5,5,3,1,1,0,0,15543,6.8,17999,160,60,704,1080,22.0,1554.3
4815085168,0,9,0,0,2,6,0,1,0,1,0,13714,6.6,16512,186,64,-2574,-1793,25.0,1371.4,13,1,1,5,1,8,1,1,0,0,16288,7.0,18305,209,48,2574,1793,25.7,1628.8
4857012039,0,0,0,1,25,27,41,0,0,0,0,37606,11.4,42059,93,0,-1225,-704,9.3,3760.6,0,0,0,27,25,65,0,0,0,0,38831,11.4,42763,93,0,1225,704,9.3,3883.1
4856891172,1,24,0,0,23,15,19,0,0,0,0,48609,10.0,47500,2,0,20399,19000,0.2,4860.9,20,0,1,7,15,6,0,0,0,0,28210,6.0,28500,0,0,-20399,-19000,0.0,2821.0
4856880915,1,0,0,0,16,19,17,0,0,0,0,48620,10.0,47500,3,0,20260,19000,0.3,4862.0,0,0,1,13,10,5,0,0,0,0,28360,6.0,28500,3,0,-20260,-19000,0.3,2836.0
4856849994,1,0,0,1,12,15,16,0,0,0,0,45250,10.0,47500,0,0,17400,19000,0.0,4525.0,1,0,0,11,8,8,0,0,0,0,27850,6.0,28500,0,0,-17400,-19000,0.0,2785.0
4855750616,0,156,0,0,14,20,29,0,0,0,1,34073,10.6,36440,84,0,-2671,-3267,8.4,3407.3,5,0,1,20,14,49,0,0,0,0,36744,10.8,39707,100,0,2671,3267,10.0,3674.4
4855715183,0,0,0,0,24,34,53,0,0,0,1,37479,11.4,41742,92,0,-2320,-3482,9.2,3747.9,0,0,1,34,24,77,0,0,0,0,39799,11.6,45224,97,0,2320,3482,9.7,3979.9
4855697392,1,0,0,0,20,21,43,0,0,0,1,36177,11.0,40003,86,0,-2487,-2457,8.6,3617.7,2,0,1,21,20,45,0,0,0,0,38664,11.4,42460,111,0,2487,2457,11.1,3866.4
4855687832,0,22,0,1,26,24,76,0,0,0,0,37085,11.0,40684,85,0,-2609,-1931,8.5,3708.5,216,3,0,24,26,67,0,0,0,0,39694,11.6,42615,99,0,2609,1931,9.9,3969.4
4855663421,1,0,0,0,28,34,56,0,0,0,1,38633,11.6,43355,92,0,-1528,-947,9.2,3863.3,0,0,1,34,28,94,0,0,0,0,40161,11.8,44302,88,0,1528,947,8.8,4016.1
4855658748,1,0,0,0,22,18,50,0,0,0,1,37602,11.6,41353,105,0,2467,2928,10.5,3760.2,0,0,1,18,22,34,0,0,0,0,35135,11.0,38425,78,0,-2467,-2928,7.8,3513.5
4855641214,0,0,0,1,30,24,69,0,0,0,0,38703,11.4,41874,96,0,-531,-2416,9.6,3870.3,8,0,0,24,30,65,0,0,0,0,39234,11.6,44290,124,0,531,2416,12.4,3923.4
4855629547,0,234,0,0,22,29,66,0,0,0,0,35543,11.0,38666,92,0,-2662,-5077,9.2,3554.3,2,0,1,29,22,88,0,0,0,0,38205,11.6,43743,103,0,2662,5077,10.3,3820.5
4854855746,1,57,0,1,22,27,16,0,0,0,0,40785,10.0,47500,5,0,11880,17820,0.5,4078.5,0,0,0,12,7,16,0,0,0,0,28905,6.2,29680,6,0,-11880,-17820,0.6,2890.5
4854832159,1,21,0,1,22,16,25,0,0,0,0,49230,10.2,48680,2,0,21630,20180,0.2,4923.0,0,1,0,9,15,8,0,0,0,0,27600,6.0,28500,3,0,-21630,-20180,0.3,2760.0
4854812496,1,252,0,0,13,17,11,0,0,0,0,60668,12.0,55000,1,0,24114,22000,0.1,6066.8,0,0,1,11,7,13,0,0,0,0,36554,7.2,33000,1,0,-24114,-22000,0.1,3655.4
4853756977,1,79,0,1,15,22,15,0,0,0,0,62107,12.0,55000,0,0,24138,22000,0.0,6210.7,0,0,0,14,7,14,0,0,0,0,37969,7.2,33000,0,0,-24138,-22000,0.0,3796.9
4852579051,1,1,0,1,14,22,16,0,0,0,0,46351,10.0,47500,0,0,16718,19000,0.0,4635.1,125,0,0,15,7,9,0,0,0,0,29633,6.0,28500,0,0,-16718,-19000,0.0,2963.3
4851618270,0,67,0,1,2,2,3,0,0,0,0,13821,6.6,16718,168,55,-481,-1137,22.3,1382.1,248,0,0,2,2,0,0,0,0,0,14302,6.8,17855,217,48,481,1137,26.5,1430.2
4851572318,1,13,0,0,3,3,7,1,1,0,0,13240,6.6,16923,162,36,-1133,1308,19.8,1324.0,73,0,1,3,3,4,0,0,0,0,14373,6.4,15615,159,48,1133,-1308,20.7,1437.3
4856031727,0,10,0,0,3,7,1,0,0,0,0,13177,6.4,15327,132,28,-1968,-1931,16.0,1317.7,12,0,1,7,3,2,1,1,0,0,15145,6.8,17258,130,60,1968,1931,19.0,1514.5
4795776773,0,87,0,1,5,4,4,1,1,0,0,14175,6.6,16059,140,50,-1813,-2975,19.0,1417.5,8,1,0,4,5,4,0,0,0,0,15988,7.0,19034,192,57,1813,2975,24.9,1598.8
4795591983,0,13,0,0,8,15,7,0,0,0,0,16135,5.8,13909,114,39,-4315,-1385,15.3,1613.5,10,0,1,15,8,16,0,0,0,0,20450,6.4,15294,163,44,4315,1385,20.7,2045.0
4795568862,0,64,1,1,6,8,5,1,1,0,0,15493,6.6,16519,170,52,-1368,-738,22.2,1549.3,16,0,0,7,5,6,0,0,0,0,16861,6.4,17257,153,44,1368,738,19.7,1686.1
4794788180,0,86,1,0,3,3,1,1,1,0,0,13891,6.4,17495,159,42,-1218,281,20.1,1389.1,75,1,1,3,3,4,0,0,0,0,15109,6.8,17214,190,44,1218,-281,23.4,1510.9
4793969970,1,13,0,1,8,6,5,0,0,0,0,16607,7.2,18061,178,60,1580,1724,23.8,1660.7,16,0,0,6,8,0,0,0,0,0,15027,6.4,16337,139,42,-1580,-1724,18.1,1502.7
4782504138,1,14,2,1,6,2,5,0,0,0,0,16772,6.8,18046,208,60,3650,2199,26.8,1677.2,15,2,0,2,6,1,0,0,0,0,13122,6.8,15847,151,42,-3650,-2199,19.3,1312.2
4782470301,1,218,0,1,4,9,4,0,0,0,0,14929,6.4,15305,124,48,-3058,-2035,17.2,1492.9,24,2,0,9,4,5,0,0,0,0,17987,6.8,17340,174,36,3058,2035,21.0,1798.7
4779579689,0,16,1,0,8,7,4,1,1,0,0,17605,7.2,18841,161,68,2210,2261,22.9,1760.5,13,0,1,6,7,9,0,0,0,0,15395,6.6,16580,168,40,-2210,-2261,20.8,1539.5
4779551378,0,250,2,0,3,6,1,0,0,0,0,13863,6.6,16604,157,48,-2978,-3156,20.5,1386.3,16,2,1,6,3,2,1,1,0,0,16841,7.4,19760,214,68,2978,3156,28.2,1684.1
4779513866,0,9,1,0,3,7,2,0,0,0,0,13759,6.0,14864,133,32,-3069,-2878,16.5,1375.9,289,1,1,7,3,4,0,0,0,0,16828,6.8,17742,197,48,3069,2878,24.5,1682.8
4778776271,0,15,0,0,3,2,3,0,0,0,0,14184,7.0,18017,175,52,-787,905,22.7,1418.4,14,2,1,2,3,1,0,0,0,0,14971,6.8,17112,195,44,787,-905,23.9,1497.1
4778734711,1,11,1,0,5,5,4,0,0,0,0,14693,6.6,16295,145,36,702,-325,18.1,1469.3,15,0,1,5,5,3,1,1,0,0,13991,6.6,16620,151,56,-702,325,20.7,1399.1
4778693760,0,12,0,1,3,3,2,0,0,0,0,14106,7.0,18249,161,60,-867,-887,22.1,1410.6,76,0,0,3,3,4,0,0,0,0,14973,7.4,19136,175,52,867,887,22.7,1497.3
4776959112,0,129,0,0,3,9,0,0,0,0,1,12642,5.8,14142,141,35,-8070,-4192,17.6,1264.2,9,1,1,9,3,10,0,0,0,0,20712,7.0,18334,171,40,8070,4192,21.1,2071.2
4776924498,1,13,0,1,6,3,5,0,0,0,0,17398,6.8,17475,191,52,1984,853,24.3,1739.8,9,0,0,3,6,3,0,0,0,0,15414,6.6,16622,195,36,-1984,-853,23.1,1541.4
4776846300,0,13,2,0,8,4,5,0,0,0,0,17423,7.2,20573,161,40,2119,3708,20.1,1742.3,11,0,1,3,7,2,0,0,0,0,15304,6.6,16865,191,56,-2119,-3708,24.7,1530.4
4775876633,0,11,2,0,1,7,2,1,1,0,0,14434,6.6,16717,179,68,-2941,-2918,24.7,1443.4,13,2,1,7,1,4,0,0,0,0,17375,7.4,19635,199,56,2941,2918,25.5,1737.5
4775830044,0,12,0,0,3,4,1,0,0,0,0,13945,6.6,16374,151,44,-2520,-904,19.5,1394.5,12,2,1,4,3,2,0,0,0,0,16465,6.6,17278,197,44,2520,904,24.1,1646.5
4831811938,1,219,1,1,4,6,3,0,0,0,0,14149,6.6,16555,154,39,-1810,-741,19.3,1414.9,11,0,0,6,4,5,1,1,0,0,15959,7.0,17296,178,46,1810,741,22.4,1595.9
4831413214,0,12,1,0,7,10,8,0,0,0,0,14276,6.0,14739,118,32,-4861,-4720,15.0,1427.6,66,3,1,10,7,9,0,0,0,0,19137,7.2,19459,173,54,4861,4720,22.7,1913.7
4831373009,0,11,1,0,2,3,2,1,0,1,0,13213,6.8,17232,134,52,-753,1135,18.6,1321.3,9,0,1,3,2,4,1,1,0,0,13966,6.2,16097,142,56,753,-1135,19.8,1396.6
4829362486,0,16,0,1,2,1,2,0,0,0,0,14143,7.0,17727,196,48,525,860,24.4,1414.3,6,0,0,1,2,1,0,0,0,0,13618,6.8,16867,163,47,-525,-860,21.0,1361.8
4829139924,0,153,0,1,4,4,1,0,0,0,0,14911,6.8,17750,178,40,1164,2262,21.8,1491.1,8,0,0,4,4,3,1,1,0,0,13747,6.0,15488,157,44,-1164,-2262,20.1,1374.7
4828922137,0,13,1,1,5,8,0,0,0,0,0,13724,6.8,17387,135,44,-3709,-1615,17.9,1372.4,9,1,0,8,5,7,2,1,1,0,17433,7.2,19002,155,52,3709,1615,20.7,1743.3
4828019753,0,138,0,0,3,4,1,0,0,0,0,14315,6.8,17355,162,48,-1621,94,21.0,1431.5,16,0,1,4,3,2,0,0,0,0,15936,6.4,17261,191,32,1621,-94,22.3,1593.6
4826915398,0,6,9,0,3,3,4,0,0,0,0,13952,6.6,16299,108,48,-1549,-2208,15.6,1395.2,31,0,1,3,3,2,1,1,0,0,15501,7.0,18507,179,60,1549,2208,23.9,1550.1
4826874367,0,17,1,0,8,3,4,0,0,0,0,15876,6.8,17404,174,52,705,319,22.6,1587.6,11,0,1,3,8,1,0,0,0,0,15171,6.6,17085,182,52,-705,-319,23.4,1517.1
4824215706,1,15,0,1,2,6,1,0,0,0,0,13582,6.6,16175,141,40,-846,-83,18.1,1358.2,12,1,0,6,2,3,0,0,0,0,14428,6.6,16258,137,40,846,83,17.7,1442.8
4824213224,0,11,0,0,1,10,0,0,0,0,0,12567,6.2,14740,163,32,-4726,-2868,19.5,1256.7,13,0,1,10,1,3,0,0,0,0,17293,7.0,17608,162,52,4726,2868,21.4,1729.3
4820472127,1,15,0,0,6,6,3,0,0,0,0,15440,7.0,18061,190,40,399,1725,23.0,1544.0,10,0,1,6,6,3,1,1,0,0,15041,6.6,16336,148,44,-399,-1725,19.2,1504.1
4819614516,1,12,2,1,7,2,8,1,1,0,0,16780,6.8,17775,192,52,3266,1172,24.4,1678.0,41,0,0,2,7,1,0,0,0,0,13514,6.4,16603,165,56,-3266,-1172,22.1,1351.4
4819601887,1,12,3,1,6,3,4,0,0,0,0,16971,7.0,18066,159,48,2639,1799,20.7,1697.1,14,0,0,3,6,2,1,1,0,0,14332,6.4,16267,144,56,-2639,-1799,20.0,1433.2
4802158417,0,13,3,1,3,7,2,0,0,0,0,14049,6.8,16149,163,50,-1351,-1190,21.3,1404.9,11,0,0,7,3,1,0,0,0,0,15400,6.8,17339,150,55,1351,1190,20.5,1540.0
4802157855,1,11,0,0,7,4,2,1,1,0,0,17399,6.8,18620,208,44,3779,3282,25.2,1739.9,6,0,1,4,7,3,0,0,0,0,13620,6.4,15338,125,8,-3779,-3282,13.3,1362.0
4802146348,1,11,0,0,6,1,3,0,0,0,0,14781,6.8,17438,159,56,703,114,21.5,1478.1,14,2,1,1,6,1,1,0,1,0,14078,6.6,17324,187,48,-703,-114,23.5,1407.8
4801066576,0,12,0,0,4,5,4,0,0,0,1,13352,6.2,15030,141,36,-3014,-3311,17.7,1335.2,11,0,1,5,4,2,1,1,0,0,16366,7.0,18341,185,52,3014,3311,23.7,1636.6
4801046008,1,0,0,1,27,30,62,0,0,0,0,37264,11.2,40856,93,0,-482,-3255,9.3,3726.4,0,0,0,29,26,65,0,0,0,0,37746,11.4,44111,71,0,482,3255,7.1,3774.6
4800481066,0,39,0,0,5,6,1,0,0,0,0,15679,7.0,17856,164,60,-371,869,22.4,1567.9,11,9,1,6,5,8,0,0,0,0,16050,6.8,16987,162,40,371,-869,20.2,1605.0
4800133138,1,0,0,0,23,25,57,0,0,0,1,38110,11.4,41859,103,0,410,1043,10.3,3811.0,94,0,1,25,23,63,0,0,0,0,37700,11.2,40816,97,0,-410,-1043,9.7,3770.0
4800125470,0,0,23,0,16,28,40,0,0,0,1,36333,10.8,38810,87,0,-1725,-3771,8.7,3633.3,49,0,1,28,16,82,0,0,0,0,38058,11.4,42581,118,0,1725,3771,11.8,3805.8
4800119878,0,0,1,1,35,21,88,0,0,0,0,40220,11.8,45902,110,0,4406,5451,11.0,4022.0,19,0,0,21,35,48,0,0,0,0,35814,11.2,40451,98,0,-4406,-5451,9.8,3581.4
4800111973,1,6,0,1,29,22,76,0,0,0,0,37338,11.4,42409,98,0,77,1858,9.8,3733.8,225,0,0,22,29,31,0,0,0,0,37261,11.2,40551,99,0,-77,-1858,9.9,3726.1
4800103537,1,0,0,1,29,17,76,0,0,0,1,41138,11.6,43209,118,0,7555,6685,11.8,4113.8,10,0,0,17,29,35,0,0,0,0,33583,10.6,36524,59,0,-7555,-6685,5.9,3358.3
4800107914,1,0,0,1,33,10,83,0,0,0,1,40652,11.6,44114,122,0,7685,8574,12.2,4065.2,18,0,0,10,33,17,0,0,0,0,32967,10.4,35540,78,0,-7685,-8574,7.8,3296.7
4800094051,1,11,9,1,8,3,5,0,0,0,0,15289,7.2,18367,131,40,1148,1740,17.1,1528.9,29,0,0,3,8,1,0,0,0,0,14141,6.6,16627,145,56,-1148,-1740,20.1,1414.1
4800076451,1,15,0,1,11,8,14,0,0,0,0,17513,6.8,16941,148,47,2373,-115,19.5,1751.3,12,0,0,8,11,3,0,0,0,0,15140,6.4,17056,152,36,-2373,115,18.8,1514.0
4796998293,0,99,1,0,11,4,11,0,0,0,0,16796,6.2,15966,142,28,22,-719,17.0,1679.6,23,0,1,4,11,4,1,1,0,0,16774,6.4,16685,180,56,-22,719,23.6,1677.4
4796952313,1,13,1,1,3,1,1,0,0,0,0,14618,7.0,18280,186,56,949,-62,24.2,1461.8,12,2,0,1,3,1,0,0,0,0,13669,6.8,18342,182,56,-949,62,23.8,1366.9
4796715664,1,20,2,0,7,5,10,0,0,0,0,15888,6.8,17574,193,44,430,-445,23.7,1588.8,13,1,1,5,7,3,0,0,0,0,15458,6.8,18019,185,60,-430,445,24.5,1545.8
4796700220,1,181,1,1,8,4,4,1,1,0,0,18951,6.8,17752,219,44,5938,4523,26.3,1895.1,13,17,0,3,7,4,0,0,0,0,13013,5.6,13229,115,36,-5938,-4523,15.1,1301.3
4796435707,0,20,0,0,4,3,4,1,0,1,0,15329,7.0,17487,154,60,332,603,21.4,1532.9,13,0,1,3,4,1,0,0,0,0,14997,6.6,16884,189,52,-332,-603,24.1,1499.7
4796431068,0,10,1,0,7,7,6,0,0,0,0,16027,6.8,17624,166,60,814,1044,22.6,1602.7,106,1,1,7,7,3,0,0,0,0,15213,6.6,16580,177,46,-814,-1044,22.3,1521.3
4649236553,1,12,2,1,8,3,6,0,0,0,0,17499,7.0,17863,155,76,3925,1515,23.1,1749.9,9,0,0,3,8,1,0,0,0,0,13574,6.4,16348,169,48,-3925,-1515,21.7,1357.4
4649206643,0,12,1,0,5,8,4,0,0,0,0,15249,6.4,16055,174,32,83,-353,20.6,1524.9,15,0,1,8,5,6,1,1,0,0,15166,6.4,16408,151,51,-83,353,20.2,1516.6
4856972169,1,8,1,1,8,6,6,0,0,0,0,15445,6.4,15974,149,48,-393,-1571,19.7,1544.5,12,0,0,5,7,4,0,0,0,0,15838,6.8,17545,200,36,393,1571,23.6,1583.8
4856953838,0,19,0,0,6,9,7,0,0,0,0,16075,6.4,16329,195,40,-624,-721,23.5,1607.5,8,2,1,9,6,4,1,1,0,0,16699,6.8,17050,196,50,624,721,24.6,1669.9
4854776659,0,12,2,0,2,8,1,0,0,0,0,14056,6.6,17010,168,40,-3708,-2112,20.8,1405.6,16,2,1,8,2,10,1,0,1,0,17764,7.0,19122,224,60,3708,2112,28.4,1776.4
4854730215,0,98,0,1,9,5,5,0,0,0,0,17781,6.8,16659,178,56,1376,-770,23.4,1778.1,10,1,0,5,9,2,0,0,0,0,16405,6.6,17429,194,48,-1376,770,24.2,1640.5
4844997141,1,13,0,1,8,7,5,0,0,0,0,16952,6.6,17089,203,44,-38,-229,24.7,1695.2,12,2,0,6,7,5,0,0,0,0,16990,6.8,17318,148,52,38,229,20.0,1699.0
4841979469,1,14,0,1,9,2,4,0,0,0,0,17777,6.8,17948,202,43,3685,1428,24.5,1777.7,11,2,0,2,9,2,0,0,0,0,14092,6.6,16520,164,64,-3685,-1428,22.8,1409.2
4837781226,1,12,0,0,5,5,3,1,1,0,0,15666,6.6,17241,203,48,431,-431,25.1,1566.6,14,0,1,4,4,3,1,0,1,0,15235,6.8,17672,204,52,-431,431,25.6,1523.5
4837709163,1,13,0,1,3,2,2,0,0,0,0,15130,6.8,18005,186,56,1558,946,24.2,1513.0,34,2,0,2,3,1,1,0,1,0,13572,6.6,17059,159,60,-1558,-946,21.9,1357.2
4836388821,0,13,0,1,7,2,7,1,1,0,0,15837,6.8,17106,161,56,2848,-647,21.7,1583.7,10,0,0,2,7,3,0,0,0,0,12989,6.8,17753,140,52,-2848,647,19.2,1298.9
4836155483,0,11,8,1,2,1,1,0,0,0,0,13919,6.8,17243,155,43,1303,661,19.8,1391.9,32,0,0,1,2,1,0,0,0,0,12616,6.6,16582,163,44,-1303,-661,20.7,1261.6
4836118183,0,11,1,0,4,5,3,1,1,0,0,13798,6.8,18275,156,56,-340,1812,21.2,1379.8,7,0,1,5,4,4,0,0,0,0,14138,6.4,16463,135,44,340,-1812,17.9,1413.8
4836071851,0,12,1,0,2,2,0,0,0,0,0,13608,6.6,17097,159,44,-868,-937,20.3,1360.8,12,1,1,2,2,1,0,0,0,0,14476,7.0,18034,204,48,868,937,25.2,1447.6
4836029511,1,278,0,0,5,5,2,0,0,0,0,15666,6.8,17904,179,56,1259,1783,23.5,1566.6,12,0,1,5,5,1,0,0,0,0,14407,6.6,16121,149,36,-1259,-1783,18.5,1440.7
4701317285,1,10,0,1,4,3,3,0,0,0,0,15361,7.0,18362,219,52,2116,199,27.1,1536.1,7,3,0,3,4,0,1,1,0,0,13245,7.2,18163,153,68,-2116,-199,22.1,1324.5
4701263421,1,9,1,1,5,9,4,0,0,0,0,16219,6.8,17476,216,48,-687,-619,26.4,1621.9,11,0,0,9,5,6,0,0,0,0,16906,7.0,18095,165,48,687,619,21.3,1690.6
4701238772,1,10,0,1,2,6,2,0,0,0,0,13113,6.8,16820,142,58,-1168,-770,20.0,1311.3,14,0,0,6,2,3,0,0,0,0,14281,6.8,17590,143,48,1168,770,19.1,1428.1
4700751217,1,11,2,0,9,8,4,0,0,0,0,17411,6.4,15548,135,48,473,-1035,18.3,1741.1,12,1,1,8,9,7,0,0,0,0,16938,6.6,16583,156,54,-473,1035,21.0,1693.8
4700723150,0,7,1,0,2,3,2,0,0,0,0,12665,6.8,17499,113,56,-2365,-463,16.9,1266.5,8,1,1,3,2,3,0,0,0,0,15030,6.8,17962,192,56,2365,463,24.8,1503.0
4700685544,1,11,1,1,1,0,0,1,1,0,0,13695,7.0,18313,180,64,788,1092,24.4,1369.5,11,0,0,0,1,0,0,0,0,0,12907,6.8,17221,175,52,-788,-1092,22.7,1290.7
4700661642,0,10,0,1,1,2,1,0,0,0,0,13184,6.8,16765,159,48,-2722,-2063,20.7,1318.4,118,2,0,2,1,1,0,0,0,0,15906,7.2,18828,182,60,2722,2063,24.2,1590.6
4840403909,1,96,0,1,5,2,6,0,0,0,0,17630,7.0,18618,217,48,3592,4184,26.5,1763.0,7,0,0,2,5,1,0,0,0,0,14038,6.2,14434,152,52,-3592,-4184,20.4,1403.8
4840186580,1,10,1,0,3,3,4,0,0,0,0,16020,7.0,17980,198,56,1473,783,25.4,1602.0,18,0,1,3,3,4,1,1,0,0,14547,7.0,17197,171,52,-1473,-783,22.3,1454.7
4839439062,1,11,0,1,7,7,5,0,0,0,0,16456,6.4,16778,163,44,-997,-254,20.7,1645.6,9,0,0,7,7,6,0,0,0,0,17453,6.6,17032,169,48,997,254,21.7,1745.3
4839403012,1,14,2,0,4,2,4,0,0,0,0,14774,7.0,17468,186,40,946,-860,22.6,1477.4,14,3,1,2,4,0,1,1,0,0,13828,7.0,18328,160,72,-946,860,23.2,1382.8
4839259462,1,81,3,0,6,6,3,0,0,0,0,15970,6.8,17647,162,60,-748,299,22.2,1597.0,15,1,1,6,6,8,1,1,0,0,16718,6.8,17348,175,48,748,-299,22.3,1671.8
4839212013,1,13,0,0,8,4,4,0,0,0,0,15301,6.8,16840,168,48,-423,-1834,21.6,1530.1,13,0,1,4,8,4,0,0,0,0,15724,7.0,18674,183,52,423,1834,23.5,1572.4
4838045255,0,35,0,1,8,3,5,0,0,0,0,16647,7.0,18534,199,52,3185,2399,25.1,1664.7,6,11,0,3,8,0,0,0,0,0,13462,6.4,16135,135,52,-3185,-2399,18.7,1346.2
4837994327,0,8,0,1,3,6,3,0,0,0,0,14541,6.4,16793,181,47,-2418,-364,22.8,1454.1,16,2,0,6,3,4,0,0,0,0,16959,6.8,17157,202,52,2418,364,25.4,1695.9
4837833043,0,12,2,1,4,7,3,1,1,0,0,14647,6.6,17026,176,51,-1022,-701,22.7,1464.7,13,0,0,7,4,4,0,0,0,0,15669,6.8,17727,176,56,1022,701,23.2,1566.9
4837069263,1,10,0,1,6,3,5,0,0,0,0,15705,6.8,17763,180,60,1064,739,24.0,1570.5,14,0,0,3,6,1,0,0,0,0,14641,6.4,17024,194,52,-1064,-739,24.6,1464.1
4836988657,1,10,2,1,2,7,1,2,1,1,0,13701,7.0,18469,176,52,-1098,1095,22.8,1370.1,10,0,0,7,2,3,0,0,0,0,14799,6.8,17374,170,44,1098,-1095,21.4,1479.9
4836916588,0,12,2,0,7,8,6,1,1,0,0,17024,6.6,17339,173,48,401,215,22.1,1702.4,11,1,1,8,7,5,0,0,0,0,16623,6.6,17124,152,52,-401,-215,20.4,1662.3
4836868448,1,10,0,1,5,4,2,0,0,0,0,15467,7.0,17722,210,48,759,21,25.8,1546.7,10,0,0,4,5,2,1,1,0,0,14708,6.8,17701,181,58,-759,-21,23.9,1470.8
4836696330,0,29,1,0,0,8,0,0,0,0,0,13350,6.8,16880,182,47,-3404,-305,22.9,1335.0,10,7,1,8,0,6,0,0,0,0,16754,6.8,17185,193,36,3404,305,22.9,1675.4
4836121551,0,10,0,1,7,7,2,0,0,0,0,15188,6.2,15828,162,4,-2201,-2999,16.6,1518.8,65,1,0,7,7,2,0,0,0,0,17389,6.8,18827,202,56,2201,2999,25.8,1738.9
4836071927,1,23,0,1,3,5,2,0,0,0,0,14043,6.6,17201,168,44,-684,-48,21.2,1404.3,222,1,0,5,3,4,0,0,0,0,14727,6.8,17249,149,56,684,48,20.5,1472.7
4836022274,1,15,0,0,7,8,11,0,0,0,0,15389,6.4,16243,166,36,-1055,-217,20.2,1538.9,21,1,1,8,7,9,1,1,0,0,16444,6.8,16460,168,50,1055,217,21.8,1644.4
4835973075,0,171,1,0,3,1,2,0,0,0,0,14353,7.0,18725,197,51,1527,1298,24.8,1435.3,19,0,1,1,3,0,1,1,0,0,12826,7.0,17427,163,52,-1527,-1298,21.5,1282.6
4752985177,1,12,1,1,1,2,1,0,0,0,0,14157,6.6,17511,220,56,-1784,-969,27.6,1415.7,129,0,0,2,1,4,1,1,0,0,15941,6.8,18480,222,76,1784,969,29.8,1594.1
4752932373,1,8,1,0,4,2,1,2,1,1,0,15416,7.0,18886,211,64,18,965,27.5,1541.6,13,0,1,2,4,2,0,0,0,0,15398,6.8,17921,204,52,-18,-965,25.6,1539.8
4750679808,1,12,0,1,5,4,4,0,0,0,0,17405,7.0,17617,205,44,1988,224,24.9,1740.5,10,1,0,4,5,4,0,0,0,0,15417,6.8,17393,170,60,-1988,-224,23.0,1541.7
4749801414,1,35,3,0,3,8,3,0,0,0,0,14916,6.6,16726,183,48,-2101,-1019,23.1,1491.6,31,3,1,8,3,9,1,1,0,0,17017,7.0,17745,173,48,2101,1019,22.1,1701.7
4749747734,0,9,0,0,3,3,3,0,0,0,0,13570,6.6,16121,156,48,-1531,-1609,20.4,1357.0,22,0,1,3,3,1,0,0,0,0,15101,6.8,17730,193,52,1531,1609,24.5,1510.1
4749578445,1,12,0,1,7,6,4,2,1,1,0,17564,7.0,18245,202,73,1074,1360,27.5,1756.4,8,1,0,6,7,6,0,0,0,0,16490,6.8,16885,187,63,-1074,-1360,25.0,1649.0
4748956284,1,17,0,1,11,6,11,0,0,0,0,17818,6.8,16833,163,56,2701,1518,21.9,1781.8,14,1,0,6,11,3,0,0,0,0,15117,6.4,15315,168,39,-2701,-1518,20.7,1511.7
4748906964,0,329,1,0,7,6,7,0,0,0,0,17939,7.2,18282,198,37,375,1666,23.5,1793.9,18,1,1,6,7,6,0,0,0,0,17564,6.6,16616,183,44,-375,-1666,22.7,1756.4
4611823668,1,11,3,0,7,9,0,0,0,0,0,16266,6.8,17672,190,71,-469,695,26.1,1626.6,14,3,1,9,7,7,0,0,0,0,16735,7.0,16977,183,44,469,-695,22.7,1673.5
4607636349,0,7,0,0,1,7,0,0,0,0,0,13824,6.8,17403,194,60,-3392,-666,25.4,1382.4,14,1,1,7,1,6,1,1,0,0,17216,7.0,18069,203,48,3392,666,25.1,1721.6
4604236855,1,17,0,1,5,4,4,0,0,0,0,16689,7.0,18458,210,56,1378,-27,26.6,1668.9,10,1,0,4,5,0,0,0,0,0,15311,7.4,18485,220,60,-1378,27,28.0,1531.1
4604188064,0,16,2,1,1,1,2,0,0,0,0,15112,6.6,17767,203,39,-4,-835,24.2,1511.2,10,4,0,1,1,0,0,0,0,0,15116,7.0,18602,217,60,4,835,27.7,1511.6
4604153592,0,8,2,0,1,8,0,1,1,0,0,12446,6.6,16590,163,40,-5995,-2879,20.3,1244.6,9,1,1,8,1,5,0,0,0,0,18441,7.2,19469,228,60,5995,2879,28.8,1844.1
4601493468,0,14,2,1,6,10,6,0,0,0,0,16137,6.4,15160,109,32,-2182,-2703,14.1,1613.7,8,0,0,10,6,4,0,0,0,0,18319,6.8,17863,192,60,2182,2703,25.2,1831.9
4601486775,1,5,0,0,7,8,3,1,0,1,0,15145,6.6,16645,168,44,-1568,-868,21.2,1514.5,11,0,1,8,7,10,0,0,0,0,16713,6.8,17513,170,52,1568,868,22.2,1671.3
4601475748,1,12,0,0,6,4,5,0,0,0,0,16199,6.6,17585,193,54,1221,650,24.7,1619.9,11,2,1,4,6,1,1,1,0,0,14978,6.6,16935,159,56,-1221,-650,21.5,1497.8
4601077986,0,10,1,1,3,4,2,0,0,0,0,14763,6.8,16891,177,67,-1170,-2162,24.4,1476.3,14,1,0,4,3,1,0,0,0,0,15933,7.2,19053,216,48,1170,2162,26.4,1593.3
4600655408,0,7,1,0,9,5,4,0,0,0,0,16583,6.6,16311,170,52,1425,1713,22.2,1658.3,8,2,1,5,9,5,0,0,0,0,15158,6.0,14598,129,28,-1425,-1713,15.7,1515.8
4600641709,0,6,0,0,1,8,0,0,0,0,0,11110,5.8,14495,128,0,-6391,-4927,12.8,1111.0,12,0,1,8,1,2,0,0,0,0,17501,7.2,19422,214,68,6391,4927,28.2,1750.1
4845899752,0,26,3,0,6,3,7,1,1,0,0,14004,6.4,15962,139,40,366,-542,17.9,1400.4,162,2,1,3,6,0,0,0,0,0,13638,6.4,16504,158,40,-366,542,19.8,1363.8
4841315683,0,11,0,0,2,9,1,0,0,0,0,12470,6.4,14708,128,39,-4626,-1437,16.7,1247.0,10,0,1,9,2,9,1,1,0,0,17096,6.4,16145,158,52,4626,1437,21.0,1709.6
4833401671,0,11,0,0,6,8,8,0,0,0,0,14796,6.6,16309,138,60,-2969,-1517,19.8,1479.6,8,0,1,8,6,9,0,0,0,0,17765,6.8,17826,186,48,2969,1517,23.4,1776.5
4833394245,1,17,2,1,11,2,11,1,1,0,0,18320,6.8,17897,164,66,4648,2597,23.0,1832.0,13,2,0,2,11,1,0,0,0,0,13672,6.0,15300,170,42,-4648,-2597,21.2,1367.2
4832850363,1,13,0,1,8,4,12,1,1,0,0,16212,6.6,16256,176,52,1458,-146,22.8,1621.2,16,1,0,4,8,2,0,0,0,0,14754,6.4,16402,171,52,-1458,146,22.3,1475.4
4831164547,0,9,0,1,5,9,2,0,0,0,0,16428,7.0,18082,207,40,957,980,24.7,1642.8,19,0,0,9,5,4,2,1,1,0,15471,6.6,17102,132,56,-957,-980,18.8,1547.1
4818923454,1,0,0,0,32,26,86,0,0,0,0,40113,11.8,44690,102,0,1092,2584,10.2,4011.3,0,0,1,26,32,53,0,0,0,0,39021,11.4,42106,74,0,-1092,-2584,7.4,3902.1
4818107931,0,0,0,0,21,34,46,0,0,0,1,35348,10.8,40488,80,0,-4145,-4202,8.0,3534.8,0,0,1,34,21,84,0,0,0,0,39493,11.6,44690,86,0,4145,4202,8.6,3949.3
4813750632,0,12,1,1,6,15,4,0,0,0,0,16057,6.6,17404,163,44,-4428,-2971,20.7,1605.7,13,0,0,15,6,6,2,1,1,0,20485,7.4,20375,183,76,4428,2971,25.9,2048.5
4810764686,1,0,0,1,25,22,40,0,0,0,0,38543,11.6,42359,117,0,3531,3338,11.7,3854.3,0,0,0,21,24,41,0,0,0,0,35012,10.8,39021,90,0,-3531,-3338,9.0,3501.2
4810754145,0,0,3,1,21,25,53,0,0,0,1,35483,10.6,38737,88,0,-2999,-4572,8.8,3548.3,30,0,0,25,21,67,0,0,0,0,38482,11.6,43309,107,0,2999,4572,10.7,3848.2
4810738413,0,6,2,1,24,28,67,0,0,0,1,36921,11.2,39989,100,0,-1568,-4233,10.0,3692.1,11,0,0,28,24,58,0,0,0,0,38489,11.6,44222,109,0,1568,4233,10.9,3848.9
4808210513,0,20,2,0,6,3,9,0,0,0,0,15914,6.6,16568,179,48,1825,86,22.7,1591.4,17,0,1,3,6,1,0,0,0,0,14089,6.6,16482,133,48,-1825,-86,18.1,1408.9
4807783300,1,15,1,0,7,5,2,2,1,1,0,15779,6.8,17220,149,56,806,676,20.5,1577.9,11,1,1,5,7,4,0,0,0,0,14973,6.6,16544,174,28,-806,-676,20.2,1497.3
4807252810,1,11,0,0,4,6,3,0,0,0,0,14957,6.6,17001,167,48,-183,621,21.5,1495.7,15,2,1,6,4,5,0,0,0,0,15140,6.6,16380,152,47,183,-621,19.9,1514.0
4806883352,0,10,2,1,4,5,2,1,1,0,0,14950,6.6,16444,145,40,-213,-1709,18.5,1495.0,11,2,0,5,4,3,0,0,0,0,15163,7.0,18153,188,52,213,1709,24.0,1516.3
4806856642,0,9,0,0,3,3,2,0,0,0,0,13238,6.8,17073,130,60,-594,-89,19.0,1323.8,19,0,1,3,3,0,1,1,0,0,13832,6.8,17162,165,60,594,89,22.5,1383.2
4786651061,1,0,0,1,33,23,99,0,0,0,0,40333,11.6,44671,113,0,2493,2507,11.3,4033.3,0,0,0,23,33,46,0,0,0,0,37840,11.4,42164,102,0,-2493,-2507,10.2,3784.0
4786632671,0,0,0,0,24,37,67,0,0,0,2,36199,10.6,39148,93,0,-7141,-7643,9.3,3619.9,0,0,1,37,24,85,0,0,0,0,43340,12.0,46791,116,0,7141,7643,11.6,4334.0
4845489304,0,20,1,0,3,5,2,0,0,0,0,14285,6.4,16288,168,50,-1048,-1302,21.8,1428.5,15,2,1,5,3,3,1,1,0,0,15333,7.0,17590,202,52,1048,1302,25.4,1533.3
4839574585,0,10,2,0,3,8,2,0,0,0,0,14155,6.8,17678,188,40,-2200,408,22.8,1415.5,14,0,1,8,3,11,0,0,0,0,16355,7.0,17270,159,47,2200,-408,20.6,1635.5
4839564212,0,15,3,1,12,10,10,0,0,0,0,18531,6.6,16254,162,56,32,170,21.8,1853.1,18,2,0,10,12,13,1,1,0,0,18499,6.4,16084,154,49,-32,-170,20.3,1849.9
4839556177,1,11,1,1,5,7,6,0,0,0,0,17374,6.8,17397,172,52,-372,-306,22.4,1737.4,11,1,0,7,5,3,0,0,0,0,17746,6.8,17703,178,44,372,306,22.2,1774.6
4839541463,1,6,2,0,8,6,6,0,0,0,0,16532,6.6,17404,173,48,660,-913,22.1,1653.2,13,0,1,6,8,2,1,1,0,0,15872,7.0,18317,218,64,-660,913,28.2,1587.2
4838591613,1,17,1,0,2,1,1,0,0,0,0,13332,6.8,16516,191,40,-463,-440,23.1,1333.2,11,1,1,1,2,1,0,0,0,0,13795,6.8,16956,197,48,463,440,24.5,1379.5
4838584806,1,14,1,0,5,4,2,0,0,0,0,16972,6.8,17754,212,52,2038,1546,26.4,1697.2,122,0,1,4,5,4,1,1,0,0,14934,6.8,16208,165,44,-2038,-1546,20.9,1493.4
4838565381,0,31,1,0,2,4,1,1,1,0,0,15638,7.0,18012,209,65,416,-66,27.4,1563.8,32,0,1,4,2,4,0,0,0,0,15222,7.2,18078,158,62,-416,66,22.0,1522.2
4838558087,1,16,1,1,8,3,8,0,0,0,0,17743,7.2,18480,197,60,3743,2048,25.7,1774.3,9,1,0,3,8,3,0,0,0,0,14000,6.4,16432,166,40,-3743,-2048,20.6,1400.0
4857192281,0,11,1,0,1,4,1,0,0,0,0,14164,7.0,17346,207,56,-1584,-927,26.3,1416.4,12,0,1,4,1,2,1,1,0,0,15748,6.8,18273,216,56,1584,927,27.2,1574.8
4857141351,1,13,1,1,9,6,6,0,0,0,0,17881,6.6,17336,187,56,1604,818,24.3,1788.1,16,1,0,6,9,4,1,1,0,0,16277,6.6,16518,190,32,-1604,-818,22.2,1627.7
4857114035,1,5,1,1,9,2,6,1,0,1,0,18685,7.4,20276,228,68,4696,3630,29.6,1868.5,10,0,0,2,9,1,0,0,0,0,13989,6.6,16646,196,44,-4696,-3630,24.0,1398.9
4857056282,0,15,1,0,7,5,2,1,1,0,0,15619,7.0,18026,177,48,-1203,1066,22.5,1561.9,64,1,1,5,7,6,0,0,0,0,16822,6.8,16960,191,38,1203,-1066,22.9,1682.2
4857019088,0,11,0,1,5,6,4,0,0,0,0,16687,7.0,18693,183,80,127,972,26.3,1668.7,10,1,0,6,5,8,1,1,0,0,16560,6.8,17721,190,48,-127,-972,23.8,1656.0
4856978362,0,12,1,1,3,1,3,0,0,0,0,15510,6.8,17459,220,56,1512,-501,27.6,1551.0,41,1,0,1,3,0,1,1,0,0,13998,6.8,17960,217,59,-1512,501,27.6,1399.8
4856925706,1,0,0,0,27,27,80,0,0,0,0,37473,11.4,42240,103,0,-318,-1499,10.3,3747.3,0,0,1,27,27,65,0,0,0,0,37791,11.8,43739,94,0,318,1499,9.4,3779.1
4856905223,0,71,0,0,23,22,52,0,0,0,1,38479,11.8,43080,96,0,973,4251,9.6,3847.9,1,2,1,22,23,52,0,0,0,0,37506,11.0,38829,113,0,-973,-4251,11.3,3750.6
4856883083,1,285,0,0,16,21,38,0,0,0,0,35260,11.0,38998,111,0,-1513,-1147,11.1,3526.0,0,0,1,21,16,37,0,0,0,0,36773,11.2,40145,93,0,1513,1147,9.3,3677.3
4856489685,1,14,2,0,4,2,4,0,0,0,0,14635,7.0,18018,158,52,108,179,21.0,1463.5,87,2,1,2,4,0,1,1,0,0,14527,7.0,17839,197,56,-108,-179,25.3,1452.7
4856445192,0,12,1,1,4,4,5,0,0,0,0,16006,6.8,17500,212,48,528,-1734,26.0,1600.6,11,0,0,4,4,2,0,0,0,0,15478,7.2,19234,223,72,-528,1734,29.5,1547.8
4856417348,1,4,0,1,24,18,51,0,0,0,0,36802,11.4,41658,99,0,960,1408,9.9,3680.2,0,0,0,18,24,34,0,0,0,0,35842,11.0,40250,82,0,-960,-1408,8.2,3584.2
4856386692,0,1,0,1,16,13,34,0,0,0,1,32925,10.6,36458,77,0,-1809,-23,7.7,3292.5,14,0,0,13,16,24,0,0,0,0,34734,10.4,36481,122,0,1809,23,12.2,3473.4
4856017631,0,19,0,0,4,4,2,1,1,0,0,15220,6.8,17430,173,52,-101,-216,22.5,1522.0,8,2,1,4,4,4,0,0,0,0,15321,6.6,17646,186,52,101,216,23.8,1532.1
4855020440,0,38,1,1,4,3,3,0,0,0,0,16091,7.2,18932,200,68,2262,1196,26.8,1609.1,10,10,0,3,4,2,0,0,0,0,13829,7.0,17736,149,52,-2262,-1196,20.1,1382.9
4854977040,0,11,16,1,8,3,6,1,1,0,0,17761,7.2,19382,222,52,2291,1051,27.4,1776.1,42,0,0,3,8,3,0,0,0,0,15470,7.2,18331,168,64,-2291,-1051,23.2,1547.0
4854946334,1,0,1,0,23,26,52,0,0,0,0,38555,11.2,40644,110,0,2544,-1666,11.0,3855.5,13,0,1,26,23,51,0,0,0,0,36011,11.4,42310,109,0,-2544,1666,10.9,3601.1
4854083428,0,19,0,0,16,22,36,0,0,0,1,34773,10.6,38189,106,0,-1654,-290,10.6,3477.3,0,0,1,22,16,46,0,0,0,0,36427,10.8,38479,115,0,1654,290,11.5,3642.7
4851917617,1,11,1,0,10,4,9,0,0,0,0,17271,6.4,16033,182,32,2939,15,21.4,1727.1,9,1,1,4,10,1,0,0,0,0,14332,6.6,16018,160,48,-2939,-15,20.8,1433.2
4851887603,0,87,3,0,3,8,2,1,0,1,0,15484,6.6,17130,170,40,-2667,-1156,21.0,1548.4,13,0,1,8,3,6,1,1,0,0,18151,7.2,18286,191,40,2667,1156,23.1,1815.1
4857426460,0,14,0,1,7,3,7,0,0,0,0,15763,6.6,16605,145,48,642,-1498,19.3,1576.3,9,1,0,3,7,0,0,0,0,0,15121,7.0,18103,241,48,-642,1498,28.9,1512.1
4857348199,1,0,0,0,18,19,19,0,0,0,0,47189,10.0,47500,3,0,19639,19000,0.3,4718.9,7,0,1,11,10,10,0,0,0,0,27550,6.0,28500,0,0,-19639,-19000,0.0,2755.0
4857239053,1,5,0,1,20,16,12,0,0,0,0,46700,10.0,47500,2,0,18150,19000,0.2,4670.0,0,0,0,5,9,12,0,0,0,0,28550,6.0,28500,0,0,-18150,-19000,0.0,2855.0
4857206347,1,62,9,0,18,20,16,0,0,0,0,48400,10.0,47500,13,0,19132,19000,1.3,4840.0,0,3,1,12,10,11,0,0,0,0,29268,6.0,28500,9,0,-19132,-19000,0.9,2926.8
4857184117,1,0,0,1,18,23,14,0,0,0,0,61650,12.0,55000,0,0,23400,22000,0.0,6165.0,0,0,0,13,8,16,0,0,0,0,38250,7.2,33000,0,0,-23400,-22000,0.0,3825.0
4854621799,1,0,0,1,19,13,18,0,0,0,0,62000,12.0,55000,0,0,24800,22000,0.0,6200.0,8,0,0,7,13,8,0,0,0,0,37200,7.2,33000,0,0,-24800,-22000,0.0,3720.0
4854354731,1,0,0,0,11,21,19,0,0,0,0,47350,12.0,55000,0,0,18100,22000,0.0,4735.0,86,0,1,17,7,10,0,0,0,0,29250,7.2,33000,0,0,-18100,-22000,0.0,2925.0
4854353823,1,0,0,1,15,18,14,0,0,0,0,62010,12.0,55000,0,0,23410,22000,0.0,6201.0,0,0,0,12,9,14,0,0,0,0,38600,7.2,33000,0,0,-23410,-22000,0.0,3860.0
4853862693,1,0,0,0,17,20,15,0,0,0,0,46650,10.4,49000,0,0,17400,20500,0.0,4665.0,0,0,1,12,9,14,0,0,0,0,29250,6.0,28500,0,0,-17400,-20500,0.0,2925.0
4853842725,1,0,0,1,18,11,20,0,0,0,0,47000,10.0,47500,0,0,20200,16000,0.0,4700.0,0,0,0,6,13,6,0,0,0,0,26800,6.6,31500,0,0,-20200,-16000,0.0,2680.0
4853070261,1,0,0,1,16,17,17,0,0,0,0,61826,12.0,55000,0,0,24976,22000,0.0,6182.6,0,0,0,9,8,12,0,0,0,0,36850,7.2,33000,0,0,-24976,-22000,0.0,3685.0
4853046702,1,20,0,1,14,24,13,0,0,0,0,61047,12.4,57000,2,0,22831,24000,0.2,6104.7,0,0,0,16,6,13,0,0,0,0,38216,7.2,33000,3,0,-22831,-24000,0.3,3821.6
4853029078,1,0,0,0,16,25,21,0,0,0,0,63050,12.6,59500,0,0,24100,22000,0.0,6305.0,0,0,1,17,8,14,0,0,0,0,38950,7.8,37500,0,0,-24100,-22000,0.0,3895.0
4853004393,1,0,0,1,15,14,20,0,0,0,0,61540,12.4,57000,6,0,24295,24000,0.6,6154.0,0,0,0,10,11,5,0,0,0,0,37245,7.2,33000,1,0,-24295,-24000,0.1,3724.5
4852900994,1,3,0,0,14,15,15,0,0,0,0,45250,10.0,47500,0,0,18100,19000,0.0,4525.0,0,0,1,8,7,10,0,0,0,0,27150,6.0,28500,0,0,-18100,-19000,0.0,2715.0
4852800754,1,0,0,0,18,22,16,0,0,0,0,48050,10.0,47500,0,0,18100,19000,0.0,4805.0,0,0,1,13,9,11,0,0,0,0,29950,6.0,28500,0,0,-18100,-19000,0.0,2995.0
4852766713,1,1,0,0,22,26,21,0,0,0,0,46829,10.0,47500,0,0,17229,19000,0.0,4682.9,11,0,1,13,9,13,0,0,0,0,29600,6.0,28500,0,0,-17229,-19000,0.0,2960.0
4852043694,1,7,0,0,22,19,58,0,0,0,0,36491,11.0,38462,107,0,1356,84,10.7,3649.1,24,0,1,19,22,37,0,0,0,0,35135,10.8,38378,98,0,-1356,-84,9.8,3513.5
4852027438,0,0,0,1,26,35,68,0,0,0,1,38422,11.4,43304,80,0,-3564,-3366,8.0,3842.2,2,0,0,35,26,97,0,0,0,0,41986,12.2,46670,126,0,3564,3366,12.6,4198.6
4854209913,0,11,1,1,4,6,1,0,0,0,0,14925,6.6,15869,160,36,-629,-1745,19.6,1492.5,80,0,0,6,4,6,1,1,0,0,15554,6.8,17614,163,56,629,1745,21.9,1555.4
4854190819,1,4,0,1,18,17,18,0,0,0,0,47000,10.0,47500,0,0,19500,19000,0.0,4700.0,1,0,0,11,12,7,0,0,0,0,27500,6.0,28500,0,0,-19500,-19000,0.0,2750.0
4854159701,1,35,4,0,12,20,11,0,0,0,0,61120,12.2,56000,6,0,22830,23000,0.6,6112.0,5,8,1,14,6,14,0,0,0,0,38290,7.2,33000,0,0,-22830,-23000,0.0,3829.0
4854017626,1,11,2,1,3,4,3,0,0,0,0,15653,6.8,17002,187,40,-72,-403,22.7,1565.3,12,3,0,4,3,4,1,1,0,0,15725,6.8,17405,174,52,72,403,22.6,1572.5
4853979509,1,15,2,1,13,3,24,0,0,0,0,19822,7.4,19413,178,60,7080,4199,23.8,1982.2,15,0,0,2,12,0,0,0,0,0,12742,6.4,15214,145,32,-7080,-4199,17.7,1274.2
4853938664,1,0,0,1,20,17,17,0,0,0,0,48092,10.0,47500,9,0,20215,19000,0.9,4809.2,72,0,0,9,12,7,0,0,0,0,27877,6.0,28500,0,0,-20215,-19000,0.0,2787.7
4851874447,0,6,2,1,3,3,3,1,0,1,0,14901,7.0,17794,169,40,752,-779,20.9,1490.1,243,2,0,3,3,1,0,0,0,0,14149,7.0,18573,186,59,-752,779,24.5,1414.9
4850960946,1,273,0,0,8,7,4,1,1,0,0,15997,6.6,17726,167,52,253,908,21.9,1599.7,11,14,1,6,7,2,0,0,0,0,15744,6.4,16818,188,44,-253,-908,23.2,1574.4
4850913205,0,12,0,0,3,9,5,0,0,0,0,13657,6.4,15184,159,40,-3926,-2044,19.9,1365.7,7,1,1,9,3,7,0,0,0,0,17583,7.0,17228,196,40,3926,2044,23.6,1758.3
4850120606,1,54,0,0,4,3,1,0,0,0,0,15496,7.2,19104,175,58,303,1647,23.3,1549.6,10,0,1,3,4,4,1,1,0,0,15193,7.0,17457,173,52,-303,-1647,22.5,1519.3
4850089544,1,11,2,1,7,5,4,1,1,0,0,15207,6.4,16396,157,56,-655,-73,21.3,1520.7,12,1,0,5,7,2,0,0,0,0,15862,6.6,16469,149,48,655,73,19.7,1586.2
4849726210,0,11,3,1,3,2,2,1,1,0,0,15392,6.8,17626,199,52,691,358,25.1,1539.2,16,1,0,2,3,3,0,0,0,0,14701,6.8,17268,179,48,-691,-358,22.7,1470.1
4849167743,1,20,0,1,6,3,5,0,0,0,0,16477,6.8,17766,200,52,2517,1909,25.2,1647.7,14,3,0,3,6,3,0,0,0,0,13960,6.6,15857,162,48,-2517,-1909,21.0,1396.0
4849128607,1,13,2,1,4,5,3,0,0,0,0,16277,6.8,17601,189,52,228,-606,24.1,1627.7,15,2,0,5,4,0,0,0,0,0,16049,7.0,18207,199,52,-228,606,25.1,1604.9
4848947786,1,13,1,1,5,2,3,0,0,0,0,15490,7.0,18321,201,36,1432,261,23.7,1549.0,10,1,0,2,5,2,1,1,0,0,14058,7.2,18060,180,64,-1432,-261,24.4,1405.8
4847842242,1,15,0,1,8,3,5,0,0,0,0,16978,7.0,18285,209,44,1985,558,25.3,1697.8,8,0,0,3,8,1,0,0,0,0,14993,6.8,17727,168,68,-1985,-558,23.6,1499.3
4847805340,0,14,1,1,6,6,6,2,1,1,0,16322,6.8,16886,166,56,120,-596,22.2,1632.2,11,0,0,6,6,6,0,0,0,0,16202,6.8,17482,182,48,-120,596,23.0,1620.2
4847214595,1,14,1,1,3,4,2,0,0,0,0,14175,6.8,16809,161,52,-827,-1344,21.3,1417.5,29,3,0,4,3,4,0,0,0,0,15002,7.0,18153,176,52,827,1344,22.8,1500.2
4819615707,0,15,1,0,7,5,5,0,0,0,0,17744,6.8,17002,206,44,1258,18,25.0,1774.4,14,2,1,5,7,2,1,1,0,0,16486,6.8,16984,177,56,-1258,-18,23.3,1648.6
4814949718,1,14,0,1,7,4,11,0,0,0,0,17792,7.0,18417,204,52,2015,1156,25.6,1779.2,10,2,0,4,7,3,0,0,0,0,15777,7.0,17261,166,36,-2015,-1156,20.2,1577.7
4814900318,1,15,0,1,3,3,4,0,0,0,0,15331,6.6,17027,188,56,1409,1029,24.4,1533.1,12,1,0,3,3,2,0,0,0,0,13922,6.4,15998,163,52,-1409,-1029,21.5,1392.2
4814883005,1,11,1,1,5,3,3,1,1,0,0,16218,7.0,18412,196,52,1963,599,24.8,1621.8,11,0,0,3,5,2,0,0,0,0,14255,6.8,17813,169,60,-1963,-599,22.9,1425.5
4814595296,1,14,0,0,3,3,3,0,0,0,0,14626,6.8,16588,174,36,-232,-816,21.0,1462.6,10,0,1,3,3,3,0,0,0,0,14858,6.6,17404,204,64,232,816,26.8,1485.8
4814582148,1,9,1,1,11,7,4,1,1,0,0,17911,7.0,18126,189,72,2292,2244,26.1,1791.1,8,0,0,7,11,5,1,0,1,0,15619,6.4,15882,166,40,-2292,-2244,20.6,1561.9
4814555035,0,10,0,1,5,7,3,0,0,0,0,15857,7.2,18058,194,59,-1120,-1283,25.3,1585.7,11,2,0,7,5,5,1,1,0,0,16977,7.2,19341,200,56,1120,1283,25.6,1697.7
4814459682,0,12,0,1,2,3,1,0,0,0,0,15204,7.0,18746,232,64,-23,531,29.6,1520.4,11,0,0,3,2,2,0,0,0,0,15227,7.0,18215,180,68,23,-531,24.8,1522.7
4814422163,1,13,1,1,5,3,5,1,1,0,0,15654,6.6,17014,193,59,1098,-264,25.2,1565.4,10,1,0,3,5,4,0,0,0,0,14556,6.8,17278,183,48,-1098,264,23.1,1455.6
4812429062,1,94,1,0,3,2,5,0,0,0,0,15852,6.8,17814,198,44,1787,767,24.2,1585.2,13,1,1,2,3,2,0,0,0,0,14065,6.6,17047,179,60,-1787,-767,23.9,1406.5
4812059230,1,11,1,1,13,4,17,0,0,0,0,19475,7.0,18062,212,44,3507,58,25.6,1947.5,171,1,0,4,13,2,1,1,0,0,15968,6.8,18004,177,56,-3507,-58,23.3,1596.8
4812018364,1,14,0,1,7,6,7,1,1,0,0,16856,6.8,17845,163,64,829,359,22.7,1685.6,13,0,0,6,7,5,0,0,0,0,16027,6.6,17486,179,62,-829,-359,24.1,1602.7
4807682727,0,14,0,0,9,4,9,1,1,0,0,17637,6.8,17222,196,56,1068,-198,25.2,1763.7,10,0,1,4,9,2,0,0,0,0,16569,6.8,17420,210,56,-1068,198,26.6,1656.9
4806592068,0,11,0,0,7,8,5,0,0,0,0,16585,7.0,18195,197,60,-410,-883,25.7,1658.5,9,0,1,8,7,3,2,1,1,0,16995,7.4,19078,226,56,410,883,28.2,1699.5
4806556570,0,13,2,0,5,8,4,1,0,1,0,15626,6.6,16923,183,52,-1943,-1324,23.5,1562.6,10,3,1,8,5,7,1,1,0,0,17569,6.8,18247,223,44,1943,1324,26.7,1756.9
4533388067,0,11,3,0,8,9,4,1,1,0,0,18390,7.0,18634,196,46,1651,3140,24.2,1839.0,11,0,1,9,8,12,0,0,0,0,16739,6.4,15494,145,64,-1651,-3140,20.9,1673.9
4224972910,0,14,1,1,3,5,3,0,0,0,0,13981,6.6,15879,176,56,-3432,-2787,23.2,1398.1,13,1,0,5,3,8,1,1,0,0,17413,7.0,18666,196,48,3432,2787,24.4,1741.3
4857306645,0,121,1,1,4,3,0,0,0,0,0,15700,6.8,16951,192,44,939,882,23.6,1570.0,14,2,0,3,4,4,1,1,0,0,14761,6.4,16069,204,48,-939,-882,25.2,1476.1
4857285121,1,15,2,1,5,3,3,1,1,0,0,16577,7.0,18475,182,56,2089,2083,23.8,1657.7,11,1,0,3,5,2,0,0,0,0,14488,6.6,16392,206,48,-2089,-2083,25.4,1448.8
4857236401,0,12,0,0,0,4,0,0,0,0,0,13061,6.6,16496,198,40,-1699,-473,23.8,1306.1,14,1,1,4,0,2,1,1,0,0,14760,6.6,16969,163,52,1699,473,21.5,1476.0
4857178343,1,16,0,1,8,7,6,1,1,0,0,17358,6.6,17716,174,44,-440,-298,21.8,1735.8,136,0,0,7,8,9,1,0,1,0,17798,7.0,18014,180,66,440,298,24.6,1779.8
4855365159,0,13,0,1,9,5,6,1,1,0,0,16716,6.6,16823,135,49,-879,-1073,18.4,1671.6,188,0,0,5,9,7,0,0,0,0,17595,7.0,17896,190,56,879,1073,24.6,1759.5
4855326858,0,45,1,0,7,7,6,0,0,0,0,15476,6.2,15325,163,47,75,-1436,21.0,1547.6,16,1,1,6,6,3,0,0,0,0,15401,6.6,16761,157,48,-75,1436,20.5,1540.1
4855278521,1,12,1,1,2,4,3,1,1,0,0,13931,6.6,16543,164,52,-1887,-528,21.6,1393.1,12,1,0,4,2,7,0,0,0,0,15818,6.6,17071,185,48,1887,528,23.3,1581.8
4852978024,0,232,3,0,16,7,17,2,1,1,0,21208,7.2,18948,199,48,4395,4016,24.7,2120.8,67,0,1,7,16,7,0,0,0,0,16813,6.4,14932,135,44,-4395,-4016,17.9,1681.3
4852927427,1,11,0,1,10,3,7,0,0,0,0,18827,7.4,19296,232,68,4820,2720,30.0,1882.7,17,0,0,3,10,3,1,1,0,0,14007,6.6,16576,167,56,-4820,-2720,22.3,1400.7
4852868060,1,12,1,0,1,3,1,0,0,0,0,14731,6.8,16818,188,48,-56,-1429,23.6,1473.1,11,0,1,3,1,0,1,1,0,0,14787,7.0,18247,201,52,56,1429,25.3,1478.7
4849168407,1,14,2,0,3,2,2,1,1,0,0,13880,6.8,17538,187,48,-1343,730,23.5,1388.0,10,0,1,2,3,4,0,0,0,0,15223,6.8,16808,190,56,1343,-730,24.6,1522.3
4849144232,1,18,0,1,12,3,14,1,1,0,0,17781,6.2,15693,163,44,3917,752,20.7,1778.1,13,0,0,3,12,3,0,0,0,0,13864,6.0,14941,170,32,-3917,-752,20.2,1386.4
4848144869,1,11,0,1,2,2,1,1,1,0,0,14610,6.8,18197,207,52,201,733,25.9,1461.0,16,2,0,2,2,2,1,0,1,0,14409,6.8,17464,184,53,-201,-733,23.7,1440.9
4848093083,1,15,0,1,5,3,6,0,0,0,0,15967,6.6,17048,179,44,983,-845,22.3,1596.7,13,2,0,3,5,2,0,0,0,0,14984,6.8,17893,191,52,-983,845,24.3,1498.4
4848035461,0,137,2,1,10,6,7,0,0,0,0,18026,6.8,18524,220,52,1524,1565,27.2,1802.6,13,0,0,6,10,5,0,0,0,0,16502,6.6,16959,171,32,-1524,-1565,20.3,1650.2
4847981029,1,13,0,1,5,3,5,0,0,0,0,15976,6.6,17033,184,32,961,-1377,21.6,1597.6,16,0,0,3,5,4,1,1,0,0,15015,6.8,18410,188,68,-961,1377,25.6,1501.5
4846231922,0,18,1,0,8,7,6,0,0,0,0,16107,6.4,16255,127,45,-983,-458,17.2,1610.7,10,2,1,7,8,4,0,0,0,0,17090,6.6,16713,218,52,983,458,27.0,1709.0
4846180848,1,14,0,1,5,3,3,1,1,0,0,15339,6.6,17289,175,60,1414,634,23.5,1533.9,9,0,0,3,5,4,0,0,0,0,13925,6.6,16655,159,52,-1414,-634,21.1,1392.5
4846154356,1,22,1,1,5,4,5,1,1,0,0,16196,6.8,18182,189,55,1877,-108,24.4,1619.6,14,2,0,4,5,2,0,0,0,0,14319,7.0,18290,175,44,-1877,108,21.9,1431.9
4844312893,1,10,0,1,5,1,2,1,1,0,0,14933,6.4,17054,181,52,466,-399,23.3,1493.3,13,0,0,1,5,1,0,0,0,0,14467,6.8,17453,189,52,-466,399,24.1,1446.7
4849609944,1,15,0,0,11,6,9,1,1,0,0,18280,6.4,16907,168,64,1737,2002,23.2,1828.0,16,1,1,6,11,8,0,0,0,0,16543,6.2,14905,142,52,-1737,-2002,19.4,1654.3
4849584119,1,77,1,1,5,3,2,1,1,0,0,15575,7.2,18898,189,72,633,1382,26.1,1557.5,30,0,0,3,5,3,0,0,0,0,14942,6.8,17516,171,44,-633,-1382,21.5,1494.2
4849557997,0,8,0,1,3,1,1,0,0,0,0,14116,6.8,17416,162,60,-19,597,22.2,1411.6,15,0,0,1,3,1,0,0,0,0,14135,6.8,16819,190,48,19,-597,23.8,1413.5
4816020573,1,20,1,1,11,4,15,1,1,0,0,18565,6.8,17602,170,47,2974,978,21.7,1856.5,11,2,0,4,11,2,0,0,0,0,15591,6.6,16624,170,36,-2974,-978,20.6,1559.1
4815993519,1,10,0,1,6,5,13,1,1,0,0,16255,6.4,15716,138,52,1040,-295,19.0,1625.5,13,0,0,5,6,6,0,0,0,0,15215,6.6,16011,153,48,-1040,295,20.1,1521.5
4815947281,1,176,4,1,5,3,6,0,0,0,0,16491,7.2,18289,187,60,2054,662,24.7,1649.1,69,0,0,3,5,2,0,0,0,0,14437,7.0,17627,185,48,-2054,-662,23.3,1443.7
4815815966,1,39,2,0,12,5,6,1,1,0,0,18656,7.2,19086,202,48,3115,3175,25.0,1865.6,11,16,1,5,12,4,0,0,0,0,15541,6.4,15911,143,54,-3115,-3175,19.7,1554.1
4815801798,1,12,1,1,6,3,7,0,0,0,0,16209,6.8,17731,200,64,2446,923,26.4,1620.9,88,0,0,3,6,0,1,1,0,0,13763,6.6,16808,175,55,-2446,-923,23.0,1376.3
4815504387,1,15,1,1,5,8,8,0,0,0,0,16037,6.6,16146,178,40,-1162,-1576,21.8,1603.7,12,0,0,8,5,7,0,0,0,0,17199,6.6,17722,154,59,1162,1576,21.3,1719.9
4815472931,0,16,0,1,8,6,4,0,0,0,0,16344,6.6,16879,187,36,331,-890,22.3,1634.4,14,0,0,5,7,7,1,1,0,0,16013,7.0,17769,185,68,-331,890,25.3,1601.3
4815429917,1,7,3,1,8,9,4,0,0,0,0,16778,6.6,16974,164,48,-792,-1141,21.2,1677.8,15,2,0,9,8,8,1,1,0,0,17570,7.0,18115,178,72,792,1141,25.0,1757.0
4815087353,1,11,1,0,9,9,16,0,0,0,0,17610,6.6,16124,158,32,-413,-1468,19.0,1761.0,13,0,1,9,9,8,0,0,0,0,18023,7.0,17592,204,52,413,1468,25.6,1802.3
4815061658,1,15,2,1,7,8,4,1,0,1,0,16657,6.8,17192,203,44,214,735,24.7,1665.7,4,0,0,8,7,11,0,0,0,0,16443,6.4,16457,151,48,-214,-735,19.9,1644.3
4809187949,1,17,1,0,2,5,2,1,0,1,0,14414,6.6,17789,200,47,-1459,25,24.7,1441.4,48,0,1,5,2,8,0,0,0,0,15873,6.8,17764,235,36,1459,-25,27.1,1587.3
4724365397,0,21,2,0,4,9,4,0,0,0,0,13885,6.2,15330,128,48,-4208,-2689,17.6,1388.5,16,1,1,9,4,7,1,1,0,0,18093,6.8,18019,203,56,4208,2689,25.9,1809.3
4644570466,0,14,2,0,40,20,107,0,0,0,0,40848,12.0,46097,79,0,3649,4883,7.9,4084.8,12,0,1,20,40,46,0,0,0,0,37199,11.2,41214,89,0,-3649,-4883,8.9,3719.9
4637861131,1,0,0,0,42,21,108,0,0,0,1,43062,12.4,48259,106,0,7238,8856,10.6,4306.2,0,0,1,21,42,43,0,0,0,0,35824,11.0,39403,69,0,-7238,-8856,6.9,3582.4
4637845022,1,0,0,0,25,19,56,0,0,0,0,39270,11.2,42162,119,0,1667,2309,11.9,3927.0,0,0,1,19,25,49,0,0,0,0,37603,11.2,39853,111,0,-1667,-2309,11.1,3760.3
4637817088,0,19,0,0,20,29,39,0,0,0,1,37434,11.4,41595,91,0,-416,508,9.1,3743.4,5,0,1,29,20,84,0,0,0,0,37850,11.0,41087,103,0,416,-508,10.3,3785.0
4855842903,1,9,2,0,5,6,5,0,0,0,0,15588,6.8,18127,191,56,-231,-199,24.7,1558.8,14,0,1,5,4,6,0,0,0,0,15819,7.0,18326,195,60,231,199,25.5,1581.9
4855803549,1,18,2,0,3,7,4,0,0,0,0,15195,6.8,17529,206,56,-1148,-680,26.2,1519.5,14,1,1,7,3,6,1,1,0,0,16343,7.0,18209,183,40,1148,680,22.3,1634.3
4847729193,1,86,1,1,7,4,7,0,0,0,0,17918,7.0,18270,205,66,1752,1957,27.1,1791.8,12,1,0,4,7,7,0,0,0,0,16166,6.4,16313,193,43,-1752,-1957,23.6,1616.6
4847690396,1,15,0,1,3,4,0,0,0,0,0,14856,7.2,18290,195,65,-1264,-566,26.0,1485.6,11,2,0,4,3,0,0,0,0,0,16120,7.2,18856,243,41,1264,566,28.4,1612.0
4847576656,0,19,2,1,5,3,3,0,0,0,0,15455,6.8,17337,195,60,24,-366,25.5,1545.5,15,2,0,3,5,1,0,0,0,0,15431,7.0,17703,199,46,-24,366,24.5,1543.1
4847541899,1,15,3,1,3,6,3,0,0,0,0,14945,6.8,17430,213,52,-707,-1802,26.5,1494.5,16,3,0,6,3,4,1,1,0,0,15652,7.2,19232,206,64,707,1802,27.0,1565.2
4847405719,1,14,0,1,10,2,7,0,0,0,0,17722,7.2,18874,189,52,3182,1672,24.1,1772.2,13,1,0,2,10,1,0,0,0,0,14540,6.8,17202,174,52,-3182,-1672,22.6,1454.0
4847386364,0,16,5,1,6,4,5,0,0,0,0,15917,6.6,16879,177,40,629,-1053,21.7,1591.7,13,2,0,4,6,2,1,1,0,0,15288,7.0,17932,208,48,-629,1053,25.6,1528.8
4841788525,0,13,1,1,7,2,5,0,0,0,0,17586,6.8,18073,221,64,4645,926,28.5,1758.6,14,0,0,2,7,1,0,0,0,0,12941,6.8,17147,169,32,-4645,-926,20.1,1294.1
4841034042,1,48,0,0,6,7,3,0,0,0,0,15648,7.0,17768,173,48,-1363,432,22.1,1564.8,16,2,1,7,6,10,1,1,0,0,17011,6.8,17336,219,52,1363,-432,27.1,1701.1
4840999758,1,71,3,0,5,11,5,1,1,0,0,15099,6.4,15271,170,52,-4148,-2275,22.2,1509.9,119,3,1,11,5,12,0,0,0,0,19247,6.8,17546,183,36,4148,2275,21.9,1924.7
4840967878,0,14,0,1,5,6,4,0,0,0,0,16934,6.8,17516,187,52,55,-1318,23.9,1693.4,14,2,0,6,5,5,0,0,0,0,16879,7.0,18834,221,40,-55,1318,26.1,1687.9
4840932538,1,46,0,0,8,4,8,0,0,0,0,16820,7.0,18415,181,52,421,-147,23.3,1682.0,9,0,1,4,8,5,0,0,0,0,16399,7.2,18562,198,56,-421,147,25.4,1639.9
4834810962,1,12,0,0,3,1,5,0,0,0,0,15774,6.8,17366,211,40,2518,755,25.1,1577.4,10,0,1,1,3,1,0,0,0,0,13256,6.6,16611,177,44,-2518,-755,22.1,1325.6
4834769959,1,15,1,0,5,7,5,1,1,0,0,15450,7.2,18332,193,48,-1001,992,24.1,1545.0,69,0,1,7,5,6,0,0,0,0,16451,6.8,17340,190,44,1001,-992,23.4,1645.1
4834730030,1,35,4,0,1,9,0,0,0,0,0,13306,6.6,16725,184,56,-4770,-2348,24.0,1330.6,20,13,1,9,1,10,0,0,0,0,18076,7.0,19073,216,52,4770,2348,26.8,1807.6
4834699252,0,46,1,0,6,8,5,1,1,0,0,16698,6.8,17223,181,52,-1806,-718,23.3,1669.8,84,0,1,8,6,10,0,0,0,0,18504,6.8,17941,211,40,1806,718,25.1,1850.4
4834667609,1,48,0,0,2,1,3,0,0,0,0,14695,6.6,16300,203,48,-32,-154,25.1,1469.5,10,1,1,1,2,3,0,0,0,0,14727,6.6,16454,216,48,32,154,26.4,1472.7
4821855739,0,14,2,0,4,7,1,1,1,0,0,14578,6.6,17456,167,63,-2855,-722,23.0,1457.8,160,4,1,7,4,9,0,0,0,0,17433,7.0,18178,189,48,2855,722,23.7,1743.3
4858422325,0,318,0,1,5,4,1,1,1,0,0,14125,6.6,15772,142,48,817,44,19.0,1412.5,13,1,0,4,5,3,0,0,0,0,13308,6.2,15728,135,35,-817,-44,17.0,1330.8
4856293196,1,9,0,1,3,4,3,0,0,0,0,14335,6.8,17814,162,68,-151,-371,23.0,1433.5,12,2,0,4,3,4,1,1,0,0,14486,6.8,18185,185,56,151,371,24.1,1448.6
4853600570,0,54,1,1,5,6,3,0,0,0,0,15785,7.0,17874,176,48,82,1076,22.4,1578.5,14,1,0,6,5,6,1,1,0,0,15703,6.6,16798,171,52,-82,-1076,22.3,1570.3
4851737775,0,41,1,0,3,4,2,1,0,1,0,15676,7.0,17476,215,52,-219,-940,26.7,1567.6,6,11,1,4,3,1,0,0,0,0,15895,7.0,18416,200,60,219,940,26.0,1589.5
4851689517,0,16,3,0,4,9,1,0,0,0,0,14579,6.8,17919,192,56,-2512,24,24.8,1457.9,11,2,1,9,4,6,1,1,0,0,17091,6.8,17895,199,51,2512,-24,25.0,1709.1
4850868388,0,21,2,0,4,7,2,0,0,0,0,15852,6.8,17420,175,52,-237,862,22.7,1585.2,9,2,1,7,4,7,0,0,0,0,16089,6.4,16558,179,60,237,-862,23.9,1608.9
4850833467,1,10,0,1,11,4,12,0,0,0,0,17860,6.6,17154,170,36,3386,1132,20.6,1786.0,12,0,0,4,11,2,0,0,0,0,14474,6.4,16022,149,56,-3386,-1132,20.5,1447.4
4850548249,1,16,1,0,4,9,3,1,1,0,0,15626,7.0,18162,200,62,-1249,-609,26.2,1562.6,10,2,1,9,4,4,0,0,0,0,16875,7.0,18771,188,49,1249,609,23.7,1687.5
4842150515,1,11,0,1,3,3,1,0,0,0,0,13973,7.0,17795,162,72,-543,513,23.4,1397.3,15,0,0,3,3,1,0,0,0,0,14516,6.6,17282,206,44,543,-513,25.0,1451.6
4842126937,1,9,0,1,3,2,0,0,0,0,0,14860,7.0,17739,205,52,1199,953,25.7,1486.0,8,0,0,2,3,2,0,0,0,0,13661,6.6,16786,177,60,-1199,-953,23.7,1366.1
4842076725,0,32,1,0,4,8,5,0,0,0,0,15862,6.8,16725,193,52,-936,-1488,24.5,1586.2,333,1,1,8,4,4,0,0,0,0,16798,7.0,18213,206,48,936,1488,25.4,1679.8
4840489091,1,120,0,0,7,7,5,0,0,0,0,18200,7.0,19186,227,56,3682,2334,28.3,1820.0,10,0,1,6,6,2,0,0,0,0,14518,6.6,16852,158,44,-3682,-2334,20.2,1451.8
4840443924,0,13,0,1,4,9,2,0,0,0,0,15195,6.4,16194,213,52,-2040,-3114,26.5,1519.5,15,0,0,9,4,3,0,0,0,0,17235,7.0,19308,198,68,2040,3114,26.6,1723.5
4840399292,0,44,1,0,2,6,0,0,0,0,0,13107,6.6,16523,153,40,-3241,-1017,19.3,1310.7,13,0,1,6,2,6,0,0,0,0,16348,6.8,17540,185,48,3241,1017,23.3,1634.8
4838932394,0,176,1,1,2,4,1,0,0,0,0,16044,6.8,17754,175,72,-234,-1664,24.7,1604.4,13,2,0,4,2,5,1,1,0,0,16278,7.2,19418,208,60,234,1664,26.8,1627.8
4838326892,1,10,0,1,7,4,7,1,1,0,0,16121,6.8,16974,138,68,2017,968,20.6,1612.1,85,0,0,4,7,2,0,0,0,0,14104,6.4,16006,150,40,-2017,-968,19.0,1410.4
4828714670,0,14,0,1,8,5,3,0,0,0,0,17484,7.4,19960,221,48,1897,2312,26.9,1748.4,100,1,0,5,8,7,0,0,0,0,15587,6.8,17648,155,60,-1897,-2312,21.5,1558.7
4827980095,0,12,0,1,3,8,3,0,0,0,0,14046,6.8,16749,179,44,-3039,-2967,22.3,1404.6,7,0,0,8,3,5,0,0,0,0,17085,7.4,19716,206,68,3039,2967,27.4,1708.5
4827952819,1,21,1,1,8,5,8,0,0,0,0,17874,6.8,17087,171,44,1187,71,21.5,1787.4,10,2,0,5,8,6,0,0,0,0,16687,6.8,17016,186,44,-1187,-71,23.0,1668.7
4858433446,1,9,0,1,8,2,3,1,1,0,0,17275,6.8,18447,204,60,4234,3451,26.4,1727.5,82,0,0,2,8,2,0,0,0,0,13041,6.2,14996,161,40,-4234,-3451,20.1,1304.1
4858406787,0,40,4,1,3,5,2,0,0,0,0,15073,6.8,16706,137,52,-2278,-1336,18.9,1507.3,15,1,0,5,3,4,0,0,0,0,17351,6.8,18042,195,60,2278,1336,25.5,1735.1
4857027174,1,10,1,0,6,10,4,0,0,0,0,16125,6.8,17271,176,40,-1925,-740,21.6,1612.5,177,1,1,10,6,7,0,0,0,0,18050,6.8,18011,162,48,1925,740,21.0,1805.0
4856440421,1,12,0,0,5,6,3,0,0,0,0,16108,7.0,17335,221,44,-156,-153,26.5,1610.8,14,0,1,6,5,9,0,0,0,0,16264,6.8,17488,164,59,156,153,22.3,1626.4
4856406406,0,14,0,0,2,5,2,1,1,0,0,13107,6.4,16734,170,36,-3089,-1625,20.6,1310.7,159,1,1,5,2,5,0,0,0,0,16196,7.2,18359,204,44,3089,1625,24.8,1619.6
4856357756,1,14,0,0,7,8,1,0,0,0,0,16498,6.8,18198,192,55,1768,1748,24.7,1649.8,12,0,1,8,7,7,0,0,0,0,14730,6.6,16450,124,44,-1768,-1748,16.8,1473.0
4856293494,0,114,0,1,2,3,2,1,1,0,0,15431,6.8,18355,172,56,846,1148,22.8,1543.1,12,0,0,3,2,3,0,0,0,0,14585,7.0,17207,148,60,-846,-1148,20.8,1458.5
4856245305,0,9,0,0,8,7,5,0,0,0,0,15601,7.0,17550,153,56,-147,-180,20.9,1560.1,17,0,1,6,7,7,1,1,0,0,15748,6.8,17730,175,48,147,180,22.3,1574.8
4856207527,0,11,0,1,5,5,1,1,1,0,0,14522,6.6,16776,164,60,293,230,22.4,1452.2,18,0,0,5,5,2,0,0,0,0,14229,6.4,16546,152,40,-293,-230,19.2,1422.9
4856143837,0,5,0,0,1,6,1,0,0,0,0,14037,6.8,17533,166,60,-1795,-720,22.6,1403.7,22,0,1,6,1,5,1,1,0,0,15832,6.8,18253,184,56,1795,720,24.0,1583.2
4856096462,1,11,0,0,1,4,0,0,0,0,0,13635,6.8,17300,171,62,-1847,-741,23.3,1363.5,9,2,1,4,1,4,0,0,0,0,15482,6.8,18041,154,54,1847,741,20.8,1548.2
4856039291,0,120,1,0,4,4,3,0,0,0,0,14876,6.8,16560,190,30,815,-1050,22.0,1487.6,12,0,1,4,4,2,1,1,0,0,14061,7.0,17610,159,58,-815,1050,21.7,1406.1
4856013158,0,14,0,0,3,8,3,0,0,0,0,13731,6.8,16899,180,48,-3131,-1938,22.8,1373.1,8,1,1,8,3,5,1,1,0,0,16862,7.0,18837,170,60,3131,1938,23.0,1686.2
4855961978,0,238,1,1,3,2,5,1,1,0,0,14854,6.6,17150,181,48,90,-609,22.9,1485.4,11,0,0,2,3,2,0,0,0,0,14764,7.0,17759,212,52,-90,609,26.4,1476.4
4855369034,1,17,2,1,10,1,12,1,1,0,0,17718,7.0,17944,222,44,4842,2443,26.6,1771.8,14,5,0,1,10,1,1,0,1,0,12876,6.2,15501,153,40,-4842,-2443,19.3,1287.6
4855329919,1,136,0,0,7,10,10,0,0,0,0,16068,6.2,15297,159,40,-1521,-1146,19.9,1606.8,16,0,1,10,7,11,1,1,0,0,17589,6.6,16443,143,60,1521,1146,20.3,1758.9
4855294100,1,24,0,1,12,5,16,1,1,0,0,18331,7.0,18228,173,61,4448,2992,23.4,1833.1,13,0,0,5,12,5,0,0,0,0,13883,6.2,15236,158,32,-4448,-2992,19.0,1388.3
4855121403,0,13,2,1,9,4,9,0,0,0,0,17713,6.8,17404,173,47,3076,1097,22.0,1771.3,249,1,0,4,9,0,1,1,0,0,14637,6.4,16307,181,56,-3076,-1097,23.7,1463.7
4855063576,0,32,2,0,2,8,1,0,0,0,0,13569,6.6,16643,180,38,-2855,-1685,21.8,1356.9,29,1,1,8,2,6,0,0,0,0,16424,7.0,18328,185,53,2855,1685,23.8,1642.4
4804657324,1,14,0,0,2,2,0,0,0,0,0,13263,6.8,17608,179,48,-285,560,22.7,1326.3,123,1,1,2,2,1,1,1,0,0,13548,6.6,17048,155,60,285,-560,21.5,1354.8
4784124443,0,9,0,0,4,5,3,1,0,1,0,14907,7.0,17734,166,64,-1246,-848,23.0,1490.7,10,0,1,5,4,3,1,1,0,0,16153,7.2,18582,156,52,1246,848,20.8,1615.3
4784106976,1,19,0,0,5,5,2,0,0,0,0,16304,6.8,17825,174,42,2697,1590,21.6,1630.4,8,0,1,5,5,1,0,0,0,0,13607,6.4,16235,121,34,-2697,-1590,15.5,1360.7
4784076549,0,16,1,0,7,5,4,1,1,0,0,15363,6.6,16297,177,48,1520,277,22.5,1536.3,78,2,1,5,7,2,0,0,0,0,13843,6.4,16020,144,52,-1520,-277,19.6,1384.3
4771165641,0,5,0,1,2,1,1,1,1,0,0,12875,6.6,16949,139,43,-933,-1297,18.2,1287.5,63,0,0,1,2,0,0,0,0,0,13808,7.2,18246,157,56,933,1297,21.3,1380.8
4766199298,0,93,0,1,4,4,5,1,1,0,0,14847,7.0,18009,177,56,-972,371,23.3,1484.7,79,0,0,4,4,2,1,0,1,0,15819,6.6,17638,175,48,972,-371,22.3,1581.9
4766165779,1,11,0,0,4,8,3,0,0,0,0,15750,6.8,16385,140,48,-34,-699,18.8,1575.0,12,0,1,8,4,6,1,1,0,0,15784,6.8,17084,170,36,34,699,20.6,1578.4
4766141269,0,9,2,1,10,9,6,0,0,0,0,16712,6.4,16008,110,43,-575,-676,15.3,1671.2,166,1,0,9,10,3,1,1,0,0,17287,6.8,16684,176,62,575,676,23.8,1728.7
4766110097,1,11,1,1,4,3,4,1,1,0,0,14443,6.6,16536,179,44,-1234,-2190,22.3,1444.3,9,0,0,3,4,0,0,0,0,0,15677,7.0,18726,179,60,1234,2190,23.9,1567.7
4765911264,1,33,3,1,2,1,4,1,1,0,0,14234,6.6,16170,171,50,262,-1289,22.1,1423.4,14,7,0,1,2,1,0,0,0,0,13972,6.6,17459,171,52,-262,1289,22.3,1397.2
4765903501,0,5,0,0,5,9,1,0,0,0,0,14073,5.8,14712,116,52,-4553,-3358,16.8,1407.3,7,1,1,9,5,5,1,1,0,0,18626,6.8,18070,190,60,4553,3358,25.0,1862.6
4765898981,0,10,0,1,4,2,0,1,0,1,0,14659,6.6,17051,145,56,665,684,20.1,1465.9,235,1,0,2,4,1,0,0,0,0,13994,6.6,16367,151,46,-665,-684,19.7,1399.4
4765157743,0,10,0,0,4,2,1,0,0,0,0,15644,6.8,18017,233,28,2011,522,26.1,1564.4,11,0,1,2,4,0,0,0,0,0,13633,7.0,17495,165,68,-2011,-522,23.3,1363.3
4764590748,0,0,15,1,13,16,28,0,0,0,0,32954,9.8,33915,86,0,-1659,-2970,8.6,3295.4,20,0,0,16,13,45,0,0,0,0,34613,10.6,36885,109,0,1659,2970,10.9,3461.3
4764278671,0,9,1,0,11,5,8,1,1,0,0,17155,6.6,16620,136,56,219,-883,19.2,1715.5,164,0,1,5,11,2,0,0,0,0,16936,6.8,17503,152,58,-219,883,21.0,1693.6
4764258555,1,13,0,1,6,5,0,1,1,0,0,15519,7.2,17821,189,68,-1100,558,25.7,1551.9,9,0,0,5,6,3,0,0,0,0,16619,7.0,17263,171,52,1100,-558,22.3,1661.9
4764249149,1,14,0,1,7,3,6,1,1,0,0,16400,6.8,17603,179,55,1203,-895,23.4,1640.0,8,0,0,3,7,0,0,0,0,0,15197,7.0,18498,164,41,-1203,895,20.5,1519.7
4763371048,1,15,0,1,5,2,2,0,0,0,0,15909,7.0,18432,177,60,2566,1621,23.7,1590.9,216,0,0,2,5,1,0,0,0,0,13343,6.6,16811,144,52,-2566,-1621,19.6,1334.3
4763355246,1,12,0,0,6,5,1,1,1,0,0,14599,6.8,18148,167,48,-981,85,21.5,1459.9,11,0,1,5,6,4,0,0,0,0,15580,7.0,18063,177,67,981,-85,24.4,1558.0
4737939046,0,17,0,1,6,1,2,0,0,0,0,14905,7.0,18331,167,52,1137,1031,21.9,1490.5,20,1,0,1,6,1,0,0,0,0,13768,6.8,17300,190,48,-1137,-1031,23.8,1376.8
4737896940,1,18,1,0,9,5,6,0,0,0,0,17740,7.0,17781,198,46,631,746,24.4,1774.0,77,1,1,5,9,3,1,1,0,0,17109,6.8,17035,183,40,-631,-746,22.3,1710.9
4737856063,0,15,0,0,8,7,8,1,0,1,0,15939,6.6,16895,141,52,-1775,-1400,19.3,1593.9,10,1,1,7,8,3,1,1,0,0,17714,7.0,18295,219,59,1775,1400,27.8,1771.4
4736470614,1,13,0,1,6,4,4,0,0,0,0,15361,6.4,16054,139,40,933,-735,17.9,1536.1,13,1,0,4,6,0,0,0,0,0,14428,6.6,16789,149,56,-933,735,20.5,1442.8
4736447134,1,11,1,1,2,2,2,0,0,0,0,14987,6.8,18137,190,52,1830,-352,24.2,1498.7,17,0,0,2,2,0,0,0,0,0,13157,6.8,18489,147,60,-1830,352,20.7,1315.7
4735502710,0,10,0,0,3,7,4,0,0,0,0,12739,6.6,17225,136,40,-2258,-489,17.6,1273.9,21,0,1,6,2,3,0,0,0,0,14997,6.8,17714,170,52,2258,489,22.2,1499.7
4733909484,1,14,0,1,4,5,5,1,1,0,0,15227,6.6,17080,168,60,140,-1252,22.8,1522.7,27,1,0,5,4,4,0,0,0,0,15087,6.8,18332,177,48,-140,1252,22.5,1508.7
4733893905,0,13,0,1,2,6,3,0,0,0,0,12902,6.4,15096,149,23,-2042,-1930,17.2,1290.2,10,1,0,6,2,4,1,1,0,0,14944,6.6,17026,174,48,2042,1930,22.2,1494.4
4733848121,1,29,2,0,3,5,2,0,0,0,0,14001,6.4,16577,150,48,-954,-1298,19.8,1400.1,18,2,1,5,3,5,0,0,0,0,14955,6.8,17875,168,45,954,1298,21.3,1495.5
4728401042,1,35,1,1,5,4,8,0,0,0,0,15544,7.4,19206,160,60,981,1243,22.0,1554.4,86,0,0,4,5,3,0,0,0,0,14563,6.8,17963,179,52,-981,-1243,23.1,1456.3
4728386397,0,11,0,1,3,6,0,0,0,0,0,13212,6.4,16285,141,40,-2689,-613,18.1,1321.2,15,0,0,6,3,6,0,0,0,0,15901,6.8,16898,170,56,2689,613,22.6,1590.1
4725188574,0,13,1,0,2,3,2,1,1,0,0,13333,6.6,16840,133,46,-1311,23,17.9,1333.3,11,1,1,3,2,2,0,0,0,0,14644,6.6,16817,175,50,1311,-23,22.5,1464.4
4724115818,0,144,1,1,4,6,0,0,0,0,0,13109,6.2,15736,133,56,-1509,-218,18.9,1310.9,8,0,0,6,4,5,1,1,0,0,14618,6.4,15954,130,44,1509,218,17.4,1461.8
4723799788,0,14,0,1,1,3,0,0,0,0,0,13088,6.6,17000,151,56,-1684,-968,20.7,1308.8,18,1,0,3,1,2,0,0,0,0,14772,6.8,17968,187,56,1684,968,24.3,1477.2
4723767622,1,11,9,0,3,6,3,1,1,0,0,14772,6.8,17808,190,48,-1478,-129,23.8,1477.2,30,0,1,6,3,3,0,0,0,0,16250,6.8,17937,166,48,1478,129,21.4,1625.0
4723750151,0,15,1,1,6,6,3,0,0,0,0,16335,6.8,17747,185,52,-497,98,23.7,1633.5,10,2,0,6,6,6,0,0,0,0,16832,7.0,17649,168,52,497,-98,22.0,1683.2
4723734975,1,11,0,1,6,7,4,0,0,0,0,16230,6.8,17775,155,56,784,330,21.1,1623.0,10,0,0,7,6,3,0,0,0,0,15446,6.6,17445,167,44,-784,-330,21.1,1544.6
4723710856,1,13,1,1,3,0,0,0,0,0,0,14878,7.4,19389,209,60,2571,1847,26.9,1487.8,8,0,0,0,3,0,0,0,0,0,12307,7.0,17542,166,44,-2571,-1847,21.0,1230.7
4723660328,0,7,1,0,4,7,1,1,1,0,0,16404,6.8,18431,173,68,371,914,24.1,1640.4,12,0,1,7,4,3,0,0,0,0,16033,7.0,17517,176,36,-371,-914,21.2,1603.3
4854276456,0,0,0,0,13,12,37,0,0,0,0,35724,10.4,35609,105,0,3298,540,10.5,3572.4,0,0,1,12,13,31,0,0,0,0,32426,10.2,35069,108,0,-3298,-540,10.8,3242.6
4854258627,1,0,0,1,16,16,23,0,0,0,0,48845,12.0,55000,3,0,21595,22000,0.3,4884.5,0,0,0,10,10,4,0,0,0,0,27250,7.2,33000,2,0,-21595,-22000,0.2,2725.0
4854215312,1,15,0,1,4,1,3,0,0,0,0,16118,6.8,17992,209,52,3044,833,26.1,1611.8,11,0,0,1,4,0,1,0,1,0,13074,6.8,17159,168,56,-3044,-833,22.4,1307.4
4853009698,0,12,2,0,2,3,1,0,0,0,0,13806,6.6,17476,184,52,-1088,-569,23.6,1380.6,15,0,1,3,2,3,1,1,0,0,14894,7.0,18045,199,48,1088,569,24.7,1489.4
4852135942,0,11,0,0,15,16,42,0,0,0,0,34756,10.6,37325,85,0,1041,759,8.5,3475.6,5,1,1,16,15,44,0,0,0,0,33715,10.6,36566,81,0,-1041,-759,8.1,3371.5
4852110369,0,11,1,0,5,10,2,0,0,0,0,14557,6.6,16766,150,52,-3396,-1777,20.2,1455.7,12,0,1,10,5,4,0,0,0,0,17953,7.2,18543,212,52,3396,1777,26.4,1795.3
4851066882,0,0,0,1,19,20,57,0,0,0,0,35937,10.2,36172,104,0,-1308,-3301,10.4,3593.7,0,0,0,20,19,44,0,0,0,0,37245,10.8,39473,106,0,1308,3301,10.6,3724.5
4851036352,1,13,1,0,11,6,9,0,0,0,0,18493,6.8,17607,178,48,2341,1258,22.6,1849.3,36,2,1,6,11,8,0,0,0,0,16152,6.6,16349,194,60,-2341,-1258,25.4,1615.2
4847146345,1,7,1,0,0,2,0,0,0,0,0,13209,6.8,17219,179,52,-955,-1261,23.1,1320.9,14,0,1,2,0,3,0,0,0,0,14164,7.2,18480,174,60,955,1261,23.4,1416.4
4846790358,0,8,1,1,11,5,9,0,0,0,0,19833,7.6,19836,170,60,4438,2082,23.0,1983.3,12,0,0,5,11,3,0,0,0,0,15395,6.8,17754,150,52,-4438,-2082,20.2,1539.5
4846275415,1,11,2,1,6,4,6,0,0,0,0,16926,7.0,18390,194,64,173,-199,25.8,1692.6,13,2,0,4,6,3,1,0,1,0,16753,7.0,18589,202,60,-173,199,26.2,1675.3
4846127341,1,177,2,1,9,7,6,0,0,0,0,18435,7.2,18785,202,43,2528,3473,24.5,1843.5,14,1,0,7,9,9,0,0,0,0,15907,6.0,15312,173,52,-2528,-3473,22.5,1590.7
4846086130,1,19,1,1,6,1,8,1,1,0,0,16065,6.6,16810,209,44,4209,1415,25.3,1606.5,15,1,0,1,6,1,0,0,0,0,11856,6.2,15395,142,40,-4209,-1415,18.2,1185.6
4845674193,0,10,1,0,1,6,1,0,0,0,0,13700,6.4,15475,152,32,-2240,-1659,18.4,1370.0,11,0,1,6,1,5,1,1,0,0,15940,6.4,17134,172,58,2240,1659,23.0,1594.0
4845655354,0,10,0,0,0,3,0,0,0,0,0,12102,6.4,16339,157,48,-3099,-2139,20.5,1210.2,82,0,1,3,0,1,1,1,0,0,15201,7.0,18478,209,56,3099,2139,26.5,1520.1
4845644992,1,64,0,1,7,2,2,1,1,0,0,16227,6.8,17924,182,52,3356,2168,23.4,1622.7,5,0,0,2,7,1,0,0,0,0,12871,6.4,15756,128,35,-3356,-2168,16.3,1287.1
4845589916,0,11,1,0,0,3,0,1,1,0,0,12523,6.4,15598,150,60,-2044,-2170,21.0,1252.3,10,0,1,3,0,1,0,0,0,0,14567,7.0,17768,190,48,2044,2170,23.8,1456.7
4845565575,1,8,0,1,4,4,4,1,0,1,0,15803,7.0,18552,195,60,906,1068,25.5,1580.3,14,0,0,4,4,1,0,0,0,0,14897,6.6,17484,206,52,-906,-1068,25.8,1489.7
4845555153,0,0,0,0,24,24,69,0,0,0,1,36100,11.0,39615,97,0,-2184,-2184,9.7,3610.0,21,0,1,24,24,69,0,0,0,0,38284,11.6,41799,95,0,2184,2184,9.5,3828.4
4845549927,0,7,0,1,13,23,25,0,0,0,1,34124,10.6,36772,80,0,-2326,-2597,8.0,3412.4,0,0,0,23,13,62,0,0,0,0,36450,11.0,39369,110,0,2326,2597,11.0,3645.0
4824457963,1,69,14,1,4,0,1,1,0,1,0,15384,7.0,18595,177,56,2960,2418,23.3,1538.4,27,1,0,0,4,0,0,0,0,0,12424,6.6,16177,157,36,-2960,-2418,19.3,1242.4
4823779006,0,60,0,1,2,4,0,0,0,0,0,14311,6.6,16769,195,52,-318,-174,24.7,1431.1,14,1,0,4,2,4,0,0,0,0,14629,6.8,16943,164,44,318,174,20.8,1462.9
4823555044,1,70,1,0,2,2,1,0,0,0,0,13248,6.8,17102,156,44,-420,-980,20.0,1324.8,9,0,1,2,2,0,1,1,0,0,13668,6.8,18082,169,55,420,980,22.4,1366.8
4822709008,0,13,1,0,3,5,3,1,1,0,0,15224,6.8,16583,192,48,830,-99,24.0,1522.4,73,2,1,5,3,3,0,0,0,0,14394,6.4,16682,129,56,-830,99,18.5,1439.4
4822667823,1,68,1,1,3,1,1,0,0,0,0,15379,6.8,18224,167,56,1586,477,22.3,1537.9,9,0,0,1,3,0,0,0,0,0,13793,6.8,17747,194,52,-1586,-477,24.6,1379.3
4822575581,0,6,1,1,4,2,1,0,0,0,0,14949,6.8,17432,178,51,550,779,22.9,1494.9,68,1,0,2,4,1,1,1,0,0,14399,6.8,16653,173,48,-550,-779,22.1,1439.9
4666761361,0,9,0,1,4,5,1,0,0,0,0,13742,6.8,16970,158,32,-1974,-590,19.0,1374.2,102,2,0,5,4,6,1,1,0,0,15716,7.0,17560,150,56,1974,590,20.6,1571.6
4662398617,0,11,0,0,3,4,3,0,0,0,0,13295,6.2,15946,129,56,-2637,-1836,18.5,1329.5,12,0,1,4,3,8,0,0,0,0,15932,6.8,17782,192,52,2637,1836,24.4,1593.2
4661308712,0,11,1,1,4,3,2,1,1,0,0,14209,6.8,17633,166,44,-315,1476,21.0,1420.9,76,0,0,3,4,3,0,0,0,0,14524,6.4,16157,179,48,315,-1476,22.7,1452.4
4660135433,0,69,0,1,6,6,6,0,0,0,0,16663,6.4,17163,161,40,1634,1601,20.1,1666.3,11,1,0,6,6,5,0,0,0,0,15029,6.6,15562,173,36,-1634,-1601,20.9,1502.9
4659716710,1,9,2,1,5,7,4,0,0,0,0,14721,6.4,15570,153,48,-600,-1550,20.1,1472.1,73,0,0,7,5,4,0,0,0,0,15321,6.6,17120,151,48,600,1550,19.9,1532.1
4659551585,0,12,2,0,3,5,5,1,1,0,0,15066,6.2,15618,165,56,427,-580,22.1,1506.6,12,1,1,5,3,2,0,0,0,0,14639,6.4,16198,148,56,-427,580,20.4,1463.9
4659361823,1,18,1,1,9,5,3,0,0,0,0,16905,6.8,17665,172,62,1718,1565,23.4,1690.5,11,1,0,5,9,2,0,0,0,0,15187,6.6,16100,159,37,-1718,-1565,19.6,1518.7
4659243998,0,9,0,1,4,10,6,0,0,0,0,14673,6.6,16876,155,32,-4028,-2031,18.7,1467.3,71,0,0,10,4,6,1,1,0,0,18701,7.2,18907,198,56,4028,2031,25.4,1870.1
4659130651,1,8,1,0,4,5,4,0,0,0,0,15515,6.6,17444,195,39,-70,117,23.4,1551.5,20,1,1,5,4,2,1,1,0,0,15585,7.0,17327,159,44,70,-117,20.3,1558.5
4658666575,0,68,1,0,5,3,6,0,0,0,0,14686,6.6,16462,118,48,312,450,16.6,1468.6,17,1,1,3,5,1,1,1,0,0,14374,6.6,16012,186,48,-312,-450,23.4,1437.4
4658095423,0,11,1,1,5,5,3,0,0,0,0,14817,6.6,16357,178,56,-286,-987,23.4,1481.7,69,2,0,5,5,2,0,0,0,0,15103,6.8,17344,187,45,286,987,23.2,1510.3
4658086067,0,11,1,1,7,5,6,1,1,0,0,16096,6.8,17948,181,46,645,417,22.7,1609.6,15,1,0,5,7,4,0,0,0,0,15451,6.8,17531,160,66,-645,-417,22.6,1545.1
4656713209,0,315,1,0,6,3,6,1,0,1,1,16810,6.4,16569,143,44,2854,-695,18.7,1681.0,13,0,1,3,6,0,0,0,0,0,13956,7.0,17264,164,40,-2854,695,20.4,1395.6
4844585242,0,93,1,1,28,27,49,0,0,0,2,37696,11.4,41984,93,0,-3086,-1330,9.3,3769.6,13,0,0,27,28,71,0,0,0,0,40782,11.4,43314,110,0,3086,1330,11.0,4078.2
4844580009,1,80,0,1,29,34,80,0,0,0,0,38751,11.8,44105,95,0,-2127,-1532,9.5,3875.1,34,0,0,34,29,82,0,0,0,0,40878,12.0,45637,94,0,2127,1532,9.4,4087.8
4844571417,1,68,2,1,6,6,11,0,0,0,1,32811,10.0,33222,118,0,1342,-246,11.8,3281.1,22,0,0,6,6,13,0,0,0,0,31469,10.0,33468,76,0,-1342,246,7.6,3146.9
4844569894,1,0,0,0,22,22,53,0,0,0,0,34885,10.8,38814,92,0,-704,-1397,9.2,3488.5,1,0,1,22,22,34,0,0,0,0,35589,10.8,40211,94,0,704,1397,9.4,3558.9
4844554650,1,24,3,1,32,15,62,0,0,0,0,37531,11.4,42989,92,0,3474,4268,9.2,3753.1,12,0,0,15,32,20,0,0,0,0,34057,11.0,38721,76,0,-3474,-4268,7.6,3405.7
4844549655,0,1,0,1,28,33,70,0,0,0,0,38950,11.6,43309,101,0,47,-2616,10.1,3895.0,0,0,0,33,28,80,0,0,0,0,38903,12.0,45925,109,0,-47,2616,10.9,3890.3
4844550157,0,29,0,0,19,31,39,0,0,0,0,34735,10.8,39286,68,0,-6186,-4442,6.8,3473.5,0,0,1,31,19,72,0,0,0,0,40921,11.8,43728,109,0,6186,4442,10.9,4092.1
4844540634,1,0,0,0,33,30,75,0,0,0,2,41514,11.8,44413,103,0,1317,382,10.3,4151.4,0,0,1,30,33,64,0,0,0,0,40197,11.8,44031,105,0,-1317,-382,10.5,4019.7
4844534463,0,68,0,1,19,24,62,0,0,0,1,35529,10.8,37847,74,0,-1388,-3319,7.4,3552.9,2,0,0,24,19,61,0,0,0,0,36917,11.2,41166,103,0,1388,3319,10.3,3691.7
4844526529,1,0,0,1,23,17,47,0,0,0,1,37349,11.4,41095,105,0,4589,4807,10.5,3734.9,0,0,0,16,22,29,0,0,0,0,32760,10.4,36288,101,0,-4589,-4807,10.1,3276.0
4844526781,0,20,0,0,17,28,34,0,0,0,2,34439,10.4,37002,76,0,-5666,-6058,7.6,3443.9,0,0,1,28,17,77,0,0,0,0,40105,11.8,43060,100,0,5666,6058,10.0,4010.5
4844516850,1,0,0,1,31,25,64,0,0,0,1,39020,11.4,43694,98,0,2441,3847,9.8,3902.0,0,0,0,25,31,55,0,0,0,0,36579,11.0,39847,89,0,-2441,-3847,8.9,3657.9
4844500660,1,84,0,0,36,36,78,0,0,0,1,41829,12.2,48385,91,0,1301,855,9.1,4182.9,0,0,1,36,36,80,0,0,0,0,40528,12.0,47530,75,0,-1301,-855,7.5,4052.8
4843608331,0,8,1,0,5,4,3,0,0,0,0,15582,7.0,17151,191,40,-587,147,23.1,1558.2,11,0,1,4,5,3,0,0,0,0,16169,6.6,17004,179,40,587,-147,21.9,1616.9
4843589358,1,11,10,0,5,4,2,0,0,0,0,14783,6.6,16726,153,36,319,-931,18.9,1478.3,26,1,1,4,5,1,0,0,0,0,14464,6.8,17657,147,40,-319,931,18.7,1446.4
4839435536,1,14,0,1,3,4,2,0,0,0,0,14726,6.6,17386,197,60,-53,30,25.7,1472.6,14,2,0,4,3,5,1,1,0,0,14779,6.6,17356,162,40,53,-30,20.2,1477.9
4839396779,1,16,1,0,9,8,6,0,0,0,0,16476,6.8,17111,166,48,-708,-1272,21.4,1647.6,17,2,1,8,9,3,0,0,0,0,17184,6.8,18383,182,64,708,1272,24.6,1718.4
4839360013,0,10,3,1,4,6,5,0,0,0,0,15523,7.0,17902,237,44,-713,-111,28.1,1552.3,17,0,0,6,4,14,0,0,0,0,16236,7.0,18013,226,56,713,111,28.2,1623.6
4837313493,0,10,1,0,5,10,4,0,0,0,0,16960,6.8,17468,214,40,-1110,-630,25.4,1696.0,11,0,1,10,5,9,0,0,0,0,18070,6.8,18098,189,60,1110,630,24.9,1807.0
4836288031,1,6,1,1,10,2,9,0,0,0,0,17638,7.0,18258,194,56,4061,1461,25.0,1763.8,10,0,0,2,10,0,1,1,0,0,13577,6.8,16797,179,58,-4061,-1461,23.7,1357.7
4755570655,0,14,0,0,2,2,3,1,1,0,0,14146,6.8,17152,188,56,-1253,-1082,24.4,1414.6,10,1,1,2,2,1,0,0,0,0,15399,6.8,18234,258,44,1253,1082,30.2,1539.9
4754623318,0,9,2,1,4,2,0,0,0,0,0,15491,7.0,19028,189,60,1139,1490,24.9,1549.1,103,2,0,2,4,1,0,0,0,0,14352,7.0,17538,191,56,-1139,-1490,24.7,1435.2
4754571548,1,5,1,1,2,3,0,0,0,0,0,13700,7.0,18443,160,60,-1650,-468,22.0,1370.0,11,0,0,2,1,2,0,0,0,0,15350,7.0,18911,202,60,1650,468,26.2,1535.0
4752143957,1,70,0,1,7,2,9,0,0,0,0,17551,6.6,17090,137,40,4180,1282,17.7,1755.1,4,0,0,2,7,2,0,0,0,0,13371,6.4,15808,155,41,-4180,-1282,19.6,1337.1
4752111182,1,0,0,1,16,15,17,0,0,0,0,48400,10.0,47500,0,0,16435,19000,0.0,4840.0,0,0,0,10,11,5,0,0,0,0,31965,6.0,28500,0,0,-16435,-19000,0.0,3196.5
4750259895,0,48,0,0,3,6,2,0,0,0,0,15061,6.8,17330,188,61,310,1887,24.9,1506.1,187,1,1,6,3,8,1,1,0,0,14751,6.4,15443,107,50,-310,-1887,15.7,1475.1
4745537410,1,12,1,1,4,4,4,0,0,0,0,15794,7.0,17760,166,76,-441,-947,24.2,1579.4,11,0,0,4,4,1,1,1,0,0,16235,6.8,18707,181,60,441,947,24.1,1623.5
4745505565,1,12,0,1,10,1,11,0,0,0,0,17938,7.0,19027,190,60,3607,3208,25.0,1793.8,11,1,0,1,10,1,0,0,0,0,14331,6.4,15819,151,56,-3607,-3208,20.7,1433.1
4742861744,1,6,0,1,9,6,3,0,0,0,0,16987,6.8,17653,164,51,3880,3316,21.5,1698.7,5,0,0,5,8,4,0,0,0,0,13107,6.2,14337,116,36,-3880,-3316,15.2,1310.7
4742830252,0,6,0,0,3,11,0,1,1,0,0,13471,6.0,14595,122,52,-4587,-3107,17.4,1347.1,14,0,1,11,3,14,0,0,0,0,18058,6.8,17702,145,44,4587,3107,18.9,1805.8
4742799042,1,6,0,1,4,4,2,0,0,0,0,15652,6.6,16418,196,0,3092,1157,19.6,1565.2,208,0,0,4,4,4,0,0,0,0,12560,6.4,15261,129,4,-3092,-1157,13.3,1256.0
4740915490,0,1,0,0,19,32,27,0,0,0,1,34776,11.0,40085,71,0,-4719,-4620,7.1,3477.6,0,0,1,32,19,86,0,0,0,0,39495,11.8,44705,107,0,4719,4620,10.7,3949.5
4740869383,1,26,0,1,7,4,3,0,0,0,0,14621,6.6,17422,136,68,-1003,288,20.4,1462.1,3,13,0,3,6,2,0,0,0,0,15624,6.6,17134,158,56,1003,-288,21.4,1562.4
4740847126,1,14,0,1,7,4,6,0,0,0,0,17948,7.2,17879,157,48,3767,838,20.5,1794.8,9,0,0,4,7,4,0,0,0,0,14181,6.8,17041,129,60,-3767,-838,18.9,1418.1
4734908484,0,7,0,1,5,1,1,0,0,0,0,14012,7.0,18487,141,48,288,1104,18.9,1401.2,7,0,0,1,5,1,0,0,0,0,13724,7.0,17383,175,56,-288,-1104,23.1,1372.4
4734885905,1,7,0,1,8,4,2,0,0,0,0,17235,6.4,16308,141,56,4058,3522,19.7,1723.5,153,0,0,4,8,2,0,0,0,0,13177,5.6,12786,89,43,-4058,-3522,13.2,1317.7
4734857857,0,6,0,1,7,11,3,0,0,0,0,14269,5.8,13678,121,0,-4179,-3449,12.1,1426.9,4,0,0,11,7,9,0,0,0,0,18448,7.0,17127,139,56,4179,3449,19.5,1844.8
4734824455,1,6,0,0,8,4,5,1,1,0,0,18367,6.8,18352,183,66,5523,5007,24.9,1836.7,3,0,1,3,7,4,0,0,0,0,12844,6.0,13345,102,0,-5523,-5007,10.2,1284.4
4589763299,1,13,0,1,6,6,6,0,0,0,0,16825,6.6,16335,208,36,1514,41,24.4,1682.5,9,0,0,6,6,5,0,0,0,0,15311,6.6,16294,152,44,-1514,-41,19.6,1531.1
4545307494,1,11,1,0,5,10,6,0,0,0,0,17004,7.0,18284,193,40,-2048,-479,23.3,1700.4,170,2,1,10,5,4,0,0,0,0,19052,7.2,18763,177,47,2048,479,22.4,1905.2
4782932445,1,9,3,1,6,1,4,1,0,1,0,16122,6.8,17414,164,40,2368,2951,20.4,1612.2,13,1,0,1,6,1,0,0,0,0,13754,6.2,14463,132,48,-2368,-2951,18.0,1375.4
4782929168,1,32,1,0,0,0,0,0,0,0,0,15821,6.8,18003,215,37,4001,768,25.2,1582.1,7,16,0,0,0,0,0,0,0,0,11820,6.8,17235,125,53,-4001,-768,17.8,1182.0
4782904574,1,15,3,0,7,10,6,0,0,0,0,16562,6.6,16666,171,64,-1735,-1421,23.5,1656.2,13,2,1,10,7,12,0,0,0,0,18297,7.0,18087,179,68,1735,1421,24.7,1829.7
4782898057,0,11,0,0,0,7,0,0,0,0,0,11535,6.6,16177,145,44,-6260,-3236,18.9,1153.5,16,0,1,7,0,9,1,1,0,0,17795,7.2,19413,224,60,6260,3236,28.4,1779.5
4782877988,0,13,0,0,3,5,4,1,1,0,0,14174,6.8,17113,182,36,-1424,-2260,21.8,1417.4,11,0,1,5,3,3,1,0,1,0,15598,7.0,19373,213,56,1424,2260,26.9,1559.8
4762239511,0,9,1,1,7,3,4,1,1,0,0,15730,6.8,16983,159,54,1900,195,21.3,1573.0,14,1,0,3,7,2,0,0,0,0,13830,6.4,16788,175,38,-1900,-195,21.3,1383.0
4762214003,0,7,0,1,5,11,0,1,1,0,0,13962,6.8,16663,133,80,-5011,-1484,21.3,1396.2,9,0,0,11,5,9,0,0,0,0,18973,7.2,18147,192,44,5011,1484,23.6,1897.3
4762135451,1,28,2,0,10,6,8,0,0,0,0,18583,7.2,18525,208,52,2541,2497,26.0,1858.3,9,3,1,6,10,4,0,0,0,0,16042,6.6,16028,171,48,-2541,-2497,21.9,1604.2
4762084351,1,10,1,0,3,6,2,0,0,0,0,14413,7.0,17468,179,48,-468,493,22.7,1441.3,9,0,1,6,3,3,0,0,0,0,14881,6.6,16975,198,36,468,-493,23.4,1488.1
4762057116,1,83,1,1,6,2,1,1,1,0,0,17070,6.8,18371,230,56,3083,3217,28.6,1707.0,117,0,0,2,6,4,0,0,0,0,13987,6.2,15154,138,50,-3083,-3217,18.8,1398.7
4762009365,0,9,1,1,3,5,2,0,0,0,0,14440,6.6,16593,140,52,-1586,-1416,19.2,1444.0,12,0,0,5,3,0,0,0,0,0,16026,6.8,18009,176,64,1586,1416,24.0,1602.6
4761964516,0,10,1,0,3,4,0,0,0,0,0,14146,6.6,17256,175,52,-1041,-849,22.7,1414.6,73,2,1,4,3,1,0,0,0,0,15187,7.0,18105,192,56,1041,849,24.8,1518.7
4761948726,0,4,0,0,1,5,2,1,1,0,0,14414,6.4,16471,161,47,-1300,-1467,20.8,1441.4,451,0,1,5,1,3,0,0,0,0,15714,6.8,17938,193,48,1300,1467,24.1,1571.4
4745814717,1,12,0,0,5,6,5,0,0,0,0,15447,6.8,17376,164,52,-458,968,21.6,1544.7,8,1,1,6,5,7,1,1,0,0,15905,6.6,16408,190,44,458,-968,23.4,1590.5
4745795240,1,10,2,1,9,5,9,0,0,0,0,18010,6.4,16035,154,40,2850,1574,19.4,1801.0,14,2,0,5,9,4,0,0,0,0,15160,6.2,14461,170,36,-2850,-1574,20.6,1516.0
4745774054,0,83,0,0,1,6,0,0,0,0,0,13336,6.4,15967,155,48,-3716,-2779,20.3,1333.6,5,1,1,6,1,4,1,1,0,0,17052,7.0,18746,198,48,3716,2779,24.6,1705.2
4745377635,1,10,0,0,2,3,2,1,1,0,0,13080,5.8,14484,149,48,-3294,-3318,19.7,1308.0,18,0,1,3,2,3,0,0,0,0,16374,7.0,17802,184,44,3294,3318,22.8,1637.4
4557911984,0,10,0,1,5,6,7,1,0,1,0,16739,7.0,18187,200,44,1299,1735,24.4,1673.9,10,3,0,6,5,3,1,1,0,0,15440,6.4,16452,192,44,-1299,-1735,23.6,1544.0
4557893945,0,28,1,0,4,4,2,0,0,0,0,13254,6.6,16446,123,47,-1681,-666,17.0,1325.4,9,17,1,4,4,2,0,0,0,0,14935,6.6,17112,165,36,1681,666,20.1,1493.5
4549841071,1,28,2,0,8,6,8,1,1,0,0,15974,6.6,17027,148,60,697,-297,20.8,1597.4,113,1,1,5,7,3,0,0,0,0,15277,6.6,17324,144,44,-697,297,18.8,1527.7
4762367160,1,10,0,1,3,5,3,0,0,0,0,15111,6.6,16999,186,48,1228,88,23.4,1511.1,12,0,0,5,3,2,1,1,0,0,13883,6.8,16911,156,48,-1228,-88,20.4,1388.3
4762350349,0,5,1,1,1,4,2,0,0,0,0,13491,6.6,16845,161,40,-2488,-1617,20.1,1349.1,11,0,0,4,1,4,0,0,0,0,15979,7.0,18462,189,52,2488,1617,24.1,1597.9
4762329032,0,10,0,1,3,7,1,0,0,0,0,14486,7.0,17765,215,48,-2778,-431,26.3,1448.6,12,1,0,6,2,8,1,1,0,0,17264,7.2,18196,187,60,2778,431,24.7,1726.4
4761505358,1,12,1,0,5,2,6,0,0,0,0,15245,7.0,17860,178,44,1050,669,22.2,1524.5,44,1,1,2,5,1,0,0,0,0,14195,6.8,17191,177,56,-1050,-669,23.3,1419.5
4734915225,0,36,0,0,2,6,0,0,0,0,0,12586,6.4,16418,149,48,-4115,-2029,19.7,1258.6,12,20,1,5,1,4,1,1,0,0,16701,7.2,18447,187,65,4115,2029,25.2,1670.1
4734880366,1,13,1,1,2,1,1,0,0,0,0,15794,7.2,19570,240,72,2424,2621,31.2,1579.4,9,1,0,1,2,2,0,0,0,0,13370,6.6,16949,176,48,-2424,-2621,22.4,1337.0
4733818554,1,13,2,1,5,3,3,1,1,0,0,17394,7.2,18890,212,64,3734,2985,27.6,1739.4,40,0,0,3,5,1,0,0,0,0,13660,6.4,15905,145,52,-3734,-2985,19.7,1366.0
4719564201,1,12,0,0,2,5,2,0,0,0,0,13083,6.4,16534,177,39,-2828,-444,21.6,1308.3,14,1,1,5,2,3,0,0,0,0,15911,6.8,16978,191,44,2828,444,23.5,1591.1
4717928185,1,16,0,1,7,0,5,0,0,0,0,16677,6.8,18366,201,50,4491,2772,25.1,1667.7,10,1,0,0,7,0,0,0,0,0,12186,6.4,15594,149,40,-4491,-2772,18.9,1218.6
4717185308,0,10,0,0,2,6,2,0,0,0,0,13589,6.8,16915,182,48,-2528,-1746,23.0,1358.9,10,0,1,6,2,6,1,1,0,0,16117,7.0,18661,177,56,2528,1746,23.3,1611.7
4717157944,1,140,0,1,5,3,3,1,1,0,0,14756,7.4,18484,154,56,-396,-379,21.0,1475.6,11,2,0,3,5,1,1,0,1,0,15152,7.0,18863,179,60,396,379,23.9,1515.2
4717109699,0,22,1,1,5,7,6,1,1,0,0,15953,6.8,17902,211,52,-179,1265,26.3,1595.3,16,0,0,7,5,8,0,0,0,0,16132,7.0,16637,166,64,179,-1265,23.0,1613.2
4717089912,1,11,0,1,5,4,4,0,0,0,0,15672,7.0,18245,198,60,1329,43,25.8,1567.2,176,3,0,4,5,3,0,0,0,0,14343,7.0,18202,152,44,-1329,-43,19.6,1434.3
4716181648,0,20,1,1,3,6,1,1,1,0,0,15508,6.8,17538,190,57,282,-1658,24.7,1550.8,12,1,0,6,3,1,0,0,0,0,15226,7.2,19196,160,60,-282,1658,22.0,1522.6
4715002698,0,2,0,0,6,8,3,0,0,0,0,14130,6.6,16490,149,40,-3369,-1548,18.9,1413.0,232,0,1,8,6,6,1,1,0,0,17499,7.0,18038,166,51,3369,1548,21.7,1749.9
4713245961,0,11,0,1,2,2,1,0,0,0,0,15897,6.8,17955,158,60,789,1051,21.8,1589.7,9,0,0,2,2,2,0,0,0,0,15108,6.6,16904,162,48,-789,-1051,21.0,1510.8
4713213347,0,13,0,1,7,7,5,0,0,0,0,15751,6.6,16404,155,42,-1071,-1706,19.7,1575.1,8,0,0,7,7,9,0,0,0,0,16822,7.0,18110,158,54,1071,1706,21.2,1682.2
4713188342,0,9,1,0,2,5,2,0,0,0,0,13669,6.4,15818,169,44,-2165,-792,21.3,1366.9,47,1,1,5,2,3,0,0,0,0,15834,6.6,16610,159,54,2165,792,21.3,1583.4
4713160208,0,11,0,0,5,5,3,0,0,0,0,14498,6.6,16851,159,40,-273,866,19.9,1449.8,10,1,1,5,5,2,0,0,0,0,14771,6.6,15985,154,48,273,-866,20.2,1477.1
4712205081,1,10,3,1,4,2,4,0,0,0,0,15240,6.8,17469,175,44,1585,724,21.9,1524.0,48,3,0,2,4,3,0,0,0,0,13655,7.0,16745,160,68,-1585,-724,22.8,1365.5
4836919252,0,0,2,0,17,25,53,0,0,0,1,34777,10.8,37579,108,0,-4053,-3924,10.8,3477.7,6,0,1,25,17,91,0,0,0,0,38830,11.2,41503,104,0,4053,3924,10.4,3883.0
4836611145,0,88,0,0,29,27,81,0,0,0,1,38203,11.2,40893,111,0,626,-167,11.1,3820.3,0,0,1,27,29,64,0,0,0,0,37577,11.2,41060,106,0,-626,167,10.6,3757.7
4836594816,1,0,0,1,30,22,74,0,0,0,1,40279,11.2,42272,109,0,3426,2333,10.9,4027.9,0,0,0,22,30,50,0,0,0,0,36853,10.8,39939,85,0,-3426,-2333,8.5,3685.3
4836305631,0,0,0,1,25,27,42,0,0,0,1,36054,11.2,40055,104,0,-4069,-4114,10.4,3605.4,0,0,0,27,25,61,0,0,0,0,40123,11.8,44169,116,0,4069,4114,11.6,4012.3
4836304094,1,1,0,0,18,24,37,0,0,0,2,34399,10.2,35436,95,0,-4134,-6354,9.5,3439.9,24,0,1,24,18,57,0,0,0,0,38533,11.2,41790,109,0,4134,6354,10.9,3853.3
4836293275,1,0,0,1,20,20,50,0,0,0,1,37822,10.8,39508,101,0,2150,1459,10.1,3782.2,0,0,0,20,20,35,0,0,0,0,35672,11.0,38049,95,0,-2150,-1459,9.5,3567.2
4836280489,0,6,0,1,22,19,51,0,0,0,1,36521,11.0,40265,92,0,-493,-266,9.2,3652.1,0,0,0,19,22,42,0,0,0,0,37014,11.2,40531,99,0,493,266,9.9,3701.4
4836269486,0,0,0,0,8,18,17,0,0,0,0,31759,9.8,32795,81,0,-3048,-4632,8.1,3175.9,0,0,1,18,8,51,0,0,0,0,34807,10.6,37427,82,0,3048,4632,8.2,3480.7
4834371854,1,22,0,1,21,19,62,0,0,0,1,38637,11.4,40828,111,0,3206,3050,11.1,3863.7,0,2,0,19,21,34,0,0,0,0,35431,10.6,37778,99,0,-3206,-3050,9.9,3543.1
4834357585,1,77,0,0,26,18,70,0,0,0,1,38108,11.2,41619,109,0,4076,4399,10.9,3810.8,0,0,1,18,26,45,0,0,0,0,34032,10.8,37220,70,0,-4076,-4399,7.0,3403.2
4834347102,1,13,0,0,16,23,29,0,0,0,0,35037,11.0,38747,100,0,135,556,10.0,3503.7,0,4,1,23,16,63,0,0,0,0,34902,10.6,38191,93,0,-135,-556,9.3,3490.2
4833411035,0,18,0,1,18,21,37,0,0,0,1,35934,11.0,39304,110,0,-1316,-80,11.0,3593.4,0,1,0,21,18,56,0,0,0,0,37250,11.0,39384,118,0,1316,80,11.8,3725.0
4833392988,0,0,0,0,21,31,46,0,0,0,0,36614,11.4,41779,98,0,-2020,-2620,9.8,3661.4,0,0,1,31,21,75,0,0,0,0,38634,11.8,44399,99,0,2020,2620,9.9,3863.4
4833378500,0,0,0,0,25,31,56,0,0,0,0,37378,11.6,43029,92,0,-2770,-1333,9.2,3737.8,0,0,1,31,25,77,0,0,0,0,40148,11.8,44362,98,0,2770,1333,9.8,4014.8
4832494317,1,13,0,1,28,27,67,0,0,0,2,38291,11.0,41115,114,0,874,-588,11.4,3829.1,0,0,0,27,28,54,0,0,0,0,37417,11.2,41703,85,0,-874,588,8.5,3741.7
4832489478,0,0,0,0,27,32,64,0,0,0,1,38498,11.6,44052,90,0,-2732,-1162,9.0,3849.8,3,0,1,32,27,80,0,0,0,0,41230,12.0,45214,103,0,2732,1162,10.3,4123.0
4832483602,0,0,20,0,11,22,24,0,0,0,0,33749,10.6,36135,98,0,-1471,-2601,9.8,3374.9,22,0,1,22,11,56,0,0,0,0,35220,10.8,38736,118,0,1471,2601,11.8,3522.0
4832482109,0,0,0,0,22,26,63,0,0,0,1,36598,11.2,40907,96,0,-43,-97,9.6,3659.8,0,0,1,26,22,55,0,0,0,0,36641,11.2,41004,88,0,43,97,8.8,3664.1
4832476802,1,22,0,0,33,35,83,0,0,0,1,41614,11.8,44700,97,0,930,-2377,9.7,4161.4,0,20,1,35,33,93,0,0,0,0,40684,12.0,47077,85,0,-930,2377,8.5,4068.4
4796291745,1,9,1,1,5,2,4,1,1,0,0,15995,6.8,17883,173,64,2828,1636,23.7,1599.5,13,1,0,2,5,1,0,0,0,0,13167,6.4,16247,115,49,-2828,-1636,16.4,1316.7
4796270897,0,6,0,0,0,11,0,0,0,0,0,11957,5.8,13960,146,36,-7308,-5355,18.2,1195.7,10,0,1,11,0,5,1,1,0,0,19265,7.0,19315,173,76,7308,5355,24.9,1926.5
4796206343,1,15,1,0,3,4,0,0,0,0,0,14563,6.8,17396,169,48,235,126,21.7,1456.3,29,1,1,4,3,2,2,1,1,0,14328,6.8,17270,161,41,-235,-126,20.2,1432.8
4796155228,0,130,1,0,9,5,6,0,0,0,0,15993,6.6,17116,171,38,983,476,20.9,1599.3,13,1,1,5,9,7,0,0,0,0,15010,6.6,16640,155,62,-983,-476,21.7,1501.0
4790719974,0,12,0,0,3,4,4,0,0,0,0,14475,6.8,17297,167,52,363,520,21.9,1447.5,10,0,1,4,3,1,0,0,0,0,14112,6.6,16777,169,48,-363,-520,21.7,1411.2
4790685595,1,20,1,0,5,12,4,1,1,0,0,14446,6.4,16275,157,40,-2602,-77,19.7,1444.6,248,1,1,12,5,9,0,0,0,0,17048,6.4,16352,169,34,2602,77,20.3,1704.8
4790654197,1,171,0,1,7,0,5,1,1,0,0,17299,7.0,18603,205,60,5202,2312,26.5,1729.9,14,0,0,0,7,0,0,0,0,0,12097,6.4,16291,146,52,-5202,-2312,19.8,1209.7
4790608930,1,74,1,1,6,4,4,0,0,0,0,17619,7.0,17368,162,51,4194,892,21.3,1761.9,13,2,0,4,6,0,1,1,0,0,13425,6.6,16476,146,56,-4194,-892,20.2,1342.5
4790551343,1,13,1,1,2,4,1,0,0,0,0,14118,6.6,16917,130,44,-392,-1606,17.4,1411.8,12,1,0,4,2,1,0,0,0,0,14510,7.0,18523,185,68,392,1606,25.3,1451.0
4784551522,0,15,0,0,3,7,0,0,0,0,0,14389,6.8,17025,162,56,-268,766,21.8,1438.9,13,1,1,7,3,7,0,0,0,0,14657,6.6,16259,128,56,268,-766,18.4,1465.7
4784515650,1,14,1,1,4,2,5,0,0,0,0,15485,6.8,17265,166,40,2211,1400,20.6,1548.5,20,0,0,2,4,0,0,0,0,0,13274,6.4,15865,136,30,-2211,-1400,16.6,1327.4
4784475162,0,34,1,1,2,1,1,0,0,0,0,13091,6.8,17544,148,52,94,-120,20.0,1309.1,13,25,0,1,2,0,0,0,0,0,12997,6.8,17664,168,56,-94,120,22.4,1299.7
4784421826,0,13,2,0,9,8,7,1,1,0,0,16840,6.8,17080,167,48,598,391,21.5,1684.0,14,0,1,8,9,7,0,0,0,0,16242,6.6,16689,168,43,-598,-391,21.1,1624.2
4780730834,1,12,1,1,4,6,0,0,0,0,0,14228,6.4,16592,154,64,-2033,-1671,21.8,1422.8,12,0,0,6,4,0,0,0,0,0,16261,6.8,18263,180,52,2033,1671,23.2,1626.1
4780659514,1,15,0,1,1,0,1,0,0,0,0,13625,7.0,18144,169,52,338,250,22.1,1362.5,12,0,0,0,1,0,1,1,0,0,13287,6.8,17894,199,48,-338,-250,24.7,1328.7
4780631997,0,10,0,1,6,6,5,0,0,0,0,14574,6.4,15370,144,40,-2840,-898,18.4,1457.4,250,0,0,6,6,7,0,0,0,0,17414,6.6,16268,154,40,2840,898,19.4,1741.4
4780592925,0,15,0,0,2,8,2,1,1,0,0,14272,7.0,17693,174,52,-3019,-765,22.6,1427.2,11,0,1,8,2,5,0,0,0,0,17291,7.2,18458,191,60,3019,765,25.1,1729.1
4780546195,0,21,4,0,2,8,0,0,0,0,0,13236,6.8,17098,155,48,-2905,-701,20.3,1323.6,18,1,1,8,2,6,1,1,0,0,16141,7.0,17799,195,44,2905,701,23.9,1614.1
4779054632,0,14,1,1,7,5,7,0,0,0,0,16390,6.6,16507,161,60,663,-1544,22.1,1639.0,14,1,0,5,7,2,0,0,0,0,15727,6.8,18051,179,40,-663,1544,21.9,1572.7
4833608321,1,9,0,0,4,6,4,0,0,0,0,16316,6.6,17000,193,40,1264,266,23.3,1631.6,84,0,1,6,4,7,0,0,0,0,15052,6.6,16734,130,52,-1264,-266,18.2,1505.2
4833587047,1,9,1,1,4,2,1,0,0,0,0,15038,6.8,17385,193,36,1573,1956,22.9,1503.8,11,2,0,2,4,2,0,0,0,0,13465,6.4,15429,157,56,-1573,-1956,21.3,1346.5
4833577000,0,13,0,1,9,23,21,0,0,0,2,32604,11.2,42138,63,59,-4288,-936,12.2,3260.4,9,0,0,23,9,37,0,0,0,0,36892,11.8,43074,86,67,4288,936,15.3,3689.2
4832867073,0,10,0,0,5,24,7,0,0,0,0,26284,9.8,31838,76,43,-10175,-9171,11.9,2628.4,25,0,1,24,5,45,0,0,0,0,36459,11.4,41009,55,71,10175,9171,12.6,3645.9
4832846457,0,9,0,0,7,22,13,0,0,0,1,30839,10.6,35966,82,36,-7221,-6923,11.8,3083.9,7,0,1,22,7,45,0,0,0,0,38060,11.6,42889,82,79,7221,6923,16.1,3806.0
4832839970,0,18,0,0,4,17,6,0,0,0,0,24245,9.6,30018,63,40,-5273,-6582,10.3,2424.5,12,0,1,17,4,28,0,0,0,0,29518,10.6,36600,57,51,5273,6582,10.8,2951.8
4828510551,1,26,20,1,15,6,32,0,0,0,1,33662,10.8,38103,84,51,-1258,1899,13.5,3366.2,34,2,0,6,15,8,0,0,0,0,34920,10.6,36204,100,53,1258,-1899,15.3,3492.0
4818570027,1,9,2,0,14,12,23,0,0,0,0,29651,10.4,34088,58,31,-3303,-1732,8.9,2965.1,18,0,1,12,14,12,0,0,0,0,32954,10.6,35820,61,52,3303,1732,11.3,3295.4
4813440112,0,18,0,1,2,4,2,0,0,0,0,14335,6.4,16476,182,58,-671,-1682,24.0,1433.5,17,0,0,4,2,2,0,0,0,0,15006,6.8,18158,180,48,671,1682,22.8,1500.6
4813379288,1,16,1,0,6,5,6,1,0,1,0,16460,6.8,17276,184,52,1013,-694,23.6,1646.0,15,2,1,5,6,5,0,0,0,0,15447,7.0,17970,165,56,-1013,694,22.1,1544.7
4812989572,1,10,1,0,9,10,12,0,0,0,1,34409,10.8,38414,94,63,6077,7031,15.7,3440.9,11,0,1,10,9,16,0,0,0,0,28332,9.8,31383,67,47,-6077,-7031,11.4,2833.2
4812975417,1,7,0,0,7,16,6,0,0,0,1,30029,10.0,32704,71,44,-5670,-6750,11.5,3002.9,7,0,1,16,7,27,0,0,0,0,35699,10.8,39454,68,58,5670,6750,12.6,3569.9
4812966239,0,15,1,0,5,37,12,0,0,0,2,27447,10.8,36713,55,47,-19339,-16215,10.2,2744.7,12,0,1,36,4,52,0,0,0,0,46786,12.8,52928,129,79,19339,16215,20.8,4678.6
4812954882,0,11,0,1,17,9,29,0,0,0,0,31539,10.6,37047,71,55,-586,131,12.6,3153.9,11,0,0,9,17,17,0,0,0,0,32125,10.6,36916,45,48,586,-131,9.3,3212.5
4812939744,1,37,0,0,9,10,10,0,0,0,0,26627,10.2,35490,83,47,-133,-1945,13.0,2662.7,21,14,1,10,9,9,0,0,0,0,26760,10.6,37435,76,46,133,1945,12.2,2676.0
4812904665,0,8,0,1,14,8,28,0,0,0,1,32164,11.0,37693,87,51,2505,2426,13.8,3216.4,109,0,0,8,14,23,0,0,0,0,29659,10.2,35267,78,51,-2505,-2426,12.9,2965.9
4812892485,1,7,1,1,27,10,53,0,0,0,2,39017,11.4,41253,90,55,5630,5050,14.5,3901.7,10,0,0,10,27,18,0,0,0,0,33387,10.4,36203,52,47,-5630,-5050,9.9,3338.7
4812020751,0,20,2,0,13,34,18,0,0,0,2,38136,11.0,37148,75,55,-1726,-9040,13.0,3813.6,34,0,1,34,13,78,0,0,0,0,39862,12.0,46188,80,61,1726,9040,14.1,3986.2
4811999113,0,20,0,1,11,28,12,0,0,0,1,37449,11.0,36887,73,50,-2096,-5810,12.3,3744.9,9,0,0,28,11,54,0,0,0,0,39545,11.6,42697,97,55,2096,5810,15.2,3954.5
4857518879,1,0,0,0,15,14,18,0,0,0,0,47000,10.0,47500,0,0,18800,19000,0.0,4700.0,0,0,1,10,11,4,0,0,0,0,28200,6.0,28500,0,0,-18800,-19000,0.0,2820.0
4857495523,1,0,0,1,19,16,21,0,0,0,0,63050,12.0,55000,0,0,26200,22000,0.0,6305.0,0,0,0,10,13,7,0,0,0,0,36850,7.2,33000,0,0,-26200,-22000,0.0,3685.0
4857471657,1,3,0,0,15,19,12,0,0,0,0,62000,12.0,55000,0,0,23400,22000,0.0,6200.0,0,0,1,12,8,13,0,0,0,0,38600,7.2,33000,0,0,-23400,-22000,0.0,3860.0
4857452931,1,0,0,1,22,11,19,0,0,0,0,47700,10.0,47500,0,0,21600,19000,0.0,4770.0,0,0,0,4,15,6,0,0,0,0,26100,6.0,28500,0,0,-21600,-19000,0.0,2610.0
4856613839,1,0,0,1,19,14,25,0,0,0,0,47205,12.0,55000,3,0,16875,22000,0.3,4720.5,0,0,0,9,14,7,0,0,0,0,30330,7.2,33000,0,0,-16875,-22000,0.0,3033.0
4856598452,1,0,0,1,20,23,22,0,0,0,0,65207,12.0,55000,0,0,26954,22000,0.0,6520.7,98,0,0,15,12,14,0,0,0,0,38253,7.2,33000,0,2,-26954,-22000,0.2,3825.3
4856591735,1,0,0,1,21,21,13,0,0,0,0,62000,12.6,59500,0,0,21631,22000,0.0,6200.0,17,0,0,11,11,16,0,0,0,0,40369,7.8,37500,0,0,-21631,-22000,0.0,4036.9
4856578197,1,0,0,1,21,19,15,0,0,0,0,62751,12.0,55000,0,0,24797,22000,0.0,6275.1,0,0,0,8,10,11,0,0,0,0,37954,7.2,33000,0,0,-24797,-22000,0.0,3795.4
4856563147,1,352,0,1,13,15,14,0,0,0,0,46650,10.0,47775,0,0,18800,19275,0.0,4665.0,0,0,0,10,8,10,0,0,0,0,27850,6.0,28500,0,0,-18800,-19275,0.0,2785.0
4855508309,1,3,0,0,28,25,56,0,0,0,1,39206,11.6,42997,100,0,2558,1115,10.0,3920.6,0,0,1,25,28,54,0,0,0,0,36648,11.2,41882,102,0,-2558,-1115,10.2,3664.8
4855494288,1,13,1,1,7,3,8,0,0,0,0,18694,7.2,18900,182,52,3598,177,23.4,1869.4,15,0,0,3,7,1,0,0,0,0,15096,7.0,18723,215,60,-3598,-177,27.5,1509.6
4855484900,1,0,0,1,21,17,18,0,0,0,0,62375,12.0,55000,1,0,19875,22000,0.1,6237.5,0,0,0,9,13,11,0,0,0,0,42500,7.2,33000,3,0,-19875,-22000,0.3,4250.0
4855470864,1,3,0,0,16,27,17,0,0,0,0,46650,10.0,47500,0,0,16700,19000,0.0,4665.0,2,0,1,16,5,15,0,0,0,0,29950,6.0,28500,0,0,-16700,-19000,0.0,2995.0
4855444476,1,0,0,1,16,15,18,0,0,0,0,48125,10.0,47500,0,0,19565,19000,0.0,4812.5,0,0,0,13,14,7,0,0,0,0,28560,6.0,28500,0,0,-19565,-19000,0.0,2856.0
4855428516,1,0,0,0,20,24,24,0,0,0,0,65852,13.0,62500,0,0,26902,25000,0.0,6585.2,0,0,1,16,12,13,0,0,0,0,38950,7.8,37500,0,0,-26902,-25000,0.0,3895.0
4855412281,1,0,0,0,19,17,18,0,0,0,0,63825,12.0,55000,3,0,27675,22000,0.3,6382.5,49,0,1,8,10,10,0,0,0,0,36150,7.2,33000,0,0,-27675,-22000,0.0,3615.0
4855397810,1,1,0,1,13,16,16,0,0,0,0,46060,10.0,47500,0,0,16810,19000,0.0,4606.0,0,0,0,13,10,9,0,0,0,0,29250,6.0,28500,0,0,-16810,-19000,0.0,2925.0
4855367643,1,0,0,1,18,16,19,0,0,0,0,63750,12.0,55000,0,0,26200,22000,0.0,6375.0,0,0,0,9,11,6,0,0,0,0,37550,7.2,33000,0,0,-26200,-22000,0.0,3755.0
4855353783,1,0,0,1,18,20,22,0,0,0,0,62740,12.8,61000,0,0,25540,25000,0.0,6274.0,0,0,0,12,10,11,0,0,0,0,37200,7.6,36000,0,0,-25540,-25000,0.0,3720.0
4855328380,1,46,2,1,27,20,25,0,0,0,0,64865,12.6,59500,17,0,27275,22000,1.7,6486.5,8,8,0,9,16,14,0,0,0,0,37590,7.8,37500,0,0,-27275,-22000,0.0,3759.0
4855261878,1,14,1,0,32,32,57,0,0,0,1,39437,11.6,44267,88,0,65,221,8.8,3943.7,21,0,1,32,32,75,0,0,0,0,39372,11.4,44046,90,0,-65,-221,9.0,3937.2
4855225624,0,18,0,0,15,16,44,0,0,0,0,33268,10.6,36616,106,0,-2340,-430,10.6,3326.8,0,0,1,16,15,40,0,0,0,0,35608,10.8,37046,119,0,2340,430,11.9,3560.8
4854179141,1,0,0,1,28,26,59,0,0,0,1,36616,11.0,40668,78,0,-1251,-857,7.8,3661.6,15,0,0,26,28,42,0,0,0,0,37867,11.4,41525,112,0,1251,857,11.2,3786.7
4854150187,0,13,0,1,16,14,38,0,0,0,0,33258,10.4,36290,86,0,-1888,-2409,8.6,3325.8,11,5,0,14,16,26,0,0,0,0,35146,10.8,38699,114,0,1888,2409,11.4,3514.6
4853139110,1,26,0,0,30,28,76,0,0,0,1,39648,11.8,44521,112,0,1452,1293,11.2,3964.8,0,19,1,28,30,78,0,0,0,0,38196,11.4,43228,79,0,-1452,-1293,7.9,3819.6
4848027375,0,5,0,0,2,5,1,0,0,0,0,14057,6.6,16710,138,52,-784,-1167,19.0,1405.7,77,1,1,5,2,1,0,0,0,0,14841,6.8,17877,167,48,784,1167,21.5,1484.1
4846018934,1,8,1,0,3,3,2,1,1,0,0,15273,6.8,17735,198,56,2579,2337,25.4,1527.3,9,1,1,3,3,1,0,0,0,0,12694,6.2,15398,135,40,-2579,-2337,17.5,1269.4
4845248987,1,21,0,1,7,7,3,1,1,0,0,15596,6.6,16532,157,44,-428,-1291,20.1,1559.6,368,1,0,7,7,5,1,0,1,0,16024,7.0,17823,141,59,428,1291,20.0,1602.4
4844296261,0,150,1,0,1,3,0,1,1,0,0,12304,6.6,16274,119,52,-3787,-1048,17.1,1230.4,11,2,1,3,1,3,0,0,0,0,16091,6.8,17322,170,44,3787,1048,21.4,1609.1
4841287515,1,11,1,1,3,2,3,0,0,0,0,14857,6.8,17463,209,44,1232,-120,25.3,1485.7,9,0,0,2,3,1,0,0,0,0,13625,6.8,17583,181,56,-1232,120,23.7,1362.5
4841240084,0,70,0,1,2,5,0,0,0,0,0,13620,6.6,16344,164,52,-1167,-230,21.6,1362.0,16,1,0,5,2,5,1,1,0,0,14787,6.6,16574,177,48,1167,230,22.5,1478.7
4840397347,0,0,0,1,24,24,50,0,0,0,0,37782,11.2,41481,85,0,969,435,8.5,3778.2,0,0,0,24,24,63,0,0,0,0,36813,11.2,41046,94,0,-969,-435,9.4,3681.3
4833244998,1,0,0,1,14,15,27,0,0,0,0,34389,10.2,35162,101,0,430,-460,10.1,3438.9,0,0,0,15,14,18,0,0,0,0,33959,10.4,35622,92,0,-430,460,9.2,3395.9
4832319614,0,3,0,0,17,22,37,0,0,0,0,34715,10.6,37965,95,0,-1724,-4110,9.5,3471.5,0,0,1,22,17,61,0,0,0,0,36439,11.2,42075,112,0,1724,4110,11.2,3643.9
4832304944,0,39,0,0,23,22,43,0,0,0,0,35232,11.0,38986,80,0,-2746,-3869,8.0,3523.2,34,0,1,22,23,62,0,0,0,0,37978,11.6,42855,89,0,2746,3869,8.9,3797.8
4832276856,0,0,0,1,14,19,19,0,0,0,1,35361,10.6,36984,92,0,875,-382,9.2,3536.1,0,0,0,19,14,53,0,0,0,0,34486,10.6,37366,103,0,-875,382,10.3,3448.6
4832252002,0,0,0,1,13,20,39,0,0,0,0,33654,10.2,34885,99,0,-2770,-4824,9.9,3365.4,0,0,0,20,13,55,0,0,0,0,36424,11.2,39709,103,0,2770,4824,10.3,3642.4
4829761183,0,0,0,0,30,39,85,0,0,0,1,39586,11.6,43722,102,0,-2498,-3878,10.2,3958.6,0,0,1,39,30,95,0,0,0,0,42084,12.2,47600,89,0,2498,3878,8.9,4208.4
4829741296,1,0,0,0,35,34,88,0,0,0,1,41154,11.8,44465,108,0,76,1089,10.8,4115.4,0,0,1,34,35,98,0,0,0,0,41078,11.6,43376,89,0,-76,-1089,8.9,4107.8
4828818480,0,0,26,0,16,25,27,0,0,0,1,33884,10.8,37735,74,0,-4310,-5956,7.4,3388.4,24,0,1,25,16,51,0,0,0,0,38194,11.6,43691,108,0,4310,5956,10.8,3819.4
4857834636,0,0,0,0,24,38,55,0,0,0,1,38156,11.4,41606,95,0,-3074,-6588,9.5,3815.6,0,0,1,38,24,101,0,0,0,0,41230,12.2,48194,101,0,3074,6588,10.1,4123.0
4857823194,1,18,0,1,24,19,53,0,0,0,0,35693,10.8,38711,98,0,1424,890,9.8,3569.3,0,2,0,19,24,48,0,0,0,0,34269,10.8,37821,96,0,-1424,-890,9.6,3426.9
4857816014,0,25,0,1,23,27,62,0,0,0,0,36829,11.2,41200,101,0,-383,-971,10.1,3682.9,0,0,0,27,23,66,0,0,0,0,37212,11.2,42171,96,0,383,971,9.6,3721.2
4857346276,1,0,0,0,16,17,29,0,0,0,0,34140,10.8,39275,97,0,-986,1919,9.7,3414.0,0,0,1,17,16,37,0,0,0,0,35126,10.8,37356,89,0,986,-1919,8.9,3512.6
4857317984,0,0,0,1,19,12,42,0,0,0,1,37125,10.8,39164,125,0,3343,5171,12.5,3712.5,78,0,0,11,18,23,0,0,0,0,33782,9.8,33993,94,0,-3343,-5171,9.4,3378.2
4857272154,0,0,0,1,28,23,68,0,0,0,0,38452,11.6,43099,102,0,232,1225,10.2,3845.2,0,0,0,23,28,55,0,0,0,0,38220,11.2,41874,88,0,-232,-1225,8.8,3822.0
4857239948,1,0,0,1,24,18,58,0,0,0,1,36839,11.2,40600,91,0,-407,168,9.1,3683.9,0,0,0,17,23,34,0,0,0,0,37246,11.2,40432,101,0,407,-168,10.1,3724.6
4857207003,0,0,1,1,30,26,74,0,0,0,1,39662,11.8,44647,102,0,1576,521,10.2,3966.2,7,0,0,26,30,58,0,0,0,0,38086,11.8,44126,113,0,-1576,-521,11.3,3808.6
4857165163,1,0,5,1,22,27,42,0,0,0,0,36851,11.4,40678,104,0,-1703,-1978,10.4,3685.1,20,0,0,27,22,62,0,0,0,0,38554,11.4,42656,107,0,1703,1978,10.7,3855.4
4857136526,1,11,0,1,26,26,67,0,0,0,1,37467,11.0,42030,92,0,193,1366,9.2,3746.7,0,2,0,26,26,66,0,0,0,0,37274,11.2,40664,93,0,-193,-1366,9.3,3727.4
4857108542,0,8,0,0,23,23,55,0,0,0,0,36851,11.2,41777,99,0,-255,1559,9.9,3685.1,0,3,1,23,23,53,0,0,0,0,37106,11.2,40218,106,0,255,-1559,10.6,3710.6
4855210466,0,2,2,1,16,22,43,0,0,0,0,35001,11.0,37568,114,0,-1593,-1321,11.4,3500.1,21,2,0,22,16,54,0,0,0,0,36594,10.8,38889,110,0,1593,1321,11.0,3659.4
4855183967,1,1,2,1,21,16,55,0,0,0,0,35258,10.6,37075,97,0,1217,348,9.7,3525.8,14,0,0,16,21,39,0,0,0,0,34041,10.4,36727,80,0,-1217,-348,8.0,3404.1
4855111203,1,7,0,1,24,3,5,1,1,0,0,23609,7.6,21161,140,84,12603,10269,22.4,2360.9,0,0,0,2,23,0,0,0,0,0,11006,5.2,10892,72,0,-12603,-10269,7.2,1100.6
4855070206,1,34,0,1,17,7,51,0,0,0,0,35266,10.8,38811,104,0,5054,4875,10.4,3526.6,34,0,0,7,17,9,0,0,0,0,30212,10.0,33936,87,0,-5054,-4875,8.7,3021.2
4855027527,0,0,3,0,19,20,47,0,0,0,0,36753,10.8,39484,105,0,1948,2339,10.5,3675.3,17,0,1,20,19,60,0,0,0,0,34805,10.6,37145,104,0,-1948,-2339,10.4,3480.5
4854985635,0,0,0,1,18,31,50,0,0,0,0,37094,11.0,39812,84,0,-728,-202,8.4,3709.4,0,0,0,31,18,93,0,0,0,0,37822,11.0,40014,114,0,728,202,11.4,3782.2
4854037517,0,0,0,1,29,28,73,0,0,0,1,39430,11.6,43629,96,0,758,2256,9.6,3943.0,0,0,0,28,29,81,0,0,0,0,38672,11.2,41373,108,0,-758,-2256,10.8,3867.2
4854009498,0,10,0,0,28,25,71,0,0,0,1,37909,11.4,42696,96,0,324,2499,9.6,3790.9,85,0,1,25,28,76,0,0,0,0,37585,11.0,40197,111,0,-324,-2499,11.1,3758.5
4853974653,1,68,2,0,24,27,62,0,0,0,1,36398,11.2,40528,79,0,-1773,-2300,7.9,3639.8,168,0,1,27,24,76,0,0,0,0,38171,11.8,42828,104,0,1773,2300,10.4,3817.1
4856248828,1,16,2,0,6,4,9,0,0,0,0,16165,7.2,18595,172,64,177,177,23.6,1616.5,9,3,1,4,6,3,0,0,0,0,15988,7.0,18418,223,52,-177,-177,27.5,1598.8
4856212250,1,7,1,1,7,4,4,0,0,0,0,18037,7.4,19818,226,71,3205,1888,29.7,1803.7,14,0,0,4,7,3,0,0,0,0,14832,7.0,17930,171,56,-3205,-1888,22.7,1483.2
4855832449,0,6,0,0,4,3,1,0,0,0,0,15224,6.8,18434,195,58,85,753,25.3,1522.4,10,0,1,3,4,1,1,1,0,0,15139,6.8,17681,203,55,-85,-753,25.8,1513.9
4855809036,1,12,2,1,6,2,3,0,0,0,0,17679,7.2,18429,220,62,2980,1180,28.2,1767.9,19,0,0,2,6,1,0,0,0,0,14699,6.8,17249,201,61,-2980,-1180,26.2,1469.9
4855121153,0,189,0,0,9,13,8,1,1,0,0,18215,6.8,17156,163,44,-1982,-1449,20.7,1821.5,12,0,1,13,9,9,0,0,0,0,20197,6.8,18605,175,52,1982,1449,22.7,2019.7
4853097228,1,0,0,1,30,19,74,0,0,0,0,38084,11.2,41848,107,0,2535,1003,10.7,3808.4,0,0,0,19,30,35,0,0,0,0,35549,11.2,40845,91,0,-2535,-1003,9.1,3554.9
4850971501,1,2,0,0,21,14,63,0,0,0,1,37461,11.0,40398,105,0,4389,4623,10.5,3746.1,0,0,1,14,21,38,0,0,0,0,33072,10.6,35775,65,0,-4389,-4623,6.5,3307.2
4850951615,1,2,0,1,45,26,109,0,0,0,1,44100,12.4,49520,109,0,6960,7860,10.9,4410.0,76,0,0,26,45,61,0,0,0,0,37140,11.2,41660,70,0,-6960,-7860,7.0,3714.0
4850922734,1,0,0,1,18,14,41,0,0,0,1,35945,10.8,37475,110,0,2484,2232,11.0,3594.5,0,0,0,14,18,32,0,0,0,0,33461,10.4,35243,103,0,-2484,-2232,10.3,3346.1
4845928506,1,13,1,0,5,6,5,0,0,0,0,16613,6.8,18073,182,48,701,352,23.0,1661.3,9,0,1,6,5,2,1,1,0,0,15912,6.8,17721,169,52,-701,-352,22.1,1591.2
4845763146,1,11,1,1,5,2,1,0,0,0,0,18051,7.6,20876,196,72,4134,5489,26.8,1805.1,10,0,0,2,5,2,1,1,0,0,13917,6.4,15387,152,60,-4134,-5489,21.2,1391.7
4842019330,1,0,0,0,12,22,25,0,0,0,0,34053,10.6,35534,118,0,-1580,-4353,11.8,3405.3,102,0,1,22,12,63,0,0,0,0,35633,11.0,39887,118,0,1580,4353,11.8,3563.3
4831987745,1,17,0,1,11,6,3,0,0,0,0,17762,7.0,18143,210,42,1487,2497,25.2,1776.2,6,2,0,6,11,6,0,0,0,0,16275,6.2,15646,177,49,-1487,-2497,22.6,1627.5
4831841588,0,0,0,0,32,31,77,0,0,0,0,40542,11.8,44556,94,0,-575,-2651,9.4,4054.2,0,0,1,31,32,77,0,0,0,0,41117,12.0,47207,73,0,575,2651,7.3,4111.7
4828931341,1,43,1,1,8,4,5,0,0,0,0,17081,6.8,17739,190,46,3376,2103,23.6,1708.1,12,13,0,4,8,2,0,0,0,0,13705,6.4,15636,142,38,-3376,-2103,18.0,1370.5
4828901431,1,10,1,1,4,2,1,0,0,0,0,16178,7.0,18337,216,52,3036,3163,26.8,1617.8,97,0,0,2,4,6,1,1,0,0,13142,6.4,15174,148,48,-3036,-3163,19.6,1314.2
4828882395,0,9,0,0,4,7,4,0,0,0,0,13112,6.2,14780,131,60,-3252,-2260,19.1,1311.2,76,0,1,7,4,2,0,0,0,0,16364,6.8,17040,174,36,3252,2260,21.0,1636.4
4828376444,0,15,15,0,3,14,1,0,0,0,0,13389,6.2,14814,148,47,-5727,-3938,19.5,1338.9,35,1,1,14,3,17,1,1,0,0,19116,7.2,18752,173,65,5727,3938,23.8,1911.6
4828357757,0,14,2,1,3,5,2,0,0,0,0,14696,6.8,17784,194,60,-928,-910,25.4,1469.6,91,5,0,5,3,2,0,0,0,0,15624,6.8,18694,235,56,928,910,29.1,1562.4
4828332488,0,15,0,1,22,24,56,0,0,0,1,39276,11.4,42009,99,0,581,-595,9.9,3927.6,5,1,0,24,22,49,0,0,0,0,38695,11.4,42604,107,0,-581,595,10.7,3869.5
4857231137,1,11,0,1,8,7,7,0,0,0,0,16876,6.8,17419,198,52,2613,2505,25.0,1687.6,9,0,0,7,8,5,0,0,0,0,14263,6.4,14914,103,44,-2613,-2505,14.7,1426.3
4857197803,1,12,0,1,13,6,4,1,1,0,0,18180,7.0,19119,180,60,3195,1902,24.0,1818.0,9,0,0,5,12,4,0,0,0,0,14985,6.8,17217,147,48,-3195,-1902,19.5,1498.5
4857162648,1,11,1,1,5,1,3,0,0,0,0,17127,7.2,19810,233,51,2695,1737,28.4,1712.7,15,0,0,1,5,1,1,0,1,0,14432,7.0,18073,212,60,-2695,-1737,27.2,1443.2
4856267932,0,14,0,0,8,7,6,0,0,0,1,16310,5.6,14040,135,49,-3266,-4628,18.4,1631.0,15,3,1,7,8,8,0,0,0,0,19576,7.2,18668,227,47,3266,4628,27.4,1957.6
4856223764,1,9,2,1,9,5,5,0,0,0,0,16997,7.2,18535,203,48,1141,1045,25.1,1699.7,9,1,0,5,9,5,0,0,0,0,15856,6.8,17490,149,56,-1141,-1045,20.5,1585.6
4856183401,0,73,3,0,6,3,11,0,0,0,0,15526,7.0,17948,164,32,-1120,-1269,19.6,1552.6,13,2,1,3,6,3,1,1,0,0,16646,7.2,19217,212,52,1120,1269,26.4,1664.6
4847977621,1,9,1,1,6,2,10,1,1,0,0,16707,7.0,19246,203,64,3046,1264,26.7,1670.7,29,0,0,2,6,1,0,0,0,0,13661,6.8,17982,184,56,-3046,-1264,24.0,1366.1
4847953089,0,12,0,0,5,5,4,0,0,0,0,14403,6.8,16718,134,52,-337,-940,18.6,1440.3,6,0,1,5,5,3,1,1,0,0,14740,6.8,17658,171,52,337,940,22.3,1474.0
4846015030,1,16,0,1,6,1,5,1,1,0,0,14498,6.6,15754,129,32,-171,-1529,16.1,1449.8,16,1,0,1,6,1,0,0,0,0,14669,6.6,17283,188,40,171,1529,22.8,1466.9
4845976256,0,14,1,1,5,3,4,0,0,0,0,14782,6.6,16481,132,40,1081,-1026,17.2,1478.2,11,1,0,3,5,1,0,0,0,0,13701,6.8,17507,162,40,-1081,1026,20.2,1370.1
4845942385,0,12,0,0,1,5,0,0,0,0,0,12308,6.8,16348,144,40,-2877,-1385,18.4,1230.8,14,2,1,5,1,2,0,0,0,0,15185,7.0,17733,186,44,2877,1385,23.0,1518.5
4845918505,0,16,3,0,3,11,2,0,0,0,0,14370,6.4,15629,162,48,-3829,-2054,21.0,1437.0,15,1,1,11,3,7,0,0,0,0,18199,7.2,17683,188,40,3829,2054,22.8,1819.9
4843369552,1,16,1,0,6,4,6,0,0,0,0,15622,7.2,18102,168,60,-50,540,22.8,1562.2,11,2,1,4,6,2,1,1,0,0,15672,6.6,17562,184,64,50,-540,24.8,1567.2
4843319704,0,15,2,0,2,4,3,1,1,0,0,14250,6.8,17707,190,48,-741,323,23.8,1425.0,16,0,1,4,2,2,0,0,0,0,14991,6.8,17384,174,56,741,-323,23.0,1499.1
4843274981,1,12,0,0,1,3,1,0,0,0,0,14406,7.0,18520,195,60,39,151,25.5,1440.6,13,0,1,3,1,1,0,0,0,0,14367,7.0,18369,207,56,-39,-151,26.3,1436.7
4843210344,1,16,0,0,1,4,0,0,0,0,0,13458,7.0,18076,156,56,371,490,21.2,1345.8,10,0,1,4,1,1,0,0,0,0,13087,7.0,17586,162,32,-371,-490,19.4,1308.7
4840225664,0,12,2,0,3,10,6,0,0,0,0,13946,6.6,16174,166,44,-4273,-2028,21.0,1394.6,10,0,1,10,3,16,0,0,0,0,18219,7.0,18202,202,51,4273,2028,25.3,1821.9
4840193369,1,12,0,1,6,2,7,1,1,0,0,17390,6.8,17261,208,44,4588,1970,25.2,1739.0,13,0,0,2,6,2,0,0,0,0,12802,6.4,15291,131,52,-4588,-1970,18.3,1280.2
4840162184,1,14,2,1,4,3,2,0,0,0,0,14528,6.8,17624,179,48,-342,-661,22.7,1452.8,12,0,0,2,3,1,0,0,0,0,14870,7.2,18285,226,52,342,661,27.8,1487.0
4819615707,0,15,1,0,7,5,5,0,0,0,0,17744,6.8,17002,206,44,1258,18,25.0,1774.4,14,2,1,5,7,2,1,1,0,0,16486,6.8,16984,177,56,-1258,-18,23.3,1648.6
4814949718,1,14,0,1,7,4,11,0,0,0,0,17792,7.0,18417,204,52,2015,1156,25.6,1779.2,10,2,0,4,7,3,0,0,0,0,15777,7.0,17261,166,36,-2015,-1156,20.2,1577.7
4814900318,1,15,0,1,3,3,4,0,0,0,0,15331,6.6,17027,188,56,1409,1029,24.4,1533.1,12,1,0,3,3,2,0,0,0,0,13922,6.4,15998,163,52,-1409,-1029,21.5,1392.2
4814883005,1,11,1,1,5,3,3,1,1,0,0,16218,7.0,18412,196,52,1963,599,24.8,1621.8,11,0,0,3,5,2,0,0,0,0,14255,6.8,17813,169,60,-1963,-599,22.9,1425.5
4814595296,1,14,0,0,3,3,3,0,0,0,0,14626,6.8,16588,174,36,-232,-816,21.0,1462.6,10,0,1,3,3,3,0,0,0,0,14858,6.6,17404,204,64,232,816,26.8,1485.8
4814582148,1,9,1,1,11,7,4,1,1,0,0,17911,7.0,18126,189,72,2292,2244,26.1,1791.1,8,0,0,7,11,5,1,0,1,0,15619,6.4,15882,166,40,-2292,-2244,20.6,1561.9
4814555035,0,10,0,1,5,7,3,0,0,0,0,15857,7.2,18058,194,59,-1120,-1283,25.3,1585.7,11,2,0,7,5,5,1,1,0,0,16977,7.2,19341,200,56,1120,1283,25.6,1697.7
4814459682,0,12,0,1,2,3,1,0,0,0,0,15204,7.0,18746,232,64,-23,531,29.6,1520.4,11,0,0,3,2,2,0,0,0,0,15227,7.0,18215,180,68,23,-531,24.8,1522.7
4814422163,1,13,1,1,5,3,5,1,1,0,0,15654,6.6,17014,193,59,1098,-264,25.2,1565.4,10,1,0,3,5,4,0,0,0,0,14556,6.8,17278,183,48,-1098,264,23.1,1455.6
4812429062,1,94,1,0,3,2,5,0,0,0,0,15852,6.8,17814,198,44,1787,767,24.2,1585.2,13,1,1,2,3,2,0,0,0,0,14065,6.6,17047,179,60,-1787,-767,23.9,1406.5
4812059230,1,11,1,1,13,4,17,0,0,0,0,19475,7.0,18062,212,44,3507,58,25.6,1947.5,171,1,0,4,13,2,1,1,0,0,15968,6.8,18004,177,56,-3507,-58,23.3,1596.8
4812018364,1,14,0,1,7,6,7,1,1,0,0,16856,6.8,17845,163,64,829,359,22.7,1685.6,13,0,0,6,7,5,0,0,0,0,16027,6.6,17486,179,62,-829,-359,24.1,1602.7
4807682727,0,14,0,0,9,4,9,1,1,0,0,17637,6.8,17222,196,56,1068,-198,25.2,1763.7,10,0,1,4,9,2,0,0,0,0,16569,6.8,17420,210,56,-1068,198,26.6,1656.9
4806592068,0,11,0,0,7,8,5,0,0,0,0,16585,7.0,18195,197,60,-410,-883,25.7,1658.5,9,0,1,8,7,3,2,1,1,0,16995,7.4,19078,226,56,410,883,28.2,1699.5
4806556570,0,13,2,0,5,8,4,1,0,1,0,15626,6.6,16923,183,52,-1943,-1324,23.5,1562.6,10,3,1,8,5,7,1,1,0,0,17569,6.8,18247,223,44,1943,1324,26.7,1756.9
4533388067,0,11,3,0,8,9,4,1,1,0,0,18390,7.0,18634,196,46,1651,3140,24.2,1839.0,11,0,1,9,8,12,0,0,0,0,16739,6.4,15494,145,64,-1651,-3140,20.9,1673.9
4224972910,0,14,1,1,3,5,3,0,0,0,0,13981,6.6,15879,176,56,-3432,-2787,23.2,1398.1,13,1,0,5,3,8,1,1,0,0,17413,7.0,18666,196,48,3432,2787,24.4,1741.3
4812159823,1,48,2,0,8,7,7,1,1,0,0,15876,6.8,16805,161,48,17,1020,20.9,1587.6,12,0,1,7,8,4,0,0,0,0,15859,6.6,15785,153,44,-17,-1020,19.7,1585.9
4812115700,0,15,2,0,3,10,6,0,0,0,0,14023,6.6,16413,160,64,-4014,-2287,22.4,1402.3,13,1,1,10,3,5,0,0,0,0,18037,7.2,18700,212,48,4014,2287,26.0,1803.7
4812089556,0,12,3,1,4,10,4,0,0,0,0,14585,6.4,15648,120,40,-3737,-2346,16.0,1458.5,14,2,0,10,4,8,0,0,0,0,18322,7.0,17994,182,56,3737,2346,23.8,1832.2
4812049589,0,17,1,0,4,3,3,0,0,0,0,15730,7.0,18618,192,59,956,1849,25.1,1573.0,14,1,1,3,4,1,0,0,0,0,14774,6.6,16769,201,40,-956,-1849,24.1,1477.4
4812009081,1,13,0,1,7,7,12,0,0,0,0,18046,6.8,18403,164,52,705,771,21.6,1804.6,12,0,0,7,7,8,1,1,0,0,17341,6.8,17632,198,56,-705,-771,25.4,1734.1
4806667518,0,10,0,0,1,8,1,0,0,0,0,13987,6.8,17127,196,48,-2971,-2137,24.4,1398.7,8,0,1,8,1,4,1,1,0,0,16958,7.2,19264,221,64,2971,2137,28.5,1695.8
4806653791,0,12,0,1,4,7,1,0,0,0,0,14028,6.6,16658,158,56,-1852,-1548,21.4,1402.8,16,2,0,7,4,3,1,1,0,0,15880,7.2,18206,201,56,1852,1548,25.7,1588.0
4806621414,1,13,1,0,12,5,9,1,1,0,0,18790,7.2,18265,167,58,3018,845,22.5,1879.0,17,2,1,5,12,0,0,0,0,0,15772,6.8,17420,193,40,-3018,-845,23.3,1577.2
4803878621,0,98,2,1,4,6,1,0,0,0,0,14673,7.0,18111,184,50,-1913,-124,23.4,1467.3,13,1,0,6,4,4,0,0,0,0,16586,6.8,18235,190,45,1913,124,23.5,1658.6
4803848180,1,6,2,0,8,8,4,0,0,0,0,16276,6.8,17750,186,56,40,-444,24.2,1627.6,13,0,1,7,7,2,0,0,0,0,16236,7.0,18194,178,64,-40,444,24.2,1623.6
4802985731,1,11,4,0,6,5,3,0,0,0,0,15730,7.2,18089,191,40,1125,582,23.1,1573.0,16,2,1,5,6,2,0,0,0,0,14605,6.8,17507,173,32,-1125,-582,20.5,1460.5
4802947730,1,13,0,0,3,7,1,0,0,0,0,14070,6.4,16715,173,48,-1797,-1578,22.1,1407.0,10,0,1,7,3,2,0,0,0,0,15867,7.0,18293,171,56,1797,1578,22.7,1586.7
4802921613,1,16,0,1,4,2,2,0,0,0,0,15636,7.2,18945,195,52,1521,1022,24.7,1563.6,12,0,0,2,4,1,0,0,0,0,14115,6.8,17923,175,44,-1521,-1022,21.9,1411.5
4802892553,0,14,0,0,3,11,1,0,0,0,0,14126,6.8,17414,179,48,-3161,-665,22.7,1412.6,7,0,1,11,3,7,0,0,0,0,17287,7.0,18079,184,56,3161,665,24.0,1728.7
4800607067,0,13,1,0,3,3,1,0,0,0,0,15069,7.2,18925,209,44,354,1200,25.3,1506.9,11,0,1,3,3,3,0,0,0,0,14715,7.0,17725,194,51,-354,-1200,24.5,1471.5
4800573764,1,15,1,1,4,3,1,0,0,0,0,14473,6.8,17896,187,56,1252,543,24.3,1447.3,15,0,0,3,4,0,0,0,0,0,13221,6.6,17353,172,44,-1252,-543,21.6,1322.1
4800547832,1,20,0,0,0,4,0,0,0,0,0,13669,6.8,16616,189,48,-1127,-1253,23.7,1366.9,11,0,1,4,0,4,1,1,0,0,14796,6.8,17869,159,64,1127,1253,22.3,1479.6
4799430846,0,10,0,0,2,4,0,0,0,0,0,13730,6.8,17028,152,40,-486,1655,19.2,1373.0,11,0,1,4,2,3,1,1,0,0,14216,6.2,15373,154,64,486,-1655,21.8,1421.6
4798984739,1,14,16,0,2,2,1,0,0,0,0,14541,7.0,18537,173,60,538,1319,23.3,1454.1,28,0,1,2,2,2,0,0,0,0,14003,6.6,17218,167,47,-538,-1319,21.4,1400.3
4798947415,0,13,0,1,2,2,3,1,0,1,0,13686,6.8,18527,154,56,-841,376,21.0,1368.6,16,2,0,2,2,0,0,0,0,0,14527,6.8,18151,206,56,841,-376,26.2,1452.7
4798909493,0,22,0,0,2,8,1,0,0,0,0,14222,6.8,17096,149,48,-2241,-709,19.7,1422.2,10,0,1,8,2,7,0,0,0,0,16463,7.0,17805,163,44,2241,709,20.7,1646.3
4798053718,1,9,2,0,4,5,5,0,0,0,0,14328,6.6,15609,155,32,-2419,-2651,18.7,1432.8,6,0,1,5,4,3,0,0,0,0,16747,7.0,18260,205,48,2419,2651,25.3,1674.7
4798024812,1,13,1,0,3,1,4,1,1,0,0,14330,6.8,17162,170,52,190,-344,22.2,1433.0,8,1,1,1,3,1,0,0,0,0,14140,6.8,17506,208,52,-190,344,26.0,1414.0
4797983499,1,11,1,1,3,1,0,0,0,0,0,13315,6.6,17012,150,44,296,-217,19.4,1331.5,14,1,0,1,3,0,0,0,0,0,13019,6.8,17229,146,40,-296,217,18.6,1301.9
4795349052,0,13,0,1,9,7,10,0,0,0,0,16445,6.6,15692,146,52,1710,187,19.8,1644.5,13,0,0,7,9,6,0,0,0,0,14735,6.2,15505,135,28,-1710,-187,16.3,1473.5
4858422266,1,35,0,1,17,15,13,0,0,0,0,46538,10.0,47500,1,0,24638,19000,0.1,4653.8,0,0,0,8,10,13,0,0,0,0,21900,6.0,28500,0,0,-24638,-19000,0.0,2190.0
4858401401,1,6,0,0,24,17,20,0,0,0,0,63050,12.0,55000,0,0,26200,22000,0.0,6305.0,0,0,1,7,14,9,0,0,0,0,36850,7.2,33000,0,0,-26200,-22000,0.0,3685.0
4858310286,1,3,4,1,13,18,12,0,0,0,0,44918,10.0,47500,1,0,16168,19000,0.1,4491.8,30,2,0,12,7,13,0,0,0,0,28750,6.0,28500,6,0,-16168,-19000,0.6,2875.0
4858294795,1,12,0,0,18,14,20,0,0,0,0,62000,12.8,59000,0,0,24800,26000,0.0,6200.0,0,0,1,6,10,8,0,0,0,0,37200,7.2,33000,0,0,-24800,-26000,0.0,3720.0
4857391655,1,60,2,1,22,16,26,0,0,0,0,49385,10.0,47500,5,0,22230,19000,0.5,4938.5,0,1,0,12,18,6,0,0,0,0,27155,6.0,28500,0,0,-22230,-19000,0.0,2715.5
4857374361,1,0,0,1,20,15,26,0,0,0,0,63750,12.2,56000,0,0,27600,23000,0.0,6375.0,4,0,0,10,15,4,0,0,0,0,36150,7.2,33000,0,0,-27600,-23000,0.0,3615.0
4857342708,1,176,0,1,16,14,17,0,0,0,0,47810,10.0,47500,0,0,20280,19000,0.0,4781.0,176,0,0,8,10,7,0,0,0,0,27530,6.0,28500,0,0,-20280,-19000,0.0,2753.0
4857305632,1,0,4,0,16,22,10,0,0,0,0,46370,10.0,47500,2,0,17455,17820,0.2,4637.0,31,1,1,12,6,13,0,0,0,0,28915,6.2,29680,0,0,-17455,-17820,0.0,2891.5
4857278951,1,0,0,1,14,14,12,0,0,0,0,45600,10.2,48680,0,0,18100,20180,0.0,4560.0,5,0,0,11,11,6,0,0,0,0,27500,6.0,28500,0,0,-18100,-20180,0.0,2750.0
4857258750,1,44,0,1,14,19,19,0,0,0,0,47445,12.0,55000,1,0,18155,22000,0.1,4744.5,7,0,0,13,8,8,0,0,0,0,29290,7.2,33000,4,0,-18155,-22000,0.4,2929.0
4857221671,1,5,0,1,23,16,20,0,0,0,0,47000,12.0,55000,0,0,18800,22000,0.0,4700.0,0,0,0,8,15,10,0,0,0,0,28200,7.2,33000,0,0,-18800,-22000,0.0,2820.0
4856449922,1,36,0,0,14,21,20,0,0,0,0,46416,10.0,47500,1,0,18150,19000,0.1,4641.6,256,0,1,14,7,11,0,0,0,0,28266,6.0,28500,1,0,-18150,-19000,0.1,2826.6
4856422639,1,2,1,1,13,13,11,0,0,0,0,46680,10.0,47500,1,0,19390,19000,0.1,4668.0,33,3,0,7,7,8,0,0,0,0,27290,6.0,28500,5,0,-19390,-19000,0.5,2729.0
4856408858,1,0,0,1,23,17,20,0,0,0,0,64100,12.0,55000,9,0,27600,22000,0.9,6410.0,0,0,0,9,15,4,0,0,0,0,36500,7.2,33000,4,0,-27600,-22000,0.4,3650.0
4856377688,1,5,0,0,18,19,24,0,0,0,0,62700,12.0,55000,0,0,24800,22000,0.0,6270.0,13,0,1,13,12,9,0,0,0,0,37900,7.2,33000,0,0,-24800,-22000,0.0,3790.0
4856359327,1,1,0,0,14,19,16,0,0,0,0,46515,10.0,47500,0,0,17831,17820,0.0,4651.5,0,0,1,15,10,11,0,0,0,0,28684,6.2,29680,0,0,-17831,-17820,0.0,2868.4
4856338773,1,66,1,0,15,20,16,0,0,0,0,46030,10.0,47500,3,0,17445,19000,0.3,4603.0,0,7,1,14,9,10,0,0,0,0,28585,6.0,28500,0,0,-17445,-19000,0.0,2858.5
4856315784,1,0,0,0,23,18,31,0,0,0,0,63790,13.0,62500,0,0,26918,28000,0.0,6379.0,0,0,1,11,16,6,0,0,0,0,36872,7.4,34500,0,0,-26918,-28000,0.0,3687.2
4856279200,1,35,0,1,23,15,23,0,0,0,0,64220,12.0,55000,1,0,28395,18000,0.1,6422.0,0,0,0,6,14,5,0,0,0,0,35825,8.0,37000,0,0,-28395,-18000,0.0,3582.5
4856242987,1,21,0,1,15,21,15,0,0,0,0,49450,10.0,47500,0,0,20200,19000,0.0,4945.0,0,0,0,14,8,11,0,0,0,0,29250,6.0,28500,0,0,-20200,-19000,0.0,2925.0
4852659844,0,12,0,1,4,4,1,0,0,0,0,14716,6.6,17249,176,40,-265,-198,21.6,1471.6,14,1,0,4,4,4,1,1,0,0,14981,6.8,17447,166,64,265,198,23.0,1498.1
4849213919,1,15,0,1,5,2,2,0,0,0,0,14848,6.8,17325,158,51,317,261,20.9,1484.8,12,1,0,2,5,1,0,0,0,0,14531,6.8,17064,188,60,-317,-261,24.8,1453.1
4802658744,1,10,2,1,3,6,0,1,0,1,0,14135,6.8,16496,183,39,-850,659,22.2,1413.5,14,1,0,6,3,6,1,1,0,0,14985,6.4,15837,151,48,850,-659,19.9,1498.5
4800480013,0,106,0,1,8,7,6,0,0,0,0,15975,6.8,16950,157,36,-1013,-826,19.3,1597.5,13,0,0,7,8,6,1,1,0,0,16988,7.0,17776,162,56,1013,826,21.8,1698.8
4794921042,1,12,1,0,6,6,4,0,0,0,0,15084,6.4,15795,130,56,920,0,18.6,1508.4,16,1,1,6,6,1,1,1,0,0,14164,6.4,15795,145,40,-920,0,18.5,1416.4
4788741301,1,12,0,0,6,8,4,0,0,0,0,15619,6.8,17077,179,56,-1802,-1378,23.5,1561.9,11,2,1,8,6,5,0,0,0,0,17421,7.0,18455,190,48,1802,1378,23.8,1742.1
4784189517,1,9,1,1,10,3,5,0,0,0,0,18698,7.0,18823,182,44,5945,3686,22.6,1869.8,84,1,0,3,10,2,0,0,0,0,12753,6.2,15137,148,40,-5945,-3686,18.8,1275.3
4783450439,0,11,1,1,2,1,2,0,0,0,0,15354,6.4,16770,190,40,2860,599,23.0,1535.4,16,0,0,1,2,2,0,0,0,0,12494,6.6,16171,157,48,-2860,-599,20.5,1249.4
4782746062,1,11,2,1,6,1,6,1,1,0,0,15401,6.8,16797,186,32,2509,622,21.8,1540.1,11,0,0,1,6,0,0,0,0,0,12892,6.4,16175,154,52,-2509,-622,20.6,1289.2
4780856766,0,20,3,0,3,6,1,0,0,0,0,15549,7.0,18512,214,64,-792,1385,27.8,1554.9,12,1,1,6,3,6,0,0,0,0,16341,6.8,17127,195,44,792,-1385,23.9,1634.1
4780368532,0,11,1,1,6,1,8,0,0,0,0,18226,6.8,18569,218,44,4790,2642,26.2,1822.6,16,2,0,1,6,2,0,0,0,0,13436,6.4,15927,163,56,-4790,-2642,21.9,1343.6
4779004344,1,9,2,1,6,5,3,1,1,0,0,15241,6.8,17400,170,56,153,-105,22.6,1524.1,14,1,0,5,6,2,0,0,0,0,15088,6.8,17505,174,48,-153,105,22.2,1508.8
4778968949,0,13,0,1,2,1,0,0,0,0,0,14145,6.4,16018,184,48,490,-829,23.2,1414.5,12,0,0,1,2,1,0,0,0,0,13655,6.6,16847,145,60,-490,829,20.5,1365.5
4778228899,1,13,1,1,11,5,6,0,0,0,0,18754,7.2,19203,224,56,4119,1998,28.0,1875.4,12,1,0,5,11,2,0,0,0,0,14635,6.8,17205,153,40,-4119,-1998,19.3,1463.5
4776030542,1,13,0,0,2,6,3,2,1,1,0,15127,7.0,18113,190,68,77,697,25.8,1512.7,20,0,1,6,2,3,0,0,0,0,15050,6.8,17416,169,52,-77,-697,22.1,1505.0
4775189593,0,80,0,1,6,2,2,1,0,1,0,15752,7.0,18289,161,56,1836,1228,21.7,1575.2,13,3,0,2,6,2,0,0,0,0,13916,6.8,17061,205,38,-1836,-1228,24.3,1391.6
4774743514,0,15,1,1,1,1,1,0,0,0,0,12728,6.4,16327,144,48,-1960,-1828,19.2,1272.8,136,1,0,1,1,2,1,1,0,0,14688,6.8,18155,184,64,1960,1828,24.8,1468.8
4774724838,1,13,1,1,8,6,8,0,0,0,0,17117,6.8,18096,186,56,1386,1204,24.2,1711.7,11,2,0,6,8,9,0,0,0,0,15731,6.8,16892,150,48,-1386,-1204,19.8,1573.1
4854189560,1,0,2,0,18,19,46,0,0,0,1,35989,10.6,38279,103,0,264,-513,10.3,3598.9,12,0,1,19,18,43,0,0,0,0,35725,10.6,38792,110,0,-264,513,11.0,3572.5
4854168433,1,0,0,1,16,13,14,0,0,0,0,46301,10.0,47500,0,0,18791,19000,0.0,4630.1,0,0,0,8,11,9,0,0,0,0,27510,6.0,28500,0,0,-18791,-19000,0.0,2751.0
4854142704,1,0,0,1,24,11,24,0,0,0,0,63400,12.0,55000,0,0,28300,22000,0.0,6340.0,0,0,0,3,16,3,0,0,0,0,35100,7.2,33000,0,0,-28300,-22000,0.0,3510.0
4853205226,1,19,0,1,22,26,53,0,0,0,0,38167,11.4,41788,89,0,1897,2233,8.9,3816.7,0,6,0,26,22,64,0,0,0,0,36270,11.0,39555,96,0,-1897,-2233,9.6,3627.0
4853186337,1,0,0,0,30,20,76,0,0,0,0,38184,11.8,44522,104,0,2814,4311,10.4,3818.4,0,0,1,20,30,41,0,0,0,0,35370,11.2,40211,83,0,-2814,-4311,8.3,3537.0
4852117362,1,10,1,0,5,6,2,0,0,0,0,15314,6.8,16762,167,44,-1844,-713,21.1,1531.4,12,0,1,6,5,5,0,0,0,0,17158,6.8,17475,155,52,1844,713,20.7,1715.8
4850615206,1,13,0,1,3,1,1,0,0,0,0,14722,7.0,17921,187,56,1331,312,24.3,1472.2,6,1,0,1,3,0,0,0,0,0,13391,7.0,17609,182,56,-1331,-312,23.8,1339.1
4847114982,1,31,0,1,6,6,6,0,0,0,0,15196,6.0,15375,171,44,362,-1353,21.5,1519.6,37,1,0,6,6,4,1,1,0,0,14834,6.4,16728,137,52,-362,1353,18.9,1483.4
4847072861,0,12,1,1,10,6,10,0,0,0,0,17417,7.0,18177,196,49,653,1206,24.5,1741.7,15,0,0,6,10,6,0,0,0,0,16764,6.6,16971,171,54,-653,-1206,22.5,1676.4
4846230234,1,10,0,1,7,2,7,2,1,1,0,17601,7.2,18438,228,60,4479,1746,28.8,1760.1,13,1,0,2,7,1,0,0,0,0,13122,6.8,16692,158,52,-4479,-1746,21.0,1312.2
4843595972,1,13,1,1,3,4,1,0,0,0,0,15227,7.0,18026,196,56,-777,-322,25.2,1522.7,110,1,0,4,3,3,0,0,0,0,16004,7.0,18348,178,48,777,322,22.6,1600.4
4843574730,0,15,0,0,2,6,4,0,0,0,0,14370,6.6,17100,180,56,-1753,-794,23.6,1437.0,10,0,1,6,2,12,1,1,0,0,16123,6.6,17894,174,68,1753,794,24.2,1612.3
4843179907,0,13,0,1,18,10,28,0,0,0,0,31679,11.0,38954,95,52,695,-21,14.7,3167.9,103,1,0,9,17,11,0,0,0,0,30984,11.2,38975,74,52,-695,21,12.6,3098.4
4843101965,0,18,0,0,8,20,12,0,0,0,0,30072,10.0,32808,62,55,-5898,-7080,11.7,3007.2,29,0,1,20,8,25,0,0,0,0,35970,11.2,39888,84,35,5898,7080,11.9,3597.0
4843053057,1,20,2,0,7,4,9,1,1,0,0,15083,6.8,16377,157,52,-201,-286,20.9,1508.3,14,2,1,4,7,4,0,0,0,0,15284,6.6,16663,166,52,201,286,21.8,1528.4
4843019640,1,11,1,1,7,7,6,1,1,0,0,17652,6.6,17452,195,48,1170,271,24.3,1765.2,64,1,0,7,7,6,0,0,0,0,16482,6.8,17181,160,60,-1170,-271,22.0,1648.2
4842972573,0,24,0,1,8,8,8,0,0,0,0,16641,6.8,16878,172,50,828,59,22.2,1664.1,11,0,0,7,7,3,0,0,0,0,15813,6.8,16819,179,54,-828,-59,23.3,1581.3
4842945499,0,10,0,0,3,5,1,0,0,0,0,15572,6.8,17206,177,48,112,-539,22.5,1557.2,36,1,1,5,3,3,1,0,1,0,15460,6.8,17745,168,52,-112,539,22.0,1546.0
4839259017,1,11,0,1,3,2,4,1,1,0,0,14296,6.8,17284,183,44,669,-545,22.7,1429.6,10,1,0,2,3,0,0,0,0,0,13627,6.8,17829,154,60,-669,545,21.4,1362.7
4856172314,1,17,1,1,11,3,8,0,0,0,0,16985,7.0,17845,157,58,2368,2176,21.5,1698.5,13,0,0,3,11,1,0,0,0,0,14617,6.6,15669,144,44,-2368,-2176,18.8,1461.7
4856134944,1,12,0,1,11,10,13,1,1,0,0,17742,6.2,14163,150,48,-847,-1680,19.8,1774.2,12,3,0,10,11,12,1,0,1,0,18589,6.2,15843,146,51,847,1680,19.7,1858.9
4856051862,0,0,0,1,23,17,54,0,0,0,0,35427,10.8,37614,100,0,1609,52,10.0,3542.7,0,0,0,17,23,50,0,0,0,0,33818,10.8,37562,101,0,-1609,-52,10.1,3381.8
4856021072,1,0,2,1,27,17,60,0,0,0,2,39374,11.6,42434,103,0,2854,2154,10.3,3937.4,13,0,0,17,27,44,0,0,0,0,36520,11.2,40280,105,0,-2854,-2154,10.5,3652.0
4855995977,0,0,0,0,22,21,60,0,0,0,0,37247,11.2,41283,111,0,1250,2823,11.1,3724.7,0,0,1,21,22,58,0,0,0,0,35997,10.8,38460,74,0,-1250,-2823,7.4,3599.7
4855976256,1,0,0,1,25,24,70,0,0,0,2,37143,10.8,39312,104,0,-2256,-2973,10.4,3714.3,18,0,0,24,25,61,0,0,0,0,39399,11.4,42285,104,0,2256,2973,10.4,3939.9
4852485125,1,0,0,1,19,13,18,0,0,0,0,63550,13.4,62000,0,0,28100,29000,0.0,6355.0,0,0,0,6,12,4,0,0,0,0,35450,7.2,33000,0,0,-28100,-29000,0.0,3545.0
4850937888,1,23,0,1,21,21,43,0,0,0,1,38618,11.6,43192,113,0,1848,2007,11.3,3861.8,0,4,0,21,21,57,0,0,0,0,36770,11.4,41185,93,0,-1848,-2007,9.3,3677.0
4842259870,0,3,0,0,30,28,74,0,0,0,1,41012,11.8,44796,106,0,1195,997,10.6,4101.2,0,1,1,28,30,67,0,0,0,0,39817,11.8,43799,86,0,-1195,-997,8.6,3981.7
4842233115,0,0,0,1,24,30,54,0,0,0,1,38613,11.4,42681,89,0,-2021,-3621,8.9,3861.3,0,0,0,30,24,71,0,0,0,0,40634,11.8,46302,117,0,2021,3621,11.7,4063.4
4837643181,0,12,0,1,31,24,73,0,0,0,1,38565,11.4,43364,96,0,-1408,900,9.6,3856.5,1,2,0,24,31,41,0,0,0,0,39973,11.4,42464,116,0,1408,-900,11.6,3997.3
4837630179,1,0,0,1,16,11,50,0,0,0,0,36465,10.6,37071,116,0,3371,2873,11.6,3646.5,0,0,0,11,16,32,0,0,0,0,33094,10.0,34198,92,0,-3371,-2873,9.2,3309.4
4836193394,1,0,0,1,31,24,68,0,0,0,1,40481,11.8,44989,112,0,3331,4226,11.2,4048.1,8,0,0,24,31,44,0,0,0,0,37150,11.2,40763,64,0,-3331,-4226,6.4,3715.0
4836174640,1,0,1,1,24,13,45,0,0,0,0,37249,10.8,39852,123,0,2564,1961,12.3,3724.9,17,0,0,13,24,25,0,0,0,0,34685,10.8,37891,105,0,-2564,-1961,10.5,3468.5
4836140564,1,204,0,0,16,23,38,0,0,0,0,34547,10.8,38431,91,0,-1296,-1018,9.1,3454.7,0,5,1,23,16,52,0,0,0,0,35843,11.0,39449,96,0,1296,1018,9.6,3584.3
4836114729,1,9,0,0,23,26,56,0,0,0,0,37145,11.4,43464,61,0,-196,1408,6.1,3714.5,25,1,1,26,23,57,0,0,0,0,37341,11.2,42056,96,0,196,-1408,9.6,3734.1
4835637672,0,0,0,0,21,28,51,0,0,0,1,37559,11.0,40244,103,0,-294,-259,10.3,3755.9,15,0,1,28,21,77,0,0,0,0,37853,11.0,40503,113,0,294,259,11.3,3785.3
4835625495,0,0,0,1,29,21,65,0,0,0,0,37427,11.4,42117,122,0,1348,2457,12.2,3742.7,0,0,0,21,29,45,0,0,0,0,36079,11.0,39660,114,0,-1348,-2457,11.4,3607.9
4835610567,1,131,0,1,30,30,65,0,0,0,1,39096,11.6,45865,87,0,1199,2524,8.7,3909.6,17,0,0,30,30,71,0,0,0,0,37897,11.4,43341,90,0,-1199,-2524,9.0,3789.7
4746223967,1,13,1,1,7,4,4,0,0,0,0,15925,6.8,16927,191,44,996,2095,23.5,1592.5,16,4,0,4,7,5,0,0,0,0,14929,6.4,14832,144,48,-996,-2095,19.2,1492.9
4746191195,0,9,4,0,3,8,1,1,1,0,0,13799,6.8,17178,150,48,-3932,-1611,19.8,1379.9,78,0,1,8,3,5,0,0,0,0,17731,7.2,18789,191,64,3932,1611,25.5,1773.1
4745124620,1,11,0,1,11,2,15,1,1,0,0,19022,7.0,18106,208,52,4183,1892,26.0,1902.2,8,0,0,2,11,1,0,0,0,0,14839,6.6,16214,196,44,-4183,-1892,24.0,1483.9
4745103993,1,15,12,0,6,4,14,0,0,0,0,15907,6.4,15942,117,36,-382,-1897,15.3,1590.7,37,1,1,4,6,0,0,0,0,0,16289,6.8,17839,193,52,382,1897,24.5,1628.9
4745074298,1,112,2,0,1,1,1,1,1,0,0,14106,6.6,15956,176,43,851,-510,21.9,1410.6,13,5,1,1,1,0,0,0,0,0,13255,6.4,16466,169,44,-851,510,21.3,1325.5
4742576361,1,17,0,0,6,2,3,1,1,0,0,15144,6.6,16971,167,52,-245,-418,21.9,1514.4,12,2,1,2,6,1,0,0,0,0,15389,7.0,17389,176,60,245,418,23.6,1538.9
4742537559,1,14,1,0,7,3,6,0,0,0,0,17486,6.8,17867,189,54,3544,1978,24.3,1748.6,15,0,1,3,7,2,0,0,0,0,13942,6.2,15889,154,37,-3544,-1978,19.1,1394.2
4590159201,1,37,0,1,5,5,4,1,1,0,0,15396,6.8,18340,180,60,501,1851,24.0,1539.6,9,15,0,5,5,2,0,0,0,0,14895,7.0,16489,163,60,-501,-1851,22.3,1489.5
4590140983,0,17,2,1,5,3,4,1,0,1,0,15052,6.4,15736,170,39,280,-1040,20.9,1505.2,66,4,0,3,5,3,0,0,0,0,14772,6.6,16776,188,54,-280,1040,24.2,1477.2
4589934561,0,15,1,1,7,5,6,0,0,0,0,17634,7.0,18634,192,52,2316,1642,24.4,1763.4,13,0,0,5,7,5,0,0,0,0,15318,6.8,16992,203,56,-2316,-1642,25.9,1531.8
4516158092,0,0,0,0,18,33,40,0,0,0,1,36202,11.0,40328,76,0,-2908,-1343,7.6,3620.2,0,0,1,33,18,88,0,0,0,0,39110,11.4,41671,97,0,2908,1343,9.7,3911.0
4516116882,1,0,0,1,38,22,106,0,0,0,0,41279,11.8,44837,110,0,5911,5492,11.0,4127.9,4,0,0,22,38,43,0,0,0,0,35368,11.0,39345,88,0,-5911,-5492,8.8,3536.8
4515845327,0,68,0,1,32,24,68,0,0,0,1,39735,11.8,44177,94,0,2821,483,9.4,3973.5,9,0,0,24,32,48,0,0,0,0,36914,11.8,43694,92,0,-2821,-483,9.2,3691.4
4504630339,1,0,0,1,12,22,27,0,0,0,1,34449,10.4,36538,96,0,231,-1369,9.6,3444.9,2,0,0,22,12,47,0,0,0,0,34218,10.8,37907,71,0,-231,1369,7.1,3421.8
4503756294,1,13,0,0,18,18,44,0,0,0,2,37417,11.2,40879,87,0,2823,5299,8.7,3741.7,0,2,1,18,18,41,0,0,0,0,34594,10.2,35580,94,0,-2823,-5299,9.4,3459.4
4503740875,1,1,4,1,26,21,56,0,0,0,0,36576,11.0,39693,103,0,826,-54,10.3,3657.6,19,0,0,21,26,46,0,0,0,0,35750,10.8,39747,93,0,-826,54,9.3,3575.0
4503723073,1,8,0,1,25,19,42,0,0,0,0,36163,11.4,42321,94,0,642,2386,9.4,3616.3,106,0,0,19,25,39,0,0,0,0,35521,11.0,39935,108,0,-642,-2386,10.8,3552.1
4503712923,1,0,0,1,25,22,61,0,0,0,2,39623,11.4,41971,118,0,2481,2957,11.8,3962.3,0,0,0,22,25,57,0,0,0,0,37142,11.0,39014,82,0,-2481,-2957,8.2,3714.2
4503469124,1,0,1,0,17,16,45,0,0,0,2,37368,11.0,39869,114,0,2690,2850,11.4,3736.8,15,0,1,16,17,27,0,0,0,0,34678,10.6,37019,90,0,-2690,-2850,9.0,3467.8
4729110920,0,0,0,0,20,27,35,0,0,0,1,37387,11.0,40727,97,0,-1133,-359,9.7,3738.7,0,0,1,27,20,73,0,0,0,0,38520,11.2,41086,96,0,1133,359,9.6,3852.0
4727851421,1,17,0,1,8,3,6,1,1,0,0,17567,7.0,18381,179,56,3255,2097,23.5,1756.7,9,2,0,3,8,2,0,0,0,0,14312,6.4,16284,175,56,-3255,-2097,23.1,1431.2
4727794530,0,14,0,1,3,1,3,1,0,1,0,14908,6.6,16753,201,68,493,-57,26.9,1490.8,14,0,0,1,3,2,0,0,0,0,14415,6.4,16810,179,48,-493,57,22.7,1441.5
4727765089,1,0,0,1,21,17,49,0,0,0,0,36753,11.2,41122,103,0,1050,2041,10.3,3675.3,0,0,0,17,21,32,0,0,0,0,35703,10.6,39081,93,0,-1050,-2041,9.3,3570.3
4726801917,1,0,0,1,18,17,17,0,0,0,0,64100,12.0,55000,6,0,24800,22000,0.6,6410.0,0,0,0,10,11,7,0,0,0,0,39300,7.2,33000,1,0,-24800,-22000,0.1,3930.0
4726750681,0,10,2,0,4,8,3,0,0,0,0,16130,6.6,17079,175,51,-2333,-1970,22.6,1613.0,14,2,1,8,4,6,0,0,0,0,18463,7.4,19049,219,60,2333,1970,27.9,1846.3
4726706614,1,17,2,1,4,0,6,1,1,0,0,16495,7.0,18554,223,76,2434,1083,29.9,1649.5,21,3,0,0,4,0,0,0,0,0,14061,6.8,17471,247,46,-2434,-1083,29.3,1406.1
4726644497,0,9,1,1,5,4,4,1,1,0,0,15393,6.8,17258,196,48,-96,-670,24.4,1539.3,13,2,0,3,4,2,0,0,0,0,15489,6.8,17928,210,40,96,670,25.0,1548.9
4726620998,1,0,0,1,27,24,46,0,0,0,1,39112,11.2,42694,100,0,1457,94,10.0,3911.2,0,0,0,24,27,58,0,0,0,0,37655,11.6,42600,103,0,-1457,-94,10.3,3765.5
4726362820,1,0,0,1,31,16,90,0,0,0,0,40295,11.8,44032,90,0,5180,4924,9.0,4029.5,0,0,0,16,31,37,0,0,0,0,35115,11.0,39108,93,0,-5180,-4924,9.3,3511.5
4726328502,0,37,4,0,27,23,63,0,0,0,0,37270,11.2,41085,117,0,765,2963,11.7,3727.0,15,7,1,23,27,52,0,0,0,0,36505,10.8,38122,86,0,-765,-2963,8.6,3650.5
4723247146,1,12,1,1,4,6,2,0,0,0,0,16542,6.8,17462,187,48,1574,2157,23.5,1654.2,12,3,0,6,4,7,0,0,0,0,14968,6.2,15305,153,44,-1574,-2157,19.7,1496.8
4723208736,1,21,0,0,23,27,61,0,0,0,0,36188,11.0,40311,101,0,-157,1121,10.1,3618.8,0,20,1,27,23,71,0,0,0,0,36345,11.0,39190,75,0,157,-1121,7.5,3634.5
4722635921,1,17,3,0,10,6,6,1,1,0,0,18549,7.0,17999,200,44,1628,1486,24.4,1854.9,14,2,1,6,10,13,1,0,1,0,16921,6.6,16513,141,44,-1628,-1486,18.5,1692.1
4722595984,1,4,0,1,20,25,48,0,0,0,2,36853,10.8,38935,75,0,-1040,-2849,7.5,3685.3,0,0,0,25,20,68,0,0,0,0,37893,11.4,41784,97,0,1040,2849,9.7,3789.3
4722580362,1,25,0,1,22,14,59,0,0,0,0,35635,10.8,37936,101,0,1890,1845,10.1,3563.5,0,7,0,14,22,31,0,0,0,0,33745,10.4,36091,122,0,-1890,-1845,12.2,3374.5
4722571986,1,0,2,1,15,10,38,0,0,0,1,36621,10.8,37707,129,0,4124,4252,12.9,3662.1,11,0,0,10,15,22,0,0,0,0,32497,10.0,33455,92,0,-4124,-4252,9.2,3249.7
4721845646,1,0,0,1,20,20,17,0,0,0,0,61460,13.2,62000,2,0,22840,19500,0.2,6146.0,39,0,0,8,8,16,0,0,0,0,38620,9.0,42500,0,0,-22840,-19500,0.0,3862.0
4796888796,1,8,1,0,4,4,0,0,0,0,0,14744,7.0,18843,156,56,655,2784,21.2,1474.4,23,0,1,4,4,6,2,1,1,0,14089,6.6,16059,129,36,-655,-2784,16.5,1408.9
4796854919,0,13,0,0,4,7,4,1,1,0,0,14199,6.2,15701,132,47,-1673,-1841,17.9,1419.9,80,1,1,7,4,8,0,0,0,0,15872,6.8,17542,165,40,1673,1841,20.5,1587.2
4796814175,1,29,1,0,9,7,10,1,1,0,0,15382,6.4,15512,105,40,303,-34,14.5,1538.2,31,1,1,7,9,7,0,0,0,0,15079,6.4,15546,94,48,-303,34,14.2,1507.9
4796747048,1,14,0,1,12,9,6,0,0,0,0,17886,6.8,16983,160,44,1836,770,20.4,1788.6,6,0,0,9,12,2,1,1,0,0,16050,6.4,16213,120,52,-1836,-770,17.2,1605.0
4796728235,0,0,0,1,18,37,36,0,0,0,0,35673,11.0,40235,95,0,-5693,-5215,9.5,3567.3,0,0,0,37,18,77,0,0,0,0,41366,11.8,45450,104,0,5693,5215,10.4,4136.6
4796715267,1,0,0,0,14,24,19,0,0,0,0,34445,10.6,36532,102,0,-960,-3651,10.2,3444.5,0,0,1,24,14,53,0,0,0,0,35405,11.0,40183,95,0,960,3651,9.5,3540.5
4796660486,1,0,0,1,38,21,82,0,0,0,1,42432,11.6,44872,109,0,4607,2207,10.9,4243.2,0,0,0,21,38,42,0,0,0,0,37825,11.6,42665,80,0,-4607,-2207,8.0,3782.5
4796596304,1,13,0,0,2,3,0,1,1,0,0,12505,6.4,16598,119,51,-1416,-928,17.0,1250.5,8,0,1,3,2,1,0,0,0,0,13921,6.4,17526,145,60,1416,928,20.5,1392.1
4796204104,1,12,0,0,1,7,1,1,1,0,0,12351,6.4,15629,125,40,-3343,-2888,16.5,1235.1,227,0,1,7,1,2,0,0,0,0,15694,7.2,18517,165,59,3343,2888,22.4,1569.4
4796115401,0,12,0,0,4,3,3,0,0,0,0,15060,6.6,17403,164,56,-629,-618,22.0,1506.0,158,1,1,3,4,1,1,1,0,0,15689,7.2,18021,193,52,629,618,24.5,1568.9
4791918281,1,12,0,1,11,1,9,0,0,0,0,18588,6.6,16687,152,56,7004,3413,20.8,1858.8,11,0,0,1,11,0,0,0,0,0,11584,5.8,13274,151,8,-7004,-3413,15.9,1158.4
4791311024,1,0,0,0,27,31,72,0,0,0,1,38371,11.2,41788,96,0,475,-2636,9.6,3837.1,0,0,1,31,27,59,0,0,0,0,37896,11.8,44424,94,0,-475,2636,9.4,3789.6
4791285866,0,95,0,1,30,33,72,0,0,0,1,39623,11.6,44839,96,0,-2115,-1304,9.6,3962.3,11,0,0,33,30,76,0,0,0,0,41738,12.0,46143,104,0,2115,1304,10.4,4173.8
4791263031,1,16,20,0,9,4,2,1,1,0,0,15493,7.0,18695,144,56,2274,1179,20.0,1549.3,36,0,1,4,9,1,0,0,0,0,13219,6.8,17516,130,56,-2274,-1179,18.6,1321.9
4791221536,0,10,0,0,1,4,0,0,0,0,0,12657,6.6,17338,166,32,-1359,-1903,19.8,1265.7,17,0,1,4,1,0,2,1,1,0,14016,7.2,19241,170,52,1359,1903,22.2,1401.6
4791174417,0,9,0,1,7,2,5,0,0,0,0,15119,6.2,16013,134,53,1701,895,18.7,1511.9,262,0,0,2,7,2,1,1,0,0,13418,6.4,15118,144,30,-1701,-895,17.4,1341.8
4791053683,1,10,0,1,5,5,4,1,1,0,0,14633,6.2,15377,147,28,312,-228,17.5,1463.3,9,0,0,5,5,6,0,0,0,0,14321,6.4,15605,104,35,-312,228,13.9,1432.1
4790794942,1,47,0,0,1,7,1,0,0,0,0,12827,6.6,15851,137,39,-1989,-1768,17.6,1282.7,96,0,1,7,1,5,0,0,0,0,14816,6.8,17619,146,52,1989,1768,19.8,1481.6
4790758714,1,10,0,1,5,2,3,2,1,1,0,14831,6.6,16561,148,52,219,115,20.0,1483.1,131,0,0,2,5,1,0,0,0,0,14612,6.6,16446,142,48,-219,-115,19.0,1461.2
4790700877,0,20,0,0,4,3,5,0,0,0,0,13577,6.6,16487,154,43,-745,-70,19.7,1357.7,140,0,1,3,4,2,0,0,0,0,14322,6.8,16557,193,45,745,70,23.8,1432.2
4816901895,1,15,0,0,5,1,8,1,1,0,0,14865,6.4,15583,133,53,653,-1188,18.6,1486.5,5,1,1,1,5,0,0,0,0,0,14212,6.8,16771,148,52,-653,1188,20.0,1421.2
4815962157,0,10,0,1,5,9,7,0,0,0,0,14923,6.0,14006,151,36,-1918,-2956,18.7,1492.3,10,0,0,9,5,8,1,1,0,0,16841,6.8,16962,148,48,1918,2956,19.6,1684.1
4815929990,1,12,1,0,5,2,3,0,0,0,0,15150,6.8,17371,171,48,338,-298,21.9,1515.0,75,0,1,2,5,2,1,1,0,0,14812,7.0,17669,192,63,-338,298,25.5,1481.2
4815424679,0,11,0,0,5,4,2,0,0,0,0,14733,7.0,17535,161,52,53,247,21.3,1473.3,12,0,1,4,5,3,0,0,0,0,14680,6.8,17288,170,56,-53,-247,22.6,1468.0
4814943896,0,53,0,1,3,8,1,0,0,0,0,14388,6.6,17077,149,60,-1937,-1265,20.9,1438.8,65,0,0,8,3,4,1,1,0,0,16325,7.0,18342,172,72,1937,1265,24.4,1632.5
4814925841,0,11,13,0,3,8,2,0,0,0,0,14549,6.4,15952,120,52,-1490,-1854,17.2,1454.9,31,1,1,8,3,5,0,0,0,0,16039,7.0,17806,167,48,1490,1854,21.5,1603.9
4738533616,0,106,0,0,5,5,0,0,0,0,0,14523,6.6,16935,155,56,899,1987,21.1,1452.3,8,0,1,5,5,2,0,0,0,0,13624,6.4,14948,149,24,-899,-1987,17.3,1362.4
4738241304,1,64,4,0,1,3,0,1,0,1,0,13752,6.8,18361,191,56,-1773,741,24.7,1375.2,24,0,1,3,1,4,0,0,0,0,15525,6.8,17620,205,48,1773,-741,25.3,1552.5
4736755547,0,11,0,1,1,2,0,0,0,0,0,12241,6.4,16015,135,32,-2391,-1282,16.7,1224.1,10,2,0,1,0,1,0,0,0,0,14632,7.0,17297,195,52,2391,1282,24.7,1463.2
4736149270,0,10,0,1,7,4,11,0,0,0,0,15625,6.8,17948,179,40,1565,2711,21.9,1562.5,14,0,0,4,7,3,1,1,0,0,14060,6.2,15237,135,60,-1565,-2711,19.5,1406.0
4736129717,0,13,2,0,3,4,3,0,0,0,0,14521,6.4,16738,202,48,-1616,-835,25.0,1452.1,19,2,1,4,3,4,0,0,0,0,16137,6.6,17573,214,56,1616,835,27.0,1613.7
4733780628,0,13,0,0,0,7,0,0,0,0,0,13283,6.4,15779,147,44,-2349,-2938,19.1,1328.3,12,1,1,7,0,0,1,1,0,0,15632,7.4,18717,163,64,2349,2938,22.7,1563.2
4732672656,1,20,0,0,4,4,4,1,1,0,0,14579,6.6,16590,150,52,-1332,-772,20.2,1457.9,10,0,1,4,4,3,0,0,0,0,15911,6.8,17362,183,51,1332,772,23.4,1591.1
4731544040,0,2,0,0,2,4,0,0,0,0,0,12180,6.4,15867,133,28,-2520,40,16.1,1218.0,9,0,1,4,2,0,0,0,0,0,14700,6.4,15827,160,32,2520,-40,19.2,1470.0
4731470360,0,14,1,0,1,3,1,0,0,0,0,13083,6.2,15702,114,59,-715,-1740,17.3,1308.3,11,0,1,3,1,1,1,1,0,0,13798,6.8,17442,134,52,715,1740,18.6,1379.8
4730888289,0,9,2,0,4,7,4,0,0,0,0,14722,6.8,16868,175,36,-2002,-360,21.1,1472.2,21,2,1,7,4,5,1,0,1,0,16724,7.0,17228,174,40,2002,360,21.4,1672.4
4730854576,0,106,2,0,4,2,5,0,0,0,0,14294,6.6,16643,158,44,33,-666,20.2,1429.4,7,1,1,2,4,1,0,0,0,0,14261,6.6,17309,179,48,-33,666,22.7,1426.1
4730809064,0,12,1,1,1,4,0,0,0,0,0,12224,6.4,16176,128,56,-4081,-2052,18.4,1222.4,19,1,0,4,1,3,1,1,0,0,16305,7.0,18228,185,48,4081,2052,23.3,1630.5
4730782385,0,65,1,0,0,3,0,0,0,0,0,13350,6.6,16937,187,56,-1127,-1154,24.3,1335.0,20,2,1,3,0,4,0,0,0,0,14477,6.8,18091,171,48,1127,1154,21.9,1447.7
4729309192,1,12,0,0,3,1,3,0,0,0,0,14115,6.8,17040,167,36,-435,-499,20.3,1411.5,12,0,1,1,3,0,1,0,1,0,14550,7.0,17539,154,64,435,499,21.8,1455.0
4857231590,0,11,0,0,2,9,0,0,0,0,0,13029,6.2,15962,188,44,-4921,-2945,23.2,1302.9,16,0,1,9,2,7,1,0,1,0,17950,7.2,18907,198,46,4921,2945,24.4,1795.0
4857190059,1,11,1,0,4,3,1,0,0,0,0,15832,7.4,19288,207,68,-308,136,27.5,1583.2,11,0,1,3,4,5,1,1,0,0,16140,7.0,19152,208,64,308,-136,27.2,1614.0
4856215345,1,15,2,1,9,3,11,1,1,0,0,16005,6.6,16816,145,48,1555,-919,19.3,1600.5,12,1,0,3,9,2,0,0,0,0,14450,6.8,17735,197,60,-1555,919,25.7,1445.0
4856166331,0,21,1,0,3,6,1,0,0,0,0,16095,7.0,18002,206,56,-747,-266,26.2,1609.5,14,2,1,6,3,7,0,0,0,0,16842,7.0,18268,194,48,747,266,24.2,1684.2
4856120294,1,7,0,1,5,1,5,1,1,0,0,16475,7.4,19900,207,64,2981,2070,27.1,1647.5,14,0,0,1,5,1,0,0,0,0,13494,6.8,17830,195,52,-2981,-2070,24.7,1349.4
4855825367,1,16,0,0,2,5,3,1,1,0,0,15344,6.8,17190,189,52,-1661,-2331,24.1,1534.4,15,1,1,5,2,5,0,0,0,0,17005,7.2,19521,211,68,1661,2331,27.9,1700.5
4855787164,1,96,0,1,3,2,1,0,0,0,0,13835,7.2,18519,187,52,321,874,23.9,1383.5,10,1,0,2,3,1,0,0,0,0,13514,6.8,17645,191,48,-321,-874,23.9,1351.4
4855764639,1,10,1,1,7,0,5,0,0,0,0,17302,7.0,18587,206,60,4165,2421,26.6,1730.2,17,0,0,0,7,0,0,0,0,0,13137,6.8,16166,178,43,-4165,-2421,22.1,1313.7
4855687730,1,11,0,1,4,2,2,0,0,0,0,15997,7.2,17869,209,64,1605,188,27.3,1599.7,11,0,0,2,4,2,1,1,0,0,14392,6.8,17681,208,52,-1605,-188,26.0,1439.2
4855670199,0,11,0,1,3,4,2,0,0,0,0,14683,6.6,16790,202,60,-1567,-2689,26.2,1468.3,9,0,0,4,3,1,0,0,0,0,16250,7.4,19479,211,70,1567,2689,28.1,1625.0
4855663015,0,16,0,0,5,12,2,0,0,0,0,14224,6.6,17292,193,44,-5772,-3474,23.7,1422.4,15,1,1,12,5,7,0,0,0,0,19996,7.4,20766,213,64,5772,3474,27.7,1999.6
4854060502,1,0,0,0,12,17,17,0,0,0,0,60389,12.0,55000,1,0,21360,22000,0.1,6038.9,234,0,1,14,9,14,0,0,0,0,39029,7.2,33000,1,0,-21360,-22000,0.1,3902.9
4854035393,1,107,0,0,24,15,23,0,0,0,0,63492,12.0,55000,0,0,27854,22000,0.0,6349.2,1,0,1,5,14,6,0,0,0,0,35638,7.2,33000,1,0,-27854,-22000,0.1,3563.8
4854004537,1,197,0,0,12,14,11,0,0,0,0,38285,10.0,47500,1,0,10799,19000,0.1,3828.5,176,1,1,8,6,8,0,0,0,0,27486,6.0,28500,4,0,-10799,-19000,0.4,2748.6
4853985834,1,79,0,0,11,18,13,0,0,0,0,60965,12.0,55000,0,0,23808,22000,0.0,6096.5,0,0,1,13,6,9,0,0,0,0,37157,7.2,33000,0,0,-23808,-22000,0.0,3715.7
4853954128,1,137,0,0,12,15,14,0,0,0,0,46121,10.6,50500,8,0,18113,22000,0.8,4612.1,0,0,1,11,8,6,0,0,0,0,28008,6.0,28500,5,0,-18113,-22000,0.5,2800.8
4853804207,1,0,0,0,15,14,18,0,0,0,0,46407,10.0,47500,2,0,18176,19000,0.2,4640.7,0,0,1,9,10,8,0,0,0,0,28231,6.0,28500,1,0,-18176,-19000,0.1,2823.1
4853787008,1,0,0,1,24,15,27,0,0,0,0,66227,12.0,55000,0,0,31088,22000,0.0,6622.7,0,0,0,8,17,4,0,0,0,0,35139,7.2,33000,0,0,-31088,-22000,0.0,3513.9
4853765693,1,12,0,1,20,12,16,0,0,0,0,63434,12.0,55000,0,0,26198,22000,0.0,6343.4,0,0,0,6,14,6,0,0,0,0,37236,7.2,33000,0,0,-26198,-22000,0.0,3723.6
4858255151,0,9,9,0,12,17,27,0,0,0,0,34681,10.4,36209,98,0,-2141,-2314,9.8,3468.1,14,0,1,17,12,39,0,0,0,0,36822,10.6,38523,105,0,2141,2314,10.5,3682.2
4858193533,1,126,1,1,8,7,6,1,1,0,0,16790,6.8,17159,181,60,-555,-564,24.1,1679.0,10,0,0,7,8,5,0,0,0,0,17345,6.8,17723,175,46,555,564,22.1,1734.5
4858175754,0,64,0,1,4,5,1,0,0,0,0,14353,6.2,15813,194,8,-1429,-3147,20.2,1435.3,14,14,0,5,4,3,1,1,0,0,15782,7.0,18960,186,64,1429,3147,25.0,1578.2
4858137683,0,13,0,0,3,6,2,0,0,0,0,14299,6.8,17018,199,42,-1567,-1676,24.1,1429.9,13,4,1,6,3,9,1,1,0,0,15866,7.0,18694,170,60,1567,1676,23.0,1586.6
4858108870,1,10,0,1,4,4,1,0,0,0,0,15751,6.6,17688,192,48,-312,-422,24.0,1575.1,9,0,0,4,4,3,1,1,0,0,16063,7.0,18110,218,64,312,422,28.2,1606.3
4858071260,1,13,13,0,2,10,2,1,0,1,0,13636,6.4,15452,141,56,-4130,-2837,19.7,1363.6,32,1,1,10,2,4,1,1,0,0,17766,6.6,18289,222,48,4130,2837,27.0,1776.6
4858050606,0,0,0,1,23,25,52,0,0,0,2,37790,10.8,38465,100,0,-1169,-4922,10.0,3779.0,4,0,0,25,23,57,0,0,0,0,38959,11.4,43387,88,0,1169,4922,8.8,3895.9
4858030610,1,0,0,0,28,23,75,0,0,0,1,36967,11.0,40662,111,0,-434,2227,11.1,3696.7,0,0,1,23,28,55,0,0,0,0,37401,10.6,38435,90,0,434,-2227,9.0,3740.1
4858016385,0,17,0,1,22,22,52,0,0,0,0,36929,11.0,38950,99,0,341,-2560,9.9,3692.9,0,4,0,22,22,56,0,0,0,0,36588,11.2,41510,112,0,-341,2560,11.2,3658.8
4858002030,0,0,0,0,18,23,49,0,0,0,1,37242,11.0,39585,102,0,-1336,-1564,10.2,3724.2,0,0,1,23,18,79,0,0,0,0,38578,11.2,41149,102,0,1336,1564,10.2,3857.8
4857944681,0,3,0,1,16,16,35,0,0,0,1,32428,10.2,34533,63,0,-2632,-2965,6.3,3242.8,0,0,0,16,16,30,0,0,0,0,35060,10.6,37498,107,0,2632,2965,10.7,3506.0
4857614083,0,0,0,1,24,29,48,0,0,0,0,35315,11.0,40137,86,0,-2404,-393,8.6,3531.5,33,0,0,29,24,75,0,0,0,0,37719,11.0,40530,98,0,2404,393,9.8,3771.9
4857579480,1,9,1,0,3,5,4,1,1,0,1,15889,6.6,16912,195,52,855,-1078,24.7,1588.9,11,0,1,5,3,2,0,0,0,0,15034,7.2,17990,161,64,-855,1078,22.5,1503.4
4857551938,0,7,0,0,10,3,9,1,1,0,0,18298,7.0,19206,181,55,3241,2072,23.6,1829.8,15,0,1,3,10,0,0,0,0,0,15057,6.8,17134,200,56,-3241,-2072,25.6,1505.7
4857512280,0,13,0,1,3,4,0,1,0,1,0,14281,6.8,17227,175,52,101,1084,22.7,1428.1,13,2,0,4,3,2,0,0,0,0,14180,6.6,16143,163,44,-101,-1084,20.7,1418.0
4857470904,1,11,0,0,1,1,1,0,0,0,0,14819,7.0,18363,190,64,962,991,25.4,1481.9,11,0,1,1,1,1,0,0,0,0,13857,6.6,17372,184,60,-962,-991,24.4,1385.7
4857438730,0,12,2,0,2,6,3,0,0,0,0,14907,6.2,15234,147,48,-2399,-2007,19.5,1490.7,19,0,1,6,2,5,0,0,0,0,17306,7.0,17241,178,68,2399,2007,24.6,1730.6
4857348856,0,9,1,0,7,6,7,0,0,0,0,16374,7.0,17334,183,48,996,1914,23.1,1637.4,13,0,1,6,7,6,1,0,1,0,15378,6.2,15420,165,52,-996,-1914,21.7,1537.8
4857319254,0,0,1,1,29,24,82,0,0,0,1,39044,11.4,41587,106,0,-496,391,10.6,3904.4,16,0,0,24,29,60,0,0,0,0,39540,11.4,41196,107,0,496,-391,10.7,3954.0
4857286416,1,0,0,0,23,18,20,0,0,0,0,48768,10.0,47500,0,0,22306,19000,0.0,4876.8,216,0,1,6,11,11,0,0,0,0,26462,6.0,28500,0,0,-22306,-19000,0.0,2646.2
4812894637,1,8,0,1,24,19,44,0,0,0,1,41855,12.2,46997,87,84,11027,8733,17.1,4185.5,10,0,0,19,24,22,0,0,0,0,30828,10.6,38264,59,55,-11027,-8733,11.4,3082.8
4812884532,1,104,4,1,28,9,74,0,0,0,0,38415,11.6,43305,101,64,6379,7066,16.5,3841.5,44,0,0,9,28,20,0,0,0,0,32036,10.6,36239,53,67,-6379,-7066,12.0,3203.6
4812874202,1,15,1,1,9,11,18,0,0,0,0,33303,11.2,41769,91,63,4138,1901,15.4,3330.3,10,0,0,11,9,29,0,0,0,0,29165,11.0,39868,79,51,-4138,-1901,13.0,2916.5
4812861226,1,13,0,0,12,16,13,0,0,0,0,30788,10.6,36600,65,67,-2637,-172,13.2,3078.8,10,0,1,16,12,29,0,0,0,0,33425,10.6,36772,77,60,2637,172,13.7,3342.5
4792963319,1,162,12,0,7,11,4,0,0,0,0,16770,6.6,16886,167,51,-1882,-644,21.8,1677.0,34,0,1,11,7,11,0,0,0,0,18652,6.8,17530,165,40,1882,644,20.5,1865.2
4788432522,1,15,2,1,7,6,7,0,0,0,0,17072,6.8,17552,160,56,2902,562,21.6,1707.2,12,1,0,5,6,3,0,0,0,0,14170,6.8,16990,151,47,-2902,-562,19.8,1417.0
4787075060,1,13,1,0,6,10,4,0,0,0,0,16636,6.4,16335,181,28,-365,-1117,20.9,1663.6,13,0,1,10,6,12,0,0,0,0,17001,6.8,17452,151,60,365,1117,21.1,1700.1
4787036771,0,13,0,1,5,6,4,0,0,0,0,17103,6.8,17833,187,60,1098,398,24.7,1710.3,18,0,0,6,5,3,1,1,0,0,16005,6.8,17435,165,60,-1098,-398,22.5,1600.5
4786992836,1,15,1,1,3,3,0,1,1,0,0,14924,6.8,18881,191,56,875,1899,24.7,1492.4,11,0,0,3,3,3,0,0,0,0,14049,6.8,16982,158,60,-875,-1899,21.8,1404.9
4776026137,1,14,0,0,5,7,3,0,0,0,0,15995,6.8,16939,175,52,-976,-399,22.7,1599.5,10,0,1,7,5,6,0,0,0,0,16971,6.8,17338,174,32,976,399,20.6,1697.1
4758008257,1,0,0,0,19,13,17,0,0,0,0,62842,12.0,55000,0,0,25602,22000,0.0,6284.2,0,0,1,8,14,7,0,0,0,0,37240,7.2,33000,0,0,-25602,-22000,0.0,3724.0
4757989308,1,0,0,1,16,16,16,0,0,0,0,63780,12.0,55000,0,0,26195,18000,0.0,6378.0,3,0,0,9,9,8,0,0,0,0,37585,8.0,37000,0,0,-26195,-18000,0.0,3758.5
4757968637,1,0,0,0,20,15,21,0,0,0,0,67357,12.0,55000,3,0,28377,22000,0.3,6735.7,0,0,1,9,14,6,0,0,0,0,38980,7.2,33000,0,0,-28377,-22000,0.0,3898.0
4757956366,1,28,1,0,18,13,19,0,0,0,0,65200,12.4,57000,8,0,28351,24000,0.8,6520.0,0,0,1,8,13,3,0,0,0,0,36849,7.2,33000,1,0,-28351,-24000,0.1,3684.9
4757878262,1,270,0,1,18,17,18,0,0,0,0,63868,12.8,61000,2,0,26246,25000,0.2,6386.8,5,0,0,11,12,9,0,0,0,0,37622,7.6,36000,1,0,-26246,-25000,0.1,3762.2
4757828021,1,352,0,1,14,14,14,0,0,0,0,61907,12.2,56000,1,0,24647,23000,0.1,6190.7,0,0,0,9,9,9,0,0,0,0,37260,7.2,33000,1,0,-24647,-23000,0.1,3726.0
4757778551,1,113,0,1,17,16,14,0,0,0,0,62600,13.0,62000,0,0,26082,26000,0.0,6260.0,175,0,0,8,9,11,0,0,0,0,36518,7.6,36000,0,0,-26082,-26000,0.0,3651.8
4757765243,1,0,0,1,18,16,12,0,0,0,0,48050,10.0,47500,0,0,18800,19000,0.0,4805.0,0,0,0,8,10,11,0,0,0,0,29250,6.0,28500,0,0,-18800,-19000,0.0,2925.0
4757757772,1,28,0,1,16,14,19,0,0,0,0,61843,12.0,55000,2,0,25538,22000,0.2,6184.3,144,0,0,9,11,6,0,0,0,0,36305,7.2,33000,2,0,-25538,-22000,0.2,3630.5
4750318657,1,32,9,1,18,13,23,0,0,0,0,64470,13.0,62500,9,0,28445,28000,0.9,6447.0,40,5,0,7,12,6,0,0,0,0,36025,7.4,34500,8,0,-28445,-28000,0.8,3602.5
4857261302,1,9,1,1,5,8,8,0,0,0,0,16578,6.6,16955,196,47,341,-601,24.3,1657.8,16,0,0,8,5,6,0,0,0,0,16237,7.0,17556,167,44,-341,601,21.1,1623.7
4857205077,0,9,2,0,6,7,2,0,0,0,0,15752,6.6,18165,203,55,-596,1382,25.8,1575.2,11,1,1,7,6,7,1,1,0,0,16348,6.8,16783,196,48,596,-1382,24.4,1634.8
4856209260,1,135,0,1,7,5,5,1,1,0,0,15321,6.8,17129,179,48,504,-19,22.7,1532.1,63,1,0,4,6,4,0,0,0,0,14817,6.8,17148,179,44,-504,19,22.3,1481.7
4856147901,1,135,0,1,2,2,0,0,0,0,0,12937,6.4,16266,157,52,-550,-818,20.9,1293.7,15,2,0,2,2,3,0,0,0,0,13487,6.6,17084,164,60,550,818,22.4,1348.7
4833618680,0,10,1,1,10,7,8,1,1,0,0,16123,6.8,17403,164,56,751,387,22.0,1612.3,15,0,0,7,10,3,0,0,0,0,15372,6.8,17016,152,52,-751,-387,20.4,1537.2
4832944294,0,12,14,1,6,3,5,0,0,0,0,14733,6.4,15848,169,28,183,-1849,19.7,1473.3,36,1,0,3,6,3,0,0,0,0,14550,6.8,17697,182,40,-183,1849,22.2,1455.0
4829541004,1,10,2,1,12,6,10,1,1,0,0,18604,7.0,17729,197,44,2826,1551,24.1,1860.4,12,2,0,6,12,7,0,0,0,0,15778,6.6,16178,120,44,-2826,-1551,16.4,1577.8
4827398685,1,20,2,1,6,7,8,0,0,0,0,15021,6.4,16023,165,24,-921,-318,18.9,1502.1,18,1,0,7,6,5,1,1,0,0,15942,6.4,16341,187,60,921,318,24.7,1594.2
4827378735,1,12,1,1,7,4,6,0,0,0,0,15604,7.0,17930,166,56,797,401,22.2,1560.4,10,1,0,4,7,3,0,0,0,0,14807,6.8,17529,178,52,-797,-401,23.0,1480.7
4827356322,1,11,1,1,10,2,14,0,0,0,0,17673,6.6,16875,191,40,3820,-382,23.1,1767.3,16,0,0,2,10,4,0,0,0,0,13853,6.8,17257,188,42,-3820,382,23.0,1385.3
4827291626,0,11,0,0,4,6,3,0,0,0,0,15365,6.4,16802,191,44,-234,812,23.5,1536.5,11,0,1,6,4,4,0,0,0,0,15599,6.6,15990,187,49,234,-812,23.6,1559.9
4823403252,0,18,0,1,5,5,4,1,1,0,0,15095,7.0,17838,178,56,-1823,-1466,23.4,1509.5,18,1,0,5,5,6,0,0,0,0,16918,7.2,19304,231,60,1823,1466,29.1,1691.8
4823382925,0,196,1,0,1,4,0,0,0,0,0,12795,6.4,15939,142,52,-1908,-1121,19.4,1279.5,16,0,1,4,1,3,0,0,0,0,14703,6.6,17060,183,56,1908,1121,23.9,1470.3
4823363929,1,12,0,0,7,4,7,0,0,0,0,16295,6.6,16818,165,49,1466,681,21.4,1629.5,11,0,1,4,7,3,0,0,0,0,14829,6.4,16137,180,51,-1466,-681,23.1,1482.9
4821913455,1,13,0,0,8,8,7,1,1,0,0,16618,6.8,17468,180,48,52,1144,22.8,1661.8,7,2,1,8,8,8,0,0,0,0,16566,6.6,16324,164,52,-52,-1144,21.6,1656.6
4821869945,1,8,0,0,5,5,3,0,0,0,0,15750,6.8,17089,174,40,703,88,21.4,1575.0,24,2,1,5,5,5,0,0,0,0,15047,6.8,17001,139,44,-703,-88,18.3,1504.7
4856308668,1,12,1,1,6,4,2,0,0,0,0,17145,7.0,18080,169,48,3279,3273,21.7,1714.5,9,0,0,4,6,4,0,0,0,0,13866,6.2,14807,139,36,-3279,-3273,17.5,1386.6
4839910512,0,45,0,1,8,14,8,0,0,0,0,18528,6.4,15910,153,32,-1767,-887,18.5,1852.8,18,22,0,14,8,10,0,0,0,0,20295,7.0,16797,149,48,1767,887,19.7,2029.5
4839866129,1,20,1,1,5,4,2,0,0,0,0,14733,7.0,18491,169,65,492,1507,23.4,1473.3,11,0,0,4,5,2,0,0,0,0,14241,7.0,16984,187,48,-492,-1507,23.5,1424.1
4839837612,0,8,0,0,2,4,1,1,1,0,0,13334,6.8,17500,180,44,-1754,-773,22.4,1333.4,73,1,1,4,2,2,0,0,0,0,15088,7.0,18273,179,64,1754,773,24.3,1508.8
4838150162,0,13,2,1,3,9,2,0,0,0,0,14123,6.6,15980,166,48,-2710,-603,21.4,1412.3,74,0,0,9,3,10,1,1,0,0,16833,6.6,16583,152,48,2710,603,20.0,1683.3
4838094801,1,9,0,0,8,7,3,1,1,0,0,16347,7.0,18009,160,60,1290,2992,22.0,1634.7,124,2,1,7,8,4,0,0,0,0,15057,6.2,15017,136,47,-1290,-2992,18.3,1505.7
4838022267,1,15,0,1,8,4,3,1,1,0,0,14607,6.8,17305,156,32,-36,652,18.8,1460.7,7,0,0,4,8,1,1,0,1,0,14643,6.6,16653,187,40,36,-652,22.7,1464.3
4837944677,1,10,0,0,7,5,8,1,1,0,0,16428,6.8,17384,161,48,808,206,20.9,1642.8,11,0,1,5,7,2,1,0,1,0,15620,7.0,17178,155,40,-808,-206,19.5,1562.0
4837902561,0,9,0,0,2,11,2,1,1,0,0,14474,6.6,16593,148,44,-4128,-1655,19.2,1447.4,11,0,1,11,2,15,0,0,0,0,18602,7.0,18248,207,44,4128,1655,25.1,1860.2
4837867501,1,14,2,1,7,9,7,1,1,0,0,14924,6.2,15111,155,36,-1627,-1777,19.1,1492.4,40,1,0,9,7,6,0,0,0,0,16551,6.8,16888,150,51,1627,1777,20.1,1655.1
4836174058,0,12,2,1,6,4,2,0,0,0,0,16252,6.8,17858,196,40,1723,3180,23.6,1625.2,279,0,0,4,6,4,0,0,0,0,14529,6.2,14678,135,42,-1723,-3180,17.7,1452.9
4836132095,1,15,1,1,6,2,7,1,1,0,0,16519,7.0,17292,204,52,2549,523,25.6,1651.9,13,1,0,2,6,2,0,0,0,0,13970,6.6,16769,164,52,-2549,-523,21.6,1397.0
4836085379,1,12,3,0,3,8,3,0,0,0,0,14918,6.4,16249,169,68,-2233,-1963,23.7,1491.8,15,0,1,8,3,8,0,0,0,0,17151,7.0,18212,182,64,2233,1963,24.6,1715.1
4835901794,1,16,0,1,5,1,6,0,0,0,0,14423,6.6,16249,123,48,1704,1012,17.1,1442.3,14,0,0,1,5,1,0,0,0,0,12719,6.4,15237,147,53,-1704,-1012,20.0,1271.9
4835853426,0,53,0,0,0,3,0,0,0,0,0,13173,6.8,17657,213,48,-1944,148,26.1,1317.3,14,1,1,3,0,3,1,1,0,0,15117,6.8,17509,184,55,1944,-148,23.9,1511.7
4835825954,1,15,1,1,11,5,7,0,0,0,0,17816,7.0,17557,168,52,3585,2090,22.0,1781.6,8,0,0,4,10,2,0,0,0,0,14231,6.4,15467,164,32,-3585,-2090,19.6,1423.1
4835791234,1,95,2,0,4,3,2,0,0,0,0,15356,6.8,17568,183,56,2274,2758,23.9,1535.6,14,5,1,3,4,4,1,1,0,0,13082,6.2,14810,142,40,-2274,-2758,18.2,1308.2
4835766546,1,14,0,1,11,2,9,0,0,0,0,16378,6.4,16352,187,39,3646,1702,22.6,1637.8,15,2,0,2,11,1,0,0,0,0,12732,6.4,14650,146,48,-3646,-1702,19.4,1273.2
4835739320,1,6,1,0,6,9,4,0,0,0,0,15762,6.2,14643,150,44,-889,-2200,19.4,1576.2,9,1,1,9,6,6,0,0,0,0,16651,6.4,16843,155,31,889,2200,18.6,1665.1
4791243508,1,18,1,0,1,3,1,1,0,1,0,14134,6.6,16975,174,64,-1422,-330,23.8,1413.4,14,1,1,3,1,2,0,0,0,0,15556,7.0,17305,194,52,1422,330,24.6,1555.6
4789915030,1,15,0,0,2,4,2,0,0,0,0,14598,6.6,16947,208,48,-515,322,25.6,1459.8,77,1,1,4,2,4,1,1,0,0,15113,6.6,16625,180,64,515,-322,24.4,1511.3
4789870937,1,14,1,1,8,3,3,1,0,1,0,17078,7.0,18237,208,56,1703,1250,26.4,1707.8,8,1,0,3,8,4,0,0,0,0,15375,6.6,16987,206,56,-1703,-1250,26.2,1537.5
4785854662,0,42,1,1,2,3,4,0,0,0,0,14605,6.4,16173,189,52,223,-582,24.1,1460.5,12,17,0,3,2,2,1,1,0,0,14382,6.4,16755,190,43,-223,582,23.3,1438.2
4785831180,1,52,0,0,0,5,0,0,0,0,0,13074,6.8,16522,181,48,-2855,-1653,22.9,1307.4,9,0,1,5,0,5,1,1,0,0,15929,6.8,18175,204,52,2855,1653,25.6,1592.9
4785804313,1,13,1,0,6,6,3,0,0,0,0,16136,6.2,15611,183,28,-158,-209,21.1,1613.6,176,0,1,6,6,8,0,0,0,0,16294,6.4,15820,177,20,158,209,19.7,1629.4
4858457023,0,12,14,0,5,5,3,0,0,0,0,15697,6.6,17064,157,56,1761,5,21.3,1569.7,35,0,1,5,5,2,1,1,0,0,13936,6.8,17059,129,40,-1761,-5,16.9,1393.6
4857602232,0,10,0,0,3,7,1,0,0,0,0,13156,6.6,16624,151,34,-4366,-1224,18.5,1315.6,14,0,1,7,3,2,0,0,0,0,17522,6.8,17848,201,46,4366,1224,24.7,1752.2
4856256663,1,20,0,1,16,22,12,0,0,0,0,61360,12.0,55000,0,0,22715,22000,0.0,6136.0,0,0,0,13,7,19,0,0,0,0,38645,7.2,33000,0,0,-22715,-22000,0.0,3864.5
4856235190,1,0,0,1,20,16,17,0,0,0,0,47000,10.2,48680,0,0,19313,20180,0.0,4700.0,0,0,0,8,12,10,0,0,0,0,27687,6.0,28500,0,0,-19313,-20180,0.0,2768.7
4856209448,1,31,3,0,12,20,12,0,0,0,0,44965,10.0,47500,2,0,16000,19000,0.2,4496.5,0,3,1,15,7,17,0,0,0,0,28965,6.0,28500,2,0,-16000,-19000,0.2,2896.5
4856183523,1,0,0,0,19,18,20,0,0,0,0,48750,10.0,47500,0,0,21600,19000,0.0,4875.0,27,0,1,11,12,7,0,0,0,0,27150,6.0,28500,0,0,-21600,-19000,0.0,2715.0
4856129836,0,11,1,1,7,6,11,0,0,0,0,16409,6.6,16478,154,40,-1143,-2184,19.4,1640.9,12,1,0,6,7,6,1,1,0,0,17552,7.2,18662,197,52,1143,2184,24.9,1755.2
4856074221,1,11,1,1,4,5,1,0,0,0,0,15010,6.8,17764,185,44,678,524,22.9,1501.0,10,1,0,5,4,3,0,0,0,0,14332,6.8,17240,160,52,-678,-524,21.2,1433.2
4855247624,0,17,0,1,6,3,2,0,0,0,0,14554,7.0,17665,152,38,-643,-160,19.0,1455.4,10,0,0,3,6,2,0,0,0,0,15197,6.6,17825,192,57,643,160,24.9,1519.7
4851154781,0,11,2,0,1,6,2,0,0,0,0,12852,6.4,16505,163,40,-2753,327,20.3,1285.2,15,2,1,6,1,11,1,1,0,0,15605,6.4,16178,152,56,2753,-327,20.8,1560.5
4850240477,1,7,1,0,6,8,6,0,0,0,0,16827,7.0,18224,180,58,-351,-200,23.8,1682.7,16,0,1,7,5,12,0,0,0,0,17178,7.0,18424,191,46,351,200,23.7,1717.8
4850223614,1,107,1,1,4,6,1,1,1,0,0,15113,7.2,18603,201,40,360,1703,24.1,1511.3,9,0,0,6,4,4,0,0,0,0,14753,6.6,16900,129,44,-360,-1703,17.3,1475.3
4848937278,0,9,1,0,1,4,0,0,0,0,0,13363,6.8,18624,166,44,-2103,-304,21.0,1336.3,16,2,1,4,1,4,1,1,0,0,15466,7.0,18928,208,67,2103,304,27.5,1546.6
4848897225,1,14,0,1,1,2,0,0,0,0,0,14157,6.8,17697,197,56,496,-291,25.3,1415.7,12,1,0,2,1,2,0,0,0,0,13661,7.0,17988,161,48,-496,291,20.9,1366.1
4848858227,1,65,0,0,4,5,2,0,0,0,0,16408,7.2,18960,159,46,388,1095,20.5,1640.8,12,1,1,5,4,3,0,0,0,0,16020,6.8,17865,204,52,-388,-1095,25.6,1602.0
4848817518,0,11,0,0,5,3,2,1,1,0,0,15442,7.4,18800,150,48,964,2617,19.8,1544.2,12,0,1,3,5,5,0,0,0,0,14478,6.4,16183,156,47,-964,-2617,20.3,1447.8
4848273964,0,12,0,0,7,6,4,1,1,0,0,14835,6.8,17364,139,52,-1397,-260,19.1,1483.5,199,0,1,6,7,3,0,0,0,0,16232,7.0,17624,189,44,1397,260,23.3,1623.2
4847195314,1,20,1,1,3,0,1,0,0,0,0,13714,6.4,16471,170,48,12,-424,21.8,1371.4,11,1,0,0,3,0,1,1,0,0,13702,6.6,16895,186,62,-12,424,24.8,1370.2
4847176193,1,13,1,1,6,7,7,0,0,0,0,16685,7.2,17884,189,51,453,440,24.0,1668.5,12,2,0,7,6,8,1,0,1,0,16232,6.8,17444,193,62,-453,-440,25.5,1623.2
4847145710,1,11,1,1,6,0,2,1,1,0,0,16132,7.2,19213,207,59,3592,2568,26.6,1613.2,14,1,0,0,6,0,0,0,0,0,12540,6.4,16645,159,56,-3592,-2568,21.5,1254.0
4760326068,0,10,0,0,4,9,4,0,0,0,0,13865,6.2,16226,133,48,-4180,-2654,18.1,1386.5,8,0,1,9,4,8,0,0,0,0,18045,7.2,18880,178,52,4180,2654,23.0,1804.5
4759821618,1,9,0,1,5,3,3,0,0,0,0,15001,6.8,17155,171,40,164,603,21.1,1500.1,7,0,0,3,5,2,0,0,0,0,14837,6.8,16552,193,48,-164,-603,24.1,1483.7
4759790426,0,10,2,1,6,6,6,1,1,0,0,16296,6.8,16592,217,44,1650,-123,26.1,1629.6,17,0,0,6,6,6,0,0,0,0,14646,6.4,16715,134,52,-1650,123,18.6,1464.6
4759585244,0,11,0,0,3,7,4,0,0,0,0,14047,6.4,16069,152,48,-2780,-1310,20.0,1404.7,12,0,1,7,3,2,0,0,0,0,16827,6.8,17379,166,64,2780,1310,23.0,1682.7
4758990037,1,18,0,0,6,5,1,0,0,0,0,15641,7.0,18478,178,62,1722,646,24.0,1564.1,9,0,1,5,6,4,0,0,0,0,13919,6.8,17832,152,49,-1722,-646,20.1,1391.9
4758948582,1,13,1,0,11,4,8,0,0,0,0,18248,6.6,17668,190,56,2724,1944,24.6,1824.8,13,1,1,4,11,6,2,1,1,0,15524,6.4,15724,188,32,-2724,-1944,22.0,1552.4
4758749687,1,132,0,1,7,8,3,0,0,0,0,17225,6.8,18274,205,56,1222,3430,26.1,1722.5,12,1,0,8,7,6,1,1,0,0,16003,6.2,14844,129,44,-1222,-3430,17.3,1600.3
4758606182,0,10,1,0,9,6,13,0,0,0,0,16783,6.4,15567,168,36,88,981,20.4,1678.3,13,1,1,6,9,6,1,1,0,0,16695,6.2,14586,142,56,-88,-981,19.8,1669.5
4757713649,0,12,0,1,3,4,4,0,0,0,0,13376,6.6,15513,136,44,-838,-1789,18.0,1337.6,12,0,0,4,3,0,0,0,0,0,14214,6.6,17302,169,48,838,1789,21.7,1421.4
4756006722,0,13,1,1,4,1,3,1,1,0,0,14442,6.8,17847,169,52,727,77,22.1,1444.2,11,0,0,1,4,1,0,0,0,0,13715,6.8,17770,196,44,-727,-77,24.0,1371.5
4753887529,1,11,1,0,2,5,2,0,0,0,0,13954,6.8,17675,161,48,-1628,-463,20.9,1395.4,296,1,1,5,2,4,1,1,0,0,15582,7.0,18138,191,60,1628,463,25.1,1558.2
4752841488,1,72,0,0,7,4,6,2,1,1,1,16277,7.2,18595,167,60,1057,1618,22.7,1627.7,7,0,1,4,7,2,0,0,0,0,15220,6.8,16977,154,36,-1057,-1618,19.0,1522.0
4752548731,1,10,0,1,8,5,4,0,0,0,0,16539,6.6,16601,196,56,1935,-1208,25.2,1653.9,13,0,0,4,7,1,1,1,0,0,14604,6.8,17809,168,48,-1935,1208,21.6,1460.4
4752150252,1,13,0,0,5,5,4,0,0,0,0,15402,6.6,16830,187,48,363,2108,23.5,1540.2,11,0,1,5,5,7,0,0,0,0,15039,6.2,14722,128,52,-363,-2108,18.0,1503.9
4751114452,0,10,1,1,4,6,3,0,0,0,0,13971,6.2,15475,153,48,-1614,-1869,20.1,1397.1,11,0,0,6,4,4,0,0,0,0,15585,6.8,17344,163,52,1614,1869,21.5,1558.5
4750717826,1,13,1,1,4,6,10,0,0,0,0,14217,6.4,15803,156,52,-1433,-1444,20.8,1421.7,8,1,0,6,4,5,1,1,0,0,15650,6.8,17247,142,47,1433,1444,18.9,1565.0
4749163619,0,28,0,1,1,2,1,0,0,0,0,13544,6.8,17951,172,52,-1462,-331,22.4,1354.4,101,7,0,2,1,2,2,1,1,0,15006,7.0,18282,183,46,1462,331,22.9,1500.6
4748423415,0,282,1,0,4,4,3,1,1,0,0,14450,6.8,16820,158,36,280,-27,19.4,1445.0,10,1,1,4,4,4,0,0,0,0,14170,6.6,16847,163,60,-280,27,22.3,1417.0
4746468260,1,11,2,0,3,3,2,0,0,0,0,13751,6.0,15161,140,43,1248,1341,18.3,1375.1,12,1,1,3,3,2,1,1,0,0,12503,6.0,13820,119,44,-1248,-1341,16.3,1250.3
4746418976,1,17,0,0,3,8,4,0,0,0,0,14697,6.8,16584,171,53,-1470,-424,22.4,1469.7,15,0,1,8,3,5,1,1,0,0,16167,6.8,17008,154,52,1470,424,20.6,1616.7
4858422184,0,34,0,1,17,29,35,0,0,0,1,34865,10.6,38034,65,0,-4390,-5111,6.5,3486.5,34,0,0,29,17,80,0,0,0,0,39255,11.4,43145,87,0,4390,5111,8.7,3925.5
4856578427,1,12,4,0,25,26,70,0,0,0,1,38418,11.6,42769,110,0,1876,2366,11.0,3841.8,13,0,1,25,24,46,0,0,0,0,36542,11.0,40403,77,0,-1876,-2366,7.7,3654.2
4856560415,1,0,2,1,17,23,36,0,0,0,0,35891,11.2,41266,94,0,1257,2770,9.4,3589.1,15,0,0,23,17,61,0,0,0,0,34634,11.0,38496,84,0,-1257,-2770,8.4,3463.4
4856251097,0,1,0,1,26,39,53,0,0,0,2,37777,11.2,40892,74,0,-5038,-7253,7.4,3777.7,0,0,0,39,26,95,0,0,0,0,42815,12.4,48145,116,0,5038,7253,11.6,4281.5
4855415305,1,77,0,0,25,21,62,0,0,0,0,36744,11.4,42659,85,0,-44,2208,8.5,3674.4,0,0,1,21,25,39,0,0,0,0,36788,11.2,40451,95,0,44,-2208,9.5,3678.8
4855397583,0,0,0,0,26,25,63,0,0,0,2,37919,11.2,40839,89,0,-170,996,8.9,3791.9,0,0,1,25,26,67,0,0,0,0,38089,11.0,39843,110,0,170,-996,11.0,3808.9
4855327325,0,32,0,0,11,14,33,0,0,0,1,33397,10.2,34586,101,0,-2453,-2681,10.1,3339.7,0,28,1,14,11,44,0,0,0,0,35850,10.6,37267,104,0,2453,2681,10.4,3585.0
4854275422,0,0,0,0,12,30,28,0,0,0,0,32710,10.2,34951,79,0,-3837,-5648,7.9,3271.0,0,0,1,30,12,89,0,0,0,0,36547,11.2,40599,98,0,3837,5648,9.8,3654.7
4854053774,0,23,0,0,18,19,50,0,0,0,0,35267,10.8,37029,93,0,101,211,9.3,3526.7,0,1,1,19,18,54,0,0,0,0,35166,10.6,36818,85,0,-101,-211,8.5,3516.6
4853125164,1,0,0,1,30,17,69,0,0,0,1,38882,11.6,43370,89,0,2625,5693,8.9,3888.2,0,0,0,17,30,40,0,0,0,0,36257,10.8,37677,99,0,-2625,-5693,9.9,3625.7
4853037814,1,0,0,0,24,15,59,0,0,0,0,37252,11.2,40492,106,0,2648,2041,10.6,3725.2,3,0,1,15,24,29,0,0,0,0,34604,10.8,38451,85,0,-2648,-2041,8.5,3460.4
4852063577,0,0,2,1,23,12,48,0,0,0,0,36689,11.2,40017,116,0,3922,5169,11.6,3668.9,12,0,0,12,23,29,0,0,0,0,32767,10.0,34848,97,0,-3922,-5169,9.7,3276.7
4852016364,1,0,1,0,33,24,81,0,0,0,1,40758,11.8,44808,105,0,4730,4038,10.5,4075.8,13,0,1,24,33,54,0,0,0,0,36028,11.2,40770,78,0,-4730,-4038,7.8,3602.8
4851105518,1,0,2,1,22,33,50,0,0,0,0,38309,11.0,40914,99,0,464,-1855,9.9,3830.9,16,0,0,33,22,93,0,0,0,0,37845,11.6,42769,82,0,-464,1855,8.2,3784.5
4850067400,0,0,0,1,14,17,28,0,0,0,1,32835,10.4,35271,92,0,-2757,-3272,9.2,3283.5,0,0,0,17,14,41,0,0,0,0,35592,11.0,38543,120,0,2757,3272,12.0,3559.2
4849215400,1,0,0,1,44,33,113,0,0,0,1,43835,12.6,49537,116,0,2910,2342,11.6,4383.5,0,0,0,33,44,82,0,0,0,0,40925,12.4,47195,110,0,-2910,-2342,11.0,4092.5
4849199311,0,0,0,0,13,12,33,0,0,0,1,34306,10.8,36475,92,0,-1888,-1263,9.2,3430.6,0,0,1,12,13,41,0,0,0,0,36194,10.8,37738,101,0,1888,1263,10.1,3619.4
4848200501,1,2,1,1,12,21,26,0,0,0,0,33346,10.4,37103,87,0,-411,-1432,8.7,3334.6,16,0,0,21,12,54,0,0,0,0,33757,10.8,38535,103,0,411,1432,10.3,3375.7
4848188452,0,0,0,1,28,33,90,0,0,0,2,40851,12.0,44971,95,0,278,751,9.5,4085.1,0,0,0,33,28,79,0,0,0,0,40573,11.8,44220,112,0,-278,-751,11.2,4057.3
4847085399,1,14,0,0,31,23,76,0,0,0,0,39801,11.6,43814,103,0,4093,4185,10.3,3980.1,13,4,1,23,31,51,0,0,0,0,35708,11.0,39629,87,0,-4093,-4185,8.7,3570.8
4770856228,1,6,1,0,6,14,4,0,0,0,0,18089,6.6,17003,189,52,-1803,-802,24.1,1808.9,27,1,1,14,6,11,1,1,0,0,19892,7.0,17805,164,68,1803,802,23.2,1989.2
4770837729,0,15,0,0,2,5,0,0,0,0,0,14078,6.6,17222,172,52,-1066,-749,22.4,1407.8,14,0,1,5,2,2,0,0,0,0,15144,7.0,17971,179,63,1066,749,24.2,1514.4
4770040351,0,11,1,1,7,6,1,0,0,0,0,16407,7.0,17975,203,62,480,608,26.5,1640.7,19,2,0,6,7,5,0,0,0,0,15927,6.8,17367,210,68,-480,-608,27.8,1592.7
4770033001,1,14,0,1,16,9,11,1,1,0,0,22016,7.0,18543,217,32,6019,3786,24.9,2201.6,10,0,0,9,16,4,0,0,0,0,15997,6.2,14757,134,52,-6019,-3786,18.6,1599.7
4770002726,1,13,2,1,5,3,5,0,0,0,0,15631,6.8,17947,194,60,782,-41,25.4,1563.1,11,0,0,3,5,1,0,0,0,0,14849,6.8,17988,202,48,-782,41,25.0,1484.9
4769989219,1,19,0,1,7,3,8,0,0,0,0,18202,7.2,18401,208,45,4525,2310,25.3,1820.2,4,0,0,3,7,4,1,1,0,0,13677,6.6,16091,161,50,-4525,-2310,21.1,1367.7
4769959019,0,11,1,1,5,5,5,0,0,0,0,15688,6.6,16234,144,52,-1350,-1390,19.6,1568.8,74,2,0,5,5,3,1,1,0,0,17038,6.6,17624,199,56,1350,1390,25.5,1703.8
4769930151,0,9,0,1,7,4,9,0,0,0,0,16479,7.0,17846,181,52,1672,1341,23.3,1647.9,10,0,0,4,7,9,1,1,0,0,14807,6.6,16505,185,36,-1672,-1341,22.1,1480.7
4769906011,1,11,1,0,2,3,2,1,1,0,0,15726,6.6,16929,171,50,1772,1396,22.1,1572.6,9,0,1,3,2,1,0,0,0,0,13954,6.2,15533,166,50,-1772,-1396,21.6,1395.4
4769869456,0,17,1,0,8,5,4,1,1,0,0,17431,7.0,18491,199,56,977,-355,25.5,1743.1,11,1,1,5,8,0,1,0,1,0,16454,7.2,18846,191,68,-977,355,25.9,1645.4
4769845738,0,13,3,0,7,8,5,0,0,0,0,17288,7.0,18752,186,60,-283,922,24.6,1728.8,15,1,1,8,7,1,0,0,0,0,17571,6.8,17830,199,56,283,-922,25.5,1757.1
4768989198,1,9,0,1,4,1,3,0,0,0,0,16395,6.6,17107,193,40,842,-870,23.3,1639.5,19,0,0,1,4,0,1,1,0,0,15553,6.8,17977,184,56,-842,870,24.0,1555.3
4768948369,1,14,2,1,3,3,3,0,0,0,0,14351,6.4,16025,153,52,545,-866,20.5,1435.1,21,0,0,3,3,4,0,0,0,0,13806,6.8,16891,164,52,-545,866,21.6,1380.6
4765854088,0,12,1,1,5,2,2,0,0,0,0,16099,6.8,17955,224,60,-20,611,28.4,1609.9,13,0,0,2,5,4,1,1,0,0,16119,6.8,17344,223,48,20,-611,27.1,1611.9
4474874541,0,24,2,0,9,9,9,1,1,0,0,17480,6.8,16590,164,41,-711,-118,20.5,1748.0,15,1,1,9,9,6,0,0,0,0,18191,6.4,16708,165,56,711,118,22.1,1819.1
4474798065,0,14,1,0,2,7,2,1,1,0,0,13954,6.2,14813,166,32,-2271,-3922,19.8,1395.4,13,1,1,7,2,3,0,0,0,0,16225,7.0,18735,207,52,2271,3922,25.9,1622.5
4474771379,0,9,0,1,2,1,1,0,0,0,0,13321,6.2,14960,146,52,-685,-2205,19.8,1332.1,11,0,0,1,2,0,0,0,0,0,14006,6.6,17165,192,52,685,2205,24.4,1400.6
4434300601,0,15,1,0,2,5,1,0,0,0,0,13812,6.6,17127,171,52,-1559,-175,22.3,1381.2,16,1,1,5,2,6,0,0,0,0,15371,6.6,17302,191,50,1559,175,24.1,1537.1
4415859899,1,82,1,0,4,4,3,0,0,0,0,15200,7.2,18664,178,52,-421,682,23.0,1520.0,8,4,1,4,4,3,0,0,0,0,15621,7.0,17982,188,59,421,-682,24.7,1562.1
4415825911,1,9,2,1,5,1,8,1,1,0,0,19065,7.2,19033,237,63,5125,1962,30.0,1906.5,8,0,0,1,5,1,0,0,0,0,13940,6.8,17071,130,52,-5125,-1962,18.2,1394.0
4833405429,0,43,1,0,4,7,5,0,0,0,0,14362,6.0,14669,154,40,-1124,-1776,19.4,1436.2,9,4,1,7,4,2,1,1,0,0,15486,6.2,16445,182,51,1124,1776,23.3,1548.6
4833389019,1,10,0,1,4,2,2,0,0,0,0,15516,7.0,18000,200,56,1646,16,25.6,1551.6,10,2,0,2,4,0,0,0,0,0,13870,6.8,17984,176,44,-1646,-16,22.0,1387.0
4832483537,0,9,0,1,6,7,4,0,0,0,0,16855,7.0,17677,186,64,-766,-1189,25.0,1685.5,10,0,0,7,6,5,1,1,0,0,17621,7.0,18866,190,40,766,1189,23.0,1762.1
4832474325,0,141,0,0,4,4,2,0,0,0,0,15322,6.6,16944,166,56,449,-413,22.2,1532.2,7,1,1,4,4,1,0,0,0,0,14873,6.8,17357,179,44,-449,413,22.3,1487.3
4832383879,1,13,0,1,17,12,26,0,0,0,1,33470,10.8,36929,95,59,3186,2256,15.4,3347.0,14,0,0,12,17,13,0,0,0,0,30284,10.2,34673,83,59,-3186,-2256,14.2,3028.4
4826014093,1,53,0,0,4,6,5,0,0,0,0,14456,7.0,17478,179,56,-601,-176,23.5,1445.6,7,0,1,6,4,3,1,1,0,0,15057,6.8,17654,163,48,601,176,21.1,1505.7
4825999851,0,13,1,0,5,9,4,0,0,0,0,14414,6.8,16558,164,40,-1979,-1532,20.4,1441.4,25,1,1,8,4,4,1,1,0,0,16393,7.0,18090,187,48,1979,1532,23.5,1639.3
4825977138,1,10,0,1,4,4,0,0,0,0,1,15464,6.8,17509,170,53,524,1362,22.3,1546.4,12,0,0,4,4,4,1,1,0,0,14940,6.4,16147,182,70,-524,-1362,25.2,1494.0
4825963444,1,10,0,1,9,6,6,0,0,0,0,17099,7.2,18593,188,52,2033,1817,24.0,1709.9,16,0,0,6,9,4,1,1,0,0,15066,6.6,16776,173,48,-2033,-1817,22.1,1506.6
4825938008,1,0,0,0,13,24,28,0,0,0,0,33629,10.6,37201,103,0,-2177,-2732,10.3,3362.9,16,0,1,24,13,56,0,0,0,0,35806,11.0,39933,95,0,2177,2732,9.5,3580.6
4825926081,0,0,0,0,14,30,37,0,0,0,1,32962,10.2,36232,92,0,-5856,-6064,9.2,3296.2,0,0,1,30,14,56,0,0,0,0,38818,11.4,42296,124,0,5856,6064,12.4,3881.8
4825884683,0,212,2,1,3,5,5,0,0,0,0,15201,6.6,16667,195,50,76,-10,24.5,1520.1,8,1,0,5,3,8,1,1,0,0,15125,6.8,16677,175,48,-76,10,22.3,1512.5
4825859200,0,15,0,0,6,4,6,0,0,0,0,16506,7.0,18502,201,44,1338,357,24.5,1650.6,11,2,1,4,6,3,1,1,0,0,15168,6.8,18145,194,56,-1338,-357,25.0,1516.8
4777431291,1,10,1,1,7,4,9,1,1,0,0,18077,6.6,16898,194,47,2983,-242,24.1,1807.7,120,0,0,3,6,2,0,0,0,0,15094,6.8,17140,164,56,-2983,242,22.0,1509.4
4777420686,0,25,0,0,3,6,3,0,0,0,0,14705,6.2,14759,162,36,-1927,-2683,19.8,1470.5,10,0,1,6,3,6,0,0,0,0,16632,6.8,17442,180,42,1927,2683,22.2,1663.2
4777411031,0,71,0,1,2,2,0,0,0,0,0,12858,6.4,15407,135,60,-3476,-2938,19.5,1285.8,12,0,0,2,2,2,2,1,1,0,16334,7.2,18345,237,64,3476,2938,30.1,1633.4
4773560419,0,11,0,0,5,10,2,0,0,0,0,16385,7.0,18491,197,60,-1644,1447,25.7,1638.5,16,1,1,10,5,6,1,1,0,0,18029,6.8,17044,189,52,1644,-1447,24.1,1802.9
4770099773,1,11,1,0,9,8,11,1,1,0,0,17969,6.6,16242,177,48,1192,-705,22.5,1796.9,9,2,1,8,9,7,0,0,0,0,16777,6.8,16947,197,48,-1192,705,24.5,1677.7
4770091736,1,12,2,1,5,3,3,1,1,0,0,16135,7.0,17402,187,42,527,174,22.9,1613.5,10,1,0,3,5,2,0,0,0,0,15608,6.8,17228,187,60,-527,-174,24.7,1560.8
4768328968,1,16,4,0,10,9,11,0,0,0,0,18052,6.6,17273,187,40,895,1053,22.7,1805.2,196,1,1,9,10,15,1,1,0,0,17157,6.6,16220,174,56,-895,-1053,23.0,1715.7
4858390461,1,0,0,0,16,19,21,0,0,0,0,46306,10.0,47500,2,0,18803,19000,0.2,4630.6,3,0,1,11,8,8,0,0,0,0,27503,6.0,28500,1,0,-18803,-19000,0.1,2750.3
4858378223,1,0,6,1,23,17,28,0,0,0,0,48824,10.0,47500,0,0,20883,19000,0.0,4882.4,31,0,0,8,14,7,0,0,0,0,27941,6.0,28500,1,0,-20883,-19000,0.1,2794.1
4858357251,1,6,0,1,17,19,22,0,0,0,0,48400,10.0,47500,0,0,19500,19000,0.0,4840.0,0,0,0,14,12,10,0,0,0,0,28900,6.0,28500,0,0,-19500,-19000,0.0,2890.0
4858331881,1,0,0,0,11,18,6,0,0,0,0,58850,12.0,55000,0,0,21300,22000,0.0,5885.0,0,0,1,10,3,13,0,0,0,0,37550,7.2,33000,0,0,-21300,-22000,0.0,3755.0
4858309147,1,0,0,1,20,16,22,0,0,0,0,47750,10.0,47500,1,0,20950,19000,0.1,4775.0,2,0,0,7,11,6,0,0,0,0,26800,6.0,28500,0,0,-20950,-19000,0.0,2680.0
4857913916,1,17,1,0,4,6,4,0,0,0,0,17057,7.0,18233,218,52,1034,767,27.0,1705.7,12,1,1,6,4,4,0,0,0,0,16023,7.0,17466,183,44,-1034,-767,22.7,1602.3
4857891221,1,17,2,0,5,3,0,0,0,0,0,17276,7.4,20187,228,64,2873,4613,29.2,1727.6,34,3,1,3,5,2,0,0,0,0,14403,6.6,15574,146,48,-2873,-4613,19.4,1440.3
4857868709,1,87,1,0,6,1,7,1,1,0,0,16171,6.6,17081,176,43,2428,1298,21.9,1617.1,17,1,1,1,6,2,0,0,0,0,13743,6.4,15783,169,52,-2428,-1298,22.1,1374.3
4857493279,1,0,0,1,17,15,14,0,0,0,0,47020,10.0,47500,0,0,18448,19000,0.0,4702.0,0,0,0,8,10,9,0,0,0,0,28572,6.0,28500,2,0,-18448,-19000,0.2,2857.2
4856525212,0,10,0,0,1,5,0,0,0,0,0,12964,6.2,15859,152,56,-1693,-1014,20.8,1296.4,16,1,1,5,1,1,1,1,0,0,14657,6.8,16873,170,56,1693,1014,22.6,1465.7
4856473217,0,16,2,0,1,5,0,1,1,0,0,12249,6.6,16787,128,60,-3165,-1733,18.8,1224.9,21,1,1,5,1,9,0,0,0,0,15414,7.0,18520,197,60,3165,1733,25.7,1541.4
4856424249,0,101,0,0,5,5,3,0,0,0,0,14608,6.6,17576,188,52,-1245,122,24.0,1460.8,8,0,1,5,5,4,0,0,0,0,15853,6.8,17454,196,60,1245,-122,25.6,1585.3
4856388596,0,11,1,1,5,6,2,0,0,0,0,14260,6.4,16089,161,48,-3004,-1151,20.9,1426.0,17,0,0,6,5,7,0,0,0,0,17264,6.6,17240,174,54,3004,1151,22.8,1726.4
4856362330,1,15,0,1,6,4,4,0,0,0,0,16448,7.0,17810,196,48,1697,249,24.4,1644.8,14,0,0,4,6,0,1,0,1,0,14751,7.0,17561,185,52,-1697,-249,23.7,1475.1
4855139826,1,17,2,1,5,4,1,0,0,0,0,16493,7.0,18240,182,50,1049,617,23.2,1649.3,17,0,0,4,5,4,1,1,0,0,15444,6.8,17623,191,63,-1049,-617,25.4,1544.4
4855060401,1,10,0,1,1,4,1,0,0,0,0,14217,6.6,17090,211,52,-508,-1358,26.3,1421.7,7,1,0,4,1,3,0,0,0,0,14725,7.0,18448,184,64,508,1358,24.8,1472.5
4854829025,1,9,1,1,3,4,1,1,0,1,0,16071,7.2,19574,207,60,1061,1376,26.7,1607.1,8,0,0,4,3,3,0,0,0,0,15010,7.2,18198,200,52,-1061,-1376,25.2,1501.0
4853641118,1,0,0,1,21,12,19,0,0,0,0,47700,10.0,47500,0,0,20200,19000,0.0,4770.0,0,0,0,5,14,4,0,0,0,0,27500,6.0,28500,0,0,-20200,-19000,0.0,2750.0
4853629044,1,0,0,1,26,12,30,0,0,0,0,63780,13.0,62500,0,0,27630,28000,0.0,6378.0,0,0,0,5,19,7,0,0,0,0,36150,7.4,34500,0,0,-27630,-28000,0.0,3615.0
4858454056,1,8,0,1,6,5,2,1,1,0,0,15195,7.0,18153,186,52,511,1147,23.8,1519.5,14,0,0,5,6,2,0,0,0,0,14684,6.8,17006,145,48,-511,-1147,19.3,1468.4
4858404270,0,158,0,1,3,3,2,0,0,0,0,14418,7.0,17465,176,56,116,-295,23.2,1441.8,22,1,0,3,3,2,0,0,0,0,14302,6.8,17760,182,56,-116,295,23.8,1430.2
4858373021,1,15,3,1,4,1,3,1,1,0,0,15254,7.0,18069,196,56,1986,1477,25.2,1525.4,15,2,0,1,4,1,0,0,0,0,13268,6.6,16592,172,52,-1986,-1477,22.4,1326.8
4857816856,0,28,1,1,3,3,1,1,1,0,0,13740,6.6,16930,168,48,-1309,-834,21.6,1374.0,14,14,0,3,3,3,0,0,0,0,15049,6.8,17764,177,60,1309,834,23.7,1504.9
4857416784,0,57,2,0,5,3,4,0,0,0,0,15930,6.6,16251,175,53,-313,-408,22.8,1593.0,14,1,1,3,5,4,0,0,0,0,16243,6.6,16659,178,52,313,408,23.0,1624.3
4857358227,0,15,1,0,1,4,0,1,1,0,0,13248,6.6,16843,147,56,-3118,-2328,20.3,1324.8,15,1,1,4,1,3,0,0,0,0,16366,7.0,19171,207,64,3118,2328,27.1,1636.6
4856424005,1,12,0,1,11,8,10,0,0,0,0,17892,6.6,16260,166,44,-91,-279,21.0,1789.2,199,0,0,8,11,12,1,1,0,0,17983,6.6,16539,155,52,91,279,20.7,1798.3
4856352608,0,13,1,0,4,3,4,0,0,0,0,16687,6.8,16718,172,43,1692,-198,21.5,1668.7,11,0,1,3,4,0,0,0,0,0,14995,6.6,16916,175,48,-1692,198,22.3,1499.5
4856305445,0,12,1,0,0,9,0,0,0,0,0,13626,7.0,16608,161,44,-3201,-2527,20.5,1362.6,156,0,1,9,0,3,1,1,0,0,16827,6.8,19135,195,52,3201,2527,24.7,1682.7
4855872990,1,15,1,0,5,6,3,0,0,0,0,15387,6.6,16694,199,44,-59,1753,24.3,1538.7,34,0,1,6,5,5,0,0,0,0,15446,6.4,14941,159,40,59,-1753,19.9,1544.6
4855820340,0,13,1,0,2,3,2,1,1,0,0,13927,6.8,17191,176,49,-495,-715,22.5,1392.7,10,2,1,3,2,2,0,0,0,0,14422,6.6,17906,199,32,495,715,23.1,1442.2
4855793781,0,10,1,0,5,5,5,1,1,0,0,15462,6.6,17182,194,52,386,-477,24.6,1546.2,9,2,1,5,5,1,0,0,0,0,15076,6.8,17659,217,52,-386,477,26.9,1507.6
4855753470,1,12,2,0,8,5,10,1,1,0,0,17153,6.6,16383,181,56,1327,-1115,23.7,1715.3,10,2,1,5,8,3,0,0,0,0,15826,6.8,17498,180,56,-1327,1115,23.6,1582.6
4855741850,0,10,9,1,3,3,0,0,0,0,0,14866,6.8,17592,175,60,-684,-40,23.5,1486.6,33,1,0,3,3,3,1,1,0,0,15550,6.8,17632,189,48,684,40,23.7,1555.0
4855271513,0,16,1,1,4,7,8,0,0,0,0,16650,6.6,16077,127,48,-82,-553,17.5,1665.0,13,2,0,7,4,3,0,0,0,0,16732,6.6,16630,187,52,82,553,23.9,1673.2
4855224525,1,8,0,1,11,5,4,0,0,0,0,19555,7.2,18750,217,60,4068,1578,27.7,1955.5,16,0,0,5,11,2,1,1,0,0,15487,7.0,17172,165,60,-4068,-1578,22.5,1548.7
4855177323,1,16,3,1,5,4,2,0,0,0,0,14728,6.2,15829,177,36,1368,2570,21.3,1472.8,12,1,0,4,5,6,0,0,0,0,13360,5.8,13259,124,40,-1368,-2570,16.4,1336.0
4853989712,1,14,1,0,2,8,1,0,0,0,0,15881,6.4,16531,197,51,-1154,-466,24.8,1588.1,101,1,1,8,2,12,1,1,0,0,17035,6.6,16997,192,40,1154,466,23.2,1703.5
4852498371,1,11,0,0,23,20,55,0,0,0,1,37951,11.2,42523,111,0,5663,5767,11.1,3795.1,0,0,1,20,23,30,0,0,0,0,32288,10.4,36756,52,0,-5663,-5767,5.2,3228.8
4843174704,0,10,9,0,4,8,5,0,0,0,0,14651,6.4,15474,171,40,-2157,-2926,21.1,1465.1,29,0,1,8,4,4,0,0,0,0,16808,7.0,18400,206,52,2157,2926,25.8,1680.8
4843146142,1,9,0,0,5,3,6,1,1,0,0,15858,7.0,18298,191,52,394,1096,24.3,1585.8,11,0,1,3,5,2,0,0,0,0,15464,6.6,17202,212,51,-394,-1096,26.3,1546.4
4820746973,0,0,0,0,17,26,35,0,0,0,1,37491,10.8,39534,107,0,-151,123,10.7,3749.1,0,0,1,26,17,70,0,0,0,0,37642,10.8,39411,90,0,151,-123,9.0,3764.2
4813976742,0,9,1,1,4,6,1,0,0,0,0,15333,7.2,18759,226,60,-140,844,28.6,1533.3,11,0,0,5,3,7,0,0,0,0,15473,6.8,17915,201,52,140,-844,25.3,1547.3
4813951437,0,15,1,0,3,9,1,0,0,0,0,13398,6.2,15498,157,48,-4558,-2629,20.5,1339.8,13,3,1,9,3,11,1,1,0,0,17956,7.0,18127,190,60,4558,2629,25.0,1795.6
4813913602,1,10,3,0,9,5,6,0,0,0,0,18306,6.8,18127,224,60,2257,941,28.4,1830.6,10,2,1,5,9,5,0,0,0,0,16049,6.8,17186,225,47,-2257,-941,27.2,1604.9
4813054544,0,9,0,1,7,3,1,0,0,0,0,16093,7.0,18355,208,48,776,1037,25.6,1609.3,9,1,0,3,7,3,0,0,0,0,15317,6.8,17318,211,60,-776,-1037,27.1,1531.7
4813016706,1,16,0,1,4,3,4,0,0,0,0,15700,7.2,17848,189,56,948,-89,24.5,1570.0,6,1,0,3,4,1,0,0,0,0,14752,6.8,17937,196,52,-948,89,24.8,1475.2
4812990521,1,14,1,0,2,7,2,0,0,0,0,15293,7.0,17733,209,63,-2741,-776,27.2,1529.3,11,0,1,7,2,9,1,1,0,0,18034,7.0,18509,203,56,2741,776,25.9,1803.4
4812968260,0,15,2,1,6,8,7,0,0,0,0,16264,6.8,17366,197,56,-1884,-2727,25.3,1626.4,13,1,0,8,6,4,1,1,0,0,18148,7.4,20093,206,52,1884,2727,25.8,1814.8
4812928948,0,17,2,0,2,3,2,1,1,0,0,15606,7.0,19004,197,72,544,1298,26.9,1560.6,16,1,1,3,2,3,0,0,0,0,15062,6.6,17706,184,56,-544,-1298,24.0,1506.2
4796336463,0,13,1,0,5,12,4,0,0,0,0,14718,6.6,16928,166,52,-3594,-1439,21.8,1471.8,11,2,1,12,5,8,0,0,0,0,18312,7.0,18367,208,44,3594,1439,25.2,1831.2
4796319975,1,10,2,1,6,3,6,1,1,0,0,17518,7.2,18675,225,59,2816,1185,28.4,1751.8,23,1,0,3,6,2,0,0,0,0,14702,6.6,17490,198,48,-2816,-1185,24.6,1470.2
4791651924,0,11,0,1,5,1,2,0,0,0,0,15976,7.0,18519,176,52,1606,832,22.8,1597.6,10,0,0,1,5,0,0,0,0,0,14370,6.8,17687,219,52,-1606,-832,27.1,1437.0
4791631688,0,16,1,1,3,6,2,0,0,0,0,14318,6.6,16595,179,40,-1554,-1454,21.9,1431.8,11,1,0,6,3,2,1,1,0,0,15872,7.0,18049,184,60,1554,1454,24.4,1587.2
4791619854,0,277,0,1,1,5,0,1,1,0,0,12722,7.0,17150,154,44,-2766,-944,19.8,1272.2,8,0,0,5,1,4,0,0,0,0,15488,7.0,18094,162,62,2766,944,22.4,1548.8
4791607992,0,10,16,0,0,4,0,0,0,0,0,11653,6.8,16540,134,52,-4594,-1614,18.6,1165.3,34,0,1,4,0,2,0,0,0,0,16247,7.2,18154,211,56,4594,1614,26.7,1624.7
4791594066,1,13,0,0,3,3,2,1,1,0,0,15513,6.8,17643,211,47,1779,-248,25.8,1551.3,9,1,1,3,3,1,0,0,0,0,13734,6.6,17891,162,56,-1779,248,21.8,1373.4
4791541424,1,13,0,0,3,5,2,1,0,1,0,15678,6.8,18053,222,36,-170,-335,25.8,1567.8,9,2,1,5,3,5,1,1,0,0,15848,7.0,18388,143,48,170,335,19.1,1584.8
4732127985,1,17,0,1,6,7,4,0,0,0,0,16043,6.8,17489,164,47,795,1536,21.1,1604.3,196,1,0,7,6,9,1,1,0,0,15248,6.6,15953,147,46,-795,-1536,19.3,1524.8
4730469263,0,163,1,0,2,4,2,0,0,0,0,13936,6.6,16501,155,44,-2166,-1869,19.9,1393.6,11,0,1,4,2,3,0,0,0,0,16102,6.8,18370,213,52,2166,1869,26.5,1610.2
4730422268,1,14,0,0,3,2,2,0,0,0,0,15007,6.8,17930,192,51,1266,773,24.3,1500.7,12,0,1,2,3,1,0,0,0,0,13741,6.8,17157,181,44,-1266,-773,22.5,1374.1
4730363147,1,159,1,0,2,5,2,1,1,0,0,14056,6.6,16992,175,44,-1698,-1312,21.9,1405.6,10,1,1,5,2,5,0,0,0,0,15754,7.2,18304,183,56,1698,1312,23.9,1575.4
4730318383,1,16,1,1,9,3,7,1,1,0,0,17500,7.0,18040,168,50,4395,2331,21.8,1750.0,13,1,0,3,9,1,0,0,0,0,13105,6.4,15709,131,43,-4395,-2331,17.4,1310.5
4725957031,1,14,0,1,11,2,12,0,0,0,0,18439,7.0,17855,181,52,4011,2212,23.3,1843.9,49,1,0,2,11,1,0,0,0,0,14428,6.6,15643,151,44,-4011,-2212,19.5,1442.8
4725912736,1,12,0,1,9,5,3,0,0,0,0,16185,7.0,17899,175,48,422,1465,22.3,1618.5,23,0,0,5,9,5,0,0,0,0,15763,6.4,16434,174,53,-422,-1465,22.7,1576.3
4725825656,1,117,0,0,2,6,1,1,0,1,0,15028,7.0,18283,178,56,-66,-760,23.4,1502.8,12,0,1,5,1,5,1,1,0,0,15094,7.0,19043,162,68,66,760,23.0,1509.4
4719473342,1,0,0,1,19,10,15,0,0,0,0,47700,10.0,47500,0,0,20727,19000,0.0,4770.0,0,0,0,3,12,4,0,0,0,0,26973,6.0,28500,0,0,-20727,-19000,0.0,2697.3
4719448743,1,355,0,0,12,17,12,0,0,0,0,44909,10.0,47500,3,0,16631,19000,0.3,4490.9,0,0,1,11,6,10,0,0,0,0,28278,6.0,28500,0,0,-16631,-19000,0.0,2827.8
4719413191,1,36,0,0,17,16,18,0,0,0,0,61035,12.0,55000,1,0,22630,22000,0.1,6103.5,0,0,1,10,11,11,0,0,0,0,38405,7.2,33000,2,0,-22630,-22000,0.2,3840.5
4719381230,1,0,0,1,12,16,13,0,0,0,0,45950,10.0,47500,0,0,13500,19000,0.0,4595.0,0,0,0,11,7,9,0,0,0,0,32450,6.0,28500,0,0,-13500,-19000,0.0,3245.0
4719348492,1,53,0,1,19,16,12,0,0,0,0,63405,12.0,55000,0,0,26200,18000,0.0,6340.5,0,0,0,6,9,9,0,0,0,0,37205,8.0,37000,0,0,-26200,-18000,0.0,3720.5
4719322810,1,125,0,0,12,17,14,0,0,0,0,44906,10.0,47500,2,0,16006,16000,0.2,4490.6,60,0,1,11,6,8,0,0,0,0,28900,6.6,31500,0,0,-16006,-16000,0.0,2890.0
4719284180,1,252,6,1,18,17,19,0,0,0,0,63804,12.0,55000,9,0,26499,22000,0.9,6380.4,20,3,0,11,12,9,0,0,0,0,37305,7.2,33000,1,0,-26499,-22000,0.1,3730.5
4719245273,1,3,0,0,12,17,13,0,0,0,0,60636,12.0,55000,0,0,22000,22000,0.0,6063.6,0,0,1,11,6,11,0,0,0,0,38636,7.2,33000,0,0,-22000,-22000,0.0,3863.6
4719225948,1,0,0,0,18,17,19,0,0,0,0,62760,12.0,55000,0,0,26201,22000,0.0,6276.0,0,0,1,9,10,9,0,0,0,0,36559,7.2,33000,1,0,-26201,-22000,0.1,3655.9
4719189183,1,0,0,1,16,11,18,0,0,0,0,63086,12.0,55000,0,0,26912,22000,0.0,6308.6,6,0,0,7,12,3,0,0,0,0,36174,7.2,33000,0,0,-26912,-22000,0.0,3617.4
4719146456,1,0,0,0,9,15,14,0,0,0,0,59575,12.0,55000,0,0,32025,22000,0.0,5957.5,0,0,1,12,6,8,0,0,0,0,27550,7.2,33000,0,0,-32025,-22000,0.0,2755.0
4719120326,1,13,0,1,15,18,20,0,0,0,0,61300,12.0,55000,0,0,22700,22000,0.0,6130.0,0,0,0,13,10,10,0,0,0,0,38600,7.2,33000,0,0,-22700,-22000,0.0,3860.0
4857264428,0,9,0,0,3,7,2,0,0,0,0,14681,6.6,16580,138,56,-1564,923,19.4,1468.1,16,0,1,7,3,9,0,0,0,0,16245,6.2,15657,166,48,1564,-923,21.4,1624.5
4855735661,0,27,1,1,7,3,12,0,0,0,0,17027,7.0,17467,193,40,3356,928,23.3,1702.7,9,1,0,3,7,3,1,1,0,0,13671,6.4,16539,155,56,-3356,-928,21.1,1367.1
4852528462,0,11,0,0,1,3,0,0,0,0,0,13489,6.8,17114,177,42,-2845,-1067,21.9,1348.9,6,2,1,3,1,3,1,1,0,0,16334,7.0,18181,221,52,2845,1067,27.3,1633.4
4851400465,0,9,7,0,1,5,1,0,0,0,0,13878,7.0,17407,119,49,-1228,-759,16.8,1387.8,22,1,1,5,1,3,1,1,0,0,15106,7.0,18166,188,54,1228,759,24.2,1510.6
4851383744,0,8,0,0,2,4,1,0,0,0,0,13826,6.8,17245,145,52,330,1169,19.7,1382.6,11,0,1,4,2,1,0,0,0,0,13496,6.4,16076,135,43,-330,-1169,17.8,1349.6
4850327232,1,8,2,0,3,6,2,0,0,0,0,13812,6.6,16263,169,52,-1055,971,22.1,1381.2,140,0,1,6,3,5,1,1,0,0,14867,6.4,15292,149,48,1055,-971,19.7,1486.7
4850313452,0,206,0,1,4,6,2,0,0,0,0,14082,6.8,16931,161,46,-1045,-602,20.7,1408.2,17,1,0,6,4,4,1,1,0,0,15127,6.8,17533,160,56,1045,602,21.6,1512.7
4849941032,1,83,1,0,2,2,3,0,0,0,0,14236,6.8,18228,174,52,1413,1040,22.6,1423.6,11,1,1,2,2,1,1,1,0,0,12823,6.6,17188,130,56,-1413,-1040,18.6,1282.3
4848811396,0,10,0,1,4,7,2,0,0,0,0,14443,6.6,16809,162,56,-455,-267,21.8,1444.3,10,0,0,7,4,2,0,0,0,0,14898,6.6,17076,140,48,455,267,18.8,1489.8
4847798712,1,14,0,0,4,4,1,0,0,0,0,14512,6.6,16369,167,44,-468,-686,21.1,1451.2,13,0,1,4,4,4,0,0,0,0,14980,6.8,17055,172,45,468,686,21.7,1498.0
4847359222,1,13,2,1,11,8,4,0,0,0,0,16206,6.4,15284,134,40,460,2230,17.4,1620.6,9,0,0,8,11,8,0,0,0,0,15746,5.6,13054,105,39,-460,-2230,14.4,1574.6
4847351971,1,18,2,1,9,3,5,0,0,0,0,16861,6.8,18416,174,44,3696,2751,21.8,1686.1,10,1,0,3,9,2,0,0,0,0,13165,6.4,15665,139,44,-3696,-2751,18.3,1316.5
4846768802,1,12,0,0,3,4,5,0,0,0,0,14003,6.6,16588,140,52,302,79,19.2,1400.3,13,0,1,4,3,1,1,1,0,0,13701,6.4,16509,166,38,-302,-79,20.4,1370.1
4845799884,1,9,1,1,3,5,2,0,0,0,0,15290,7.0,18305,173,52,627,1472,22.5,1529.0,408,0,0,5,3,3,1,1,0,0,14663,6.8,16833,173,40,-627,-1472,21.3,1466.3
4844021321,0,13,0,1,1,6,1,1,1,0,0,13908,6.6,17505,158,40,-2196,-1272,19.8,1390.8,13,0,0,6,1,4,0,0,0,0,16104,7.0,18777,178,52,2196,1272,23.0,1610.4
4843989459,1,11,0,1,6,6,3,1,1,0,0,17660,7.0,18563,184,56,3074,2691,24.0,1766.0,8,0,0,6,6,4,0,0,0,0,14586,6.4,15872,135,47,-3074,-2691,18.2,1458.6
4843966976,1,6,0,0,3,7,1,0,0,0,0,12880,6.0,15042,146,20,-2891,-3381,16.6,1288.0,6,0,1,7,3,2,1,1,0,0,15771,6.8,18423,152,60,2891,3381,21.2,1577.1
4841776279,0,10,0,1,8,6,5,0,0,0,0,16848,6.8,17011,167,44,2675,1179,21.1,1684.8,11,0,0,6,8,0,0,0,0,0,14173,6.4,15832,145,32,-2675,-1179,17.7,1417.3
4841067586,1,220,0,1,4,5,1,1,1,0,0,14571,7.2,18091,166,48,520,1077,21.4,1457.1,72,0,0,4,3,3,0,0,0,0,14051,6.6,17014,160,48,-520,-1077,20.8,1405.1
4841030631,0,25,0,1,4,6,0,0,0,0,0,13336,6.6,16838,154,48,-1084,-924,20.2,1333.6,8,12,0,6,4,2,0,0,0,0,14420,6.6,17762,152,51,1084,924,20.3,1442.0
4845234840,0,0,0,1,24,28,54,0,0,0,1,38161,11.2,41602,100,0,593,-517,10.0,3816.1,0,0,0,28,24,84,0,0,0,0,37568,11.4,42119,100,0,-593,517,10.0,3756.8
4844040747,1,0,0,1,23,23,66,0,0,0,0,36753,11.4,41138,95,0,493,232,9.5,3675.3,0,0,0,23,23,64,0,0,0,0,36260,11.4,40906,86,0,-493,-232,8.6,3626.0
4842077542,0,19,0,1,29,25,70,0,0,0,1,41609,12.2,45797,118,0,3363,2420,11.8,4160.9,0,1,0,25,29,65,0,0,0,0,38246,11.6,43377,75,0,-3363,-2420,7.5,3824.6
4840914217,1,0,0,0,16,13,46,0,0,0,0,33806,10.4,36470,83,0,-357,-508,8.3,3380.6,83,0,1,13,16,29,0,0,0,0,34163,10.4,36978,97,0,357,508,9.7,3416.3
4839975264,0,1,0,1,20,15,58,0,0,0,0,34498,10.6,37033,103,0,315,-198,10.3,3449.8,8,0,0,15,20,47,0,0,0,0,34183,10.6,37231,96,0,-315,198,9.6,3418.3
4839389935,0,0,0,1,20,29,42,0,0,0,0,36239,11.4,41309,84,0,-1903,-2090,8.4,3623.9,0,0,0,29,20,69,0,0,0,0,38142,11.6,43399,98,0,1903,2090,9.8,3814.2
4838730414,1,85,0,1,24,19,64,0,0,0,1,37061,11.2,40216,106,0,2826,3543,10.6,3706.1,0,0,0,19,24,46,0,0,0,0,34235,10.4,36673,81,0,-2826,-3543,8.1,3423.5
4838709682,1,13,0,1,27,21,60,0,0,0,0,36396,11.2,40883,78,0,835,1795,7.8,3639.6,0,4,0,21,27,45,0,0,0,0,35561,11.0,39088,103,0,-835,-1795,10.3,3556.1
4838380263,1,0,0,1,32,21,69,0,0,0,1,38314,11.8,43749,95,0,2021,1683,9.5,3831.4,0,0,0,21,32,44,0,0,0,0,36293,11.2,42066,92,0,-2021,-1683,9.2,3629.3
4838346489,0,0,0,0,24,29,65,0,0,0,1,37626,11.2,40525,105,0,326,-2467,10.5,3762.6,0,0,1,29,24,53,0,0,0,0,37300,11.6,42992,91,0,-326,2467,9.1,3730.0
4832947333,0,25,0,0,19,25,48,0,0,0,1,34885,10.8,39054,94,0,-3211,-2859,9.4,3488.5,0,0,1,25,19,62,0,0,0,0,38096,11.4,41913,90,0,3211,2859,9.0,3809.6
4832933056,0,0,0,1,26,28,80,0,0,0,2,38164,11.4,41580,92,0,-1873,-3075,9.2,3816.4,0,0,0,28,26,74,0,0,0,0,40037,11.8,44655,108,0,1873,3075,10.8,4003.7
4832551148,0,0,3,0,20,28,42,0,0,0,0,37331,10.8,39773,97,0,114,-3967,9.7,3733.1,30,0,1,28,20,67,0,0,0,0,37217,11.8,43740,88,0,-114,3967,8.8,3721.7
4832376684,0,26,0,0,22,20,53,0,0,0,0,35064,10.8,38750,84,0,-52,859,8.4,3506.4,0,1,1,20,22,47,0,0,0,0,35116,10.6,37891,83,0,52,-859,8.3,3511.6
4832367215,0,0,0,0,21,36,60,0,0,0,1,35940,10.8,39784,87,0,-4032,-4230,8.7,3594.0,0,0,1,36,21,89,0,0,0,0,39972,11.8,44014,86,0,4032,4230,8.6,3997.2
4832083939,0,0,0,1,15,26,41,0,0,0,2,34480,10.6,36619,88,0,-2652,-4811,8.8,3448.0,0,0,0,26,15,50,0,0,0,0,37132,11.2,41430,104,0,2652,4811,10.4,3713.2
4831550688,1,15,0,1,6,4,3,1,1,0,0,14916,6.8,17147,171,44,1048,175,21.5,1491.6,35,1,0,4,6,7,0,0,0,0,13868,6.8,16972,150,48,-1048,-175,19.8,1386.8
4831538266,1,24,0,1,22,14,66,0,0,0,0,36554,11.2,40438,100,0,2600,4402,10.0,3655.4,0,3,0,14,22,29,0,0,0,0,33954,10.4,36036,97,0,-2600,-4402,9.7,3395.4
4828581115,0,14,1,0,3,3,3,0,0,0,0,14811,6.6,16886,192,32,-603,-235,22.4,1481.1,16,2,1,3,3,3,1,1,0,0,15414,6.6,17121,206,52,603,235,25.8,1541.4
4769096583,0,13,0,0,3,11,0,0,0,0,0,13326,6.4,15826,159,40,-5975,-3710,19.9,1332.6,14,1,1,11,3,9,1,1,0,0,19301,7.4,19536,181,64,5975,3710,24.5,1930.1
4765390761,0,16,0,0,6,4,1,1,1,0,0,15240,6.8,16600,168,60,-79,492,22.8,1524.0,10,0,1,4,6,2,0,0,0,0,15319,6.4,16108,176,52,79,-492,22.8,1531.9
4765354612,1,11,0,1,7,3,5,1,1,0,0,16702,6.8,17087,166,49,3024,1319,21.5,1670.2,12,1,0,3,7,2,1,0,1,0,13678,6.4,15768,139,56,-3024,-1319,19.5,1367.8
4761937795,1,17,2,0,11,5,5,0,0,0,0,17755,7.2,19453,185,56,2727,1916,24.1,1775.5,10,1,1,5,11,1,1,0,1,0,15028,7.0,17537,173,52,-2727,-1916,22.5,1502.8
4761910769,0,8,4,0,10,2,8,0,0,0,0,18309,6.8,18396,188,44,4974,3452,23.2,1830.9,13,1,1,2,10,2,1,0,1,0,13335,6.2,14944,126,68,-4974,-3452,19.4,1333.5
4857837878,0,13,16,0,6,12,3,0,0,0,0,14969,6.0,14745,148,36,-2657,-2274,18.4,1496.9,37,0,1,12,6,11,0,0,0,0,17626,6.8,17019,155,47,2657,2274,20.2,1762.6
4857298327,0,8,0,0,3,5,1,0,0,0,0,13621,7.2,18170,187,48,-2268,105,23.5,1362.1,8,0,1,5,3,3,0,0,0,0,15889,6.8,18065,197,52,2268,-105,24.9,1588.9
4857224291,0,11,0,1,3,7,2,0,0,0,0,14134,6.8,17083,171,56,-3605,-1011,22.7,1413.4,13,0,0,7,3,8,0,0,0,0,17739,7.2,18094,187,44,3605,1011,23.1,1773.9
4856775074,1,3,0,1,22,15,18,0,0,0,0,62035,12.0,55000,0,0,26235,22000,0.0,6203.5,25,0,0,5,12,10,0,0,0,0,35800,7.2,33000,0,0,-26235,-22000,0.0,3580.0
4855735294,1,21,1,0,6,3,9,0,0,0,0,15699,6.8,17137,149,52,1477,-298,20.1,1569.9,125,2,1,3,6,3,1,1,0,0,14222,6.6,17435,177,56,-1477,298,23.3,1422.2
4854101544,1,7,0,0,8,3,7,2,1,1,0,17087,6.8,17288,178,48,3693,1058,22.6,1708.7,13,0,1,3,8,1,0,0,0,0,13394,6.6,16230,151,48,-3693,-1058,19.9,1339.4
4854014920,1,35,1,1,7,5,10,1,1,0,0,17121,6.6,16642,125,56,859,679,18.1,1712.1,234,12,0,5,7,5,0,0,0,0,16262,6.4,15963,183,36,-859,-679,21.9,1626.2
4852254112,1,10,2,1,9,5,3,0,0,0,0,17897,7.2,19119,181,56,2696,2318,23.7,1789.7,12,0,0,5,9,6,1,1,0,0,15201,6.8,16801,140,48,-2696,-2318,18.8,1520.1
4851951254,1,11,0,1,3,7,2,1,1,0,0,15789,6.8,17704,193,52,704,948,24.5,1578.9,13,1,0,7,3,4,0,0,0,0,15085,6.6,16756,162,44,-704,-948,20.6,1508.5
4851548546,1,20,1,0,4,4,5,0,0,0,0,14167,6.6,17428,160,64,-82,363,22.4,1416.7,11,2,1,4,4,3,0,0,0,0,14249,6.8,17065,191,42,82,-363,23.3,1424.9
4849756536,1,20,2,0,3,4,1,0,0,0,0,14337,6.6,16902,198,48,-1113,-358,24.6,1433.7,10,1,1,4,3,1,0,0,0,0,15450,6.8,17260,171,48,1113,358,21.9,1545.0
4849498842,1,13,0,0,6,4,5,1,1,0,0,16335,6.8,17263,192,56,1573,1299,24.8,1633.5,8,0,1,4,6,2,0,0,0,0,14762,6.4,15964,156,40,-1573,-1299,19.6,1476.2
4847689890,0,8,1,0,5,7,4,0,0,0,0,14584,6.2,15901,163,44,-1638,-351,20.7,1458.4,149,0,1,7,5,11,1,1,0,0,16222,6.6,16252,181,52,1638,351,23.3,1622.2
4846555946,1,8,0,0,2,7,1,0,0,0,0,13760,6.8,17693,176,60,-3306,-1219,23.6,1376.0,14,0,1,7,2,5,0,0,0,0,17066,7.0,18912,201,56,3306,1219,25.7,1706.6
4843989065,1,11,0,0,8,5,5,1,1,0,0,16290,6.8,18247,157,50,1520,1845,20.7,1629.0,28,0,1,5,8,7,0,0,0,0,14770,6.6,16402,172,49,-1520,-1845,22.1,1477.0
4841997285,1,13,0,1,6,2,2,1,1,0,0,15867,7.2,18995,187,64,2018,3042,25.1,1586.7,13,2,0,2,6,1,0,0,0,0,13849,6.4,15953,168,52,-2018,-3042,22.0,1384.9
4840993130,1,13,0,1,7,4,6,1,1,0,0,16227,6.8,17445,173,52,1521,-887,22.5,1622.7,18,0,0,4,7,0,0,0,0,0,14706,7.0,18332,190,64,-1521,887,25.4,1470.6
4838755507,1,22,13,1,6,1,6,1,1,0,0,16682,7.0,18241,188,68,3272,1497,25.6,1668.2,28,2,0,1,6,1,0,0,0,0,13410,6.6,16744,194,40,-3272,-1497,23.4,1341.0
4837961471,1,23,0,0,2,4,0,0,0,0,0,13909,6.4,16345,192,41,-1175,-1324,23.3,1390.9,17,0,1,4,2,4,0,0,0,0,15084,6.8,17669,166,56,1175,1324,22.2,1508.4
4835820668,0,13,0,0,2,16,2,0,0,0,0,13600,6.4,15738,162,48,-6161,-3397,21.0,1360.0,15,0,1,16,2,15,1,1,0,0,19761,7.2,19135,205,48,6161,3397,25.3,1976.1
4856787897,1,12,1,0,4,8,0,0,0,0,0,15409,6.8,17658,128,48,-871,973,17.6,1540.9,15,1,1,8,4,6,0,0,0,0,16280,6.8,16685,149,52,871,-973,20.1,1628.0
4856744617,0,6,0,0,3,5,0,0,0,0,0,11997,6.2,15496,103,52,-4507,-3542,15.5,1199.7,9,0,1,4,2,7,1,1,0,0,16504,7.4,19038,161,60,4507,3542,22.1,1650.4
4855799804,1,165,1,0,9,5,5,0,0,0,0,15608,6.4,16567,177,36,818,-570,21.3,1560.8,12,2,1,4,8,3,0,0,0,0,14790,6.8,17137,188,42,-818,570,23.0,1479.0
4855677381,1,10,0,0,6,5,10,0,0,0,0,15633,6.8,16314,153,48,1058,149,20.1,1563.3,19,0,1,5,6,7,0,0,0,0,14575,6.6,16165,177,44,-1058,-149,22.1,1457.5
4855632186,0,18,2,1,6,4,6,1,1,0,0,14830,6.8,17357,172,56,853,-119,22.8,1483.0,13,0,0,3,5,3,0,0,0,0,13977,7.0,17476,160,56,-853,119,21.6,1397.7
4855614192,1,14,0,0,6,5,6,0,0,0,0,15461,6.4,16259,190,24,-136,-963,21.4,1546.1,13,0,1,5,6,5,2,1,1,0,15597,6.8,17222,214,52,136,963,26.6,1559.7
4855542177,0,13,1,1,6,7,6,0,0,0,0,15354,6.4,16157,178,40,-2025,-2370,21.8,1535.4,12,0,0,7,6,5,1,1,0,0,17379,7.2,18527,161,60,2025,2370,22.1,1737.9
4855519561,1,25,0,0,2,10,1,0,0,0,0,14135,6.4,16468,148,48,-2007,-1092,19.6,1413.5,29,3,1,10,2,5,1,1,0,0,16142,6.8,17560,152,44,2007,1092,19.6,1614.2
4855492994,0,17,1,1,5,4,4,1,1,0,0,14681,6.8,16959,193,40,-765,-951,23.3,1468.1,12,1,0,4,5,2,0,0,0,0,15446,6.8,17910,182,68,765,951,25.0,1544.6
4854752484,0,16,0,0,7,7,8,1,0,1,0,15191,6.4,15895,150,43,-861,-2083,19.3,1519.1,31,3,1,7,7,7,1,1,0,0,16052,7.0,17978,165,60,861,2083,22.5,1605.2
4854720230,0,34,0,0,5,9,3,1,1,0,0,14686,6.4,16190,177,48,-1597,-249,22.5,1468.6,228,9,1,9,5,4,1,0,1,0,16283,6.6,16439,137,55,1597,249,19.2,1628.3
4854660562,1,148,2,0,7,7,1,1,1,0,0,15844,6.6,17166,160,56,981,867,21.6,1584.4,111,0,1,7,7,2,0,0,0,0,14863,6.4,16299,146,44,-981,-867,19.0,1486.3
4854468578,0,11,1,1,9,3,5,1,1,0,0,17526,7.0,17884,173,48,2940,1149,22.1,1752.6,14,1,0,3,9,1,0,0,0,0,14586,6.6,16735,141,36,-2940,-1149,17.7,1458.6
4854451705,1,12,0,1,10,3,13,1,1,0,0,17400,7.0,17352,143,48,2720,1453,19.1,1740.0,20,1,0,3,10,2,0,0,0,0,14680,6.6,15899,144,44,-2720,-1453,18.8,1468.0
4854426249,1,11,0,1,6,4,3,1,0,1,0,16422,6.8,18178,144,79,2078,2379,22.3,1642.2,15,1,0,4,6,6,1,1,0,0,14344,6.4,15799,141,44,-2078,-2379,18.5,1434.4
4854398613,1,17,2,0,9,8,8,0,0,0,0,16559,6.6,16628,158,44,-323,-786,20.2,1655.9,15,0,1,8,9,7,1,0,1,0,16882,6.8,17414,160,56,323,786,21.6,1688.2
4853415623,0,15,0,0,2,8,1,0,0,0,0,14865,7.0,17290,162,48,-1285,-471,21.0,1486.5,10,0,1,8,2,4,1,1,0,0,16150,6.6,17761,188,56,1285,471,24.4,1615.0
4853399285,0,13,0,1,8,5,5,1,1,0,0,16062,6.4,15976,144,36,-147,329,18.0,1606.2,137,0,0,5,8,3,0,0,0,0,16209,6.2,15647,136,44,147,-329,18.0,1620.9
4851918139,1,13,0,0,2,5,1,0,0,0,0,13318,6.2,15357,165,44,-2220,-2361,20.9,1331.8,13,0,1,5,2,3,1,1,0,0,15538,6.8,17718,147,60,2220,2361,20.7,1553.8
4747165545,0,11,2,1,5,4,5,0,0,0,0,15657,7.0,18762,172,60,-82,920,23.2,1565.7,38,1,0,4,5,3,0,0,0,0,15739,6.8,17842,178,52,82,-920,23.0,1573.9
4747149425,0,13,2,0,8,10,4,1,1,0,0,15081,6.4,15844,168,40,-3818,-2323,20.8,1508.1,18,1,1,10,8,9,0,0,0,0,18899,6.8,18167,189,52,3818,2323,24.1,1889.9
4747130847,1,19,0,1,4,3,6,1,1,0,0,16778,7.0,18078,207,56,1650,1480,26.3,1677.8,133,3,0,3,4,4,0,0,0,0,15128,6.6,16598,162,60,-1650,-1480,22.2,1512.8
4747109882,0,23,2,0,3,8,1,0,0,0,0,14146,6.4,16252,194,52,-2699,-1425,24.6,1414.6,13,1,1,8,3,15,1,1,0,0,16845,7.0,17677,212,56,2699,1425,26.8,1684.5
4734417986,1,0,0,0,31,31,80,0,0,0,1,40599,12.0,46276,93,0,2588,1564,9.3,4059.9,0,0,1,31,31,68,0,0,0,0,38011,11.6,44712,94,0,-2588,-1564,9.4,3801.1
4734380689,0,24,0,1,30,27,69,0,0,0,0,38332,11.6,43967,84,0,-1108,-442,8.4,3833.2,0,0,0,27,30,57,0,0,0,0,39440,11.6,44409,83,0,1108,442,8.3,3944.0
4734355536,0,1,0,0,20,33,34,0,0,0,1,35387,10.8,38834,95,0,-3693,-3283,9.5,3538.7,0,0,1,33,20,82,0,0,0,0,39080,11.4,42117,110,0,3693,3283,11.0,3908.0
4733592264,0,7,1,0,0,4,0,0,0,0,0,11321,6.2,15842,156,40,-2765,-1245,19.6,1132.1,232,0,1,4,0,5,1,1,0,0,14086,6.6,17087,138,52,2765,1245,19.0,1408.6
4733559351,1,9,0,1,6,1,6,0,0,0,0,15708,7.0,18224,181,56,3452,2723,23.7,1570.8,10,1,0,1,6,2,0,0,0,0,12256,6.4,15501,137,48,-3452,-2723,18.5,1225.6
4733533908,1,19,0,1,7,3,4,0,0,0,0,16808,7.2,18814,164,60,3211,2991,22.4,1680.8,12,1,0,3,7,2,0,0,0,0,13597,6.4,15823,159,46,-3211,-2991,20.5,1359.7
4733343255,1,0,0,1,26,33,46,0,0,0,0,38504,11.4,42184,107,0,-919,-1782,10.7,3850.4,0,0,0,33,26,77,0,0,0,0,39423,11.6,43966,93,0,919,1782,9.3,3942.3
4732314282,0,2,0,1,26,17,75,0,0,0,1,38734,10.8,39479,87,0,3195,1757,8.7,3873.4,3,1,0,17,26,43,0,0,0,0,35539,10.8,37722,91,0,-3195,-1757,9.1,3553.9
4732291330,0,22,0,0,20,31,48,0,0,0,0,37268,11.2,41534,128,0,-2335,-3269,12.8,3726.8,0,41,1,31,20,76,0,0,0,0,39603,11.8,44803,91,0,2335,3269,9.1,3960.3
4732266642,0,0,0,0,13,20,19,0,0,0,0,33217,10.6,35871,94,0,-2049,-4568,9.4,3321.7,0,0,1,20,13,54,0,0,0,0,35266,11.0,40439,99,0,2049,4568,9.9,3526.6
4732232673,1,17,12,1,4,2,3,0,0,0,0,16067,6.8,17231,169,44,1200,347,21.3,1606.7,23,2,0,2,4,2,1,0,1,0,14867,6.6,16884,198,59,-1200,-347,25.7,1486.7
4731441348,1,11,0,1,23,18,62,0,0,0,1,37932,11.2,40504,97,0,3047,1846,9.7,3793.2,0,7,0,18,23,41,0,0,0,0,34885,10.8,38658,89,0,-3047,-1846,8.9,3488.5
4731406963,0,13,0,0,5,4,6,0,0,0,0,14230,6.6,17194,160,40,-784,815,20.0,1423.0,16,0,1,4,5,7,1,1,0,0,15014,6.6,16379,143,64,784,-815,20.7,1501.4
4728879031,1,5,1,1,8,5,5,0,0,0,0,16736,6.8,16987,202,52,84,-274,25.4,1673.6,7,0,0,5,8,5,0,0,0,0,16652,7.0,17261,187,56,-84,274,24.3,1665.2
4727753993,0,56,0,1,2,5,2,0,0,0,0,14530,6.8,17349,182,58,-1959,-1036,24.0,1453.0,13,4,0,5,2,5,1,1,0,0,16489,7.0,18385,203,48,1959,1036,25.1,1648.9
4777191794,1,13,1,1,6,5,7,0,0,0,0,16704,7.2,18038,186,64,1106,-292,25.0,1670.4,110,1,0,5,6,2,0,0,0,0,15598,7.0,18330,200,48,-1106,292,24.8,1559.8
4776889514,1,11,7,1,4,3,2,0,0,0,0,13755,6.8,17194,144,68,-2660,-1974,21.2,1375.5,300,1,0,3,4,0,0,0,0,0,16415,7.0,19168,204,56,2660,1974,26.0,1641.5
4776819374,0,9,0,0,1,8,1,0,0,0,0,13594,6.6,16183,137,48,-3765,-2376,18.5,1359.4,354,0,1,8,1,4,1,1,0,0,17359,7.0,18559,187,52,3765,2376,23.9,1735.9
4776261748,1,12,0,1,8,2,9,1,1,0,0,16620,6.8,18007,193,60,2192,128,25.3,1662.0,11,0,0,2,8,0,0,0,0,0,14428,6.8,17879,219,60,-2192,-128,27.9,1442.8
4774669573,0,9,13,0,2,3,1,0,0,0,0,13299,6.0,14507,148,36,-1947,-2470,18.4,1329.9,43,0,1,3,2,2,0,0,0,0,15246,6.6,16977,172,40,1947,2470,21.2,1524.6
4774646618,0,8,1,0,4,6,2,1,1,0,0,16085,7.2,17850,216,60,-162,795,27.6,1608.5,7,1,1,6,4,4,0,0,0,0,16247,6.4,17055,179,48,162,-795,22.7,1624.7
4774057719,1,11,3,0,0,3,0,1,1,0,0,13396,7.0,16968,188,48,-2288,-1031,23.6,1339.6,79,2,1,3,0,2,0,0,0,0,15684,7.0,17999,186,56,2288,1031,24.2,1568.4
4774021810,0,14,1,1,9,6,7,0,0,0,0,17979,6.8,17268,188,52,2159,48,24.0,1797.9,120,2,0,6,9,6,1,1,0,0,15820,6.8,17220,192,48,-2159,-48,24.0,1582.0
4773857875,0,21,1,0,1,3,1,0,0,0,0,14549,7.2,18760,186,72,-135,1259,25.8,1454.9,113,1,1,3,1,3,1,1,0,0,14684,6.6,17501,181,64,135,-1259,24.5,1468.4
4773388690,1,10,0,1,6,3,5,1,1,0,0,15780,6.6,16931,215,43,72,-271,25.8,1578.0,13,0,0,3,6,2,0,0,0,0,15708,6.8,17202,192,48,-72,271,24.0,1570.8
4773360890,1,13,1,1,6,3,4,1,1,0,0,15743,6.8,17591,161,56,1847,792,21.7,1574.3,10,0,0,3,6,0,0,0,0,0,13896,6.8,16799,190,44,-1847,-792,23.4,1389.6
4773115439,0,7,1,0,6,3,2,0,0,0,0,14825,7.0,18549,169,52,84,1614,22.1,1482.5,230,0,1,3,6,5,0,0,0,0,14741,6.8,16935,180,56,-84,-1614,23.6,1474.1
4772726649,1,18,8,1,4,4,4,1,1,0,0,15179,6.8,17402,178,55,273,1039,23.3,1517.9,40,0,0,4,4,4,0,0,0,0,14906,6.6,16363,171,44,-273,-1039,21.5,1490.6
4771117181,0,140,0,1,1,3,1,0,0,0,0,15144,6.8,17875,183,52,554,946,23.5,1514.4,9,0,0,3,1,2,0,0,0,0,14590,6.8,16929,179,48,-554,-946,22.7,1459.0
4771091608,0,19,3,0,4,5,4,0,0,0,0,15593,6.6,16025,171,52,-55,-1097,22.3,1559.3,109,1,1,5,4,2,1,1,0,0,15648,6.6,17122,169,46,55,1097,21.5,1564.8
4770994063,1,10,1,0,5,4,7,0,0,0,0,14826,6.4,15855,151,44,255,928,19.5,1482.6,164,1,1,4,5,2,0,0,0,0,14571,6.0,14927,134,44,-255,-928,17.8,1457.1
4770338963,1,75,1,1,8,1,6,0,0,0,0,16229,6.6,16996,144,56,2188,-152,20.0,1622.9,181,1,0,1,8,1,0,0,0,0,14041,6.8,17148,197,56,-2188,152,25.3,1404.1
4769375404,1,36,0,1,12,4,10,1,0,1,0,17134,6.4,16089,137,42,2518,192,17.9,1713.4,225,0,0,4,12,1,0,0,0,0,14616,6.4,15897,157,56,-2518,-192,21.3,1461.6
4769353863,0,17,0,1,6,1,4,0,0,0,0,16982,7.4,18638,202,60,4027,1728,26.2,1698.2,224,1,0,1,6,2,0,0,0,0,12955,6.4,16910,144,56,-4027,-1728,20.0,1295.5
4857685822,1,6,0,0,8,10,6,0,0,0,0,14796,6.0,14346,133,4,-578,-305,13.7,1479.6,0,0,1,10,8,7,0,0,0,0,15374,6.4,14651,168,0,578,305,16.8,1537.4
4857360957,1,12,0,1,3,4,2,0,0,0,0,14442,6.6,16771,181,35,1261,608,21.6,1444.2,16,1,0,4,3,0,1,1,0,0,13181,6.2,16163,141,40,-1261,-608,18.1,1318.1
4857314802,0,11,2,1,6,3,3,0,0,0,0,16348,7.4,18797,177,56,3089,2482,23.3,1634.8,10,1,0,3,6,0,0,0,0,0,13259,6.6,16315,154,44,-3089,-2482,19.8,1325.9
4856641137,1,4,0,0,6,12,3,0,0,0,0,15186,6.2,14627,147,0,-1047,847,14.7,1518.6,0,0,1,12,6,10,0,0,0,0,16233,6.0,13780,139,0,1047,-847,13.9,1623.3
4856628099,1,4,0,0,8,6,4,0,0,0,0,15617,6.2,15724,124,48,1145,711,17.2,1561.7,1,0,1,6,8,7,0,0,0,0,14472,6.2,15013,145,0,-1145,-711,14.5,1447.2
4856016907,0,10,0,0,1,7,0,0,0,0,0,14796,6.8,17726,202,60,-1445,-63,26.2,1479.6,16,2,1,7,1,4,1,1,0,0,16241,6.8,17789,158,52,1445,63,21.0,1624.1
4855980587,0,12,1,0,1,5,1,0,0,0,0,13679,6.6,16517,171,56,-1961,-1396,22.7,1367.9,57,1,1,5,1,2,0,0,0,0,15640,6.8,17913,165,72,1961,1396,23.7,1564.0
4855916817,0,10,1,1,2,1,1,0,0,0,0,12580,6.4,15319,127,52,-691,-577,17.9,1258.0,13,1,0,1,2,0,0,0,0,0,13271,6.4,15896,146,44,691,577,19.0,1327.1
4855852211,1,7,0,0,7,9,6,0,0,0,0,16274,6.4,15567,165,0,841,1228,16.5,1627.4,6,0,1,9,7,8,0,0,0,0,15433,6.0,14339,132,0,-841,-1228,13.2,1543.3
4855827728,0,12,2,0,6,6,5,0,0,0,0,15062,7.0,18103,167,44,-452,-832,21.1,1506.2,13,1,1,5,5,0,0,0,0,0,15514,7.0,18935,221,56,452,832,27.7,1551.4
4855797690,1,14,2,1,8,1,7,1,1,0,0,16241,7.0,17989,167,56,2227,-71,22.3,1624.1,9,2,0,1,8,0,0,0,0,0,14014,6.8,18060,199,44,-2227,71,24.3,1401.4
4855769490,0,10,2,1,7,2,7,0,0,0,0,16828,6.8,16966,207,52,2182,-60,25.9,1682.8,9,0,0,2,7,2,0,0,0,0,14646,6.6,17026,161,52,-2182,60,21.3,1464.6
4855330187,1,22,0,0,6,7,6,0,0,0,0,16298,6.6,16974,168,52,1366,243,22.0,1629.8,11,2,1,7,6,3,0,0,0,0,14932,6.6,16731,144,52,-1366,-243,19.6,1493.2
4854973630,1,27,1,0,13,15,14,0,0,0,0,45005,10.0,47500,4,0,16805,19000,0.4,4500.5,0,0,1,9,7,8,0,0,0,0,28200,6.0,28500,0,0,-16805,-19000,0.0,2820.0
4854906045,1,11,1,1,2,7,0,0,0,0,0,14118,6.0,14797,182,36,-1500,-2267,21.8,1411.8,15,3,0,7,2,4,0,0,0,0,15618,6.6,17064,178,44,1500,2267,22.2,1561.8
4854844474,1,16,2,0,9,11,8,0,0,0,0,16609,6.2,15745,130,32,-1794,-272,16.2,1660.9,13,3,1,11,9,9,1,1,0,0,18403,6.6,16017,130,48,1794,272,17.8,1840.3
4854810581,1,15,1,1,8,3,4,0,0,0,0,16121,6.8,17714,166,52,2033,1758,21.8,1612.1,11,0,0,3,8,1,0,0,0,0,14088,6.4,15956,128,52,-2033,-1758,18.0,1408.8
4757349422,1,205,1,1,8,5,6,0,0,0,0,16301,6.8,17179,170,52,272,-136,22.2,1630.1,12,2,0,5,8,5,0,0,0,0,16029,6.6,17315,184,55,-272,136,23.9,1602.9
4757317073,1,9,1,1,13,3,9,0,0,0,1,20724,7.4,19374,178,56,6992,3856,23.4,2072.4,11,0,0,3,13,5,0,0,0,0,13732,6.4,15518,150,48,-6992,-3856,19.8,1373.2
4757277049,1,6,1,1,2,5,0,0,0,0,0,15119,7.0,18026,170,60,1931,4125,23.0,1511.9,12,0,0,5,2,2,0,0,0,0,13188,5.6,13901,116,40,-1931,-4125,15.6,1318.8
4858466083,1,7,0,1,18,28,35,0,0,0,0,36076,11.0,39106,95,0,-1477,-2498,9.5,3607.6,0,0,0,28,18,80,0,0,0,0,37553,11.0,41604,80,0,1477,2498,8.0,3755.3
4858187382,1,9,0,1,32,20,69,0,0,0,1,41173,12.0,44783,89,0,5698,6213,8.9,4117.3,0,2,0,20,32,51,0,0,0,0,35475,10.8,38570,92,0,-5698,-6213,9.2,3547.5
4858170819,0,10,0,0,7,28,18,0,0,0,0,31311,10.2,33996,87,0,-6235,-7101,8.7,3131.1,0,2,1,28,7,90,0,0,0,0,37546,11.4,41097,100,0,6235,7101,10.0,3754.6
4858095344,0,15,0,1,21,15,34,0,0,0,1,35274,10.6,37795,58,0,-74,214,5.8,3527.4,0,0,0,15,21,29,0,0,0,0,35348,10.6,37581,112,0,74,-214,11.2,3534.8
4858005377,1,288,0,1,30,31,70,0,0,0,0,39197,11.6,42450,89,0,82,-2785,8.9,3919.7,0,0,0,31,30,61,0,0,0,0,39115,11.8,45235,101,0,-82,2785,10.1,3911.5
4857560519,0,14,3,0,3,7,2,0,0,0,0,13767,6.4,15734,170,39,-2491,-2831,20.9,1376.7,14,4,1,7,3,3,1,1,0,0,16258,7.2,18565,172,43,2491,2831,21.5,1625.8
4857536433,0,0,0,0,27,22,55,0,0,0,1,39333,11.6,43834,99,0,3205,5710,9.9,3933.3,2,0,1,22,27,46,0,0,0,0,36128,10.8,38124,88,0,-3205,-5710,8.8,3612.8
4857356951,0,22,0,1,25,22,76,0,0,0,0,39381,11.2,40596,96,0,2082,-109,9.6,3938.1,0,9,0,22,25,58,0,0,0,0,37299,11.2,40705,105,0,-2082,109,10.5,3729.9
4856980371,1,0,0,1,26,31,68,0,0,0,0,37339,11.6,43375,87,0,-887,-119,8.7,3733.9,9,0,0,31,26,75,0,0,0,0,38226,11.6,43494,107,0,887,119,10.7,3822.6
4856519833,1,131,0,0,31,18,74,0,0,0,1,39368,11.2,41438,109,0,5216,2978,10.9,3936.8,0,0,1,18,31,36,0,0,0,0,34152,10.8,38460,81,0,-5216,-2978,8.1,3415.2
4856490213,0,0,0,1,17,15,36,0,0,0,1,36205,11.0,38974,104,0,1949,2948,10.4,3620.5,0,0,0,15,17,34,0,0,0,0,34256,10.4,36026,100,0,-1949,-2948,10.0,3425.6
4855704755,0,0,0,0,17,35,31,0,0,0,1,37288,11.4,42030,93,0,-5116,-4479,9.3,3728.8,0,0,1,35,17,101,0,0,0,0,42404,12.0,46509,95,0,5116,4479,9.5,4240.4
4855107455,1,0,0,0,22,18,48,0,0,0,0,34591,11.2,40441,101,0,-782,2670,10.1,3459.1,0,0,1,18,22,44,0,0,0,0,35373,11.0,37771,111,0,782,-2670,11.1,3537.3
4854139373,1,9,11,1,4,3,1,0,0,0,0,15170,6.8,17377,179,64,718,869,24.3,1517.0,35,0,0,3,4,5,0,0,0,0,14452,6.6,16508,142,44,-718,-869,18.6,1445.2
4854088964,0,24,0,1,16,21,33,0,0,0,1,34680,10.4,36209,106,0,-2608,-3355,10.6,3468.0,0,1,0,21,16,55,0,0,0,0,37288,11.0,39564,110,0,2608,3355,11.0,3728.8
4854050168,0,0,0,1,26,33,45,0,0,0,0,36292,11.4,41790,64,0,-3818,-3435,6.4,3629.2,1,0,0,33,26,82,0,0,0,0,40110,11.8,45225,107,0,3818,3435,10.7,4011.0
4853621963,0,83,0,0,21,22,33,0,0,0,0,36123,11.2,39962,116,0,-32,-189,11.6,3612.3,5,0,1,22,21,40,0,0,0,0,36155,11.0,40151,95,0,32,189,9.5,3615.5
4853437049,0,0,0,0,24,28,46,0,0,0,0,36073,11.2,41167,81,0,-4868,-2404,8.1,3607.3,0,0,1,28,24,67,0,0,0,0,40941,11.6,43571,120,0,4868,2404,12.0,4094.1
4852403603,0,16,0,0,21,35,39,0,0,0,1,35268,11.2,39983,87,0,-4921,-4879,8.7,3526.8,0,6,1,35,21,90,0,0,0,0,40189,11.8,44862,118,0,4921,4879,11.8,4018.9
4849143915,0,0,0,1,15,14,28,0,0,0,1,35740,10.4,36984,106,0,1822,-1326,10.6,3574.0,0,0,0,14,15,27,0,0,0,0,33918,10.6,38310,82,0,-1822,1326,8.2,3391.8
4807104519,1,10,0,1,6,2,5,0,0,0,0,15772,7.0,17364,184,42,1448,-807,22.6,1577.2,11,1,0,2,6,0,0,0,0,0,14324,6.8,18171,193,54,-1448,807,24.7,1432.4
4807079107,1,21,0,1,6,4,6,1,1,0,0,16239,6.8,18056,168,64,1784,1114,23.2,1623.9,11,0,0,4,6,2,0,0,0,0,14455,6.6,16942,149,52,-1784,-1114,20.1,1445.5
4784976869,1,10,0,1,6,1,7,1,0,1,0,15931,6.8,16896,133,60,3637,1489,19.3,1593.1,177,0,0,1,6,0,0,0,0,0,12294,6.4,15407,141,48,-3637,-1489,18.9,1229.4
4783673990,0,13,0,0,1,9,1,0,0,0,0,12850,6.4,15536,123,52,-4638,-2929,17.5,1285.0,8,1,1,9,1,5,1,1,0,0,17488,7.0,18465,176,48,4638,2929,22.4,1748.8
4783648329,0,10,0,0,2,5,1,0,0,0,0,13022,6.8,17664,141,56,-2315,-666,19.7,1302.2,9,0,1,5,2,2,0,0,0,0,15337,6.8,18330,201,32,2315,666,23.3,1533.7
4781392487,0,22,1,1,20,22,41,0,0,0,0,36624,11.0,39710,92,0,-839,-1402,9.2,3662.4,22,3,0,22,20,61,0,0,0,0,37463,11.0,41112,95,0,839,1402,9.5,3746.3
4781369955,1,20,1,1,3,3,4,1,1,0,0,14974,7.0,17496,159,56,1694,857,21.5,1497.4,11,0,0,3,3,0,0,0,0,0,13280,6.6,16639,135,44,-1694,-857,17.9,1328.0
4781339594,1,23,1,1,7,1,2,1,1,0,0,16081,7.2,19511,173,58,4170,4056,23.1,1608.1,11,1,0,1,7,0,0,0,0,0,11911,6.4,15455,138,50,-4170,-4056,18.8,1191.1
4780934685,1,20,2,1,5,4,4,0,0,0,0,14844,6.6,16271,148,52,-1770,-498,20.0,1484.4,16,1,0,4,5,2,0,0,0,0,16614,6.6,16769,159,52,1770,498,21.1,1661.4
4780898585,1,16,2,1,5,1,3,0,0,0,0,15528,7.0,17756,164,51,1578,563,21.5,1552.8,12,0,0,1,5,1,0,0,0,0,13950,6.6,17193,165,48,-1578,-563,21.3,1395.0
4779895594,1,12,0,1,8,5,3,0,0,0,0,16888,7.0,17559,193,40,1301,836,23.3,1688.8,12,2,0,5,8,7,1,0,1,0,15587,6.6,16723,162,52,-1301,-836,21.4,1558.7
4779555131,1,114,0,1,5,7,2,0,0,0,0,14719,5.8,12572,120,32,-1581,-2251,15.2,1471.9,11,0,0,7,5,4,1,1,0,0,16300,6.2,14823,140,36,1581,2251,17.6,1630.0
4779516349,0,11,0,0,2,7,1,0,0,0,0,13174,6.8,16350,142,44,-3337,-1298,18.6,1317.4,8,0,1,7,2,3,1,1,0,0,16511,7.0,17648,176,56,3337,1298,23.2,1651.1
4778810144,0,12,1,0,4,5,3,0,0,0,0,14618,6.6,16228,148,48,-1201,-680,19.6,1461.8,17,1,1,5,4,4,0,0,0,0,15819,6.6,16908,184,48,1201,680,23.2,1581.9
4777228171,1,22,3,1,5,3,1,0,0,0,0,15681,6.8,17901,189,65,1226,-478,25.4,1568.1,175,2,0,3,5,1,0,0,0,0,14455,7.0,18379,186,56,-1226,478,24.2,1445.5
4776055085,0,72,1,1,4,3,3,0,0,0,0,15161,6.8,17341,192,48,-95,-953,24.0,1516.1,21,0,0,3,4,1,0,0,0,0,15256,7.0,18294,204,56,95,953,26.0,1525.6
4775141889,1,17,2,0,4,5,1,1,0,1,0,14734,6.8,18143,162,58,-767,104,22.0,1473.4,14,1,1,5,4,3,0,0,0,0,15501,7.2,18039,182,45,767,-104,22.7,1550.1
4775031807,0,11,1,1,3,4,1,0,0,0,0,13415,6.6,16009,147,48,-1927,-1830,19.5,1341.5,21,0,0,4,3,3,0,0,0,0,15342,6.8,17839,172,48,1927,1830,22.0,1534.2
4774891565,0,16,2,1,5,5,5,0,0,0,0,13727,6.6,17117,129,49,-2181,-453,17.8,1372.7,15,1,0,5,5,6,0,0,0,0,15908,6.8,17570,179,49,2181,453,22.8,1590.8
4774880742,0,13,1,0,4,6,3,0,0,0,0,13880,6.8,16108,148,41,-3197,-2386,18.9,1388.0,8,1,1,6,4,4,1,1,0,0,17077,7.0,18494,174,60,3197,2386,23.4,1707.7
4854593513,1,13,0,0,15,23,15,0,0,0,0,45950,10.0,47500,0,0,17400,19000,0.0,4595.0,0,0,1,14,6,12,0,0,0,0,28550,6.0,28500,0,0,-17400,-19000,0.0,2855.0
4850985087,1,0,0,1,30,28,67,0,0,0,0,39018,12.0,45796,107,0,-1125,868,10.7,3901.8,12,0,0,28,30,70,0,0,0,0,40143,11.8,44928,113,0,1125,-868,11.3,4014.3
4848867920,0,14,0,1,7,2,9,0,0,0,0,16411,6.2,15428,160,48,3025,-738,20.8,1641.1,14,0,0,2,7,2,1,1,0,0,13386,6.2,16166,177,44,-3025,738,22.1,1338.6
4848819628,1,55,0,1,6,5,7,0,0,0,0,16908,6.4,16212,186,40,1673,357,22.6,1690.8,13,2,0,5,6,5,0,0,0,0,15235,6.6,15855,167,48,-1673,-357,21.5,1523.5
4848774730,1,47,3,0,7,4,7,0,0,0,0,16642,7.2,18134,212,44,2436,912,25.6,1664.2,12,16,1,4,7,1,1,1,0,0,14206,6.8,17222,152,60,-2436,-912,21.2,1420.6
4848019165,1,14,1,1,8,7,4,1,1,0,0,17440,7.2,18205,176,60,932,1358,23.6,1744.0,14,0,0,7,8,6,0,0,0,0,16508,6.6,16847,167,40,-932,-1358,20.7,1650.8
4847688413,0,10,1,0,7,7,5,0,0,0,0,14674,6.2,15832,127,52,-2553,-1774,17.9,1467.4,13,1,1,7,7,6,1,1,0,0,17227,6.8,17606,203,48,2553,1774,25.1,1722.7
4847662698,0,21,2,0,2,12,1,0,0,0,0,13041,6.6,16221,158,43,-5218,-2613,20.1,1304.1,8,3,1,12,2,9,0,0,0,0,18259,7.0,18834,205,44,5218,2613,24.9,1825.9
4847641658,1,13,0,1,5,3,4,0,0,0,0,15809,6.8,17815,206,44,1123,408,25.0,1580.9,9,0,0,3,5,3,0,0,0,0,14686,6.6,17407,179,60,-1123,-408,23.9,1468.6
4847627842,0,16,0,0,4,10,4,0,0,0,0,15320,6.4,16030,155,48,-2642,-2659,20.3,1532.0,8,1,1,10,4,5,0,0,0,0,17962,7.2,18689,196,52,2642,2659,24.8,1796.2
4847505416,0,13,0,0,5,4,2,0,0,0,0,15847,7.0,18082,182,60,568,-791,24.2,1584.7,46,1,1,4,5,2,1,1,0,0,15279,7.2,18873,179,67,-568,791,24.6,1527.9
4846153960,1,10,0,1,4,2,3,0,0,0,0,15655,6.8,18016,196,60,1952,1445,25.6,1565.5,14,0,0,2,4,2,0,0,0,0,13703,6.6,16571,145,52,-1952,-1445,19.7,1370.3
4845004256,1,16,0,0,2,4,2,0,0,0,0,13440,6.6,16617,148,41,-1039,-1364,18.9,1344.0,11,2,1,4,2,2,0,0,0,0,14479,6.8,17981,184,58,1039,1364,24.2,1447.9
4844399509,1,15,0,0,3,2,4,0,0,0,0,15342,6.8,16742,150,44,2083,286,19.4,1534.2,11,1,1,2,3,0,0,0,0,0,13259,6.6,16456,139,56,-2083,-286,19.5,1325.9
4843528368,1,13,0,1,5,6,8,0,0,0,0,14905,6.4,16676,182,39,-1624,-939,22.1,1490.5,14,0,0,6,5,11,0,0,0,0,16529,7.0,17615,195,48,1624,939,24.3,1652.9
4843491882,0,16,2,1,10,6,6,0,0,0,0,16248,7.0,17552,185,40,462,-791,22.5,1624.8,75,1,0,4,8,1,0,0,0,0,15786,6.8,18343,196,60,-462,791,25.6,1578.6
4841104185,0,12,0,0,5,6,2,0,0,0,0,14323,6.8,17230,140,56,-1200,-594,19.6,1432.3,12,0,1,5,4,3,0,0,0,0,15523,6.8,17824,145,40,1200,594,18.5,1552.3
4840114783,1,18,4,1,5,1,4,0,0,0,0,16489,7.0,18626,223,52,3414,1191,27.5,1648.9,22,1,0,1,5,2,0,0,0,0,13075,6.8,17435,135,64,-3414,-1191,19.9,1307.5
4753063171,1,12,0,1,8,6,7,0,0,0,0,16291,7.0,18385,150,64,999,1065,21.4,1629.1,64,0,0,6,8,1,0,0,0,0,15292,6.8,17320,188,36,-999,-1065,22.4,1529.2
4753019401,1,85,0,0,5,5,6,1,1,0,0,15604,7.0,17593,147,56,1003,-136,20.3,1560.4,9,0,1,5,5,0,0,0,0,0,14601,7.0,17729,165,48,-1003,136,21.3,1460.1
4749448286,0,20,9,1,7,7,5,1,1,0,0,15656,6.6,17287,177,40,-661,-776,21.7,1565.6,34,0,0,6,6,3,0,0,0,0,16317,7.0,18063,190,56,661,776,24.6,1631.7
4749428667,0,11,0,0,6,6,6,0,0,0,0,14590,5.8,13892,132,39,-1620,-3332,17.1,1459.0,7,0,1,6,6,4,0,0,0,0,16210,6.8,17224,186,43,1620,3332,22.9,1621.0
4741938218,1,10,1,1,5,6,5,0,0,0,0,16721,6.8,17560,170,48,-10,-568,21.8,1672.1,219,1,0,6,5,6,0,0,0,0,16731,7.0,18128,192,56,10,568,24.8,1673.1
4741913743,1,11,3,0,3,4,1,0,0,0,0,15029,6.8,17564,158,48,-1004,-1337,20.6,1502.9,10,1,1,4,3,2,0,0,0,0,16033,7.0,18901,228,68,1004,1337,29.6,1603.3
4741807838,0,27,3,1,3,2,1,0,0,0,0,14475,6.6,17179,168,51,-118,-355,21.9,1447.5,13,2,0,2,3,3,1,1,0,0,14593,6.8,17534,171,56,118,355,22.7,1459.3
4736758604,1,17,0,0,4,1,2,0,0,0,0,15114,7.0,17944,201,48,2180,1042,24.9,1511.4,11,0,1,1,4,2,0,0,0,0,12934,6.8,16902,157,44,-2180,-1042,20.1,1293.4
4735306428,0,12,2,1,5,2,4,0,0,0,0,15086,6.8,16952,152,52,2097,1174,20.4,1508.6,13,0,0,2,5,1,0,0,0,0,12989,6.4,15778,144,48,-2097,-1174,19.2,1298.9
4735284780,1,15,0,1,3,2,4,0,0,0,0,14207,6.8,17788,166,56,192,-483,22.2,1420.7,12,0,0,2,3,2,0,0,0,0,14015,6.8,18271,176,52,-192,483,22.8,1401.5
4734811855,1,13,10,0,4,4,2,1,1,0,0,15578,7.0,18634,243,44,591,1863,28.7,1557.8,28,2,1,4,4,3,0,0,0,0,14987,6.6,16771,193,48,-591,-1863,24.1,1498.7
4734769600,0,13,0,0,8,7,4,0,0,0,0,15949,6.6,16504,156,44,-977,-803,20.0,1594.9,14,1,1,7,8,5,0,0,0,0,16926,6.8,17307,185,56,977,803,24.1,1692.6
4734197782,1,36,3,1,9,3,9,1,0,1,0,18456,6.8,17364,194,68,4109,1123,26.2,1845.6,20,5,0,3,9,2,0,0,0,0,14347,6.6,16241,175,35,-4109,-1123,21.0,1434.7
4734158506,1,7,0,1,4,3,2,1,1,0,0,15064,6.8,18607,152,52,-390,707,20.4,1506.4,5,1,0,3,4,4,0,0,0,0,15454,6.8,17900,188,48,390,-707,23.6,1545.4
4733826383,0,54,1,1,1,1,1,0,0,0,0,14646,7.2,19209,209,43,-227,119,25.2,1464.6,18,1,0,1,1,1,1,1,0,0,14873,7.0,19090,203,60,227,-119,26.3,1487.3
4733805746,1,14,2,1,8,2,6,0,0,0,0,17069,7.0,17934,175,56,3510,1597,23.1,1706.9,226,1,0,2,8,1,0,0,0,0,13559,6.4,16337,173,44,-3510,-1597,21.7,1355.9
4733765249,1,11,3,1,3,2,2,1,1,0,0,14334,6.6,16358,142,44,331,-174,18.6,1433.4,228,0,0,2,3,1,0,0,0,0,14003,6.6,16532,195,36,-331,174,23.1,1400.3
4732703703,0,44,5,0,5,3,4,0,0,0,0,14162,5.8,14800,150,23,-1143,-2567,17.3,1416.2,36,0,1,3,5,1,1,1,0,0,15305,6.8,17367,192,56,1143,2567,24.8,1530.5
4731540721,1,54,0,0,17,12,14,0,0,0,0,63450,12.0,55000,1,0,26200,21000,0.1,6345.0,2,0,1,6,11,6,0,0,0,0,37250,7.4,34000,1,0,-26200,-21000,0.1,3725.0
4851789877,0,11,1,0,4,6,1,0,0,0,0,14020,6.4,15728,132,52,-3201,-1469,18.4,1402.0,24,4,1,6,4,6,1,1,0,0,17221,6.6,17197,182,56,3201,1469,23.8,1722.1
4851753308,0,10,1,1,2,5,0,0,0,0,0,12931,6.6,16916,134,55,-874,-1002,18.9,1293.1,15,1,0,5,2,4,0,0,0,0,13805,7.0,17918,148,50,874,1002,19.8,1380.5
4851727743,1,14,3,0,5,1,4,1,1,0,0,15382,7.2,19105,204,56,1946,2556,26.0,1538.2,11,0,1,1,5,1,1,0,1,0,13436,6.6,16549,168,51,-1946,-2556,21.9,1343.6
4850955536,0,13,0,0,5,6,5,0,0,0,0,15454,6.4,16690,171,55,-148,-1959,22.6,1545.4,8,0,1,6,5,0,0,0,0,0,15602,7.0,18649,200,46,148,1959,24.6,1560.2
4848194611,1,15,0,1,3,5,2,0,0,0,0,15746,6.8,17027,137,56,2125,1277,19.3,1574.6,17,1,0,5,3,2,0,0,0,0,13621,6.4,15750,159,40,-2125,-1277,19.9,1362.1
4848164418,0,15,0,1,3,6,3,1,1,0,0,15368,6.4,15413,188,44,-661,-2860,23.2,1536.8,11,1,0,6,3,2,0,0,0,0,16029,6.8,18273,184,60,661,2860,24.4,1602.9
4848128458,1,8,0,0,1,2,1,0,0,0,0,13728,6.8,17492,165,61,-513,479,22.6,1372.8,14,0,1,2,1,0,0,0,0,0,14241,6.8,17013,180,60,513,-479,24.0,1424.1
4847963708,0,12,1,1,5,2,5,1,1,0,0,15546,6.6,17514,196,48,498,-993,24.4,1554.6,6,0,0,2,5,1,0,0,0,0,15048,7.0,18507,181,68,-498,993,24.9,1504.8
4847737739,1,14,0,0,2,5,1,1,1,0,0,14661,6.6,16358,159,61,-1128,-312,22.0,1466.1,12,0,1,5,2,1,0,0,0,0,15789,6.8,16670,161,48,1128,312,20.9,1578.9
4847607190,0,36,0,0,2,8,2,0,0,0,0,13506,6.8,17049,162,56,-2648,-662,21.8,1350.6,6,15,1,8,2,13,1,1,0,0,16154,6.6,17711,153,62,2648,662,21.5,1615.4
4847536125,1,92,3,1,3,5,4,0,0,0,0,14336,6.6,16942,167,48,-1259,-595,21.5,1433.6,13,0,0,5,3,2,0,0,0,0,15595,6.8,17537,211,52,1259,595,26.3,1559.5
4847511926,0,16,1,0,1,5,2,1,1,0,0,14026,6.4,16539,167,52,-2328,-1910,21.9,1402.6,12,3,1,5,1,2,1,0,1,0,16354,7.0,18449,187,30,2328,1910,21.7,1635.4
4846986677,1,12,0,0,2,4,0,1,1,0,0,14225,7.2,18886,203,44,185,2209,24.7,1422.5,113,0,1,4,2,2,0,0,0,0,14040,6.8,16677,152,48,-185,-2209,20.0,1404.0
4846942797,0,8,0,0,2,2,1,0,0,0,0,14395,6.8,17635,193,48,95,-328,24.1,1439.5,7,0,1,2,2,0,0,0,0,0,14300,7.0,17963,155,44,-95,328,19.9,1430.0
4846903417,1,14,1,1,4,4,5,0,0,0,0,16122,7.0,17961,173,44,1902,812,21.7,1612.2,14,0,0,4,4,3,1,0,1,0,14220,6.6,17149,116,56,-1902,-812,17.2,1422.0
4846545544,1,9,3,1,6,5,7,1,1,0,0,17274,6.6,17380,190,52,1891,790,24.2,1727.4,15,0,0,5,6,3,0,0,0,0,15383,6.6,16590,161,60,-1891,-790,22.1,1538.3
4846522399,1,13,0,1,1,1,0,1,0,1,0,15680,7.2,18661,219,56,2009,726,27.5,1568.0,11,0,0,1,1,0,0,0,0,0,13671,6.8,17935,196,44,-2009,-726,24.0,1367.1
4846485971,0,10,0,1,4,4,4,0,0,0,0,15292,6.8,17599,149,48,-1597,-941,19.7,1529.2,18,0,0,4,4,2,1,1,0,0,16889,7.2,18540,192,60,1597,941,25.2,1688.9
4846225162,0,101,3,0,4,6,5,1,0,1,0,14481,6.6,16561,174,48,-968,-1182,22.2,1448.1,11,0,1,6,4,3,1,1,0,0,15449,6.8,17743,179,52,968,1182,23.1,1544.9
4846202408,1,16,2,1,2,0,3,1,1,0,0,14726,7.0,18694,216,60,2877,3319,27.6,1472.6,14,1,0,0,2,0,0,0,0,0,11849,6.2,15375,168,24,-2877,-3319,19.2,1184.9
4856179633,0,86,0,0,16,23,45,0,0,0,1,35659,10.8,36647,98,0,-2456,-3725,9.8,3565.9,0,0,1,23,16,64,0,0,0,0,38115,11.0,40372,110,0,2456,3725,11.0,3811.5
4856150894,0,0,0,0,14,22,33,0,0,0,1,36106,10.6,38700,96,0,-340,-1641,9.6,3610.6,0,0,1,22,14,46,0,0,0,0,36446,11.0,40341,105,0,340,1641,10.5,3644.6
4856113534,1,0,0,1,22,20,61,0,0,0,1,35878,11.0,38447,99,0,-2079,-2363,9.9,3587.8,0,0,0,20,22,64,0,0,0,0,37957,11.0,40810,98,0,2079,2363,9.8,3795.7
4856038190,1,0,2,1,15,22,13,0,0,0,0,46660,10.0,47500,0,0,18030,19000,0.0,4666.0,28,1,0,12,5,13,0,0,0,0,28630,6.0,28500,3,0,-18030,-19000,0.3,2863.0
4856017941,1,29,0,1,18,20,12,0,0,0,0,46458,10.0,47500,8,0,15988,19000,0.8,4645.8,288,0,0,10,8,14,0,0,0,0,30470,6.0,28500,6,0,-15988,-19000,0.6,3047.0
4855849390,1,14,0,0,6,3,4,1,1,0,1,17881,7.0,18220,213,54,3043,1773,26.7,1788.1,12,1,1,3,6,5,0,0,0,0,14838,6.6,16447,194,52,-3043,-1773,24.6,1483.8
4855231940,1,0,0,0,17,16,17,0,0,0,0,62075,12.0,55000,0,0,25510,22000,0.0,6207.5,0,0,1,11,12,10,0,0,0,0,36565,7.2,33000,1,0,-25510,-22000,0.1,3656.5
4855200468,1,6,0,1,18,13,19,0,0,0,0,66550,12.0,55000,0,0,30400,22000,0.0,6655.0,0,0,0,7,12,8,0,0,0,0,36150,7.2,33000,0,0,-30400,-22000,0.0,3615.0
4855166668,1,234,0,1,18,16,15,0,0,0,0,47370,10.0,47500,0,0,17882,19000,0.0,4737.0,5,0,0,9,11,12,0,0,0,0,29488,6.0,28500,1,0,-17882,-19000,0.1,2948.8
4855093587,0,9,0,0,9,7,8,0,0,0,0,17144,6.6,16248,175,32,-634,-1117,20.7,1714.4,83,0,1,7,9,4,0,0,0,0,17778,6.6,17365,205,55,634,1117,26.0,1777.8
4855042097,1,52,2,1,6,7,3,0,0,0,0,15664,6.4,16820,174,32,302,-456,20.6,1566.4,30,0,0,7,6,7,0,0,0,0,15362,6.8,17276,153,40,-302,456,19.3,1536.2
4855008024,0,0,0,1,20,25,47,0,0,0,1,36541,11.0,38994,101,0,-510,-722,10.1,3654.1,0,0,0,25,20,71,0,0,0,0,37051,11.0,39716,105,0,510,722,10.5,3705.1
4853948878,1,622,0,1,15,20,15,0,0,0,0,46064,10.0,47500,0,0,24445,19000,0.0,4606.4,0,0,0,14,9,16,0,0,0,0,21619,6.0,28500,0,0,-24445,-19000,0.0,2161.9
4853916324,1,28,0,1,25,15,22,0,0,0,0,63403,12.0,55000,1,0,28303,22000,0.1,6340.3,0,0,0,4,14,7,0,0,0,0,35100,7.2,33000,0,0,-28303,-22000,0.0,3510.0
4853888603,1,0,0,0,24,10,22,0,0,0,0,64900,13.8,66500,1,0,28005,32000,0.1,6490.0,0,0,1,3,17,5,0,0,0,0,36895,7.4,34500,1,0,-28005,-32000,0.1,3689.5
4853863534,1,0,0,1,16,17,15,0,0,0,0,62700,12.2,56000,0,0,26200,23000,0.0,6270.0,0,0,0,12,11,9,0,0,0,0,36500,7.2,33000,0,0,-26200,-23000,0.0,3650.0
4847755575,1,13,1,1,6,6,1,1,1,0,0,16416,7.0,17993,161,67,-789,945,22.8,1641.6,15,2,0,6,6,4,0,0,0,0,17205,6.8,17048,182,43,789,-945,22.5,1720.5
4847700885,1,88,0,0,9,8,5,0,0,0,0,18742,7.2,19146,181,52,-375,243,23.3,1874.2,16,0,1,8,9,5,0,0,0,0,19117,7.2,18903,196,56,375,-243,25.2,1911.7
4846792872,1,11,1,0,10,11,5,0,0,0,0,17920,7.2,18810,184,48,-1364,91,23.2,1792.0,12,0,1,11,10,9,0,0,0,0,19284,7.2,18719,199,60,1364,-91,25.9,1928.4
4845850663,0,70,0,1,8,10,4,1,1,0,0,16413,6.6,17039,209,52,-897,-251,26.1,1641.3,21,0,0,10,8,9,0,0,0,0,17310,6.6,17290,159,49,897,251,20.8,1731.0
4812217803,0,15,2,1,5,3,5,0,0,0,0,15354,6.8,17203,192,32,1871,513,22.4,1535.4,10,1,0,3,5,1,1,0,1,0,13483,6.6,16690,165,48,-1871,-513,21.3,1348.3
4812190031,0,10,1,1,6,5,3,1,1,0,0,16052,6.8,17282,156,56,1267,573,21.2,1605.2,10,1,0,5,6,2,0,0,0,0,14785,6.6,16709,135,56,-1267,-573,19.1,1478.5
4758090194,1,126,1,0,4,6,3,1,1,0,0,15437,6.8,16952,200,52,-1823,-1226,25.2,1543.7,13,1,1,6,4,5,0,0,0,0,17260,7.0,18178,182,60,1823,1226,24.2,1726.0
4745426057,0,22,1,0,2,3,0,0,0,0,0,12381,6.2,15226,134,44,-2976,-3608,17.8,1238.1,14,13,1,3,2,2,0,0,0,0,15357,7.4,18834,200,72,2976,3608,27.2,1535.7
4745383026,1,15,1,0,3,3,3,0,0,0,0,14020,6.6,17099,183,56,-1126,-508,23.9,1402.0,15,3,1,3,3,5,1,0,1,0,15146,6.8,17607,184,52,1126,508,23.6,1514.6
4745342242,0,13,1,1,2,3,3,0,0,0,0,14141,6.4,15696,164,48,44,-987,21.2,1414.1,12,0,0,3,2,3,1,1,0,0,14097,6.4,16683,153,56,-44,987,20.9,1409.7
4745321072,0,10,1,0,1,5,1,0,0,0,0,13179,6.2,15508,130,41,-2219,-1424,17.1,1317.9,11,1,1,5,1,3,0,0,0,0,15398,6.4,16932,179,44,2219,1424,22.3,1539.8
4738648941,0,13,2,1,5,13,7,1,1,0,0,15327,6.6,16461,155,36,-3560,-2003,19.1,1532.7,12,1,0,13,5,14,1,0,1,0,18887,7.0,18464,142,79,3560,2003,22.1,1888.7
4738318506,1,12,2,0,5,8,6,1,1,0,0,15312,6.4,15932,172,52,-1751,-2314,22.4,1531.2,12,0,1,8,5,5,0,0,0,0,17063,7.0,18246,215,43,1751,2314,25.8,1706.3
4738292247,0,25,0,0,10,7,8,0,0,0,0,17835,7.0,18049,176,42,1656,1139,21.8,1783.5,9,2,1,7,10,7,1,1,0,0,16179,6.8,16910,161,53,-1656,-1139,21.4,1617.9
4738252597,1,12,0,1,5,3,3,1,1,0,0,15833,6.8,17534,155,56,2026,1244,21.1,1583.3,11,0,0,2,4,2,0,0,0,0,13807,6.6,16290,163,40,-2026,-1244,20.3,1380.7
4733604860,1,30,1,0,1,4,1,0,0,0,0,13867,7.2,18056,195,56,-1452,858,25.1,1386.7,9,2,1,4,1,3,2,1,1,0,15319,6.8,17198,182,56,1452,-858,23.8,1531.9
4733556421,0,67,2,0,2,5,1,1,1,0,0,13722,6.8,17041,170,64,-1393,-284,23.4,1372.2,8,3,1,5,2,4,0,0,0,0,15115,6.8,17325,156,48,1393,284,20.4,1511.5
4731401052,0,15,1,0,0,10,0,0,0,0,0,12080,6.4,15721,153,56,-5157,-2556,20.9,1208.0,22,3,1,10,0,4,1,1,0,0,17237,7.0,18277,178,60,5157,2556,23.8,1723.7
4729993471,1,7,3,1,3,0,3,1,1,0,0,15442,7.0,18476,214,48,2434,1247,26.2,1544.2,34,2,0,0,3,0,0,0,0,0,13008,6.6,17229,192,64,-2434,-1247,25.6,1300.8
4729952397,1,9,1,1,1,1,0,1,1,0,0,12063,6.6,16951,126,44,-596,1584,17.0,1206.3,18,0,0,1,1,0,0,0,0,0,12659,6.2,15367,152,48,596,-1584,20.0,1265.9
4726993702,1,22,3,1,3,0,6,0,0,0,0,14936,6.8,17200,207,55,1431,-393,26.2,1493.6,11,0,0,0,3,0,0,0,0,0,13505,6.8,17593,194,52,-1431,393,24.6,1350.5
4726945399,0,68,2,0,3,6,2,0,0,0,0,14877,6.6,16335,154,44,-1201,-1418,19.8,1487.7,16,1,1,6,3,8,0,0,0,0,16078,6.8,17753,202,56,1201,1418,25.8,1607.8
4726683291,1,20,2,1,6,3,6,1,0,1,0,16637,7.0,17929,208,60,3234,1141,26.8,1663.7,13,2,0,3,6,2,0,0,0,0,13403,6.6,16788,144,44,-3234,-1141,18.8,1340.3
4856293314,0,73,0,1,20,19,64,0,0,0,0,36524,11.2,39278,102,0,-116,-1999,10.2,3652.4,0,2,0,19,20,47,0,0,0,0,36640,11.0,41277,94,0,116,1999,9.4,3664.0
4856251265,1,258,0,1,24,19,61,0,0,0,0,36774,11.0,39804,107,0,1649,2967,10.7,3677.4,0,0,0,19,24,36,0,0,0,0,35125,10.6,36837,116,0,-1649,-2967,11.6,3512.5
4856225880,0,9,0,1,34,16,83,0,0,0,0,38772,11.8,43129,79,0,1900,4105,7.9,3877.2,0,0,0,16,34,38,0,0,0,0,36872,11.0,39024,107,0,-1900,-4105,10.7,3687.2
4852736820,1,20,0,0,17,19,22,0,0,0,0,62374,12.0,55000,0,0,24090,22000,0.0,6237.4,86,1,1,15,13,11,0,0,0,0,38284,7.2,33000,1,0,-24090,-22000,0.1,3828.4
4852704266,1,0,0,0,16,19,15,0,0,0,0,61700,12.0,55000,1,0,23450,22000,0.1,6170.0,0,0,1,11,8,11,0,0,0,0,38250,7.2,33000,0,0,-23450,-22000,0.0,3825.0
4852680687,1,0,0,1,25,16,34,0,0,0,0,65150,13.0,62500,0,0,29700,25000,0.0,6515.0,3,0,0,6,15,4,0,0,0,0,35450,7.8,37500,0,0,-29700,-25000,0.0,3545.0
4852667155,1,0,0,0,16,14,10,0,0,0,0,45950,10.2,48680,0,0,17400,20180,0.0,4595.0,0,0,1,8,10,13,0,0,0,0,28550,6.0,28500,0,0,-17400,-20180,0.0,2855.0
4847618651,0,49,1,1,1,6,1,0,0,0,0,14432,6.6,16710,164,44,-1800,-1588,20.8,1443.2,14,2,0,6,1,3,1,1,0,0,16232,7.0,18298,210,56,1800,1588,26.6,1623.2
4847599189,1,7,1,0,5,5,3,0,0,0,1,16137,6.8,17384,186,44,-81,153,23.0,1613.7,134,0,1,5,5,3,1,1,0,0,16218,6.6,17231,184,52,81,-153,23.6,1621.8
4847578947,1,8,0,0,4,4,3,0,0,0,0,15418,6.4,15787,153,48,1206,288,20.1,1541.8,13,1,1,4,4,4,0,0,0,0,14212,6.2,15499,147,36,-1206,-288,18.3,1421.2
4847546831,1,12,4,1,6,1,3,1,1,0,0,17569,7.4,19379,188,68,3269,2689,25.6,1756.9,14,0,0,1,6,2,0,0,0,0,14300,6.6,16690,202,52,-3269,-2689,25.4,1430.0
4846819608,0,32,0,0,2,3,2,0,0,0,0,14975,6.8,18258,201,55,170,-408,25.6,1497.5,29,0,1,3,2,1,1,1,0,0,14805,7.2,18666,186,61,-170,408,24.7,1480.5
4846785211,1,16,0,1,5,1,3,0,0,0,0,15862,6.8,17796,176,48,1864,654,22.4,1586.2,137,1,0,1,5,0,1,1,0,0,13998,6.6,17142,154,63,-1864,-654,21.7,1399.8
4846761694,0,11,1,0,3,5,2,0,0,0,0,14578,6.8,17496,206,56,-1942,-908,26.2,1457.8,16,1,1,5,3,3,1,1,0,0,16520,7.0,18404,153,60,1942,908,21.3,1652.0
4846466138,1,14,0,1,4,2,4,0,0,0,0,16201,7.0,17842,191,60,2900,2774,25.1,1620.1,9,1,0,2,4,0,0,0,0,0,13301,6.4,15068,160,52,-2900,-2774,21.2,1330.1
4846443264,1,10,0,1,9,4,1,0,0,0,0,17996,7.0,19612,244,56,3323,3575,30.0,1799.6,9,0,0,4,9,3,1,1,0,0,14673,6.4,16037,167,40,-3323,-3575,20.7,1467.3
4846423677,1,9,1,0,6,10,6,1,0,1,0,15904,6.4,15643,143,40,-1522,734,18.3,1590.4,21,0,1,10,6,13,0,0,0,0,17426,6.2,14909,215,0,1522,-734,21.5,1742.6
4846410354,1,8,0,1,4,1,4,1,1,0,0,16423,6.6,16580,195,59,3086,1383,25.4,1642.3,12,0,0,1,4,1,0,0,0,0,13337,6.2,15197,129,48,-3086,-1383,17.7,1333.7
4846396163,1,20,1,1,5,4,1,0,0,0,0,16028,6.6,16820,194,47,86,156,24.1,1602.8,14,2,0,4,5,2,0,0,0,0,15942,6.6,16664,219,44,-86,-156,26.3,1594.2
4856567054,0,10,0,0,1,4,1,1,0,1,0,14312,6.8,17314,166,56,-377,275,22.2,1431.2,8,0,1,4,1,4,1,1,0,0,14689,6.8,17039,161,55,377,-275,21.6,1468.9
4847607993,0,10,3,0,3,4,2,0,0,0,0,14255,7.0,17339,201,43,-1255,-464,24.4,1425.5,10,1,1,4,3,1,0,0,0,0,15510,6.8,17803,196,52,1255,464,24.8,1551.0
4846787893,0,15,1,1,5,6,3,0,0,0,0,15655,6.8,17993,182,56,61,1767,23.8,1565.5,11,4,0,6,5,3,0,0,0,0,15594,6.6,16226,185,44,-61,-1767,22.9,1559.4
4846757507,1,11,1,1,6,5,8,0,0,0,0,15614,7.0,17867,173,57,-213,-371,23.0,1561.4,14,1,0,5,6,3,0,0,0,0,15827,6.8,18238,196,52,213,371,24.8,1582.7
4845808127,0,14,0,0,4,4,6,0,0,0,0,14446,6.8,17160,162,60,-595,-20,22.2,1444.6,13,1,1,4,4,6,1,1,0,0,15041,6.8,17180,162,44,595,20,20.6,1504.1
4834353081,0,40,0,0,21,14,57,0,0,0,0,35925,11.2,40582,98,0,744,2394,9.8,3592.5,34,0,1,14,21,34,0,0,0,0,35181,10.8,38188,94,0,-744,-2394,9.4,3518.1
4833259456,0,0,0,0,7,22,21,0,0,0,1,31459,9.6,31150,88,0,-7163,-8236,8.8,3145.9,15,0,1,22,7,70,0,0,0,0,38622,11.0,39386,112,0,7163,8236,11.2,3862.2
4833231328,0,3,0,0,29,31,70,0,0,0,0,37609,11.0,41102,106,0,-590,-1275,10.6,3760.9,0,0,1,31,29,81,0,0,0,0,38199,11.6,42377,105,0,590,1275,10.5,3819.9
4833206954,0,39,1,1,17,16,46,0,0,0,0,35443,10.8,38156,80,0,785,1113,8.0,3544.3,7,0,0,16,17,40,0,0,0,0,34658,10.6,37043,74,0,-785,-1113,7.4,3465.8
4833172426,1,0,0,1,22,27,40,0,0,0,0,36305,11.2,40512,106,0,-201,-1399,10.6,3630.5,22,0,0,27,22,72,0,0,0,0,36506,11.4,41911,94,0,201,1399,9.4,3650.6
4825935180,1,0,0,0,44,21,97,0,0,0,2,43645,12.2,47983,101,0,6401,5942,10.1,4364.5,0,0,1,21,44,44,0,0,0,0,37244,11.2,42041,77,0,-6401,-5942,7.7,3724.4
4825915364,1,0,0,1,34,25,91,0,0,0,3,41266,12.2,46005,104,0,1741,3838,10.4,4126.6,0,0,0,25,34,45,0,0,0,0,39525,11.2,42167,92,0,-1741,-3838,9.2,3952.5
4825887963,1,13,0,1,22,23,51,0,0,0,0,36077,11.0,40305,105,0,-146,-868,10.5,3607.7,0,1,0,23,22,50,0,0,0,0,36223,11.4,41173,83,0,146,868,8.3,3622.3
4825579657,0,10,0,0,30,28,84,0,0,0,0,38002,11.8,44216,95,0,-2531,1379,9.5,3800.2,0,0,1,28,30,67,0,0,0,0,40533,11.4,42837,95,0,2531,-1379,9.5,4053.3
4825562122,0,69,0,1,15,22,44,0,0,0,0,33917,10.4,36751,93,0,-2223,-3557,9.3,3391.7,17,0,0,22,15,62,0,0,0,0,36140,11.0,40308,93,0,2223,3557,9.3,3614.0
4821137361,1,0,0,1,28,22,66,0,0,0,1,39239,11.8,44079,111,0,2463,2622,11.1,3923.9,0,0,0,22,28,51,0,0,0,0,36776,11.4,41457,87,0,-2463,-2622,8.7,3677.6
4821118266,0,148,0,0,28,35,61,0,0,0,0,37182,11.6,42835,82,0,-4860,-3998,8.2,3718.2,0,0,1,35,28,95,0,0,0,0,42042,12.0,46833,103,0,4860,3998,10.3,4204.2
4813188377,0,0,0,0,17,21,46,0,0,0,0,36118,10.8,37129,107,0,-178,-2610,10.7,3611.8,0,0,1,21,17,58,0,0,0,0,36296,11.0,39739,92,0,178,2610,9.2,3629.6
4812108665,1,10,2,0,16,18,34,0,0,0,1,35063,11.0,38583,77,71,-1782,-1887,14.8,3506.3,7,0,1,18,16,38,0,0,0,0,36845,11.2,40470,95,49,1782,1887,14.4,3684.5
4858280417,0,11,0,0,10,3,6,0,0,0,0,17406,7.0,18571,195,52,2265,1343,24.7,1740.6,13,0,1,3,10,3,0,0,0,0,15141,6.8,17228,171,44,-2265,-1343,21.5,1514.1
4858239257,0,50,2,1,4,8,4,0,0,0,0,14902,6.6,16540,138,48,-2494,-613,18.6,1490.2,176,1,0,8,4,7,2,1,1,0,17396,6.8,17153,146,48,2494,613,19.4,1739.6
4857954052,0,18,2,1,7,4,7,0,0,0,0,15716,6.8,17364,157,52,973,200,20.9,1571.6,13,1,0,4,7,4,0,0,0,0,14743,6.6,17164,175,48,-973,-200,22.3,1474.3
4857899010,0,11,1,0,5,10,5,0,0,0,0,16424,6.8,16869,167,64,-1596,63,23.1,1642.4,13,0,1,10,5,10,1,1,0,0,18020,6.6,16806,197,48,1596,-63,24.5,1802.0
4856717360,0,8,2,0,1,10,1,0,0,0,0,13099,6.8,16217,138,44,-3461,-2411,18.2,1309.9,15,0,1,10,1,5,1,1,0,0,16560,7.2,18628,159,52,3461,2411,21.1,1656.0
4856704544,0,7,0,0,0,6,0,0,0,0,0,12014,6.6,15790,147,47,-3479,-2278,19.4,1201.4,9,0,1,6,0,3,1,1,0,0,15493,6.8,18068,178,52,3479,2278,23.0,1549.3
4854174728,1,10,1,0,2,1,3,0,0,0,0,14850,7.0,18276,212,48,1759,2952,26.0,1485.0,15,0,1,1,2,2,0,0,0,0,13091,6.2,15324,141,40,-1759,-2952,18.1,1309.1
4854123543,0,22,0,1,3,5,0,0,0,0,0,13582,7.0,18114,155,56,-1569,944,21.1,1358.2,10,1,0,5,3,4,1,1,0,0,15151,7.0,17170,178,52,1569,-944,23.0,1515.1
4854056157,0,20,1,1,2,3,1,0,0,0,0,14194,6.6,15814,159,48,-636,-1116,20.7,1419.4,32,2,0,3,2,3,0,0,0,0,14830,6.6,16930,197,28,636,1116,22.5,1483.0
4853308227,1,143,2,1,4,7,1,0,0,0,0,14580,6.6,16632,156,44,-2512,-96,20.0,1458.0,13,2,0,7,4,8,0,0,0,0,17092,6.4,16728,163,28,2512,96,19.1,1709.2
4852988320,0,10,0,0,6,6,5,1,0,1,0,16333,7.0,17702,197,68,772,645,26.5,1633.3,19,0,1,6,6,4,1,1,0,0,15561,6.6,17057,182,48,-772,-645,23.0,1556.1
4852931223,1,15,0,1,8,2,8,1,1,0,0,16075,6.8,17447,176,48,2512,130,22.4,1607.5,25,1,0,2,8,1,0,0,0,0,13563,6.8,17317,130,40,-2512,-130,17.0,1356.3
4852383478,1,12,0,1,5,3,4,1,1,0,0,15645,6.8,17190,189,52,1518,1180,24.1,1564.5,6,1,0,3,5,3,0,0,0,0,14127,6.4,16010,171,36,-1518,-1180,20.7,1412.7
4851351493,1,10,1,1,6,6,4,1,1,0,0,15024,6.6,16795,156,58,-165,-853,21.4,1502.4,6,1,0,5,5,1,0,0,0,0,15189,6.8,17648,203,48,165,853,25.1,1518.9
4460639375,0,12,0,0,3,9,2,0,0,0,0,13264,6.8,16609,137,64,-3965,-2720,20.1,1326.4,12,1,1,9,3,3,0,0,0,0,17229,7.0,19329,168,58,3965,2720,22.6,1722.9
4459616908,0,10,0,0,2,6,3,0,0,0,0,13010,6.2,14625,143,44,-4135,-4359,18.7,1301.0,10,1,1,6,2,2,0,0,0,0,17145,7.2,18984,200,64,4135,4359,26.4,1714.5
4459525752,1,10,2,1,8,6,3,0,0,0,0,17122,7.0,18386,192,48,2279,1430,24.0,1712.2,118,1,0,6,8,4,0,0,0,0,14843,7.0,16956,166,44,-2279,-1430,21.0,1484.3
4457374805,1,9,0,0,3,6,3,0,0,0,0,14051,6.2,14964,195,40,-419,-1054,23.5,1405.1,10,0,1,6,3,6,0,0,0,0,14470,6.6,16018,152,40,419,1054,19.2,1447.0
4457315555,0,11,1,0,7,2,7,0,0,0,0,15646,6.6,16638,136,49,1436,536,18.5,1564.6,13,0,1,2,7,1,0,0,0,0,14210,6.4,16102,155,37,-1436,-536,19.2,1421.0
4804130151,0,60,1,0,5,3,2,1,1,0,0,15330,7.4,19233,169,68,688,1795,23.7,1533.0,10,1,1,3,5,3,1,0,1,0,14642,6.6,17438,191,60,-688,-1795,25.1,1464.2
4804109043,1,139,5,0,6,5,1,1,1,0,0,15876,6.6,17010,206,38,1465,727,24.4,1587.6,16,1,1,5,6,3,0,0,0,0,14411,6.6,16283,149,59,-1465,-727,20.8,1441.1
4804085545,0,11,0,0,6,10,2,0,0,0,0,16334,6.8,17436,210,60,-776,-452,27.0,1633.4,11,0,1,10,6,11,0,0,0,0,17110,7.0,17888,176,48,776,452,22.4,1711.0
4804075183,1,10,0,1,4,4,2,0,0,0,0,15431,6.6,16763,186,56,2060,2398,24.2,1543.1,157,0,0,4,4,2,0,0,0,0,13371,6.0,14365,133,40,-2060,-2398,17.3,1337.1
4803508712,1,14,1,1,8,2,5,0,0,0,0,16859,7.2,18444,182,56,3222,2481,23.8,1685.9,11,0,0,2,8,3,0,0,0,0,13637,6.4,15963,161,52,-3222,-2481,21.3,1363.7
4798604714,1,149,2,1,13,3,12,1,1,0,0,19851,7.0,18386,206,44,5010,2057,25.0,1985.1,16,0,0,3,13,2,0,0,0,0,14841,6.6,16329,196,28,-5010,-2057,22.4,1484.1
4793741432,1,10,2,1,5,6,3,0,0,0,0,16455,7.0,17550,173,52,215,236,22.5,1645.5,14,0,0,6,5,9,0,0,0,0,16240,6.8,17314,182,64,-215,-236,24.6,1624.0
4793595487,1,11,0,0,3,7,1,0,0,0,0,15343,7.0,18550,200,56,-775,-32,25.6,1534.3,10,0,1,7,3,5,0,0,0,0,16118,7.2,18582,186,50,775,32,23.6,1611.8
4792816498,0,19,3,0,5,10,3,0,0,0,0,16214,6.4,15887,183,36,-1356,-410,21.9,1621.4,12,2,1,10,5,12,0,0,0,0,17570,6.4,16297,151,44,1356,410,19.5,1757.0
4792805041,1,20,0,1,7,2,5,1,1,0,0,15976,6.8,17569,188,43,3596,1941,23.1,1597.6,11,0,0,1,6,1,0,0,0,0,12380,6.2,15628,149,48,-3596,-1941,19.7,1238.0
4790657830,0,35,1,1,10,2,11,0,0,0,0,17851,7.0,17614,186,52,4334,1672,23.8,1785.1,8,14,0,2,10,1,0,0,0,0,13517,6.4,15942,150,52,-4334,-1672,20.2,1351.7
4790490733,1,17,1,1,5,5,3,1,1,0,0,15618,6.8,17608,173,52,415,502,22.5,1561.8,7,1,0,5,5,2,0,0,0,0,15203,6.6,17106,175,56,-415,-502,23.1,1520.3
4752515247,1,10,0,1,5,2,4,0,0,0,0,14365,6.6,16224,143,54,-53,-1565,19.7,1436.5,5,1,0,2,5,1,1,1,0,0,14418,7.0,17789,186,50,53,1565,23.6,1441.8
4741008019,0,11,1,0,7,10,5,0,0,0,0,15388,6.2,15885,159,14,-2947,-1808,17.3,1538.8,16,0,1,10,7,7,0,0,0,0,18335,6.6,17693,172,72,2947,1808,24.4,1833.5
4740970895,0,8,1,0,3,11,1,0,0,0,0,13815,6.8,17531,155,44,-3894,328,19.9,1381.5,23,0,1,11,3,13,1,1,0,0,17709,6.8,17203,171,48,3894,-328,21.9,1770.9
4740934890,1,100,2,0,6,4,6,0,0,0,0,16710,7.0,18006,169,52,1419,581,22.1,1671.0,15,1,1,4,6,5,0,0,0,0,15291,6.8,17425,186,60,-1419,-581,24.6,1529.1
4740889104,0,13,0,1,6,6,6,0,0,0,0,16143,6.8,16685,183,44,-748,-1229,22.7,1614.3,20,1,0,6,6,4,0,0,0,0,16891,7.0,17914,207,28,748,1229,23.5,1689.1
4730813881,1,20,1,0,1,3,1,0,0,0,0,14364,6.8,17306,210,60,13,162,27.0,1436.4,13,0,1,3,1,1,1,1,0,0,14351,6.6,17144,192,58,-13,-162,25.0,1435.1
4583776777,0,0,0,1,3,7,1,0,0,0,0,14316,6.8,17207,132,56,-1028,-515,18.8,1431.6,0,1,0,7,3,1,0,0,0,0,15344,7.0,17722,162,46,1028,515,20.8,1534.4
4808877693,0,10,0,0,1,6,0,0,0,0,0,12843,6.4,15779,161,40,-2872,-1234,20.1,1284.3,22,1,1,6,1,4,1,1,0,0,15715,6.8,17013,184,36,2872,1234,22.0,1571.5
4808768856,0,18,0,1,6,7,1,1,1,0,0,16730,6.8,16831,191,56,437,-1380,24.7,1673.0,12,0,0,6,5,4,0,0,0,0,16293,7.0,18211,189,36,-437,1380,22.5,1629.3
4789030259,0,12,1,1,8,13,8,0,0,0,0,17187,6.6,16749,170,52,-1824,-749,22.2,1718.7,14,0,0,13,8,20,1,1,0,0,19011,7.0,17498,184,52,1824,749,23.6,1901.1
4778375177,0,259,13,1,3,2,1,1,1,0,0,15033,6.8,18473,185,60,1585,964,24.5,1503.3,24,0,0,2,3,1,0,0,0,0,13448,6.8,17509,152,47,-1585,-964,19.9,1344.8
4776232960,0,10,0,0,3,3,2,0,0,0,0,14207,6.8,18257,157,44,-1661,549,20.1,1420.7,147,0,1,3,3,3,1,0,1,0,15868,6.6,17708,165,48,1661,-549,21.3,1586.8
4775686970,0,14,1,0,3,6,2,0,0,0,0,13871,6.2,15409,147,55,-2096,-2189,20.2,1387.1,61,0,1,6,3,4,0,0,0,0,15967,7.0,17598,162,52,2096,2189,21.4,1596.7
4775665267,1,12,1,1,7,10,3,1,0,1,0,16734,6.4,16298,159,52,72,-616,21.1,1673.4,6,0,0,10,7,6,1,1,0,0,16662,6.6,16914,159,44,-72,616,20.3,1666.2
4775649269,1,13,9,1,6,6,6,1,0,1,0,16061,7.0,17740,181,52,-271,-1029,23.3,1606.1,31,0,0,6,6,2,0,0,0,0,16332,7.0,18769,195,56,271,1029,25.1,1633.2
4775566013,1,15,0,0,6,3,2,0,0,0,0,15767,6.6,16633,153,60,1890,-268,21.3,1576.7,8,1,1,3,6,3,0,0,0,0,13877,6.6,16901,138,40,-1890,268,17.8,1387.7
4775549427,0,8,1,0,4,6,2,0,0,0,0,14529,6.8,17241,153,44,-916,503,19.7,1452.9,238,0,1,6,4,4,1,1,0,0,15445,6.8,16738,167,36,916,-503,20.3,1544.5
4775535888,0,13,3,0,5,5,2,0,0,0,0,15649,7.0,17700,152,64,79,74,21.6,1564.9,14,3,1,5,5,2,0,0,0,0,15570,6.6,17626,200,56,-79,-74,25.6,1557.0
4774667912,1,9,0,0,7,4,5,0,0,0,0,15297,6.8,17460,158,48,-52,21,20.6,1529.7,13,0,1,4,7,1,1,0,1,0,15349,6.6,17439,168,51,52,-21,21.9,1534.9
4774639763,1,13,2,1,3,2,2,1,0,1,0,14904,7.4,19857,172,52,1644,2532,22.4,1490.4,13,1,0,2,3,1,1,1,0,0,13260,6.8,17325,160,50,-1644,-2532,21.0,1326.0
4774621884,1,34,1,0,11,9,6,0,0,0,0,18252,6.6,17739,198,48,2216,3560,24.6,1825.2,9,17,1,9,11,7,0,0,0,0,16036,6.2,14179,142,48,-2216,-3560,19.0,1603.6
4774603824,0,168,2,0,5,4,6,0,0,0,0,15318,6.6,15942,160,44,-275,-9,20.4,1531.8,12,0,1,4,5,4,0,0,0,0,15593,6.6,15951,129,44,275,9,17.3,1559.3
4774521124,0,13,0,0,3,4,0,0,0,0,0,14015,6.8,17709,154,64,-645,1401,21.8,1401.5,6,0,1,4,3,5,0,0,0,0,14660,6.2,16308,145,40,645,-1401,18.5,1466.0
4774440571,1,12,0,0,5,4,1,1,1,0,0,14916,7.0,18412,183,56,39,746,23.9,1491.6,8,1,1,4,5,4,0,0,0,0,14877,7.0,17666,169,49,-39,-746,21.8,1487.7
4774377161,0,10,1,0,5,3,5,0,0,0,0,14472,6.6,16216,138,42,-270,-828,18.0,1447.2,245,1,1,3,5,3,0,0,0,0,14742,6.8,17044,170,44,270,828,21.4,1474.2
4774344654,0,8,1,0,1,9,0,0,0,0,0,13948,6.6,17377,167,63,-2511,-252,23.0,1394.8,12,0,1,9,1,6,1,1,0,0,16459,7.0,17629,169,40,2511,252,20.9,1645.9
4748266333,1,22,13,0,27,31,61,0,0,0,2,39041,11.0,40928,93,0,-1137,-2843,9.3,3904.1,27,0,1,30,26,81,0,0,0,0,40178,11.6,43771,111,0,1137,2843,11.1,4017.8
4748243833,1,24,0,0,11,15,30,0,0,0,0,32993,10.2,35105,104,0,-1017,-2853,10.4,3299.3,103,25,1,15,11,35,0,0,0,0,34010,10.6,37958,90,0,1017,2853,9.0,3401.0
4736695851,0,14,1,0,4,4,2,0,0,0,0,14850,6.8,16687,148,32,-485,191,18.0,1485.0,14,2,1,4,4,2,1,1,0,0,15335,6.4,16496,194,48,485,-191,24.2,1533.5
4734776782,0,0,0,1,34,23,87,0,0,0,0,40094,11.4,43748,116,0,2380,1359,11.6,4009.4,8,0,0,23,34,49,0,0,0,0,37714,11.4,42389,120,0,-2380,-1359,12.0,3771.4
4734747225,1,0,0,1,30,19,77,0,0,0,0,38681,11.4,43882,95,0,2214,2695,9.5,3868.1,0,0,0,19,30,47,0,0,0,0,36467,11.2,41187,108,0,-2214,-2695,10.8,3646.7
4734489075,0,15,3,0,0,2,0,0,0,0,0,11911,6.2,15501,160,44,-4757,-2751,20.4,1191.1,19,3,1,2,0,2,0,0,0,0,16668,7.2,18252,223,68,4757,2751,29.1,1666.8
4734437373,0,35,0,1,6,3,10,0,0,0,0,14748,6.2,14847,148,44,450,-1816,19.2,1474.8,8,0,0,3,6,1,0,0,0,0,14298,6.6,16663,163,60,-450,1816,22.3,1429.8
4733495801,1,13,2,1,6,2,5,1,1,0,0,15080,6.6,16192,149,52,1086,-54,20.1,1508.0,14,0,0,2,6,1,0,0,0,0,13994,6.4,16246,164,62,-1086,54,22.6,1399.4
4733451795,0,22,0,0,2,9,0,0,0,0,0,13297,6.8,16824,189,48,-3793,-1290,23.7,1329.7,9,1,1,9,2,8,0,0,0,0,17090,7.0,18114,197,32,3793,1290,22.9,1709.0
4733395213,1,11,2,1,5,3,3,1,1,0,0,15152,6.6,17130,141,68,1112,-81,20.9,1515.2,14,4,0,3,5,2,0,0,0,0,14040,6.8,17211,184,44,-1112,81,22.8,1404.0
4733362053,1,9,1,1,6,6,7,0,0,0,0,15528,6.8,17700,169,32,-1178,-812,20.1,1552.8,21,0,0,6,6,5,0,0,0,0,16706,7.0,18512,197,44,1178,812,24.1,1670.6
4732489500,1,15,0,1,10,5,5,0,0,0,0,19308,6.8,18818,204,67,4299,3010,27.1,1930.8,87,0,0,5,10,6,0,0,0,0,15009,6.4,15808,135,40,-4299,-3010,17.5,1500.9
4732464848,1,14,0,1,5,2,3,1,1,0,0,14680,6.6,16486,175,40,903,-572,21.5,1468.0,23,1,0,2,5,1,0,0,0,0,13777,6.8,17058,160,44,-903,572,20.4,1377.7
4732399664,1,15,0,0,4,8,2,0,0,0,0,15086,6.8,17880,169,45,-599,1432,21.4,1508.6,11,1,1,8,4,6,0,0,0,0,15685,6.8,16448,146,52,599,-1432,19.8,1568.5
4723599024,1,36,3,0,20,17,20,0,0,0,0,63265,12.0,55000,8,0,26280,22000,0.8,6326.5,8,1,1,9,12,7,0,0,0,0,36985,7.2,33000,0,0,-26280,-22000,0.0,3698.5
4723578092,1,29,0,1,15,13,13,0,0,0,0,46650,10.6,50500,0,0,18800,22000,0.0,4665.0,0,0,0,9,11,7,0,0,0,0,27850,6.0,28500,0,0,-18800,-22000,0.0,2785.0
4723560112,1,21,2,0,14,21,14,0,0,0,0,59920,12.0,55000,2,0,21310,20000,0.2,5992.0,27,1,1,12,5,16,0,0,0,0,38610,7.6,35000,1,0,-21310,-20000,0.1,3861.0
4723541408,1,84,4,0,14,22,20,0,0,0,0,62555,12.6,59500,8,0,23438,22000,0.8,6255.5,73,3,1,15,7,13,0,0,0,0,39117,7.8,37500,8,0,-23438,-22000,0.8,3911.7
4723507480,0,0,20,1,20,24,57,0,0,0,0,35288,10.6,36985,99,0,-1179,-3432,9.9,3528.8,17,0,0,24,20,50,0,0,0,0,36467,11.4,40417,90,0,1179,3432,9.0,3646.7
4723477701,0,0,0,0,20,25,58,0,0,0,1,36778,11.2,40307,98,0,-1019,-444,9.8,3677.8,0,0,1,25,20,54,0,0,0,0,37797,11.2,40751,88,0,1019,444,8.8,3779.7
4753476993,0,10,0,1,8,6,16,1,1,0,0,15868,6.4,16098,161,56,428,-1004,21.7,1586.8,122,0,0,6,8,3,0,0,0,0,15440,6.4,17102,161,59,-428,1004,22.0,1544.0
4753455664,0,8,12,1,6,8,2,0,0,0,0,14214,6.4,15978,154,52,-4365,-2797,20.6,1421.4,98,0,0,8,6,5,1,1,0,0,18579,7.4,18775,179,48,4365,2797,22.7,1857.9
4753436484,0,189,0,0,3,7,3,1,1,0,0,13996,6.8,17320,173,52,-2898,925,22.5,1399.6,8,0,1,7,3,6,1,0,1,0,16894,6.4,16395,165,48,2898,-925,21.3,1689.4
4743235849,0,14,0,0,4,8,2,0,0,0,0,14164,6.4,15122,156,52,-4261,-3693,20.8,1416.4,85,0,1,8,4,8,1,1,0,0,18425,7.2,18815,166,68,4261,3693,23.4,1842.5
4738241779,1,41,1,1,7,5,7,1,1,0,0,15867,7.2,18510,155,72,1593,797,22.7,1586.7,9,11,0,5,7,2,0,0,0,0,14274,6.8,17713,177,40,-1593,-797,21.7,1427.4
4738211889,0,13,1,0,5,6,1,0,0,0,0,15392,6.8,17872,158,46,-1264,1431,20.4,1539.2,13,0,1,6,5,6,1,1,0,0,16656,6.6,16441,186,60,1264,-1431,24.6,1665.6
4738193835,1,18,3,0,11,8,8,0,0,0,0,18426,6.8,17026,190,52,2171,1195,24.2,1842.6,8,2,1,8,11,4,0,0,0,0,16255,6.6,15831,145,48,-2171,-1195,19.3,1625.5
4738160856,1,53,0,1,4,0,2,0,0,0,0,13572,6.6,17702,154,60,810,1292,21.4,1357.2,11,0,0,0,4,0,1,1,0,0,12762,6.6,16410,151,60,-810,-1292,21.1,1276.2
4738118418,0,14,1,0,3,3,2,1,1,0,0,14406,6.6,16829,176,40,-1740,-1633,21.6,1440.6,10,1,1,3,3,3,1,0,1,0,16146,7.2,18462,149,52,1740,1633,20.1,1614.6
4495631941,1,233,0,0,3,6,5,1,1,0,0,13215,6.2,15112,132,44,-2377,-2892,17.6,1321.5,19,1,1,6,3,3,0,0,0,0,15592,7.2,18004,152,60,2377,2892,21.2,1559.2
4495596007,0,11,1,0,0,6,0,0,0,0,0,12372,6.4,16039,134,44,-4011,-1973,17.8,1237.2,11,2,1,6,0,4,2,1,1,0,16383,7.2,18012,160,56,4011,1973,21.6,1638.3
4495561038,1,12,0,1,6,1,3,1,0,1,0,15244,6.4,16315,158,54,2555,1578,21.2,1524.4,95,0,0,1,6,2,1,1,0,0,12689,6.2,14737,121,38,-2555,-1578,15.9,1268.9
4487759498,0,65,0,0,15,30,30,0,0,0,1,33540,10.2,35249,87,0,-5114,-5273,8.7,3354.0,0,0,1,30,15,69,0,0,0,0,38654,11.0,40522,113,0,5114,5273,11.3,3865.4
4484497782,0,12,0,0,2,6,1,0,0,0,0,13029,6.2,14918,152,46,-1587,-1705,19.8,1302.9,180,0,1,6,2,4,0,0,0,0,14616,6.6,16623,157,38,1587,1705,19.5,1461.6
4484456417,0,6,0,0,5,8,1,0,0,0,0,14649,6.6,16645,167,36,-3684,-927,20.3,1464.9,13,1,1,8,5,5,0,0,0,0,18333,6.8,17572,167,60,3684,927,22.7,1833.3
4484406590,0,10,0,0,2,4,0,0,0,0,0,12986,6.8,16548,170,44,-3430,-2544,21.4,1298.6,11,1,1,3,1,3,1,1,0,0,16416,7.2,19092,183,56,3430,2544,23.9,1641.6
4481531841,0,298,1,0,5,7,3,0,0,0,0,14079,6.6,17041,119,56,-1799,259,17.5,1407.9,13,0,1,7,5,8,0,0,0,0,15878,6.8,16782,145,48,1799,-259,19.3,1587.8
4476562864,0,12,0,0,6,9,2,1,0,1,0,15553,7.0,18300,152,52,-277,20,20.4,1555.3,73,1,1,9,6,3,0,0,0,0,15830,7.0,18280,136,64,277,-20,20.0,1583.0
4453547978,0,11,3,1,7,4,6,0,0,0,0,15204,6.6,17205,145,44,-380,140,18.9,1520.4,12,2,0,4,7,3,1,1,0,0,15584,6.8,17065,147,48,380,-140,19.5,1558.4
4452744983,0,27,1,0,2,6,2,0,0,0,0,13758,6.8,16837,146,52,-1687,-531,19.8,1375.8,7,11,1,6,2,4,0,0,0,0,15445,6.8,17368,157,45,1687,531,20.2,1544.5
4845489304,0,20,1,0,3,5,2,0,0,0,0,14285,6.4,16288,168,50,-1048,-1302,21.8,1428.5,15,2,1,5,3,3,1,1,0,0,15333,7.0,17590,202,52,1048,1302,25.4,1533.3
4839574585,0,10,2,0,3,8,2,0,0,0,0,14155,6.8,17678,188,40,-2200,408,22.8,1415.5,14,0,1,8,3,11,0,0,0,0,16355,7.0,17270,159,47,2200,-408,20.6,1635.5
4839564212,0,15,3,1,12,10,10,0,0,0,0,18531,6.6,16254,162,56,32,170,21.8,1853.1,18,2,0,10,12,13,1,1,0,0,18499,6.4,16084,154,49,-32,-170,20.3,1849.9
4839556177,1,11,1,1,5,7,6,0,0,0,0,17374,6.8,17397,172,52,-372,-306,22.4,1737.4,11,1,0,7,5,3,0,0,0,0,17746,6.8,17703,178,44,372,306,22.2,1774.6
4839541463,1,6,2,0,8,6,6,0,0,0,0,16532,6.6,17404,173,48,660,-913,22.1,1653.2,13,0,1,6,8,2,1,1,0,0,15872,7.0,18317,218,64,-660,913,28.2,1587.2
4838591613,1,17,1,0,2,1,1,0,0,0,0,13332,6.8,16516,191,40,-463,-440,23.1,1333.2,11,1,1,1,2,1,0,0,0,0,13795,6.8,16956,197,48,463,440,24.5,1379.5
4838584806,1,14,1,0,5,4,2,0,0,0,0,16972,6.8,17754,212,52,2038,1546,26.4,1697.2,122,0,1,4,5,4,1,1,0,0,14934,6.8,16208,165,44,-2038,-1546,20.9,1493.4
4838565381,0,31,1,0,2,4,1,1,1,0,0,15638,7.0,18012,209,65,416,-66,27.4,1563.8,32,0,1,4,2,4,0,0,0,0,15222,7.2,18078,158,62,-416,66,22.0,1522.2
4838558087,1,16,1,1,8,3,8,0,0,0,0,17743,7.2,18480,197,60,3743,2048,25.7,1774.3,9,1,0,3,8,3,0,0,0,0,14000,6.4,16432,166,40,-3743,-2048,20.6,1400.0
4857426460,0,14,0,1,7,3,7,0,0,0,0,15763,6.6,16605,145,48,642,-1498,19.3,1576.3,9,1,0,3,7,0,0,0,0,0,15121,7.0,18103,241,48,-642,1498,28.9,1512.1
4857348199,1,0,0,0,18,19,19,0,0,0,0,47189,10.0,47500,3,0,19639,19000,0.3,4718.9,7,0,1,11,10,10,0,0,0,0,27550,6.0,28500,0,0,-19639,-19000,0.0,2755.0
4857239053,1,5,0,1,20,16,12,0,0,0,0,46700,10.0,47500,2,0,18150,19000,0.2,4670.0,0,0,0,5,9,12,0,0,0,0,28550,6.0,28500,0,0,-18150,-19000,0.0,2855.0
4857206347,1,62,9,0,18,20,16,0,0,0,0,48400,10.0,47500,13,0,19132,19000,1.3,4840.0,0,3,1,12,10,11,0,0,0,0,29268,6.0,28500,9,0,-19132,-19000,0.9,2926.8
4857184117,1,0,0,1,18,23,14,0,0,0,0,61650,12.0,55000,0,0,23400,22000,0.0,6165.0,0,0,0,13,8,16,0,0,0,0,38250,7.2,33000,0,0,-23400,-22000,0.0,3825.0
4854621799,1,0,0,1,19,13,18,0,0,0,0,62000,12.0,55000,0,0,24800,22000,0.0,6200.0,8,0,0,7,13,8,0,0,0,0,37200,7.2,33000,0,0,-24800,-22000,0.0,3720.0
4854354731,1,0,0,0,11,21,19,0,0,0,0,47350,12.0,55000,0,0,18100,22000,0.0,4735.0,86,0,1,17,7,10,0,0,0,0,29250,7.2,33000,0,0,-18100,-22000,0.0,2925.0
4854353823,1,0,0,1,15,18,14,0,0,0,0,62010,12.0,55000,0,0,23410,22000,0.0,6201.0,0,0,0,12,9,14,0,0,0,0,38600,7.2,33000,0,0,-23410,-22000,0.0,3860.0
4853862693,1,0,0,0,17,20,15,0,0,0,0,46650,10.4,49000,0,0,17400,20500,0.0,4665.0,0,0,1,12,9,14,0,0,0,0,29250,6.0,28500,0,0,-17400,-20500,0.0,2925.0
4853842725,1,0,0,1,18,11,20,0,0,0,0,47000,10.0,47500,0,0,20200,16000,0.0,4700.0,0,0,0,6,13,6,0,0,0,0,26800,6.6,31500,0,0,-20200,-16000,0.0,2680.0
4853070261,1,0,0,1,16,17,17,0,0,0,0,61826,12.0,55000,0,0,24976,22000,0.0,6182.6,0,0,0,9,8,12,0,0,0,0,36850,7.2,33000,0,0,-24976,-22000,0.0,3685.0
4853046702,1,20,0,1,14,24,13,0,0,0,0,61047,12.4,57000,2,0,22831,24000,0.2,6104.7,0,0,0,16,6,13,0,0,0,0,38216,7.2,33000,3,0,-22831,-24000,0.3,3821.6
4853029078,1,0,0,0,16,25,21,0,0,0,0,63050,12.6,59500,0,0,24100,22000,0.0,6305.0,0,0,1,17,8,14,0,0,0,0,38950,7.8,37500,0,0,-24100,-22000,0.0,3895.0
4853004393,1,0,0,1,15,14,20,0,0,0,0,61540,12.4,57000,6,0,24295,24000,0.6,6154.0,0,0,0,10,11,5,0,0,0,0,37245,7.2,33000,1,0,-24295,-24000,0.1,3724.5
4852900994,1,3,0,0,14,15,15,0,0,0,0,45250,10.0,47500,0,0,18100,19000,0.0,4525.0,0,0,1,8,7,10,0,0,0,0,27150,6.0,28500,0,0,-18100,-19000,0.0,2715.0
4852800754,1,0,0,0,18,22,16,0,0,0,0,48050,10.0,47500,0,0,18100,19000,0.0,4805.0,0,0,1,13,9,11,0,0,0,0,29950,6.0,28500,0,0,-18100,-19000,0.0,2995.0
4852766713,1,1,0,0,22,26,21,0,0,0,0,46829,10.0,47500,0,0,17229,19000,0.0,4682.9,11,0,1,13,9,13,0,0,0,0,29600,6.0,28500,0,0,-17229,-19000,0.0,2960.0
4852043694,1,7,0,0,22,19,58,0,0,0,0,36491,11.0,38462,107,0,1356,84,10.7,3649.1,24,0,1,19,22,37,0,0,0,0,35135,10.8,38378,98,0,-1356,-84,9.8,3513.5
4852027438,0,0,0,1,26,35,68,0,0,0,1,38422,11.4,43304,80,0,-3564,-3366,8.0,3842.2,2,0,0,35,26,97,0,0,0,0,41986,12.2,46670,126,0,3564,3366,12.6,4198.6
4780299082,1,10,2,1,2,2,1,0,0,0,0,16001,7.2,19206,224,68,1562,646,29.2,1600.1,10,0,0,2,2,1,0,0,0,0,14439,6.8,18560,214,60,-1562,-646,27.4,1443.9
4776865631,1,14,3,1,8,1,7,0,0,0,0,17343,6.6,16864,209,36,3413,-688,24.5,1734.3,9,3,0,1,8,0,0,0,0,0,13930,7.0,17552,214,48,-3413,688,26.2,1393.0
4774728471,0,8,2,1,6,7,2,0,0,0,0,14626,6.6,15714,177,40,-2290,-729,21.7,1462.6,20,0,0,7,6,10,0,0,0,0,16916,6.6,16443,180,48,2290,729,22.8,1691.6
4774706338,1,9,3,0,5,6,3,0,0,0,0,15549,7.2,17877,175,52,-341,1433,22.7,1554.9,29,0,1,6,5,5,1,1,0,0,15890,6.8,16444,195,59,341,-1433,25.4,1589.0
4769555542,1,16,2,0,9,6,3,0,0,0,0,16227,7.0,17071,163,44,1021,287,20.7,1622.7,9,1,1,6,9,2,0,0,0,0,15206,6.6,16784,185,44,-1021,-287,22.9,1520.6
4769530068,0,10,0,0,4,5,1,0,0,0,0,15714,6.8,17771,215,52,-876,-914,26.7,1571.4,19,2,1,5,4,7,1,1,0,0,16590,7.2,18685,218,72,876,914,29.0,1659.0
4858134552,1,0,0,0,21,15,20,0,0,0,0,63100,12.0,55000,1,0,25500,22000,0.1,6310.0,0,0,1,7,13,10,0,0,0,0,37600,7.2,33000,1,0,-25500,-22000,0.1,3760.0
4858084082,1,4,0,1,18,15,15,0,0,0,0,49450,10.0,47500,0,0,21950,19000,0.0,4945.0,0,0,0,6,9,8,0,0,0,0,27500,6.0,28500,0,0,-21950,-19000,0.0,2750.0
4858065488,1,0,0,1,22,11,23,0,0,0,0,63050,12.0,55000,0,0,27600,22000,0.0,6305.0,5,0,0,5,16,3,0,0,0,0,35450,7.2,33000,0,0,-27600,-22000,0.0,3545.0
4858050469,1,0,0,0,19,20,20,0,0,0,0,61382,12.0,55000,2,0,22757,22000,0.2,6138.2,0,0,1,13,12,15,0,0,0,0,38625,7.2,33000,1,0,-22757,-22000,0.1,3862.5
4857960065,1,0,4,0,22,20,43,0,0,0,0,35823,10.6,37954,128,0,1463,1087,12.8,3582.3,24,0,1,20,22,50,0,0,0,0,34360,10.8,36867,93,0,-1463,-1087,9.3,3436.0
4857945909,0,68,0,0,21,21,47,0,0,0,0,34593,10.8,37497,88,0,-2618,-3351,8.8,3459.3,5,0,1,21,21,51,0,0,0,0,37211,11.2,40848,102,0,2618,3351,10.2,3721.1
4857809617,1,0,0,1,30,20,89,0,0,0,1,37253,11.6,42558,91,0,1237,3234,9.1,3725.3,0,0,0,20,30,56,0,0,0,0,36016,11.0,39324,69,0,-1237,-3234,6.9,3601.6
4857807054,0,86,0,0,30,32,63,0,0,0,1,38251,11.6,44105,98,0,-1408,-1809,9.8,3825.1,0,0,1,32,30,70,0,0,0,0,39659,11.8,45914,100,0,1408,1809,10.0,3965.9
4857012039,0,0,0,1,25,27,41,0,0,0,0,37606,11.4,42059,93,0,-1225,-704,9.3,3760.6,0,0,0,27,25,65,0,0,0,0,38831,11.4,42763,93,0,1225,704,9.3,3883.1
4856891172,1,24,0,0,23,15,19,0,0,0,0,48609,10.0,47500,2,0,20399,19000,0.2,4860.9,20,0,1,7,15,6,0,0,0,0,28210,6.0,28500,0,0,-20399,-19000,0.0,2821.0
4856880915,1,0,0,0,16,19,17,0,0,0,0,48620,10.0,47500,3,0,20260,19000,0.3,4862.0,0,0,1,13,10,5,0,0,0,0,28360,6.0,28500,3,0,-20260,-19000,0.3,2836.0
4856849994,1,0,0,1,12,15,16,0,0,0,0,45250,10.0,47500,0,0,17400,19000,0.0,4525.0,1,0,0,11,8,8,0,0,0,0,27850,6.0,28500,0,0,-17400,-19000,0.0,2785.0
4855750616,0,156,0,0,14,20,29,0,0,0,1,34073,10.6,36440,84,0,-2671,-3267,8.4,3407.3,5,0,1,20,14,49,0,0,0,0,36744,10.8,39707,100,0,2671,3267,10.0,3674.4
4855715183,0,0,0,0,24,34,53,0,0,0,1,37479,11.4,41742,92,0,-2320,-3482,9.2,3747.9,0,0,1,34,24,77,0,0,0,0,39799,11.6,45224,97,0,2320,3482,9.7,3979.9
4855697392,1,0,0,0,20,21,43,0,0,0,1,36177,11.0,40003,86,0,-2487,-2457,8.6,3617.7,2,0,1,21,20,45,0,0,0,0,38664,11.4,42460,111,0,2487,2457,11.1,3866.4
4855687832,0,22,0,1,26,24,76,0,0,0,0,37085,11.0,40684,85,0,-2609,-1931,8.5,3708.5,216,3,0,24,26,67,0,0,0,0,39694,11.6,42615,99,0,2609,1931,9.9,3969.4
4855663421,1,0,0,0,28,34,56,0,0,0,1,38633,11.6,43355,92,0,-1528,-947,9.2,3863.3,0,0,1,34,28,94,0,0,0,0,40161,11.8,44302,88,0,1528,947,8.8,4016.1
4855658748,1,0,0,0,22,18,50,0,0,0,1,37602,11.6,41353,105,0,2467,2928,10.5,3760.2,0,0,1,18,22,34,0,0,0,0,35135,11.0,38425,78,0,-2467,-2928,7.8,3513.5
4855641214,0,0,0,1,30,24,69,0,0,0,0,38703,11.4,41874,96,0,-531,-2416,9.6,3870.3,8,0,0,24,30,65,0,0,0,0,39234,11.6,44290,124,0,531,2416,12.4,3923.4
4856382038,1,12,1,1,4,1,2,0,0,0,0,15452,7.2,18655,211,48,2156,1508,25.9,1545.2,8,0,0,1,4,0,1,1,0,0,13296,6.6,17147,162,68,-2156,-1508,23.0,1329.6
4854034074,1,34,0,1,9,6,5,0,0,0,0,16599,6.6,16512,138,44,1532,622,18.2,1659.9,35,3,0,5,8,5,1,0,1,0,15067,6.6,15890,159,44,-1532,-622,20.3,1506.7
4853983430,1,50,1,0,4,6,2,0,0,0,0,15230,6.8,18048,146,58,-447,639,20.4,1523.0,10,1,1,6,4,5,0,0,0,0,15677,6.8,17409,179,59,447,-639,23.8,1567.7
4845854427,0,12,0,0,5,9,6,0,0,0,0,16610,6.8,16887,180,56,114,-1094,23.6,1661.0,8,0,1,9,5,5,0,0,0,0,16496,6.8,17981,163,44,-114,1094,20.7,1649.6
4845783325,1,11,1,0,3,2,3,0,0,0,0,14783,7.0,17638,163,56,-23,77,21.9,1478.3,62,0,1,2,3,0,0,0,0,0,14806,6.8,17561,173,72,23,-77,24.5,1480.6
4845760762,1,13,0,0,4,2,5,2,1,1,0,16076,7.0,18687,182,56,1538,921,23.8,1607.6,4,0,1,2,4,1,0,0,0,0,14538,6.8,17766,145,56,-1538,-921,20.1,1453.8
4845735722,1,49,0,1,8,3,7,1,1,0,0,15764,7.2,18156,179,48,1081,1466,22.7,1576.4,11,0,0,3,8,3,0,0,0,0,14683,6.8,16690,181,56,-1081,-1466,23.7,1468.3
4842562595,0,13,0,1,5,7,2,0,0,0,0,15690,6.6,17754,173,44,662,-129,21.7,1569.0,13,1,0,7,5,2,0,0,0,0,15028,6.8,17883,154,48,-662,129,20.2,1502.8
4842525800,1,12,0,0,2,7,1,0,0,0,0,13257,6.6,17602,167,56,-1741,-303,22.3,1325.7,11,0,1,7,2,6,0,0,0,0,14998,6.8,17905,149,48,1741,303,19.7,1499.8
4840501567,1,10,1,0,6,2,3,0,0,0,0,15284,6.8,17564,168,44,145,305,21.2,1528.4,15,1,1,2,6,1,0,0,0,0,15139,6.8,17259,173,48,-145,-305,22.1,1513.9
4840464467,1,12,1,0,5,5,3,0,0,0,0,15063,7.0,17415,176,48,-405,-1124,22.4,1506.3,14,0,1,5,5,2,0,0,0,0,15468,7.0,18539,196,52,405,1124,24.8,1546.8
4840050080,1,14,1,1,6,8,4,0,0,0,0,16613,6.8,17160,208,40,205,-554,24.8,1661.3,12,2,0,8,6,5,0,0,0,0,16408,6.8,17714,152,56,-205,554,20.8,1640.8
4808158465,0,174,0,1,7,4,2,0,0,0,0,16081,7.2,18315,173,60,710,1458,23.3,1608.1,15,1,0,4,7,2,0,0,0,0,15371,6.8,16857,168,48,-710,-1458,21.6,1537.1
4808140093,1,13,0,1,6,0,7,0,0,0,0,15448,6.4,15735,196,40,2337,-967,23.6,1544.8,15,0,0,0,6,0,0,0,0,0,13111,6.6,16702,166,56,-2337,967,22.2,1311.1
4808119115,0,13,0,0,2,6,1,0,0,0,0,12946,6.2,15319,138,56,-3245,-3172,19.4,1294.6,9,0,1,6,2,0,0,0,0,0,16191,6.8,18491,173,60,3245,3172,23.3,1619.1
4801883003,1,15,1,1,6,2,2,1,1,0,0,17210,7.2,19192,177,68,3789,1533,24.5,1721.0,8,0,0,2,6,2,0,0,0,0,13421,7.0,17659,171,44,-3789,-1533,21.5,1342.1
4801823076,0,14,1,0,6,4,4,0,0,0,0,15465,6.8,17609,176,56,482,-250,23.2,1546.5,15,1,1,4,6,2,0,0,0,0,14983,6.8,17859,177,44,-482,250,22.1,1498.3
4796216776,0,0,0,1,22,21,43,0,0,0,2,36767,11.0,39334,102,0,124,-1704,10.2,3676.7,3,0,0,21,22,47,0,0,0,0,36643,11.2,41038,99,0,-124,1704,9.9,3664.3
4792966401,0,17,0,0,4,6,2,0,0,0,0,14061,6.6,16427,174,44,-1521,-2721,21.8,1406.1,12,1,1,6,4,0,0,0,0,0,15582,7.2,19148,161,56,1521,2721,21.7,1558.2
4858492305,0,0,0,0,22,30,54,0,0,0,0,36007,10.8,39824,86,0,-3753,-4679,8.6,3600.7,0,0,1,30,22,74,0,0,0,0,39760,11.8,44503,114,0,3753,4679,11.4,3976.0
4858471493,0,0,0,1,19,19,40,0,0,0,1,33791,10.6,37719,84,0,-1562,-835,8.4,3379.1,0,0,0,19,19,50,0,0,0,0,35353,11.0,38554,124,0,1562,835,12.4,3535.3
4858452163,1,12,0,0,22,23,57,0,0,0,1,37704,11.2,41147,109,0,794,1475,10.9,3770.4,0,0,1,23,22,59,0,0,0,0,36910,11.0,39672,104,0,-794,-1475,10.4,3691.0
4851948184,1,95,0,0,16,18,32,0,0,0,0,33519,10.2,36133,106,0,-764,-686,10.6,3351.9,13,2,1,18,16,53,0,0,0,0,34283,10.6,36819,120,0,764,686,12.0,3428.3
4851895058,0,11,0,0,6,9,2,0,0,0,0,16325,6.8,17237,186,38,-1029,188,22.4,1632.5,184,1,1,9,6,15,1,1,0,0,17354,6.8,17049,160,44,1029,-188,20.4,1735.4
4849966732,1,13,2,1,6,5,10,0,0,0,0,15482,6.2,15594,153,52,-75,-2905,20.5,1548.2,11,1,0,5,6,2,0,0,0,0,15557,7.0,18499,203,55,75,2905,25.8,1555.7
4849935763,0,179,0,1,2,5,1,0,0,0,0,14739,6.6,16669,183,55,-1664,-1250,23.8,1473.9,7,1,0,5,2,6,2,1,1,0,16403,6.8,17919,203,60,1664,1250,26.3,1640.3
4846097697,0,0,0,0,9,15,27,0,0,0,1,32527,10.0,33624,85,0,-2977,-3554,8.5,3252.7,25,0,1,15,9,36,0,0,0,0,35504,10.8,37178,102,0,2977,3554,10.2,3550.4
4842433914,0,23,0,1,12,19,27,0,0,0,0,35457,10.6,37741,62,59,52,-1536,12.1,3545.7,11,0,0,19,12,38,0,0,0,0,35405,11.0,39277,80,60,-52,1536,14.0,3540.5
4842406396,0,13,0,0,12,22,17,0,0,0,1,28795,9.6,30174,42,51,-8460,-8442,9.3,2879.5,19,0,1,22,12,38,0,0,0,0,37255,10.8,38616,74,67,8460,8442,14.1,3725.5
4842388862,0,15,0,0,5,28,7,0,0,0,2,30689,10.0,33739,61,43,-10327,-10211,10.4,3068.9,16,0,1,28,5,47,0,0,0,0,41016,11.6,43950,79,75,10327,10211,15.4,4101.6
4842356298,0,14,1,0,11,6,17,0,0,0,1,31272,10.4,35409,105,55,2306,1019,16.0,3127.2,14,0,1,6,11,9,0,0,0,0,28966,10.4,34390,79,59,-2306,-1019,13.8,2896.6
4839304447,1,13,2,0,18,21,55,0,0,0,0,37637,11.6,42811,77,53,-1770,1883,13.0,3763.7,18,0,1,20,17,45,0,0,0,0,39407,11.2,40928,98,67,1770,-1883,16.5,3940.7
4839280816,1,14,0,1,21,10,50,0,0,0,0,33117,11.2,40883,89,51,1361,1860,14.0,3311.7,30,0,0,10,21,21,0,0,0,0,31756,11.2,39023,103,47,-1361,-1860,15.0,3175.6
4838126775,0,44,0,0,10,10,19,0,0,0,0,32965,11.0,38876,90,59,-1433,-3437,14.9,3296.5,14,23,1,10,10,30,0,0,0,0,34398,11.4,42313,87,71,1433,3437,15.8,3439.8
4838086740,1,13,0,1,16,8,37,0,0,0,1,33975,10.8,39098,70,63,5604,5466,13.3,3397.5,13,0,0,8,16,21,0,0,0,0,28371,10.2,33632,86,43,-5604,-5466,12.9,2837.1
4838054200,0,22,0,1,12,16,22,0,0,0,1,32735,10.6,37030,80,48,-6958,-3528,12.8,3273.5,14,1,0,16,12,33,0,0,0,0,39693,11.2,40558,92,72,6958,3528,16.4,3969.3
4838028775,0,28,0,0,16,20,29,0,0,0,0,33760,10.6,36963,75,47,-4500,-5377,12.2,3376.0,9,0,1,20,16,46,0,0,0,0,38260,11.4,42340,76,63,4500,5377,13.9,3826.0
4837985256,0,15,0,1,10,22,14,0,0,0,0,32081,10.6,37499,61,59,-5539,-4900,12.0,3208.1,11,2,0,21,9,53,0,0,0,0,37620,11.6,42399,79,75,5539,4900,15.4,3762.0
4831811938,1,219,1,1,4,6,3,0,0,0,0,14149,6.6,16555,154,39,-1810,-741,19.3,1414.9,11,0,0,6,4,5,1,1,0,0,15959,7.0,17296,178,46,1810,741,22.4,1595.9
4831413214,0,12,1,0,7,10,8,0,0,0,0,14276,6.0,14739,118,32,-4861,-4720,15.0,1427.6,66,3,1,10,7,9,0,0,0,0,19137,7.2,19459,173,54,4861,4720,22.7,1913.7
4831373009,0,11,1,0,2,3,2,1,0,1,0,13213,6.8,17232,134,52,-753,1135,18.6,1321.3,9,0,1,3,2,4,1,1,0,0,13966,6.2,16097,142,56,753,-1135,19.8,1396.6
4829362486,0,16,0,1,2,1,2,0,0,0,0,14143,7.0,17727,196,48,525,860,24.4,1414.3,6,0,0,1,2,1,0,0,0,0,13618,6.8,16867,163,47,-525,-860,21.0,1361.8
4829139924,0,153,0,1,4,4,1,0,0,0,0,14911,6.8,17750,178,40,1164,2262,21.8,1491.1,8,0,0,4,4,3,1,1,0,0,13747,6.0,15488,157,44,-1164,-2262,20.1,1374.7
4828922137,0,13,1,1,5,8,0,0,0,0,0,13724,6.8,17387,135,44,-3709,-1615,17.9,1372.4,9,1,0,8,5,7,2,1,1,0,17433,7.2,19002,155,52,3709,1615,20.7,1743.3
4828019753,0,138,0,0,3,4,1,0,0,0,0,14315,6.8,17355,162,48,-1621,94,21.0,1431.5,16,0,1,4,3,2,0,0,0,0,15936,6.4,17261,191,32,1621,-94,22.3,1593.6
4826915398,0,6,9,0,3,3,4,0,0,0,0,13952,6.6,16299,108,48,-1549,-2208,15.6,1395.2,31,0,1,3,3,2,1,1,0,0,15501,7.0,18507,179,60,1549,2208,23.9,1550.1
4826874367,0,17,1,0,8,3,4,0,0,0,0,15876,6.8,17404,174,52,705,319,22.6,1587.6,11,0,1,3,8,1,0,0,0,0,15171,6.6,17085,182,52,-705,-319,23.4,1517.1
4824215706,1,15,0,1,2,6,1,0,0,0,0,13582,6.6,16175,141,40,-846,-83,18.1,1358.2,12,1,0,6,2,3,0,0,0,0,14428,6.6,16258,137,40,846,83,17.7,1442.8
4824213224,0,11,0,0,1,10,0,0,0,0,0,12567,6.2,14740,163,32,-4726,-2868,19.5,1256.7,13,0,1,10,1,3,0,0,0,0,17293,7.0,17608,162,52,4726,2868,21.4,1729.3
4820472127,1,15,0,0,6,6,3,0,0,0,0,15440,7.0,18061,190,40,399,1725,23.0,1544.0,10,0,1,6,6,3,1,1,0,0,15041,6.6,16336,148,44,-399,-1725,19.2,1504.1
4819614516,1,12,2,1,7,2,8,1,1,0,0,16780,6.8,17775,192,52,3266,1172,24.4,1678.0,41,0,0,2,7,1,0,0,0,0,13514,6.4,16603,165,56,-3266,-1172,22.1,1351.4
4819601887,1,12,3,1,6,3,4,0,0,0,0,16971,7.0,18066,159,48,2639,1799,20.7,1697.1,14,0,0,3,6,2,1,1,0,0,14332,6.4,16267,144,56,-2639,-1799,20.0,1433.2
4802158417,0,13,3,1,3,7,2,0,0,0,0,14049,6.8,16149,163,50,-1351,-1190,21.3,1404.9,11,0,0,7,3,1,0,0,0,0,15400,6.8,17339,150,55,1351,1190,20.5,1540.0
4802157855,1,11,0,0,7,4,2,1,1,0,0,17399,6.8,18620,208,44,3779,3282,25.2,1739.9,6,0,1,4,7,3,0,0,0,0,13620,6.4,15338,125,8,-3779,-3282,13.3,1362.0
4802146348,1,11,0,0,6,1,3,0,0,0,0,14781,6.8,17438,159,56,703,114,21.5,1478.1,14,2,1,1,6,1,1,0,1,0,14078,6.6,17324,187,48,-703,-114,23.5,1407.8
4801066576,0,12,0,0,4,5,4,0,0,0,1,13352,6.2,15030,141,36,-3014,-3311,17.7,1335.2,11,0,1,5,4,2,1,1,0,0,16366,7.0,18341,185,52,3014,3311,23.7,1636.6
4754825048,0,13,0,0,4,8,1,0,0,0,0,13592,6.6,15844,154,44,-3201,-1784,19.8,1359.2,8,1,1,8,4,6,0,0,0,0,16793,6.8,17628,183,52,3201,1784,23.5,1679.3
4749335941,1,12,3,0,5,4,2,0,0,0,0,15043,6.8,16730,199,44,-248,536,24.3,1504.3,25,1,1,4,5,8,0,0,0,0,15291,6.4,16194,197,44,248,-536,24.1,1529.1
4749294697,1,194,1,0,8,2,4,1,1,0,0,17287,7.4,19505,193,56,4240,3324,24.9,1728.7,4,0,1,2,8,1,0,0,0,0,13047,6.4,16181,139,48,-4240,-3324,18.7,1304.7
4749255864,1,14,11,1,9,4,9,1,1,0,0,17622,7.0,17791,184,52,2402,902,23.6,1762.2,33,2,0,4,9,1,0,0,0,0,15220,6.6,16889,172,48,-2402,-902,22.0,1522.0
4747923399,0,28,3,0,4,4,5,0,0,0,0,14173,6.8,17470,143,60,-1949,-1111,20.3,1417.3,13,9,1,4,4,5,1,1,0,0,16122,7.0,18581,200,60,1949,1111,26.0,1612.2
4747769858,1,10,3,0,6,4,3,0,0,0,0,16694,6.8,18843,214,58,2364,1687,27.2,1669.4,15,1,1,2,4,4,1,1,0,0,14330,6.6,17156,196,53,-2364,-1687,24.9,1433.0
4747575277,0,13,1,0,3,10,3,1,1,0,0,13758,6.4,15096,141,56,-4717,-2315,19.7,1375.8,48,0,1,10,3,6,0,0,0,0,18475,6.6,17411,179,32,4717,2315,21.1,1847.5
4747019512,0,22,2,0,4,8,6,0,0,0,0,13619,6.2,14510,154,36,-3485,-2569,19.0,1361.9,10,3,1,8,4,5,0,0,0,0,17104,6.8,17079,194,48,3485,2569,24.2,1710.4
4747003560,1,14,1,0,7,10,4,1,1,0,0,17322,7.0,18923,162,56,-1509,741,21.8,1732.2,71,2,1,10,7,11,0,0,0,0,18831,7.2,18182,192,52,1509,-741,24.4,1883.1
4746981622,0,14,1,1,10,7,13,1,1,0,0,17484,6.6,15918,159,52,708,-305,21.1,1748.4,12,0,0,7,10,4,0,0,0,0,16776,6.6,16223,174,48,-708,305,22.2,1677.6
4739323644,0,6,0,0,2,11,1,0,0,0,0,14480,6.6,15594,191,28,-3646,-4056,21.9,1448.0,17,1,1,11,2,2,0,0,0,0,18126,7.4,19650,215,56,3646,4056,27.1,1812.6
4739108730,0,8,1,1,8,8,5,0,0,0,0,16333,6.6,16976,183,48,-375,-898,23.1,1633.3,10,1,0,8,8,4,0,0,0,0,16708,6.8,17874,167,52,375,898,21.9,1670.8
4670171040,0,16,1,0,2,9,2,0,0,0,0,14107,6.6,16474,183,40,-3756,-2771,22.3,1410.7,8,3,1,9,2,3,0,0,0,0,17863,7.0,19245,201,52,3756,2771,25.3,1786.3
4669358756,1,16,2,1,1,0,0,1,1,0,0,15952,7.0,19177,236,56,2977,1468,29.2,1595.2,10,3,0,0,1,0,0,0,0,0,12975,7.0,17709,181,48,-2977,-1468,22.9,1297.5
4511939882,0,13,2,1,12,3,9,0,0,0,0,17093,7.0,17441,183,52,2305,1155,23.5,1709.3,13,1,0,3,12,2,0,0,0,0,14788,6.2,16286,202,32,-2305,-1155,23.4,1478.8
4298308031,0,15,2,0,8,6,5,0,0,0,0,15654,6.8,17394,163,48,-100,1335,21.1,1565.4,20,0,1,6,8,10,1,1,0,0,15754,6.4,16059,136,44,100,-1335,18.0,1575.4
4296768196,1,12,1,1,4,1,2,1,1,0,0,15215,7.0,18762,192,52,2015,2667,24.4,1521.5,17,1,0,1,4,0,0,0,0,0,13200,6.6,16095,179,52,-2015,-2667,23.1,1320.0
4296712069,1,14,2,0,6,6,6,0,0,0,0,16787,6.8,16582,178,35,863,1478,21.3,1678.7,12,2,1,6,6,9,0,0,0,0,15924,6.2,15104,147,36,-863,-1478,18.3,1592.4
4296466463,1,16,1,0,10,6,7,1,1,0,0,16868,6.4,16373,146,56,-260,-1978,20.2,1686.8,11,1,1,6,10,5,0,0,0,0,17128,7.0,18351,157,60,260,1978,21.7,1712.8
4858473684,0,0,0,0,15,27,33,0,0,0,0,35454,10.8,39172,102,0,-3020,-1263,10.2,3545.4,0,0,1,27,15,89,0,0,0,0,38474,11.2,40435,117,0,3020,1263,11.7,3847.4
4858448246,0,0,5,0,27,25,61,0,0,0,1,37838,11.0,40116,96,0,1327,-3316,9.6,3783.8,12,0,1,25,27,71,0,0,0,0,36511,11.4,43432,70,0,-1327,3316,7.0,3651.1
4858399889,1,12,2,1,8,4,7,1,1,0,0,17868,6.6,16939,167,47,4547,2280,21.4,1786.8,72,0,0,4,8,1,0,0,0,0,13321,6.2,14659,135,41,-4547,-2280,17.6,1332.1
4858353870,0,16,1,0,1,6,1,0,0,0,0,12937,6.4,16258,169,47,-4011,-2893,21.6,1293.7,14,0,1,6,1,5,0,0,0,0,16948,7.2,19151,194,60,4011,2893,25.4,1694.8
4858032862,1,0,0,1,17,10,46,0,0,0,0,36462,11.0,38387,103,0,4210,3197,10.3,3646.2,0,0,0,10,17,25,0,0,0,0,32252,10.2,35190,86,0,-4210,-3197,8.6,3225.2
4858004619,1,0,0,1,17,20,40,0,0,0,0,35471,10.6,37893,77,0,100,-274,7.7,3547.1,15,0,0,20,17,54,0,0,0,0,35371,10.8,38167,97,0,-100,274,9.7,3537.1
4857611003,0,34,0,0,14,20,30,0,0,0,0,34153,10.8,37412,88,0,-1852,-1558,8.8,3415.3,123,0,1,20,14,49,0,0,0,0,36005,11.0,38970,98,0,1852,1558,9.8,3600.5
4856780052,0,35,3,0,2,11,4,0,0,0,0,12995,6.2,14337,153,28,-4315,-2573,18.1,1299.5,17,14,1,11,2,8,0,0,0,0,17310,6.6,16910,130,56,4315,2573,18.6,1731.0
4856386876,0,14,1,0,4,4,4,0,0,0,0,15472,6.6,16602,158,56,-848,-878,21.4,1547.2,10,2,1,4,4,2,1,1,0,0,16320,6.8,17480,163,52,848,878,21.5,1632.0
4856322342,1,13,1,1,2,6,2,0,0,0,0,15899,6.6,16468,175,60,1121,394,23.5,1589.9,16,3,0,6,2,6,0,0,0,0,14778,6.4,16074,146,52,-1121,-394,19.8,1477.8
4856286011,0,7,0,0,5,11,8,0,0,0,0,14172,6.2,14978,150,40,-4459,-3208,19.0,1417.2,187,1,1,11,5,12,0,0,0,0,18631,6.8,18186,211,48,4459,3208,25.9,1863.1
4856228472,0,10,6,1,4,3,3,0,0,0,0,16057,6.8,16959,171,48,620,-1411,21.9,1605.7,31,1,0,3,4,0,1,1,0,0,15437,7.0,18370,207,64,-620,1411,27.1,1543.7
4856174944,1,30,2,1,4,1,4,0,0,0,0,15487,6.8,17026,212,36,594,209,24.8,1548.7,12,3,0,1,4,1,0,0,0,0,14893,6.8,16817,208,56,-594,-209,26.4,1489.3
4854176437,0,13,1,1,6,7,9,0,0,0,0,16489,7.0,17633,164,36,-655,30,20.0,1648.9,115,1,0,7,6,5,1,1,0,0,17144,6.8,17603,200,56,655,-30,25.6,1714.4
4854139500,1,80,1,1,1,2,0,0,0,0,0,14465,6.6,17222,169,60,1198,923,22.9,1446.5,13,1,0,2,1,0,0,0,0,0,13267,6.6,16299,165,40,-1198,-923,20.5,1326.7
4853823543,0,0,0,0,6,16,17,0,0,0,1,32345,10.0,34361,74,0,-2172,-1897,7.4,3234.5,0,0,1,16,6,48,0,0,0,0,34517,10.4,36258,102,0,2172,1897,10.2,3451.7
4852901255,1,0,0,0,14,12,34,0,0,0,1,36222,10.8,39027,103,0,3507,4379,10.3,3622.2,0,0,1,12,14,32,0,0,0,0,32715,10.2,34648,90,0,-3507,-4379,9.0,3271.5
4851996218,1,67,1,1,25,21,34,0,0,0,2,35810,10.8,38823,94,0,-38,144,9.4,3581.0,3,0,0,20,24,53,0,0,0,0,35848,10.8,38679,110,0,38,-144,11.0,3584.8
4851953446,0,66,0,0,10,22,11,0,0,0,0,33110,10.4,37221,94,0,-2146,-1100,9.4,3311.0,0,0,1,22,10,45,0,0,0,0,35256,10.8,38321,99,0,2146,1100,9.9,3525.6
4728920684,1,11,0,0,2,4,1,1,1,0,0,15029,6.8,18196,174,64,493,981,23.8,1502.9,96,0,1,4,2,3,0,0,0,0,14536,6.8,17215,177,44,-493,-981,22.1,1453.6
4728900167,1,15,1,0,4,5,3,0,0,0,0,16298,6.6,17049,169,48,1143,340,21.7,1629.8,8,0,1,5,4,2,0,0,0,0,15155,6.6,16709,172,47,-1143,-340,21.9,1515.5
4728593293,1,6,0,0,18,22,47,0,0,0,0,36172,11.2,39806,99,0,-228,303,9.9,3617.2,0,0,1,22,18,51,0,0,0,0,36400,11.0,39503,103,0,228,-303,10.3,3640.0
4727381765,1,126,0,1,28,27,68,0,0,0,0,38314,11.2,41648,93,0,535,-48,9.3,3831.4,3,2,0,27,28,74,0,0,0,0,37779,11.4,41696,107,0,-535,48,10.7,3777.9
4727367313,1,21,1,1,16,24,39,0,0,0,0,36404,11.0,38576,99,0,-1023,-1370,9.9,3640.4,15,2,0,24,16,70,0,0,0,0,37427,11.0,39946,74,0,1023,1370,7.4,3742.7
4726271492,0,0,0,0,17,30,39,0,0,0,1,34667,10.6,37775,78,0,-6643,-6012,7.8,3466.7,0,0,1,30,17,80,0,0,0,0,41310,11.6,43787,122,0,6643,6012,12.2,4131.0
4726269774,1,0,0,1,25,14,67,0,0,0,1,37780,11.2,42365,115,0,4296,5906,11.5,3778.0,0,0,0,14,25,20,0,0,0,0,33484,10.6,36459,90,0,-4296,-5906,9.0,3348.4
4725615187,1,0,0,1,14,17,22,0,0,0,0,61650,12.0,55000,0,0,24100,22000,0.0,6165.0,0,0,0,12,9,8,0,0,0,0,37550,7.2,33000,0,0,-24100,-22000,0.0,3755.0
4725584360,1,0,0,0,17,16,19,0,0,0,0,62700,12.0,55000,0,0,24800,22000,0.0,6270.0,41,0,1,8,9,9,0,0,0,0,37900,7.2,33000,0,0,-24800,-22000,0.0,3790.0
4725519953,1,0,0,1,30,27,87,0,0,0,0,40200,12.0,45092,109,0,2410,1415,10.9,4020.0,0,0,0,27,30,59,0,0,0,0,37790,11.4,43677,84,0,-2410,-1415,8.4,3779.0
4725259214,0,34,0,1,19,19,45,0,0,0,2,38261,10.8,39293,128,0,2585,218,12.8,3826.1,0,4,0,19,19,44,0,0,0,0,35676,11.0,39075,103,0,-2585,-218,10.3,3567.6
4725236715,0,0,0,1,25,26,59,0,0,0,0,38285,11.4,42273,100,0,194,-87,10.0,3828.5,0,0,0,26,25,73,0,0,0,0,38091,11.4,42360,79,0,-194,87,7.9,3809.1
4725064293,1,1,0,0,17,17,12,0,0,0,0,61954,12.0,55000,0,0,23333,22000,0.0,6195.4,50,0,1,9,9,11,0,0,0,0,38621,7.2,33000,0,0,-23333,-22000,0.0,3862.1
4725059083,1,0,0,0,10,20,12,0,0,0,0,59846,12.0,55000,0,0,21596,22000,0.0,5984.6,0,0,1,14,4,12,0,0,0,0,38250,7.2,33000,0,0,-21596,-22000,0.0,3825.0
4725044652,1,7,0,1,14,12,18,0,0,0,0,47500,10.0,47500,0,0,20000,19000,0.0,4750.0,7,0,0,9,11,4,0,0,0,0,27500,6.0,28500,0,0,-20000,-19000,0.0,2750.0
4724412277,1,0,0,0,13,16,18,0,0,0,0,62150,12.0,55000,1,0,25482,22000,0.1,6215.0,216,0,1,11,8,8,0,0,0,0,36668,7.2,33000,0,0,-25482,-22000,0.0,3666.8
4724388421,1,0,0,0,10,17,14,0,0,0,0,59550,12.0,55000,0,0,21300,22000,0.0,5955.0,0,0,1,13,6,11,0,0,0,0,38250,7.2,33000,0,0,-21300,-22000,0.0,3825.0
4724361657,1,0,0,1,15,13,18,0,0,0,0,63086,12.0,55000,0,0,25416,22000,0.0,6308.6,7,0,0,7,9,9,0,0,0,0,37670,7.2,33000,0,0,-25416,-22000,0.0,3767.0
4724351083,1,0,0,0,13,14,17,0,0,0,0,61694,12.0,55000,0,0,23794,21000,0.0,6169.4,0,0,1,10,9,8,0,0,0,0,37900,7.4,34000,0,0,-23794,-21000,0.0,3790.0
4724336831,1,0,0,1,19,16,14,0,0,0,0,62933,12.0,55000,0,0,25033,22000,0.0,6293.3,13,0,0,8,11,13,0,0,0,0,37900,7.2,33000,0,0,-25033,-22000,0.0,3790.0
4858015719,1,99,2,0,32,22,71,0,0,0,1,39456,11.6,43644,119,0,2252,4238,11.9,3945.6,22,0,1,22,32,46,0,0,0,0,37204,11.0,39406,100,0,-2252,-4238,10.0,3720.4
4855783270,0,0,0,0,17,23,49,0,0,0,0,34211,10.4,37014,97,0,-4038,-4301,9.7,3421.1,0,0,1,23,17,60,0,0,0,0,38249,11.2,41315,110,0,4038,4301,11.0,3824.9
4853630879,1,113,0,1,21,23,56,0,0,0,0,32998,10.6,37443,53,0,-3134,-1208,5.3,3299.8,0,0,0,23,21,61,0,0,0,0,36132,10.8,38651,92,0,3134,1208,9.2,3613.2
4853614210,0,38,0,0,18,21,41,0,0,0,0,36782,11.0,39343,106,0,-923,95,10.6,3678.2,0,23,1,21,18,44,0,0,0,0,37705,11.2,39248,96,0,923,-95,9.6,3770.5
4853596221,0,0,0,0,7,22,9,0,0,0,1,33852,10.6,36193,107,0,-1462,-2145,10.7,3385.2,0,0,1,22,7,59,0,0,0,0,35314,11.0,38338,110,0,1462,2145,11.0,3531.4
4852579968,1,0,0,0,23,25,68,0,0,0,0,37566,11.4,41490,94,0,-27,1252,9.4,3756.6,0,0,1,25,23,72,0,0,0,0,37593,11.2,40238,85,0,27,-1252,8.5,3759.3
4852550590,1,0,0,0,12,7,26,0,0,0,0,32672,10.2,35001,95,0,1225,2571,9.5,3267.2,0,0,1,7,12,13,0,0,0,0,31447,10.0,32430,110,0,-1225,-2571,11.0,3144.7
4852535343,0,0,0,0,25,21,45,0,0,0,1,37101,11.2,42144,94,0,2144,4313,9.4,3710.1,0,0,1,21,25,48,0,0,0,0,34957,10.6,37831,85,0,-2144,-4313,8.5,3495.7
4851490612,0,0,0,0,24,42,49,0,0,0,2,38322,11.8,43395,106,0,-3894,-3054,10.6,3832.2,20,0,1,42,24,108,0,0,0,0,42216,12.0,46449,100,0,3894,3054,10.0,4221.6
4850557390,1,0,0,0,26,21,66,0,0,0,1,37263,11.6,41760,103,0,1983,2839,10.3,3726.3,0,0,1,21,26,58,0,0,0,0,35280,10.8,38921,88,0,-1983,-2839,8.8,3528.0
4849701245,0,15,0,0,23,27,58,0,0,0,0,36456,11.2,39749,99,0,129,-470,9.9,3645.6,0,2,1,27,23,65,0,0,0,0,36327,10.8,40219,98,0,-129,470,9.8,3632.7
4849690745,1,14,0,0,20,16,56,0,0,0,1,36571,10.8,39412,103,0,3350,4087,10.3,3657.1,0,0,1,16,20,40,0,0,0,0,33221,10.2,35325,90,0,-3350,-4087,9.0,3322.1
4849670742,0,34,0,1,25,25,73,0,0,0,0,36639,11.2,41441,98,0,-287,178,9.8,3663.9,34,0,0,25,25,64,0,0,0,0,36926,11.4,41263,105,0,287,-178,10.5,3692.6
4849647295,0,0,0,1,24,31,56,0,0,0,0,36970,11.2,41648,105,0,-1071,-2077,10.5,3697.0,0,0,0,31,24,87,0,0,0,0,38041,11.6,43725,80,0,1071,2077,8.0,3804.1
4845723221,1,0,0,1,23,23,39,0,0,0,0,35190,10.8,39038,112,0,-389,582,11.2,3519.0,0,0,0,23,23,56,0,0,0,0,35579,10.8,38456,86,0,389,-582,8.6,3557.9
4845712064,1,0,0,0,28,27,78,0,0,0,1,38486,11.0,41068,104,0,1287,-829,10.4,3848.6,0,0,1,27,28,62,0,0,0,0,37199,11.4,41897,89,0,-1287,829,8.9,3719.9
4841751515,1,77,0,0,26,32,68,0,0,0,0,38665,11.6,43524,102,0,345,-890,10.2,3866.5,0,0,1,32,26,64,0,0,0,0,38320,11.6,44414,86,0,-345,890,8.6,3832.0
4839623584,0,0,0,1,17,30,43,0,0,0,1,35922,10.8,39441,117,0,-3808,-5277,11.7,3592.2,139,0,0,30,17,70,0,0,0,0,39730,11.8,44718,95,0,3808,5277,9.5,3973.0
4838904402,1,3,0,1,27,24,84,0,0,0,1,38607,11.6,43791,101,0,2818,4456,10.1,3860.7,0,0,0,24,27,74,0,0,0,0,35789,11.0,39335,87,0,-2818,-4456,8.7,3578.9
4836706603,1,16,0,1,17,10,50,0,0,0,1,37737,10.8,39246,113,0,5269,3466,11.3,3773.7,29,3,0,10,17,28,0,0,0,0,32468,10.6,35780,85,0,-5269,-3466,8.5,3246.8
4828227937,0,115,0,1,31,25,81,0,0,0,0,39141,11.8,44113,108,0,627,2741,10.8,3914.1,0,0,0,25,31,73,0,0,0,0,38514,11.2,41372,102,0,-627,-2741,10.2,3851.4
4826667113,1,35,0,1,20,17,50,0,0,0,1,37343,11.0,39302,100,0,2831,1722,10.0,3734.3,0,14,0,17,20,35,0,0,0,0,34512,10.6,37580,87,0,-2831,-1722,8.7,3451.2
4825505575,1,0,0,1,23,17,60,0,0,0,1,37551,11.0,39314,105,0,2039,794,10.5,3755.1,86,0,0,17,23,35,0,0,0,0,35512,11.0,38520,96,0,-2039,-794,9.6,3551.2
4825484865,0,0,0,1,28,35,49,0,0,0,0,38031,11.6,43761,101,0,-1512,-2273,10.1,3803.1,0,0,0,35,28,110,0,0,0,0,39543,12.0,46034,114,0,1512,2273,11.4,3954.3
4824769742,0,0,3,0,21,17,46,0,0,0,0,35662,11.2,40357,106,0,1065,2984,10.6,3566.2,41,0,1,17,21,39,0,0,0,0,34597,10.8,37373,116,0,-1065,-2984,11.6,3459.7
4824727505,1,13,0,0,17,13,30,0,0,0,0,34610,10.8,38538,99,0,1700,4084,9.9,3461.0,0,2,1,13,17,28,0,0,0,0,32910,10.0,34454,75,0,-1700,-4084,7.5,3291.0
4823845500,0,88,18,0,2,7,2,0,0,0,0,13983,6.2,14978,160,44,-2702,-1976,20.4,1398.3,32,0,1,7,2,6,1,1,0,0,16685,6.6,16954,174,48,2702,1976,22.2,1668.5
4823028299,0,12,0,0,5,7,2,0,0,0,0,15819,7.0,17695,193,60,-226,963,25.3,1581.9,12,0,1,7,5,7,1,1,0,0,16045,6.6,16732,177,52,226,-963,22.9,1604.5
4822983289,1,13,1,1,3,1,2,0,0,0,0,14903,6.8,17043,216,48,2152,335,26.4,1490.3,12,2,0,1,3,1,0,0,0,0,12751,6.6,16708,146,56,-2152,-335,20.2,1275.1
4821889666,1,80,0,0,1,2,1,0,0,0,0,13403,6.8,17187,179,48,-530,-305,22.7,1340.3,13,0,1,2,1,0,0,0,0,0,13933,7.0,17492,182,52,530,305,23.4,1393.3
4821827291,0,12,1,1,3,5,2,1,0,1,0,14586,6.8,17305,168,64,-323,40,23.2,1458.6,14,1,0,5,3,7,1,1,0,0,14909,6.8,17265,164,52,323,-40,21.6,1490.9
4821781690,0,66,3,1,5,5,5,1,1,0,0,15138,6.8,16978,178,48,-412,138,22.6,1513.8,13,1,0,5,5,5,0,0,0,0,15550,6.8,16840,186,44,412,-138,23.0,1555.0
4821361880,0,12,1,0,7,5,4,0,0,0,0,15727,7.0,17793,177,56,991,929,23.3,1572.7,14,0,1,5,7,1,0,0,0,0,14736,6.4,16864,163,52,-991,-929,21.5,1473.6
4820824333,0,7,0,1,5,4,1,1,1,0,0,15095,6.6,17925,160,60,-217,1389,22.0,1509.5,16,0,0,4,5,4,0,0,0,0,15312,6.6,16536,148,44,217,-1389,19.2,1531.2
4816848876,1,3,0,1,29,22,75,0,0,0,1,38697,11.2,41726,96,0,1801,-180,9.6,3869.7,0,0,0,22,29,55,0,0,0,0,36896,11.6,41906,84,0,-1801,180,8.4,3689.6
4814339325,0,0,0,1,22,29,47,0,0,0,0,38432,11.4,42335,116,0,89,563,11.6,3843.2,0,0,0,29,22,67,0,0,0,0,38343,11.2,41772,98,0,-89,-563,9.8,3834.3
4813792181,1,32,0,0,14,26,29,0,0,0,2,32456,10.4,35313,87,51,-4500,-5922,13.8,3245.6,23,1,1,26,14,63,0,0,0,0,36956,11.2,41235,67,60,4500,5922,12.7,3695.6
4813769702,1,23,0,1,12,9,18,0,0,0,0,37404,11.8,44643,111,76,6003,6794,18.7,3740.4,87,1,0,9,12,12,0,0,0,0,31401,10.8,37849,60,63,-6003,-6794,12.3,3140.1
4813761448,1,10,1,0,20,17,40,0,0,0,2,38331,11.2,41481,107,71,4604,1598,17.8,3833.1,7,0,1,16,19,37,0,0,0,0,33727,11.2,39883,105,47,-4604,-1598,15.2,3372.7
4753921297,0,77,1,0,7,8,6,0,0,0,0,17089,7.0,18045,180,64,427,819,24.4,1708.9,9,2,1,8,7,6,0,0,0,0,16662,7.0,17226,203,32,-427,-819,23.5,1666.2
4753889479,0,8,1,0,5,5,4,0,0,0,0,16484,6.8,17311,201,40,-11,-692,24.1,1648.4,13,2,1,5,5,1,0,0,0,0,16495,6.8,18003,226,52,11,692,27.8,1649.5
4753861104,0,21,3,0,3,7,3,0,0,0,0,15248,7.0,17684,222,60,-711,-1075,28.2,1524.8,16,0,1,7,3,4,0,0,0,0,15959,7.2,18759,172,60,711,1075,23.2,1595.9
4752239589,0,44,2,0,5,6,12,1,1,0,0,15989,6.6,16732,192,44,-1353,-1689,23.6,1598.9,14,3,1,6,5,7,0,0,0,0,17342,7.2,18421,232,64,1353,1689,29.6,1734.2
4738870056,0,16,0,1,2,1,1,0,0,0,0,14235,6.4,16761,202,52,913,-609,25.4,1423.5,8,2,0,1,2,1,0,0,0,0,13322,6.8,17370,184,36,-913,609,22.0,1332.2
4180585233,0,13,2,0,5,9,3,0,0,0,0,16583,7.0,18147,196,60,330,71,25.6,1658.3,23,1,1,9,5,5,1,1,0,0,16253,7.0,18076,204,40,-330,-71,24.4,1625.3
4179306268,0,12,2,0,6,11,3,0,0,0,0,16849,6.6,16608,146,64,-1151,-753,21.0,1684.9,12,1,1,11,6,10,0,0,0,0,18000,6.8,17361,203,39,1151,753,24.2,1800.0
4178435564,1,21,1,1,10,8,11,0,0,0,0,18139,7.2,18986,201,51,974,633,25.2,1813.9,12,1,0,8,10,4,0,0,0,0,17165,7.0,18353,181,55,-974,-633,23.6,1716.5
4176874434,0,14,2,1,5,6,5,1,1,0,0,16293,6.6,16852,196,56,-1258,-1779,25.2,1629.3,18,2,0,6,5,6,0,0,0,0,17551,7.2,18631,200,56,1258,1779,25.6,1755.1
4162673790,1,0,0,1,23,23,50,0,0,0,2,36258,11.4,41274,85,0,-502,1893,8.5,3625.8,0,0,0,23,23,53,0,0,0,0,36760,11.2,39381,109,0,502,-1893,10.9,3676.0
4162597683,0,11,2,0,6,12,4,0,0,0,0,15985,6.6,16829,191,56,-1052,39,24.7,1598.5,137,2,1,11,5,15,0,0,0,0,17037,6.4,16790,161,40,1052,-39,20.1,1703.7
4162591004,1,10,0,1,10,27,8,0,0,0,0,19322,5.4,13328,101,16,-502,-3134,11.7,1932.2,124,0,0,26,9,10,0,0,0,0,19824,6.4,16462,152,48,502,3134,20.0,1982.4
4858288528,1,27,1,1,19,22,17,0,0,0,0,63480,12.0,55000,3,0,24865,22000,0.3,6348.0,4,2,0,13,10,10,0,0,0,0,38615,7.2,33000,0,0,-24865,-22000,0.0,3861.5
4858263714,1,0,0,1,15,27,25,0,0,0,0,61324,13.0,62500,0,0,22024,21000,0.0,6132.4,0,0,0,18,6,14,0,0,0,0,39300,8.6,41500,0,0,-22024,-21000,0.0,3930.0
4858180422,1,12,0,1,18,13,17,0,0,0,0,63050,12.0,55000,0,0,26200,22000,0.0,6305.0,6,0,0,7,12,7,0,0,0,0,36850,7.2,33000,0,0,-26200,-22000,0.0,3685.0
4858152868,1,1,0,1,19,22,18,0,0,0,0,45950,10.0,47500,0,0,16700,19000,0.0,4595.0,38,0,0,15,12,11,0,0,0,0,29250,6.0,28500,0,0,-16700,-19000,0.0,2925.0
4857928579,1,6,0,0,17,17,16,0,0,0,0,61360,12.0,55000,0,0,24148,22000,0.0,6136.0,0,0,1,9,9,11,0,0,0,0,37212,7.2,33000,0,0,-24148,-22000,0.0,3721.2
4857913228,1,27,1,1,14,20,13,0,0,0,0,61424,12.0,55000,2,0,23422,22000,0.2,6142.4,0,4,0,12,6,12,0,0,0,0,38002,7.2,33000,1,0,-23422,-22000,0.1,3800.2
4857891848,0,79,1,0,3,6,3,0,0,0,0,15051,6.6,16494,156,48,-608,-1043,20.4,1505.1,8,1,1,6,3,6,1,1,0,0,15659,6.8,17537,173,52,608,1043,22.5,1565.9
4857854659,1,13,1,1,9,7,7,0,0,0,0,17235,6.4,16143,139,48,1817,-885,18.7,1723.5,70,0,0,7,9,6,0,0,0,0,15418,6.6,17028,172,44,-1817,885,21.6,1541.8
4857846807,1,33,0,0,7,5,3,1,1,0,0,15887,7.4,18940,181,56,475,1048,23.7,1588.7,10,18,1,5,7,5,0,0,0,0,15412,6.8,17892,164,48,-475,-1048,21.2,1541.2
4857482865,1,0,0,0,18,15,16,0,0,0,0,45250,10.0,47500,0,0,16700,19000,0.0,4525.0,0,0,1,11,14,11,0,0,0,0,28550,6.0,28500,0,0,-16700,-19000,0.0,2855.0
4857456107,1,0,0,0,9,17,13,0,0,0,0,44200,10.0,47500,0,0,16000,19000,0.0,4420.0,0,0,1,13,5,10,0,0,0,0,28200,6.0,28500,0,0,-16000,-19000,0.0,2820.0
4857429685,1,0,0,1,9,19,12,0,0,0,0,52000,12.0,55000,1,0,18450,22000,0.1,5200.0,0,0,0,15,5,13,0,0,0,0,33550,7.2,33000,0,0,-18450,-22000,0.0,3355.0
4857399166,1,144,0,0,16,18,15,0,0,0,0,49256,12.0,55000,0,0,20688,22000,0.0,4925.6,0,0,1,11,9,10,0,0,0,0,28568,7.2,33000,0,0,-20688,-22000,0.0,2856.8
4857067091,1,26,2,0,18,20,14,0,0,0,0,48585,10.0,47500,5,0,18180,19000,0.5,4858.5,0,0,1,12,10,14,0,0,0,0,30405,6.0,28500,1,0,-18180,-19000,0.1,3040.5
4857012548,1,0,0,1,20,18,13,0,0,0,0,60956,12.0,55000,1,0,23406,22000,0.1,6095.6,0,0,0,8,10,16,0,0,0,0,37550,7.2,33000,5,0,-23406,-22000,0.5,3755.0
4856996440,1,4,0,1,19,13,11,0,0,0,0,46388,10.0,47500,0,0,17889,19000,0.0,4638.8,91,0,0,5,11,13,0,0,0,0,28499,6.0,28500,0,0,-17889,-19000,0.0,2849.9
4856981282,1,0,0,0,18,15,14,0,0,0,0,48110,10.0,47500,0,0,18845,19000,0.0,4811.0,0,0,1,9,12,12,0,0,0,0,29265,6.0,28500,0,0,-18845,-19000,0.0,2926.5
4856961403,1,2,0,1,10,19,10,0,0,0,0,44200,10.4,49000,0,0,14600,20500,0.0,4420.0,21,0,0,14,5,13,0,0,0,0,29600,6.0,28500,0,0,-14600,-20500,0.0,2960.0
4856946297,1,80,0,0,14,18,12,0,0,0,0,58236,12.0,55000,0,0,23702,22000,0.0,5823.6,0,0,1,11,7,12,0,0,0,0,34534,7.2,33000,1,0,-23702,-22000,0.1,3453.4
4856294947,1,6,0,1,15,17,21,0,0,0,0,61650,12.0,55000,0,0,24800,22000,0.0,6165.0,0,0,0,11,9,6,0,0,0,0,36850,7.2,33000,0,0,-24800,-22000,0.0,3685.0
4845899752,0,26,3,0,6,3,7,1,1,0,0,14004,6.4,15962,139,40,366,-542,17.9,1400.4,162,2,1,3,6,0,0,0,0,0,13638,6.4,16504,158,40,-366,542,19.8,1363.8
4841315683,0,11,0,0,2,9,1,0,0,0,0,12470,6.4,14708,128,39,-4626,-1437,16.7,1247.0,10,0,1,9,2,9,1,1,0,0,17096,6.4,16145,158,52,4626,1437,21.0,1709.6
4833401671,0,11,0,0,6,8,8,0,0,0,0,14796,6.6,16309,138,60,-2969,-1517,19.8,1479.6,8,0,1,8,6,9,0,0,0,0,17765,6.8,17826,186,48,2969,1517,23.4,1776.5
4833394245,1,17,2,1,11,2,11,1,1,0,0,18320,6.8,17897,164,66,4648,2597,23.0,1832.0,13,2,0,2,11,1,0,0,0,0,13672,6.0,15300,170,42,-4648,-2597,21.2,1367.2
4832850363,1,13,0,1,8,4,12,1,1,0,0,16212,6.6,16256,176,52,1458,-146,22.8,1621.2,16,1,0,4,8,2,0,0,0,0,14754,6.4,16402,171,52,-1458,146,22.3,1475.4
4831164547,0,9,0,1,5,9,2,0,0,0,0,16428,7.0,18082,207,40,957,980,24.7,1642.8,19,0,0,9,5,4,2,1,1,0,15471,6.6,17102,132,56,-957,-980,18.8,1547.1
4818923454,1,0,0,0,32,26,86,0,0,0,0,40113,11.8,44690,102,0,1092,2584,10.2,4011.3,0,0,1,26,32,53,0,0,0,0,39021,11.4,42106,74,0,-1092,-2584,7.4,3902.1
4818107931,0,0,0,0,21,34,46,0,0,0,1,35348,10.8,40488,80,0,-4145,-4202,8.0,3534.8,0,0,1,34,21,84,0,0,0,0,39493,11.6,44690,86,0,4145,4202,8.6,3949.3
4813750632,0,12,1,1,6,15,4,0,0,0,0,16057,6.6,17404,163,44,-4428,-2971,20.7,1605.7,13,0,0,15,6,6,2,1,1,0,20485,7.4,20375,183,76,4428,2971,25.9,2048.5
4810764686,1,0,0,1,25,22,40,0,0,0,0,38543,11.6,42359,117,0,3531,3338,11.7,3854.3,0,0,0,21,24,41,0,0,0,0,35012,10.8,39021,90,0,-3531,-3338,9.0,3501.2
4810754145,0,0,3,1,21,25,53,0,0,0,1,35483,10.6,38737,88,0,-2999,-4572,8.8,3548.3,30,0,0,25,21,67,0,0,0,0,38482,11.6,43309,107,0,2999,4572,10.7,3848.2
4810738413,0,6,2,1,24,28,67,0,0,0,1,36921,11.2,39989,100,0,-1568,-4233,10.0,3692.1,11,0,0,28,24,58,0,0,0,0,38489,11.6,44222,109,0,1568,4233,10.9,3848.9
4808210513,0,20,2,0,6,3,9,0,0,0,0,15914,6.6,16568,179,48,1825,86,22.7,1591.4,17,0,1,3,6,1,0,0,0,0,14089,6.6,16482,133,48,-1825,-86,18.1,1408.9
4807783300,1,15,1,0,7,5,2,2,1,1,0,15779,6.8,17220,149,56,806,676,20.5,1577.9,11,1,1,5,7,4,0,0,0,0,14973,6.6,16544,174,28,-806,-676,20.2,1497.3
4807252810,1,11,0,0,4,6,3,0,0,0,0,14957,6.6,17001,167,48,-183,621,21.5,1495.7,15,2,1,6,4,5,0,0,0,0,15140,6.6,16380,152,47,183,-621,19.9,1514.0
4806883352,0,10,2,1,4,5,2,1,1,0,0,14950,6.6,16444,145,40,-213,-1709,18.5,1495.0,11,2,0,5,4,3,0,0,0,0,15163,7.0,18153,188,52,213,1709,24.0,1516.3
4806856642,0,9,0,0,3,3,2,0,0,0,0,13238,6.8,17073,130,60,-594,-89,19.0,1323.8,19,0,1,3,3,0,1,1,0,0,13832,6.8,17162,165,60,594,89,22.5,1383.2
4786651061,1,0,0,1,33,23,99,0,0,0,0,40333,11.6,44671,113,0,2493,2507,11.3,4033.3,0,0,0,23,33,46,0,0,0,0,37840,11.4,42164,102,0,-2493,-2507,10.2,3784.0
4786632671,0,0,0,0,24,37,67,0,0,0,2,36199,10.6,39148,93,0,-7141,-7643,9.3,3619.9,0,0,1,37,24,85,0,0,0,0,43340,12.0,46791,116,0,7141,7643,11.6,4334.0
4847493556,0,9,2,1,2,2,2,1,1,0,0,14199,6.4,16773,157,52,-724,-1291,20.9,1419.9,16,0,0,2,2,1,0,0,0,0,14923,6.8,18064,193,60,724,1291,25.3,1492.3
4842336432,0,9,1,0,1,6,0,0,0,0,0,13432,6.6,17330,166,48,-3467,-2714,21.4,1343.2,11,2,1,6,1,4,0,0,0,0,16899,7.2,20044,204,62,3467,2714,26.6,1689.9
4841752814,1,13,1,0,3,6,3,0,0,0,0,14513,6.6,16632,204,44,-936,-199,24.8,1451.3,108,1,1,6,3,9,2,1,1,0,15449,6.8,16831,190,48,936,199,23.8,1544.9
4841048869,0,15,0,1,6,7,5,0,0,0,0,16202,7.0,17741,175,52,-596,19,22.7,1620.2,13,1,0,7,6,7,1,1,0,0,16798,6.8,17722,171,44,596,-19,21.5,1679.8
4840901224,1,10,1,1,8,2,2,0,0,0,0,17507,7.0,18749,211,60,4240,1919,27.1,1750.7,16,0,0,2,8,1,0,0,0,0,13267,6.6,16830,121,46,-4240,-1919,16.7,1326.7
4840792611,0,14,2,1,12,9,10,0,0,0,0,18244,7.0,17871,171,55,1786,2296,22.6,1824.4,10,1,0,9,12,7,1,0,1,0,16458,6.2,15575,133,40,-1786,-2296,17.3,1645.8
4827256426,0,9,0,0,3,2,0,0,0,0,0,13691,6.8,18398,182,44,-678,582,22.6,1369.1,14,1,1,2,3,2,1,1,0,0,14369,6.6,17816,199,52,678,-582,25.1,1436.9
4827127906,1,15,2,0,4,3,4,1,1,0,0,15502,6.8,16702,148,48,1554,-1252,19.6,1550.2,17,0,1,3,4,3,0,0,0,0,13948,7.0,17954,151,60,-1554,1252,21.1,1394.8
4806203886,0,12,1,0,2,10,3,0,0,0,0,13274,6.2,14693,130,52,-4184,-3615,18.2,1327.4,15,0,1,10,2,8,0,0,0,0,17458,7.0,18308,174,44,4184,3615,21.8,1745.8
4787657884,1,111,0,0,4,9,5,0,0,0,0,14835,6.0,15248,132,46,-3377,-3234,17.8,1483.5,10,1,1,9,4,3,1,0,1,0,18212,7.0,18482,191,49,3377,3234,24.0,1821.2
4779518829,0,12,0,1,5,9,6,0,0,0,0,15792,6.6,16327,173,48,-1079,-1509,22.1,1579.2,45,1,0,9,5,8,1,1,0,0,16871,7.0,17836,167,51,1079,1509,21.8,1687.1
4774944457,1,14,0,0,3,5,1,1,1,0,0,14302,6.8,17656,198,60,-1607,-1278,25.8,1430.2,34,0,1,5,3,2,0,0,0,0,15909,7.0,18934,178,64,1607,1278,24.2,1590.9
4771540774,1,12,0,1,3,1,2,0,0,0,0,15010,6.6,16982,166,44,1466,-148,21.0,1501.0,174,0,0,1,3,0,0,0,0,0,13544,6.6,17130,137,48,-1466,148,18.5,1354.4
4683564935,0,12,0,1,7,4,7,0,0,0,0,15233,6.6,16890,135,36,-878,-578,17.1,1523.3,13,1,0,4,7,3,0,0,0,0,16111,7.2,17468,178,36,878,578,21.4,1611.1
4682821656,0,16,0,0,4,4,4,0,0,0,0,13532,6.8,16664,152,44,-2026,-154,19.6,1353.2,10,0,1,4,4,2,0,0,0,0,15558,6.6,16818,179,56,2026,154,23.5,1555.8
4682799290,1,11,0,1,5,2,4,0,0,0,0,16842,7.0,18279,164,64,3627,2365,22.8,1684.2,10,0,0,2,5,1,0,0,0,0,13215,6.6,15914,145,44,-3627,-2365,18.9,1321.5
4681826746,0,266,2,1,5,9,3,1,1,0,0,14656,6.8,17788,201,40,-1982,6,24.1,1465.6,26,1,0,9,5,11,0,0,0,0,16638,7.0,17782,187,60,1982,-6,24.7,1663.8
4679278509,1,17,0,0,2,4,1,1,1,0,0,14886,7.0,18596,243,56,-1012,-867,29.9,1488.6,16,0,1,4,2,7,0,0,0,0,15898,7.4,19463,201,48,1012,867,24.9,1589.8
4638002510,1,33,0,0,4,6,2,0,0,0,0,15715,7.0,17886,213,36,940,215,24.9,1571.5,12,8,1,6,4,5,1,1,0,0,14775,7.0,17671,130,64,-940,-215,19.4,1477.5
4743812904,1,295,1,0,7,10,5,1,1,0,0,15901,6.4,15877,147,54,-1736,-1577,20.1,1590.1,14,1,1,10,7,3,0,0,0,0,17637,6.6,17454,142,48,1736,1577,19.0,1763.7
4743778830,1,16,1,1,9,3,6,1,1,0,0,16903,7.0,18419,183,55,3246,3039,23.8,1690.3,13,0,0,3,9,3,0,0,0,0,13657,6.4,15380,138,52,-3246,-3039,19.0,1365.7
4740632492,0,8,0,1,5,5,2,1,0,1,0,14101,6.4,16121,150,34,-2393,-2799,18.4,1410.1,77,1,0,5,5,3,1,1,0,0,16494,7.2,18920,197,64,2393,2799,26.1,1649.4
4740465850,1,10,8,1,5,8,4,1,1,0,0,14771,6.8,16324,170,59,-2089,-2345,22.9,1477.1,144,0,0,8,5,6,0,0,0,0,16860,7.0,18669,185,48,2089,2345,23.3,1686.0
4740430355,0,14,1,1,6,4,4,0,0,0,0,16335,6.6,16598,158,52,1900,-183,21.0,1633.5,18,1,0,4,6,8,1,1,0,0,14435,6.4,16781,158,64,-1900,183,22.2,1443.5
4739784043,0,11,0,1,6,6,4,1,0,1,0,15179,6.4,16687,153,48,-1291,-1818,20.1,1517.9,11,0,0,6,6,4,0,0,0,0,16470,7.0,18505,204,56,1291,1818,26.0,1647.0
4739515766,1,71,0,0,7,5,5,0,0,0,0,16252,6.8,17017,166,51,-537,324,21.7,1625.2,12,0,1,5,7,3,1,1,0,0,16789,6.6,16693,169,36,537,-324,20.5,1678.9
4739487793,1,12,1,1,4,2,8,1,1,0,0,14264,6.4,15973,144,48,-315,-432,19.2,1426.4,13,0,0,2,4,3,0,0,0,0,14579,6.8,16405,170,40,315,432,21.0,1457.9
4739268486,0,15,0,0,6,6,2,0,0,0,0,14948,6.4,15367,120,48,-1694,-1448,16.8,1494.8,13,2,1,6,6,5,0,0,0,0,16642,6.8,16815,165,56,1694,1448,22.1,1664.2
4739253438,0,105,0,0,2,9,0,0,0,0,0,15064,6.8,17009,216,44,-2802,-2837,26.0,1506.4,10,1,1,9,2,1,0,0,0,0,17866,7.2,19846,212,68,2802,2837,28.0,1786.6
4739083068,1,12,1,1,4,2,3,0,0,0,0,15873,7.0,18637,170,56,3457,3003,22.6,1587.3,11,1,0,2,4,0,1,1,0,0,12416,6.2,15634,137,59,-3457,-3003,19.6,1241.6
4739051490,0,8,0,1,8,6,6,0,0,0,0,15709,7.0,18118,176,32,212,-156,20.8,1570.9,22,0,0,6,8,2,1,1,0,0,15497,7.2,18274,193,56,-212,156,24.9,1549.7
4739023551,1,12,1,0,2,6,0,0,0,0,0,13565,6.4,16102,160,24,-2431,-1171,18.4,1356.5,14,0,1,6,2,5,1,1,0,0,15996,6.8,17273,158,56,2431,1171,21.4,1599.6
4636947818,1,13,4,1,6,5,10,0,0,0,0,16286,6.6,16146,195,40,606,-1067,23.5,1628.6,54,0,0,5,6,8,2,1,1,0,15680,6.8,17213,167,60,-606,1067,22.7,1568.0
4625788832,0,15,1,0,3,3,3,0,0,0,0,13271,6.6,16969,159,56,-1038,-1066,21.5,1327.1,26,0,1,3,3,4,1,1,0,0,14309,7.0,18035,160,60,1038,1066,22.0,1430.9
4625725825,1,18,1,1,2,1,0,0,0,0,0,13916,6.8,17215,171,53,462,267,22.4,1391.6,14,0,0,1,2,0,0,0,0,0,13454,6.8,16948,159,51,-462,-267,21.0,1345.4
4607152832,0,15,11,1,6,9,6,0,0,0,0,14513,6.6,16038,153,40,-2422,-724,19.3,1451.3,44,4,0,9,6,7,0,0,0,0,16935,6.4,16762,159,44,2422,724,20.3,1693.5
4607107501,1,13,2,1,9,7,3,1,1,0,0,16456,7.0,16897,166,60,162,44,22.6,1645.6,9,1,0,7,9,3,0,0,0,0,16294,6.8,16853,180,68,-162,-44,24.8,1629.4
4607078977,0,12,2,1,4,6,3,0,0,0,0,14956,6.4,15878,138,44,-1940,-1996,18.2,1495.6,12,2,0,6,4,3,1,1,0,0,16896,6.8,17874,162,48,1940,1996,21.0,1689.6
4752985177,1,12,1,1,1,2,1,0,0,0,0,14157,6.6,17511,220,56,-1784,-969,27.6,1415.7,129,0,0,2,1,4,1,1,0,0,15941,6.8,18480,222,76,1784,969,29.8,1594.1
4752932373,1,8,1,0,4,2,1,2,1,1,0,15416,7.0,18886,211,64,18,965,27.5,1541.6,13,0,1,2,4,2,0,0,0,0,15398,6.8,17921,204,52,-18,-965,25.6,1539.8
4750679808,1,12,0,1,5,4,4,0,0,0,0,17405,7.0,17617,205,44,1988,224,24.9,1740.5,10,1,0,4,5,4,0,0,0,0,15417,6.8,17393,170,60,-1988,-224,23.0,1541.7
4749801414,1,35,3,0,3,8,3,0,0,0,0,14916,6.6,16726,183,48,-2101,-1019,23.1,1491.6,31,3,1,8,3,9,1,1,0,0,17017,7.0,17745,173,48,2101,1019,22.1,1701.7
4749747734,0,9,0,0,3,3,3,0,0,0,0,13570,6.6,16121,156,48,-1531,-1609,20.4,1357.0,22,0,1,3,3,1,0,0,0,0,15101,6.8,17730,193,52,1531,1609,24.5,1510.1
4749578445,1,12,0,1,7,6,4,2,1,1,0,17564,7.0,18245,202,73,1074,1360,27.5,1756.4,8,1,0,6,7,6,0,0,0,0,16490,6.8,16885,187,63,-1074,-1360,25.0,1649.0
4748956284,1,17,0,1,11,6,11,0,0,0,0,17818,6.8,16833,163,56,2701,1518,21.9,1781.8,14,1,0,6,11,3,0,0,0,0,15117,6.4,15315,168,39,-2701,-1518,20.7,1511.7
4748906964,0,329,1,0,7,6,7,0,0,0,0,17939,7.2,18282,198,37,375,1666,23.5,1793.9,18,1,1,6,7,6,0,0,0,0,17564,6.6,16616,183,44,-375,-1666,22.7,1756.4
4611823668,1,11,3,0,7,9,0,0,0,0,0,16266,6.8,17672,190,71,-469,695,26.1,1626.6,14,3,1,9,7,7,0,0,0,0,16735,7.0,16977,183,44,469,-695,22.7,1673.5
4607636349,0,7,0,0,1,7,0,0,0,0,0,13824,6.8,17403,194,60,-3392,-666,25.4,1382.4,14,1,1,7,1,6,1,1,0,0,17216,7.0,18069,203,48,3392,666,25.1,1721.6
4604236855,1,17,0,1,5,4,4,0,0,0,0,16689,7.0,18458,210,56,1378,-27,26.6,1668.9,10,1,0,4,5,0,0,0,0,0,15311,7.4,18485,220,60,-1378,27,28.0,1531.1
4604188064,0,16,2,1,1,1,2,0,0,0,0,15112,6.6,17767,203,39,-4,-835,24.2,1511.2,10,4,0,1,1,0,0,0,0,0,15116,7.0,18602,217,60,4,835,27.7,1511.6
4604153592,0,8,2,0,1,8,0,1,1,0,0,12446,6.6,16590,163,40,-5995,-2879,20.3,1244.6,9,1,1,8,1,5,0,0,0,0,18441,7.2,19469,228,60,5995,2879,28.8,1844.1
4601493468,0,14,2,1,6,10,6,0,0,0,0,16137,6.4,15160,109,32,-2182,-2703,14.1,1613.7,8,0,0,10,6,4,0,0,0,0,18319,6.8,17863,192,60,2182,2703,25.2,1831.9
4601486775,1,5,0,0,7,8,3,1,0,1,0,15145,6.6,16645,168,44,-1568,-868,21.2,1514.5,11,0,1,8,7,10,0,0,0,0,16713,6.8,17513,170,52,1568,868,22.2,1671.3
4601475748,1,12,0,0,6,4,5,0,0,0,0,16199,6.6,17585,193,54,1221,650,24.7,1619.9,11,2,1,4,6,1,1,1,0,0,14978,6.6,16935,159,56,-1221,-650,21.5,1497.8
4601077986,0,10,1,1,3,4,2,0,0,0,0,14763,6.8,16891,177,67,-1170,-2162,24.4,1476.3,14,1,0,4,3,1,0,0,0,0,15933,7.2,19053,216,48,1170,2162,26.4,1593.3
4600655408,0,7,1,0,9,5,4,0,0,0,0,16583,6.6,16311,170,52,1425,1713,22.2,1658.3,8,2,1,5,9,5,0,0,0,0,15158,6.0,14598,129,28,-1425,-1713,15.7,1515.8
4600641709,0,6,0,0,1,8,0,0,0,0,0,11110,5.8,14495,128,0,-6391,-4927,12.8,1111.0,12,0,1,8,1,2,0,0,0,0,17501,7.2,19422,214,68,6391,4927,28.2,1750.1
4843968796,0,12,0,0,18,30,40,0,0,0,1,33911,10.4,36385,99,0,-5691,-6720,9.9,3391.1,0,3,1,30,18,93,0,0,0,0,39602,11.6,43105,112,0,5691,6720,11.2,3960.2
4838538290,1,11,5,0,6,9,7,0,0,0,0,15934,6.8,17165,159,56,-1562,-987,21.5,1593.4,97,0,1,9,6,8,1,1,0,0,17496,7.2,18152,167,64,1562,987,23.1,1749.6
4838516245,1,171,4,0,5,5,4,1,1,0,0,16219,7.0,17922,225,48,793,706,27.3,1621.9,15,0,1,5,5,3,0,0,0,0,15426,6.8,17216,189,48,-793,-706,23.7,1542.6
4838026321,1,0,0,1,21,18,45,0,0,0,1,37080,11.4,41672,106,0,2424,3256,10.6,3708.0,0,0,0,18,21,46,0,0,0,0,34656,11.0,38416,106,0,-2424,-3256,10.6,3465.6
4836279915,1,8,0,0,6,6,10,0,0,0,0,17212,6.6,17996,151,48,608,536,19.9,1721.2,19,0,1,6,6,3,1,1,0,0,16604,6.8,17460,159,40,-608,-536,19.9,1660.4
4836251244,0,32,0,0,7,2,7,0,0,0,0,16000,7.0,17474,165,40,2063,495,20.5,1600.0,29,1,1,2,7,2,0,0,0,0,13937,6.6,16979,170,52,-2063,-495,22.2,1393.7
4836227893,0,9,0,0,4,10,2,0,0,0,0,14690,6.4,16278,165,44,-1817,-1097,20.9,1469.0,8,0,1,10,4,5,1,1,0,0,16507,6.8,17375,141,63,1817,1097,20.4,1650.7
4836151336,1,12,1,0,3,3,2,0,0,0,0,14525,6.6,17401,159,44,732,1024,20.3,1452.5,22,3,1,3,3,1,1,1,0,0,13793,6.4,16377,157,52,-732,-1024,20.9,1379.3
4835364366,0,12,1,1,9,6,10,1,1,0,0,16219,6.0,13556,126,44,-568,-2937,17.0,1621.9,13,0,0,6,9,2,1,0,1,0,16787,6.4,16493,145,48,568,2937,19.3,1678.7
4834405919,0,13,0,1,5,10,2,0,0,0,0,14054,6.6,16107,117,36,-3539,-2355,15.3,1405.4,18,0,0,10,5,7,1,1,0,0,17593,7.2,18462,169,52,3539,2355,22.1,1759.3
4834402822,0,11,14,0,3,4,3,0,0,0,0,13228,6.6,15827,162,44,-2815,-2959,20.6,1322.8,29,0,1,4,3,1,0,0,0,0,16043,7.2,18786,193,56,2815,2959,24.9,1604.3
4834366363,1,10,1,0,4,3,4,0,0,0,0,14857,6.8,17653,181,48,1093,350,22.9,1485.7,15,1,1,3,4,1,1,1,0,0,13764,7.0,17303,181,36,-1093,-350,21.7,1376.4
4834334918,0,17,1,0,5,13,4,0,0,0,0,16785,6.8,16824,163,44,-2160,-1761,20.7,1678.5,19,2,1,13,5,10,1,1,0,0,18945,7.4,18585,140,56,2160,1761,19.6,1894.5
4833439908,1,24,0,0,13,4,7,1,1,0,0,17514,6.6,16978,112,64,4543,4251,17.6,1751.4,0,1,1,4,13,2,0,0,0,0,12971,5.6,12727,126,0,-4543,-4251,12.6,1297.1
4833423539,1,16,3,0,6,2,3,0,0,0,0,17652,6.8,18667,237,44,3869,3400,28.1,1765.2,90,3,1,2,6,4,0,0,0,0,13783,6.0,15267,161,50,-3869,-3400,21.1,1378.3
4833402628,1,12,1,0,3,8,3,0,0,0,0,14076,6.4,15727,142,52,-2663,-2440,19.4,1407.6,10,1,1,8,3,4,1,1,0,0,16739,7.0,18167,194,48,2663,2440,24.2,1673.9
4831588380,1,16,0,1,9,5,10,0,0,0,0,16522,6.6,16477,165,51,2092,156,21.6,1652.2,17,0,0,5,9,4,1,1,0,0,14430,6.6,16321,173,44,-2092,-156,21.7,1443.0
4831582786,0,10,2,1,4,7,1,0,0,0,0,14213,6.6,16160,137,56,-2382,-1344,19.3,1421.3,10,1,0,7,4,7,0,0,0,0,16595,6.8,17504,131,44,2382,1344,17.5,1659.5
4830785217,1,21,0,0,34,15,86,0,0,0,1,38249,11.4,43079,87,0,2935,6310,8.7,3824.9,0,1,1,15,34,38,0,0,0,0,35314,10.6,36769,96,0,-2935,-6310,9.6,3531.4
4830782794,1,22,0,0,15,18,35,0,0,0,1,36360,10.8,38551,91,0,1225,1023,9.1,3636.0,0,5,1,18,15,47,0,0,0,0,35135,10.8,37528,111,0,-1225,-1023,11.1,3513.5
4853475964,1,9,2,1,11,5,5,0,0,0,0,18797,6.6,17925,164,51,1850,1665,21.5,1879.7,12,0,0,5,11,3,0,0,0,0,16947,6.4,16260,183,44,-1850,-1665,22.7,1694.7
4849622897,1,12,2,1,7,5,5,1,1,0,0,15686,6.8,17464,173,48,746,-497,22.1,1568.6,14,1,0,5,7,3,0,0,0,0,14940,6.8,17961,175,52,-746,497,22.7,1494.0
4849586820,1,15,2,0,3,4,2,0,0,0,0,14065,6.6,16773,171,48,689,154,21.9,1406.5,8,0,1,4,3,3,0,0,0,0,13376,6.6,16619,146,48,-689,-154,19.4,1337.6
4848522365,1,13,3,1,7,8,1,2,1,1,0,17164,7.0,18949,197,68,840,2237,26.5,1716.4,13,1,0,8,7,11,0,0,0,0,16324,6.8,16712,158,44,-840,-2237,20.2,1632.4
4848489133,0,14,2,1,3,7,1,0,0,0,0,14382,6.8,17653,160,67,-1251,642,22.7,1438.2,19,1,0,7,3,9,0,0,0,0,15633,6.6,17011,191,28,1251,-642,21.9,1563.3
4847542253,0,11,1,1,6,4,6,0,0,0,0,14703,6.2,15630,148,22,-170,-1541,17.0,1470.3,9,1,0,4,6,2,1,0,1,0,14873,6.8,17171,163,52,170,1541,21.5,1487.3
4847508290,1,15,4,1,7,3,12,0,0,0,0,16303,7.0,17419,155,34,2819,908,18.9,1630.3,12,2,0,3,7,1,0,0,0,0,13484,6.2,16511,193,36,-2819,-908,22.9,1348.4
4846573292,0,14,2,1,6,6,4,0,0,0,0,16674,6.4,15944,150,32,1315,-107,18.2,1667.4,9,2,0,6,6,4,2,1,1,0,15359,6.6,16051,160,40,-1315,107,20.0,1535.9
4846542311,1,18,11,0,9,11,11,0,0,0,0,17330,6.2,15349,158,36,315,-993,19.4,1733.0,37,4,1,11,9,9,0,0,0,0,17015,6.6,16342,145,48,-315,993,19.3,1701.5
4846531382,0,0,0,0,7,28,15,0,0,0,2,32045,10.0,34219,51,0,-6457,-6440,5.1,3204.5,0,0,1,28,7,84,0,0,0,0,38502,11.2,40659,105,0,6457,6440,10.5,3850.2
4831923795,0,10,1,0,1,5,1,0,0,0,0,13100,6.4,16467,138,52,-4183,-3476,19.0,1310.0,47,0,1,5,1,4,1,1,0,0,17283,7.4,19943,199,58,4183,3476,25.7,1728.3
4831573497,1,14,5,0,8,4,5,0,0,0,0,17316,7.0,17848,187,20,1967,1137,20.7,1731.6,14,1,1,4,8,3,0,0,0,0,15349,6.6,16711,178,56,-1967,-1137,23.4,1534.9
4831153350,0,13,1,0,6,4,4,0,0,0,0,15350,7.2,18097,174,48,1200,1263,22.2,1535.0,35,0,1,4,6,1,0,0,0,0,14150,6.8,16834,149,44,-1200,-1263,19.3,1415.0
4828371613,1,220,1,1,5,3,1,1,1,0,0,16301,7.2,18792,204,40,2725,2822,24.4,1630.1,14,1,0,3,5,3,0,0,0,0,13576,6.4,15970,122,48,-2725,-2822,17.0,1357.6
4828320524,1,55,0,0,5,3,4,1,1,0,0,14329,6.8,17381,147,48,-2002,691,19.5,1432.9,10,1,1,3,5,5,0,0,0,0,16331,6.6,16690,176,44,2002,-691,22.0,1633.1
4824427619,0,11,0,1,6,7,2,0,0,0,0,15463,6.8,17423,168,52,-2464,-1707,22.0,1546.3,10,0,0,7,6,4,0,0,0,0,17927,7.0,19130,181,52,2464,1707,23.3,1792.7
4824408731,0,10,0,0,2,3,1,0,0,0,0,11735,5.0,10958,62,64,-4641,-6781,12.6,1173.5,233,2,1,3,2,1,1,1,0,0,16376,6.8,17739,194,60,4641,6781,25.4,1637.6
4824381203,0,255,5,0,6,9,3,0,0,0,0,16498,7.0,17585,186,60,1375,1522,24.6,1649.8,25,0,1,9,6,2,0,0,0,0,15123,6.4,16063,125,36,-1375,-1522,16.1,1512.3
4823602840,0,0,0,1,25,20,60,0,0,0,1,37406,11.2,41271,98,0,1833,-249,9.8,3740.6,16,0,0,20,25,37,0,0,0,0,35573,11.2,41520,59,0,-1833,249,5.9,3557.3
4834423231,1,30,1,1,4,0,1,1,1,0,0,16604,7.2,18745,204,58,4300,2724,26.2,1660.4,10,9,0,0,4,0,0,0,0,0,12304,6.6,16021,159,49,-4300,-2724,20.8,1230.4
4771371938,1,13,1,1,14,4,16,0,0,0,0,17215,5.8,13984,127,32,3651,1238,15.9,1721.5,117,0,0,4,14,6,0,0,0,0,13564,5.6,12746,130,26,-3651,-1238,15.6,1356.4
4768268861,1,14,0,1,8,4,5,0,0,0,0,17772,6.8,18230,177,48,3973,2620,22.5,1777.2,62,1,0,4,8,1,0,0,0,0,13799,6.4,15610,137,40,-3973,-2620,17.7,1379.9
4765589084,0,11,0,0,6,3,9,1,1,0,0,16218,6.4,16836,154,60,2051,-738,21.4,1621.8,14,0,1,3,6,1,0,0,0,0,14167,7.0,17574,181,52,-2051,738,23.3,1416.7
4764657647,0,7,1,0,5,11,2,0,0,0,0,13981,6.4,15456,150,44,-4655,-1228,19.4,1398.1,7,0,1,11,5,8,0,0,0,0,18636,6.4,16684,201,36,4655,1228,23.7,1863.6
4764196509,0,13,0,1,2,4,3,0,0,0,0,13959,6.4,16248,179,40,-969,-677,21.9,1395.9,41,0,0,4,2,4,0,0,0,0,14928,6.8,16925,159,40,969,677,19.9,1492.8
4764158206,0,10,0,1,5,5,5,0,0,0,0,15179,6.6,17384,183,40,-650,-1156,22.3,1517.9,17,0,0,5,5,2,1,1,0,0,15829,7.0,18540,166,56,650,1156,22.2,1582.9
4764134573,0,12,3,1,3,6,4,0,0,0,0,15633,6.6,17314,209,56,-529,-1908,26.5,1563.3,14,1,0,6,3,4,1,1,0,0,16162,7.2,19222,201,64,529,1908,26.5,1616.2
4764106608,1,247,0,0,8,10,7,1,1,0,0,16543,6.4,15795,141,44,-2313,-3001,18.5,1654.3,9,0,1,10,8,7,0,0,0,0,18856,7.0,18796,190,48,2313,3001,23.8,1885.6
4764068512,1,9,1,0,11,6,7,2,1,1,0,17285,6.8,17480,187,40,3416,666,22.7,1728.5,11,1,1,4,9,3,0,0,0,0,13869,6.6,16814,149,48,-3416,-666,19.7,1386.9
4764027185,1,13,2,0,2,7,0,1,1,0,0,14136,6.8,17232,179,68,-1174,1946,24.7,1413.6,13,1,1,7,2,10,0,0,0,0,15310,6.4,15286,164,16,1174,-1946,18.0,1531.0
4763988658,1,13,0,1,10,3,3,1,1,0,0,18136,7.0,18436,169,64,4956,2615,23.3,1813.6,9,1,0,3,10,2,0,0,0,0,13180,6.6,15821,165,36,-4956,-2615,20.1,1318.0
4763946177,0,12,1,1,9,1,8,0,0,0,0,17333,6.4,16884,193,36,4295,1056,22.9,1733.3,10,1,0,1,9,0,1,1,0,0,13038,6.4,15828,167,52,-4295,-1056,21.9,1303.8
4763896484,0,12,1,0,0,5,0,0,0,0,0,13686,6.2,15843,163,59,-2717,-1660,22.2,1368.6,10,1,1,5,0,4,0,0,0,0,16403,6.8,17503,165,52,2717,1660,21.7,1640.3
4763235376,0,11,1,1,5,5,8,0,0,0,0,15828,6.4,16134,151,43,999,-823,19.4,1582.8,42,0,0,5,5,9,1,1,0,0,14829,6.8,16957,134,52,-999,823,18.6,1482.9
4763212608,1,12,0,0,7,6,2,0,0,0,0,15809,6.8,17629,184,49,313,2343,23.3,1580.9,6,1,1,6,7,5,0,0,0,0,15496,6.2,15286,140,50,-313,-2343,19.0,1549.6
4758067533,0,9,0,1,4,2,1,0,0,0,0,15826,7.0,17639,171,72,-121,-457,24.3,1582.6,12,0,0,2,4,3,1,1,0,0,15947,7.0,18096,213,60,121,457,27.3,1594.7
4758013561,0,13,1,0,1,5,0,0,0,0,0,14231,6.6,16687,182,44,-2395,-1879,22.6,1423.1,9,0,1,5,1,2,0,0,0,0,16626,7.0,18566,143,68,2395,1879,21.1,1662.6
4742225205,0,72,1,1,4,3,3,0,0,0,0,14773,6.8,17873,172,44,438,111,21.6,1477.3,13,2,0,3,4,2,0,0,0,0,14335,6.8,17762,212,56,-438,-111,26.8,1433.5
4696339202,1,14,1,0,5,3,3,1,1,0,0,16254,6.6,16630,159,48,1050,17,20.7,1625.4,75,0,1,3,5,2,0,0,0,0,15204,6.6,16613,178,52,-1050,-17,23.0,1520.4
4845302109,0,13,1,0,5,3,3,0,0,0,0,14337,7.0,17845,139,52,76,1380,19.1,1433.7,11,0,1,3,5,3,1,1,0,0,14261,6.8,16465,153,68,-76,-1380,22.1,1426.1
4844397218,1,110,1,0,1,1,2,2,1,1,0,14963,6.8,17920,202,56,-73,-917,25.8,1496.3,12,0,1,1,1,1,0,0,0,0,15036,7.0,18837,181,56,73,917,23.7,1503.6
4843488389,0,11,0,0,0,1,0,0,0,0,0,12444,6.6,16709,157,50,-1567,-893,20.7,1244.4,11,0,1,1,0,0,1,1,0,0,14011,6.6,17602,197,45,1567,893,24.2,1401.1
4841381536,1,34,1,1,8,3,7,1,1,0,0,17818,7.0,18365,170,44,4097,2119,21.4,1781.8,32,1,0,3,8,4,0,0,0,0,13721,6.6,16246,150,43,-4097,-2119,19.3,1372.1
4841347642,0,14,0,1,7,7,4,0,0,0,0,15067,6.4,15881,135,40,-3883,-3003,17.5,1506.7,312,2,0,7,7,4,1,1,0,0,18950,7.0,18884,232,44,3883,3003,27.6,1895.0
4839233892,0,14,0,1,7,6,7,0,0,0,0,15239,6.6,16519,146,51,-1599,-2120,19.7,1523.9,83,0,0,6,7,1,0,0,0,0,16838,7.2,18639,204,57,1599,2120,26.1,1683.8
4837167991,0,19,0,1,2,3,1,0,0,0,0,14123,6.8,17310,140,33,-816,-121,17.3,1412.3,10,0,0,3,2,1,0,0,0,0,14939,6.8,17431,182,46,816,121,22.8,1493.9
4837120823,0,15,0,0,6,6,3,1,1,0,0,15078,6.8,17067,118,48,-854,-24,16.6,1507.8,14,0,1,6,6,5,0,0,0,0,15932,6.6,17091,169,64,854,24,23.3,1593.2
4837057703,0,9,1,0,4,3,6,0,0,0,0,14255,6.6,16358,157,32,-2197,-1770,18.9,1425.5,23,3,1,3,4,2,0,0,0,0,16452,6.6,18128,186,52,2197,1770,23.8,1645.2
4836138905,1,76,3,1,7,3,4,1,1,0,0,16401,7.4,19016,193,48,2423,1871,24.1,1640.1,15,0,0,3,7,2,0,0,0,0,13978,6.8,17145,175,48,-2423,-1871,22.3,1397.8
4836093671,1,22,0,0,4,4,4,0,0,0,0,15336,6.6,16766,206,0,-344,-1261,20.6,1533.6,4,0,1,4,4,3,1,1,0,0,15680,7.0,18027,157,56,344,1261,21.3,1568.0
4835037990,0,14,1,0,2,4,2,1,1,0,0,13805,6.4,16246,152,32,-3709,-2766,18.4,1380.5,12,0,1,4,2,4,1,0,1,0,17514,7.0,19012,210,59,3709,2766,26.9,1751.4
4834134835,1,17,0,1,4,7,5,0,0,0,0,14575,6.6,16863,146,52,-213,38,19.8,1457.5,9,0,0,7,4,5,1,1,0,0,14788,6.8,16825,147,48,213,-38,19.5,1478.8
4834077217,1,13,5,0,4,3,4,1,1,0,0,14106,6.2,15688,187,52,-604,-1050,23.9,1410.6,12,2,1,3,4,3,0,0,0,0,14710,6.8,16738,197,36,604,1050,23.3,1471.0
4833703898,0,13,0,1,4,7,4,0,0,0,0,15261,6.8,16774,159,44,-2057,-2433,20.3,1526.1,167,2,0,7,4,6,1,1,0,0,17318,7.0,19207,192,48,2057,2433,24.0,1731.8
4833301110,1,12,2,1,4,4,4,1,0,1,0,15505,6.8,17516,176,44,1254,-202,22.0,1550.5,10,1,0,4,4,2,0,0,0,0,14251,6.8,17718,158,60,-1254,202,21.8,1425.1
4833253555,0,10,0,1,3,11,0,0,0,0,0,13896,6.4,15350,134,51,-3735,-2398,18.5,1389.6,22,1,0,11,3,6,1,1,0,0,17631,7.0,17748,169,52,3735,2398,22.1,1763.1
4832310674,1,10,3,0,5,7,9,1,1,0,0,15412,6.4,16113,171,44,-608,-982,21.5,1541.2,14,1,1,7,5,9,0,0,0,0,16020,6.8,17095,159,56,608,982,21.5,1602.0
4831471126,0,11,0,0,1,4,1,0,0,0,0,13341,6.4,15580,186,50,-2367,-3895,23.6,1334.1,12,1,1,4,1,2,0,0,0,0,15708,7.2,19475,229,68,2367,3895,29.7,1570.8
4830650053,0,17,1,1,9,3,6,0,0,0,0,18255,7.0,18409,182,68,3457,1702,25.0,1825.5,9,0,0,3,9,3,0,0,0,0,14798,6.8,16707,146,32,-3457,-1702,17.8,1479.8
4858441287,1,7,0,0,13,16,14,0,0,0,0,46650,10.0,47500,0,0,18100,19000,0.0,4665.0,0,0,1,14,11,10,0,0,0,0,28550,6.0,28500,0,0,-18100,-19000,0.0,2855.0
4858423337,1,16,2,1,24,13,26,0,0,0,0,64120,12.0,55000,2,0,29020,22000,0.2,6412.0,0,0,0,5,16,3,0,0,0,0,35100,7.2,33000,0,0,-29020,-22000,0.0,3510.0
4858391670,1,6,0,0,14,20,15,0,0,0,0,61712,12.0,55000,0,0,24154,22000,0.0,6171.2,0,0,1,14,8,12,0,0,0,0,37558,7.2,33000,0,0,-24154,-22000,0.0,3755.8
4854979069,1,0,0,0,14,23,14,0,0,0,0,55390,12.0,55000,0,0,15950,22000,0.0,5539.0,0,0,1,14,5,13,0,0,0,0,39440,7.2,33000,2,0,-15950,-22000,0.2,3944.0
4854953730,1,396,0,1,20,22,22,0,0,0,0,61782,12.0,55000,2,0,24152,22000,0.2,6178.2,0,0,0,14,12,12,0,0,0,0,37630,7.2,33000,1,0,-24152,-22000,0.1,3763.0
4854944814,1,7,0,1,17,17,15,0,0,0,0,47000,10.0,47500,0,0,20200,19000,0.0,4700.0,0,0,0,10,10,6,0,0,0,0,26800,6.0,28500,0,0,-20200,-19000,0.0,2680.0
4854922010,1,10,0,1,21,17,24,0,0,0,0,64100,13.0,62500,0,0,26200,21000,0.0,6410.0,0,0,0,9,13,8,0,0,0,0,37900,8.6,41500,0,0,-26200,-21000,0.0,3790.0
4851023226,1,11,1,1,7,2,4,0,0,0,0,16253,6.8,16807,188,52,2801,941,24.0,1625.3,157,1,0,2,7,1,0,0,0,0,13452,6.6,15866,178,44,-2801,-941,22.2,1345.2
4850662073,0,13,1,1,9,3,4,0,0,0,0,16790,7.0,18068,156,54,2480,1448,21.0,1679.0,12,0,0,3,9,0,0,0,0,0,14310,6.6,16620,177,54,-2480,-1448,23.1,1431.0
4849686379,1,12,0,1,2,6,0,0,0,0,0,14639,6.6,17033,161,55,-832,1085,21.6,1463.9,15,2,0,6,2,7,1,1,0,0,15471,6.6,15948,152,44,832,-1085,19.6,1547.1
4846153248,0,12,2,0,4,8,3,0,0,0,0,15516,6.8,17315,170,48,-1908,-647,21.8,1551.6,77,1,1,8,4,6,0,0,0,0,17424,7.0,17962,178,60,1908,647,23.8,1742.4
4845947817,1,13,4,1,16,5,12,1,1,0,0,20692,7.2,19051,188,60,6126,2975,24.8,2069.2,15,2,0,5,16,3,0,0,0,0,14566,6.4,16076,171,48,-6126,-2975,21.9,1456.6
4845115631,0,39,1,1,4,1,5,1,0,1,0,15207,6.8,17115,179,48,1498,212,22.7,1520.7,12,17,0,1,4,1,0,0,0,0,13709,6.6,16903,155,44,-1498,-212,19.9,1370.9
4659367066,0,0,0,1,25,27,57,0,0,0,2,39246,11.0,40629,91,0,-5,-3358,9.1,3924.6,7,0,0,27,25,59,0,0,0,0,39251,11.6,43987,104,0,5,3358,10.4,3925.1
4659330068,1,82,0,1,5,6,10,0,0,0,0,16049,6.4,15939,144,36,36,-34,18.0,1604.9,12,0,0,6,5,6,0,0,0,0,16013,6.2,15973,153,60,-36,34,21.3,1601.3
4641608621,1,0,0,1,28,18,90,0,0,0,0,36612,11.4,41073,93,0,1201,2275,9.3,3661.2,0,0,0,18,28,54,0,0,0,0,35411,10.8,38798,87,0,-1201,-2275,8.7,3541.1
4640744907,0,11,0,0,8,8,11,0,0,0,0,16923,6.8,16562,179,40,-481,-154,21.9,1692.3,11,0,1,8,8,7,0,0,0,0,17404,6.8,16716,135,48,481,154,18.3,1740.4
4639525362,1,0,0,1,28,32,73,0,0,0,1,37470,11.6,42976,92,0,-2319,-2778,9.2,3747.0,0,0,0,32,28,70,0,0,0,0,39789,12.2,45754,110,0,2319,2778,11.0,3978.9
4638308821,1,14,1,1,5,4,3,1,1,0,0,15758,6.6,16628,152,60,1283,-811,21.2,1575.8,13,2,0,4,5,2,0,0,0,0,14475,7.0,17439,163,60,-1283,811,22.3,1447.5
4638173305,0,17,0,1,22,15,62,0,0,0,0,34689,10.6,36617,82,0,-2248,-2321,8.2,3468.9,0,0,0,15,22,40,0,0,0,0,36937,10.8,38938,96,0,2248,2321,9.6,3693.7
4857194358,1,13,1,1,9,6,4,1,1,0,0,17223,6.8,17456,167,54,1727,508,22.1,1722.3,8,1,0,6,9,3,0,0,0,0,15496,6.6,16948,127,50,-1727,-508,17.7,1549.6
4857020316,1,80,1,1,9,5,2,1,1,0,0,17180,7.0,18355,174,52,2768,2308,22.6,1718.0,15,1,0,4,8,2,0,0,0,0,14412,6.6,16047,134,47,-2768,-2308,18.1,1441.2
4856419151,1,15,2,1,9,3,4,0,0,0,0,17410,6.8,18147,186,60,2844,2762,24.6,1741.0,14,1,0,3,9,2,0,0,0,0,14566,6.4,15385,133,43,-2844,-2762,17.6,1456.6
4856340968,0,171,0,0,5,8,3,0,0,0,0,14231,6.8,17733,163,52,-3515,-920,21.5,1423.1,9,1,1,8,5,6,1,1,0,0,17746,7.0,18653,178,60,3515,920,23.8,1774.6
4856232613,1,13,1,1,2,2,2,1,0,1,0,15768,6.8,18506,234,60,3052,1543,29.4,1576.8,11,0,0,2,2,2,0,0,0,0,12716,6.6,16963,147,44,-3052,-1543,19.1,1271.6
4856187501,0,12,0,0,1,6,0,0,0,0,0,12403,6.4,15812,123,60,-3750,-2532,18.3,1240.3,9,0,1,6,1,5,1,1,0,0,16153,7.0,18344,206,44,3750,2532,25.0,1615.3
4856104248,0,14,2,0,2,7,2,0,0,0,0,13645,6.2,14827,123,36,-2527,-2753,15.9,1364.5,14,1,1,7,2,9,1,1,0,0,16172,6.8,17580,160,53,2527,2753,21.3,1617.2
4856004969,1,9,1,0,2,2,1,0,0,0,0,14983,6.6,17081,152,56,1223,1305,20.8,1498.3,351,0,1,2,2,1,1,1,0,0,13760,6.6,15776,186,48,-1223,-1305,23.4,1376.0
4855963698,0,16,0,1,5,4,2,0,0,0,0,15200,6.4,16315,183,48,421,-960,23.1,1520.0,9,1,0,4,5,2,1,1,0,0,14779,7.0,17275,151,44,-421,960,19.5,1477.9
4855861034,1,3,0,1,20,20,18,0,0,0,0,48750,10.2,48680,0,0,20900,20180,0.0,4875.0,0,0,0,10,10,8,0,0,0,0,27850,6.0,28500,0,0,-20900,-20180,0.0,2785.0
4855772812,1,14,1,1,4,6,5,0,0,0,0,15117,6.4,15989,143,63,396,0,20.6,1511.7,82,3,0,6,4,6,1,1,0,0,14721,6.4,15989,140,46,-396,0,18.6,1472.1
4853637869,0,71,1,0,1,3,0,1,0,1,0,13908,6.8,17783,200,52,-1248,-738,25.2,1390.8,9,0,1,3,1,3,1,1,0,0,15156,7.0,18521,189,64,1248,738,25.3,1515.6
4852610110,0,12,0,0,3,8,5,0,0,0,0,14648,6.6,16844,172,44,-2168,-362,21.6,1464.8,78,0,1,8,3,10,2,1,1,0,16816,6.6,17206,153,64,2168,362,21.7,1681.6
4851575070,1,34,0,0,6,7,1,0,0,0,0,14835,6.8,17842,151,56,-865,719,20.7,1483.5,9,4,1,7,6,6,0,0,0,0,15700,6.8,17123,178,60,865,-719,23.8,1570.0
4851498572,0,175,0,0,5,7,4,0,0,0,0,15666,6.8,17010,180,39,-442,-236,21.9,1566.6,12,1,1,6,4,10,0,0,0,0,16108,6.8,17246,171,68,442,236,23.9,1610.8
4849151532,0,15,1,0,4,9,3,0,0,0,0,14817,6.4,15824,189,20,-496,621,20.9,1481.7,27,3,1,9,4,8,0,0,0,0,15313,6.2,15203,154,36,496,-621,19.0,1531.3
4849078573,0,12,1,0,4,11,3,0,0,0,0,16145,6.4,15205,132,40,-1873,-1288,17.2,1614.5,76,0,1,11,4,18,0,0,0,0,18018,6.6,16493,139,44,1873,1288,18.3,1801.8
4845051492,0,143,2,1,12,7,11,0,0,0,0,18778,6.6,16774,156,48,3031,1142,20.4,1877.8,14,1,0,7,12,4,0,0,0,0,15747,6.6,15632,152,49,-3031,-1142,20.1,1574.7
4844967879,0,15,3,1,3,0,0,1,1,0,0,13718,7.0,17903,131,72,-624,1425,20.3,1371.8,25,3,0,0,3,0,0,0,0,0,14342,6.6,16478,163,48,624,-1425,21.1,1434.2
4856618579,1,0,1,0,29,23,88,0,0,0,0,38300,11.4,41993,82,0,2266,410,8.2,3830.0,6,0,1,23,29,48,0,0,0,0,36034,11.2,41583,75,0,-2266,-410,7.5,3603.4
4856509406,1,13,2,1,3,6,1,0,0,0,0,13259,6.6,16657,152,48,-2570,-879,20.0,1325.9,15,1,0,6,3,4,1,1,0,0,15829,6.8,17536,189,56,2570,879,24.5,1582.9
4855760967,0,15,3,0,5,3,3,1,1,0,0,15869,6.8,17360,152,55,998,2456,20.7,1586.9,12,1,1,3,5,2,0,0,0,0,14871,6.2,14904,149,32,-998,-2456,18.1,1487.1
4855436168,0,133,1,1,4,7,3,1,1,0,0,14264,6.6,16355,167,44,-2398,-358,21.1,1426.4,19,2,0,7,4,10,1,0,1,0,16662,6.8,16713,170,44,2398,358,21.4,1666.2
4855310092,1,20,0,1,32,27,84,0,0,0,1,43095,11.8,46583,132,0,6634,6476,13.2,4309.5,0,3,0,27,32,64,0,0,0,0,36461,11.2,40107,103,0,-6634,-6476,10.3,3646.1
4855276929,1,13,0,1,28,20,70,0,0,0,1,35143,11.0,40189,80,0,-774,1787,8.0,3514.3,0,5,0,20,28,33,0,0,0,0,35917,11.0,38402,121,0,774,-1787,12.1,3591.7
4854701420,1,107,2,1,1,0,0,0,0,0,0,13826,6.8,17616,193,52,204,984,24.5,1382.6,15,1,0,0,1,0,0,0,0,0,13622,6.6,16632,218,40,-204,-984,25.8,1362.2
4854663449,0,10,0,0,6,5,4,1,1,0,0,15473,6.6,16705,207,36,-1049,-1654,24.3,1547.3,12,0,1,5,6,6,0,0,0,0,16522,7.0,18359,193,72,1049,1654,26.5,1652.2
4829817167,0,9,0,0,19,21,33,0,0,0,0,36096,11.2,40386,104,0,-649,1654,10.4,3609.6,0,0,1,21,19,42,0,0,0,0,36745,10.8,38732,103,0,649,-1654,10.3,3674.5
4823148761,0,0,5,1,19,18,53,0,0,0,1,35942,10.6,38403,109,0,-797,-2093,10.9,3594.2,17,0,0,18,19,52,0,0,0,0,36739,11.2,40496,88,0,797,2093,8.8,3673.9
4821205850,1,0,3,0,40,32,112,0,0,0,1,43855,12.4,49464,132,0,4021,4782,13.2,4385.5,15,0,1,32,40,60,0,0,0,0,39834,11.8,44682,89,0,-4021,-4782,8.9,3983.4
4821031532,1,38,0,1,22,20,49,0,0,0,0,37135,10.8,40345,121,0,1386,1431,12.1,3713.5,34,0,0,20,22,43,0,0,0,0,35749,10.6,38914,83,0,-1386,-1431,8.3,3574.9
4820904960,0,0,1,1,21,25,52,0,0,0,0,35876,10.8,38534,77,0,-1917,-3875,7.7,3587.6,14,0,0,25,21,72,0,0,0,0,37793,11.4,42409,100,0,1917,3875,10.0,3779.3
4819158172,0,20,0,0,24,29,56,0,0,0,0,37841,11.0,39660,95,0,-981,-4144,9.5,3784.1,0,2,1,29,24,72,0,0,0,0,38822,11.4,43804,107,0,981,4144,10.7,3882.2
4819132887,0,22,0,0,19,31,40,0,0,0,1,36174,11.0,39216,95,0,-3329,-3533,9.5,3617.4,0,0,1,31,19,80,0,0,0,0,39503,11.8,42749,114,0,3329,3533,11.4,3950.3
4819091044,1,15,0,0,26,19,64,0,0,0,1,36047,11.0,39930,92,0,1448,3560,9.2,3604.7,0,5,1,19,26,43,0,0,0,0,34599,10.4,36370,111,0,-1448,-3560,11.1,3459.9
4819054926,1,0,0,0,18,13,46,0,0,0,1,34418,10.8,37440,89,0,1035,3038,8.9,3441.8,0,0,1,13,18,34,0,0,0,0,33383,10.0,34402,98,0,-1035,-3038,9.8,3338.3
4818326540,0,92,2,1,8,8,6,0,0,0,0,17288,7.2,18298,176,48,1013,1039,22.4,1728.8,10,2,0,8,8,7,0,0,0,0,16275,7.0,17259,153,32,-1013,-1039,18.5,1627.5
4818262136,1,172,0,0,23,19,48,0,0,0,2,37046,11.2,41687,97,0,1792,4625,9.7,3704.6,0,0,1,19,23,49,0,0,0,0,35254,10.6,37062,93,0,-1792,-4625,9.3,3525.4
4858037139,1,0,0,1,23,18,47,0,0,0,0,36057,11.0,39757,100,0,-478,474,10.0,3605.7,14,0,0,18,23,46,0,0,0,0,36535,10.8,39283,102,0,478,-474,10.2,3653.5
4858024910,1,0,0,1,45,23,108,0,0,0,0,43731,12.4,49301,93,0,7588,9878,9.3,4373.1,0,0,0,23,45,54,0,0,0,0,36143,11.0,39423,70,0,-7588,-9878,7.0,3614.3
4857977961,1,68,0,0,22,19,66,0,0,0,0,38739,11.4,42181,111,0,3301,5502,11.1,3873.9,0,0,1,19,22,55,0,0,0,0,35438,10.4,36679,107,0,-3301,-5502,10.7,3543.8
4857965089,1,0,0,1,28,21,88,0,0,0,1,38771,11.4,42389,85,0,2786,2474,8.5,3877.1,0,0,0,21,28,47,0,0,0,0,35985,11.0,39915,98,0,-2786,-2474,9.8,3598.5
4857952844,1,53,0,1,33,17,97,0,0,0,1,39382,11.6,43303,105,0,4175,3390,10.5,3938.2,34,0,0,17,33,30,0,0,0,0,35207,11.0,39913,100,0,-4175,-3390,10.0,3520.7
4857938148,0,0,0,1,10,12,23,0,0,0,0,33650,10.4,35308,98,0,739,-185,9.8,3365.0,0,0,0,12,10,25,0,0,0,0,32911,10.4,35493,104,0,-739,185,10.4,3291.1
4857917443,1,0,0,0,27,34,54,0,0,0,0,37998,11.8,43630,106,0,-1016,-860,10.6,3799.8,82,0,1,34,27,70,0,0,0,0,39014,11.8,44490,117,0,1016,860,11.7,3901.4
4857899357,0,0,0,1,20,25,59,0,0,0,1,35746,11.2,39497,110,0,-2158,-2362,11.0,3574.6,0,0,0,25,20,55,0,0,0,0,37904,11.2,41859,108,0,2158,2362,10.8,3790.4
4857891793,0,25,0,0,35,44,77,0,0,0,1,40904,12.0,47344,97,0,-1940,-2544,9.7,4090.4,0,18,1,44,35,104,0,0,0,0,42844,12.6,49888,104,0,1940,2544,10.4,4284.4
4857878755,1,191,0,0,24,24,46,0,0,0,0,36745,11.4,41311,101,0,-471,-143,10.1,3674.5,4,0,1,24,24,57,0,0,0,0,37216,11.2,41454,109,0,471,143,10.9,3721.6
4857865247,0,0,0,0,21,29,54,0,0,0,1,38206,11.2,40558,112,0,59,130,11.2,3820.6,0,0,1,29,21,78,0,0,0,0,38147,11.0,40428,99,0,-59,-130,9.9,3814.7
4857845447,1,46,0,0,34,23,75,0,0,0,0,40488,12.0,46059,112,0,3125,4360,11.2,4048.8,34,0,1,23,34,51,0,0,0,0,37363,11.0,41699,98,0,-3125,-4360,9.8,3736.3
4857832489,0,13,0,1,24,28,53,0,0,0,0,38050,11.4,42719,111,0,27,-831,11.1,3805.0,11,1,0,28,24,72,0,0,0,0,38023,11.6,43550,108,0,-27,831,10.8,3802.3
4857828112,0,3,2,0,23,29,49,0,0,0,1,37412,11.0,40332,115,0,-3286,-3278,11.5,3741.2,11,0,1,29,23,88,0,0,0,0,40698,11.4,43610,111,0,3286,3278,11.1,4069.8
4857513564,0,11,0,1,17,24,46,0,0,0,0,34866,10.4,36447,94,0,-2485,-4659,9.4,3486.6,16,4,0,24,17,59,0,0,0,0,37351,11.0,41106,121,0,2485,4659,12.1,3735.1
4857495928,1,0,0,0,36,42,94,0,0,0,2,41248,12.2,46357,102,0,-2230,-1336,10.2,4124.8,0,0,1,42,36,109,0,0,0,0,43478,12.0,47693,100,0,2230,1336,10.0,4347.8
4857393304,1,0,4,1,23,21,64,0,0,0,0,37173,11.0,40150,126,0,1235,-187,12.6,3717.3,88,0,0,21,23,43,0,0,0,0,35938,11.0,40337,92,0,-1235,187,9.2,3593.8
4857365489,0,20,0,1,18,17,52,0,0,0,0,35730,10.2,36302,110,0,1724,-222,11.0,3573.0,30,5,0,17,18,54,0,0,0,0,34006,10.8,36524,70,0,-1724,222,7.0,3400.6
4857345947,1,0,0,1,33,22,111,0,0,0,0,39797,11.6,43652,109,0,3264,3967,10.9,3979.7,22,0,0,22,33,52,0,0,0,0,36533,11.2,39685,112,0,-3264,-3967,11.2,3653.3
4857025418,0,0,0,1,24,25,53,0,0,0,1,37718,10.8,38921,99,0,161,-1831,9.9,3771.8,0,0,0,25,24,61,0,0,0,0,37557,11.2,40752,104,0,-161,1831,10.4,3755.7
4858514851,0,9,0,0,2,2,2,1,1,0,0,14460,6.6,16800,163,48,2081,1013,21.1,1446.0,8,0,1,2,2,1,0,0,0,0,12379,6.4,15787,105,40,-2081,-1013,14.5,1237.9
4858471309,1,13,0,1,7,3,4,0,0,0,0,17124,6.6,17501,243,36,2416,890,27.9,1712.4,11,1,0,3,7,3,0,0,0,0,14708,6.6,16611,186,45,-2416,-890,23.1,1470.8
4858434333,1,94,0,1,35,19,97,0,0,0,1,40268,11.8,45320,111,0,4895,6929,11.1,4026.8,25,0,0,19,35,48,0,0,0,0,35373,10.8,38391,88,0,-4895,-6929,8.8,3537.3
4858392267,0,19,18,0,21,24,50,0,0,0,0,36819,11.0,40150,76,0,399,-1005,7.6,3681.9,26,0,1,24,21,61,0,0,0,0,36420,11.0,41155,105,0,-399,1005,10.5,3642.0
4858354588,0,0,5,1,15,24,35,0,0,0,1,37322,10.8,39004,109,0,-30,-1774,10.9,3732.2,17,0,0,24,15,62,0,0,0,0,37352,11.2,40778,89,0,30,1774,8.9,3735.2
4858339743,1,0,0,1,18,12,58,0,0,0,1,36347,10.8,37265,112,0,2370,1399,11.2,3634.7,0,0,0,12,18,34,0,0,0,0,33977,10.4,35866,71,0,-2370,-1399,7.1,3397.7
4858315146,0,68,0,0,17,19,40,0,0,0,1,35975,11.2,39324,89,0,-499,-1406,8.9,3597.5,0,0,1,19,17,32,0,0,0,0,36474,11.0,40730,115,0,499,1406,11.5,3647.4
4857275258,0,41,1,1,21,24,56,0,0,0,0,35937,11.0,40559,92,0,-1459,-1432,9.2,3593.7,14,0,0,24,21,65,0,0,0,0,37396,11.0,41991,89,0,1459,1432,8.9,3739.6
4857244149,1,2,0,1,20,16,64,0,0,0,0,37843,11.0,40076,98,0,2979,1339,9.8,3784.3,84,1,0,16,20,43,0,0,0,0,34864,10.8,38737,104,0,-2979,-1339,10.4,3486.4
4857213485,1,15,0,1,30,18,66,0,0,0,1,38648,11.4,43120,102,0,3883,3821,10.2,3864.8,0,0,0,18,30,31,0,0,0,0,34765,11.0,39299,64,0,-3883,-3821,6.4,3476.5
4857187740,1,0,0,0,21,27,41,0,0,0,0,36514,10.8,39295,94,0,-1705,-2975,9.4,3651.4,0,0,1,27,21,81,0,0,0,0,38219,11.4,42270,88,0,1705,2975,8.8,3821.9
4857139179,1,38,2,0,15,15,12,0,0,0,0,46632,10.0,47500,3,0,16887,19000,0.3,4663.2,34,0,1,10,10,10,0,0,0,0,29745,6.0,28500,1,0,-16887,-19000,0.1,2974.5
4857112661,1,8,0,1,15,21,15,0,0,0,0,60600,12.0,55000,0,0,20600,22000,0.0,6060.0,0,0,0,14,8,15,0,0,0,0,40000,7.2,33000,0,0,-20600,-22000,0.0,4000.0
4857100395,0,306,0,1,21,28,57,0,0,0,2,39199,11.2,41514,107,0,355,-1319,10.7,3919.9,0,0,0,28,21,61,0,0,0,0,38844,11.4,42833,114,0,-355,1319,11.4,3884.4
4857074591,0,11,0,1,19,16,41,0,0,0,0,34968,10.8,38523,106,0,1086,1515,10.6,3496.8,0,2,0,16,19,46,0,0,0,0,33882,10.6,37008,98,0,-1086,-1515,9.8,3388.2
4857051669,1,0,0,1,26,14,70,0,0,0,0,37885,11.2,41370,103,0,3681,5823,10.3,3788.5,0,0,0,14,26,26,0,0,0,0,34204,10.2,35547,90,0,-3681,-5823,9.0,3420.4
4856586405,0,85,1,0,3,6,0,0,0,0,0,14916,6.4,16750,178,60,-1269,-442,23.8,1491.6,14,0,1,6,3,7,1,1,0,0,16185,6.6,17192,203,36,1269,442,23.9,1618.5
4856574261,1,10,0,0,9,6,5,0,0,0,0,16415,6.2,15765,149,48,1229,-573,19.7,1641.5,17,0,1,6,9,3,0,0,0,0,15186,6.4,16338,157,56,-1229,573,21.3,1518.6
4856553481,1,15,1,0,1,2,1,0,0,0,0,13666,6.8,16707,206,42,-525,-893,24.8,1366.6,290,0,1,2,1,0,1,1,0,0,14191,6.8,17600,184,49,525,893,23.3,1419.1
4856536007,1,11,3,0,5,5,2,0,0,0,0,14381,6.6,16337,159,42,-102,133,20.1,1438.1,14,1,1,5,5,4,0,0,0,0,14483,6.6,16204,157,39,102,-133,19.6,1448.3
4854209913,0,11,1,1,4,6,1,0,0,0,0,14925,6.6,15869,160,36,-629,-1745,19.6,1492.5,80,0,0,6,4,6,1,1,0,0,15554,6.8,17614,163,56,629,1745,21.9,1555.4
4854190819,1,4,0,1,18,17,18,0,0,0,0,47000,10.0,47500,0,0,19500,19000,0.0,4700.0,1,0,0,11,12,7,0,0,0,0,27500,6.0,28500,0,0,-19500,-19000,0.0,2750.0
4854159701,1,35,4,0,12,20,11,0,0,0,0,61120,12.2,56000,6,0,22830,23000,0.6,6112.0,5,8,1,14,6,14,0,0,0,0,38290,7.2,33000,0,0,-22830,-23000,0.0,3829.0
4854017626,1,11,2,1,3,4,3,0,0,0,0,15653,6.8,17002,187,40,-72,-403,22.7,1565.3,12,3,0,4,3,4,1,1,0,0,15725,6.8,17405,174,52,72,403,22.6,1572.5
4853979509,1,15,2,1,13,3,24,0,0,0,0,19822,7.4,19413,178,60,7080,4199,23.8,1982.2,15,0,0,2,12,0,0,0,0,0,12742,6.4,15214,145,32,-7080,-4199,17.7,1274.2
4853938664,1,0,0,1,20,17,17,0,0,0,0,48092,10.0,47500,9,0,20215,19000,0.9,4809.2,72,0,0,9,12,7,0,0,0,0,27877,6.0,28500,0,0,-20215,-19000,0.0,2787.7
4851874447,0,6,2,1,3,3,3,1,0,1,0,14901,7.0,17794,169,40,752,-779,20.9,1490.1,243,2,0,3,3,1,0,0,0,0,14149,7.0,18573,186,59,-752,779,24.5,1414.9
4850960946,1,273,0,0,8,7,4,1,1,0,0,15997,6.6,17726,167,52,253,908,21.9,1599.7,11,14,1,6,7,2,0,0,0,0,15744,6.4,16818,188,44,-253,-908,23.2,1574.4
4850913205,0,12,0,0,3,9,5,0,0,0,0,13657,6.4,15184,159,40,-3926,-2044,19.9,1365.7,7,1,1,9,3,7,0,0,0,0,17583,7.0,17228,196,40,3926,2044,23.6,1758.3
4850120606,1,54,0,0,4,3,1,0,0,0,0,15496,7.2,19104,175,58,303,1647,23.3,1549.6,10,0,1,3,4,4,1,1,0,0,15193,7.0,17457,173,52,-303,-1647,22.5,1519.3
4850089544,1,11,2,1,7,5,4,1,1,0,0,15207,6.4,16396,157,56,-655,-73,21.3,1520.7,12,1,0,5,7,2,0,0,0,0,15862,6.6,16469,149,48,655,73,19.7,1586.2
4849726210,0,11,3,1,3,2,2,1,1,0,0,15392,6.8,17626,199,52,691,358,25.1,1539.2,16,1,0,2,3,3,0,0,0,0,14701,6.8,17268,179,48,-691,-358,22.7,1470.1
4849167743,1,20,0,1,6,3,5,0,0,0,0,16477,6.8,17766,200,52,2517,1909,25.2,1647.7,14,3,0,3,6,3,0,0,0,0,13960,6.6,15857,162,48,-2517,-1909,21.0,1396.0
4849128607,1,13,2,1,4,5,3,0,0,0,0,16277,6.8,17601,189,52,228,-606,24.1,1627.7,15,2,0,5,4,0,0,0,0,0,16049,7.0,18207,199,52,-228,606,25.1,1604.9
4848947786,1,13,1,1,5,2,3,0,0,0,0,15490,7.0,18321,201,36,1432,261,23.7,1549.0,10,1,0,2,5,2,1,1,0,0,14058,7.2,18060,180,64,-1432,-261,24.4,1405.8
4847842242,1,15,0,1,8,3,5,0,0,0,0,16978,7.0,18285,209,44,1985,558,25.3,1697.8,8,0,0,3,8,1,0,0,0,0,14993,6.8,17727,168,68,-1985,-558,23.6,1499.3
4847805340,0,14,1,1,6,6,6,2,1,1,0,16322,6.8,16886,166,56,120,-596,22.2,1632.2,11,0,0,6,6,6,0,0,0,0,16202,6.8,17482,182,48,-120,596,23.0,1620.2
4847214595,1,14,1,1,3,4,2,0,0,0,0,14175,6.8,16809,161,52,-827,-1344,21.3,1417.5,29,3,0,4,3,4,0,0,0,0,15002,7.0,18153,176,52,827,1344,22.8,1500.2
4829716102,1,8,2,0,5,4,5,0,0,0,0,16735,7.2,18493,189,52,1616,1020,24.1,1673.5,14,0,1,4,5,2,0,0,0,0,15119,6.8,17473,195,60,-1616,-1020,25.5,1511.9
4829672817,1,30,0,0,4,4,2,0,0,0,0,14749,6.8,18255,187,60,719,2785,24.7,1474.9,14,6,1,4,4,7,1,1,0,0,14030,6.4,15470,126,52,-719,-2785,17.8,1403.0
4829619518,0,15,0,0,1,4,0,1,1,0,0,13549,6.8,17683,184,60,-1879,147,24.4,1354.9,11,0,1,4,1,2,0,0,0,0,15428,6.8,17536,186,48,1879,-147,23.4,1542.8
4829575584,0,9,4,0,1,5,1,0,0,0,0,14516,6.4,16251,173,40,-1226,-238,21.3,1451.6,16,0,1,5,1,4,0,0,0,0,15742,6.6,16489,190,35,1226,238,22.5,1574.2
4827721251,0,7,0,0,4,2,2,0,0,0,0,15175,6.8,18115,205,44,224,641,24.9,1517.5,9,0,1,2,4,1,0,0,0,0,14951,6.8,17474,216,48,-224,-641,26.4,1495.1
4825137727,0,16,0,0,6,4,3,0,0,0,0,14569,6.4,16222,137,44,-821,-693,18.1,1456.9,215,2,1,4,6,3,0,0,0,0,15390,6.6,16915,180,44,821,693,22.4,1539.0
4823193360,1,11,1,1,2,0,3,0,0,0,0,14758,7.0,18620,195,64,519,161,25.9,1475.8,9,0,0,0,2,0,1,1,0,0,14239,6.8,18459,223,56,-519,-161,27.9,1423.9
4817499440,0,6,0,0,7,11,1,0,0,0,0,13651,6.2,15822,155,45,-3509,-298,20.0,1365.1,73,1,1,9,5,13,0,0,0,0,17160,6.2,16120,135,63,3509,298,19.8,1716.0
4815633164,0,12,0,1,10,24,19,0,0,0,0,32505,10.6,35177,53,63,-2645,-6482,11.6,3250.5,13,0,0,23,9,41,0,0,0,0,35150,11.2,41659,91,51,2645,6482,14.2,3515.0
4815622389,1,8,4,0,15,8,28,0,0,0,0,29837,10.2,32913,59,43,2012,1377,10.2,2983.7,33,0,1,8,15,16,0,0,0,0,27825,9.6,31536,86,36,-2012,-1377,12.2,2782.5
4815605502,1,96,0,1,12,6,16,0,0,0,0,30293,10.4,33753,77,47,3171,3730,12.4,3029.3,8,0,0,6,12,13,0,0,0,0,27122,9.6,30023,48,47,-3171,-3730,9.5,2712.2
4815588126,0,13,0,1,5,4,3,0,0,0,0,15269,6.8,17080,179,44,74,-745,22.3,1526.9,12,2,0,4,5,4,0,0,0,0,15195,7.0,17825,178,60,-74,745,23.8,1519.5
4815570809,0,49,0,1,3,1,1,0,0,0,0,15439,7.4,18902,194,60,1271,1213,25.4,1543.9,9,2,0,1,3,0,0,0,0,0,14168,6.8,17689,223,48,-1271,-1213,27.1,1416.8
4815427604,0,54,3,1,8,3,10,1,1,0,0,16375,6.6,16893,164,56,1941,-325,22.0,1637.5,14,1,0,3,8,1,0,0,0,0,14434,7.0,17218,186,56,-1941,325,24.2,1443.4
4815115748,1,11,1,0,3,9,0,0,0,0,0,12573,6.2,15794,106,59,-2902,-552,16.5,1257.3,10,1,1,8,2,4,1,0,1,0,15475,6.6,16346,155,36,2902,552,19.1,1547.5
4814936320,1,9,0,0,4,4,2,0,0,0,0,15455,7.0,18768,186,52,-440,948,23.8,1545.5,12,0,1,4,4,3,0,0,0,0,15895,7.0,17820,178,48,440,-948,22.6,1589.5
4814834666,1,8,0,1,9,8,7,1,1,0,0,18618,7.2,18702,189,76,2773,2631,26.5,1861.8,134,0,0,8,9,8,0,0,0,0,15845,6.6,16071,152,41,-2773,-2631,19.3,1584.5
4814821753,0,13,0,0,5,5,1,0,0,0,0,12629,6.2,15930,133,36,-2516,-7,16.9,1262.9,12,0,1,5,5,7,1,1,0,0,15145,6.6,15937,138,56,2516,7,19.4,1514.5
4813667839,0,14,0,1,4,2,2,0,0,0,0,13834,6.6,16015,150,48,-1628,-1696,19.8,1383.4,14,0,0,2,4,2,0,0,0,0,15462,6.8,17711,177,48,1628,1696,22.5,1546.2
4813065124,1,11,2,1,8,5,8,0,0,0,0,16842,6.8,17786,189,44,1746,1355,23.3,1684.2,8,0,0,5,8,5,0,0,0,0,15096,6.4,16431,154,44,-1746,-1355,19.8,1509.6
4857195381,0,18,0,1,3,4,3,0,0,0,0,13472,6.8,17230,121,52,-1123,-1176,17.3,1347.2,21,0,0,4,3,1,1,1,0,0,14595,7.0,18406,188,48,1123,1176,23.6,1459.5
4855747728,1,14,0,1,4,6,1,0,0,0,0,14651,6.8,17169,147,56,317,108,20.3,1465.1,11,0,0,6,4,2,0,0,0,0,14334,6.8,17061,146,44,-317,-108,19.0,1433.4
4854014171,0,17,2,0,1,7,1,0,0,0,0,13373,6.4,15888,153,55,-2435,-1893,20.8,1337.3,11,1,1,7,1,3,1,1,0,0,15808,7.0,17781,182,40,2435,1893,22.2,1580.8
4853967672,1,12,0,1,4,1,1,0,0,0,0,14621,6.8,17504,166,44,3278,2032,21.0,1462.1,16,0,0,1,4,1,0,0,0,0,11343,6.2,15472,118,32,-3278,-2032,15.0,1134.3
4853745371,1,25,2,0,5,2,5,0,0,0,0,16348,6.8,18033,216,55,2683,1402,27.1,1634.8,8,2,1,2,5,1,0,0,0,0,13665,6.6,16631,177,44,-2683,-1402,22.1,1366.5
4852731731,1,8,0,0,3,5,3,1,1,0,0,13145,6.4,16367,168,36,-1563,-422,20.4,1314.5,21,0,1,5,3,8,0,0,0,0,14708,6.8,16789,162,52,1563,422,21.4,1470.8
4852603920,1,25,2,0,4,4,4,1,1,0,0,14808,6.8,18122,178,64,779,158,24.2,1480.8,15,2,1,4,4,0,0,0,0,0,14029,6.8,17964,169,56,-779,-158,22.5,1402.9
4850012002,0,11,0,0,3,6,1,0,0,0,0,14224,6.6,17060,174,48,-1499,72,22.2,1422.4,9,0,1,6,3,5,0,0,0,0,15723,6.6,16988,167,40,1499,-72,20.7,1572.3
4848501198,0,26,0,0,3,6,2,0,0,0,0,13690,5.6,13758,171,5,-1484,-2320,17.6,1369.0,76,16,1,6,3,6,1,1,0,0,15174,6.4,16078,166,56,1484,2320,22.2,1517.4
4847941274,1,8,0,0,3,5,3,0,0,0,0,13315,6.4,16150,164,44,-1433,-1498,20.8,1331.5,9,0,1,5,3,0,1,1,0,0,14748,6.8,17648,170,56,1433,1498,22.6,1474.8
4847784782,0,14,0,0,4,5,5,0,0,0,0,15306,6.8,17036,166,56,-1463,-627,22.2,1530.6,28,1,1,5,4,5,0,0,0,0,16769,6.8,17663,184,52,1463,627,23.6,1676.9
4847730126,1,11,0,0,16,5,17,0,0,0,0,20203,6.6,17233,183,44,6288,3388,22.7,2020.3,7,0,1,5,16,9,1,0,1,0,13915,5.8,13845,105,56,-6288,-3388,16.1,1391.5
4846845166,0,6,1,0,4,7,2,0,0,0,0,14460,6.4,15885,175,48,-1876,-2126,22.3,1446.0,14,0,1,7,4,3,1,1,0,0,16336,7.0,18011,168,68,1876,2126,23.6,1633.6
4846052471,1,21,1,1,7,1,3,0,0,0,0,16645,7.0,18721,207,64,3505,1432,27.1,1664.5,13,0,0,1,7,0,0,0,0,0,13140,6.8,17289,173,52,-3505,-1432,22.5,1314.0
4844998261,0,15,1,1,5,5,5,0,0,0,0,14957,6.6,16952,141,48,-2412,-1124,18.9,1495.7,319,2,0,5,5,4,1,1,0,0,17369,7.2,18076,200,54,2412,1124,25.4,1736.9
4843975299,0,140,7,0,3,5,3,1,1,0,0,13825,6.4,16808,171,44,-1781,-1581,21.5,1382.5,31,0,1,5,3,2,0,0,0,0,15606,7.0,18389,186,52,1781,1581,23.8,1560.6
4842938340,0,15,1,0,4,4,3,0,0,0,0,14771,7.0,17594,191,43,-691,-306,23.4,1477.1,20,0,1,4,4,4,0,0,0,0,15462,7.0,17900,175,60,691,306,23.5,1546.2
4842415917,0,14,1,1,7,5,7,0,0,0,0,15592,6.4,15886,148,52,86,-406,20.0,1559.2,25,0,0,5,7,5,1,1,0,0,15506,6.4,16292,163,40,-86,406,20.3,1550.6
4841193648,0,17,1,0,5,7,6,1,1,0,0,15743,6.4,16309,162,52,-243,54,21.4,1574.3,10,0,1,7,5,9,0,0,0,0,15986,6.6,16255,196,38,243,-54,23.4,1598.6
4840963270,0,11,1,0,0,4,0,0,0,0,0,13341,6.6,17084,161,48,-1761,-610,20.9,1334.1,11,1,1,4,0,3,0,0,0,0,15102,7.0,17694,182,36,1761,610,21.8,1510.2
4847964869,1,0,3,1,27,12,75,0,0,0,0,37868,11.2,41377,113,0,4675,5259,11.3,3786.8,12,0,0,12,27,27,0,0,0,0,33193,10.6,36118,91,0,-4675,-5259,9.1,3319.3
4847931507,0,81,0,0,30,31,70,0,0,0,1,39479,11.6,44190,85,0,-1420,-593,8.5,3947.9,0,0,1,31,30,62,0,0,0,0,40899,11.8,44783,121,0,1420,593,12.1,4089.9
4841418464,1,0,0,1,25,24,79,0,0,0,1,37674,11.2,42644,104,0,2020,1141,10.4,3767.4,7,0,0,24,25,55,0,0,0,0,35654,11.2,41503,82,0,-2020,-1141,8.2,3565.4
4841217456,1,75,1,1,15,17,37,0,0,0,0,34213,10.6,36878,116,0,-80,-831,11.6,3421.3,15,0,0,16,14,42,0,0,0,0,34293,10.8,37709,100,0,80,831,10.0,3429.3
4841189471,1,0,0,0,26,17,71,0,0,0,0,37736,11.2,40683,116,0,1948,1781,11.6,3773.6,0,0,1,17,26,35,0,0,0,0,35788,11.0,38902,97,0,-1948,-1781,9.7,3578.8
4841162470,1,0,0,1,33,26,90,0,0,0,1,41956,12.2,46280,112,0,3797,2341,11.2,4195.6,92,0,0,26,33,59,0,0,0,0,38159,11.6,43939,82,0,-3797,-2341,8.2,3815.9
4841138070,0,0,0,1,34,19,80,0,0,0,0,39353,11.8,44016,109,0,3629,5210,10.9,3935.3,8,0,0,19,34,50,0,0,0,0,35724,10.6,38806,91,0,-3629,-5210,9.1,3572.4
4835988175,0,0,0,0,17,22,42,0,0,0,0,34897,10.6,37274,115,0,-75,-663,11.5,3489.7,0,0,1,22,17,43,0,0,0,0,34972,10.8,37937,99,0,75,663,9.9,3497.2
4835963174,1,0,1,0,18,21,33,0,0,0,0,35023,10.8,37599,97,0,-1101,-3205,9.7,3502.3,13,0,1,21,18,61,0,0,0,0,36124,11.2,40804,85,0,1101,3205,8.5,3612.4
4835930146,1,0,0,1,23,12,70,0,0,0,0,35422,10.8,38827,103,0,1496,2263,10.3,3542.2,8,0,0,12,23,28,0,0,0,0,33926,10.4,36564,100,0,-1496,-2263,10.0,3392.6
4835912960,1,0,0,1,18,12,58,0,0,0,1,37187,11.0,38555,102,0,2582,2408,10.2,3718.7,0,0,0,12,18,35,0,0,0,0,34605,10.4,36147,93,0,-2582,-2408,9.3,3460.5
4835878386,0,0,0,0,19,33,41,0,0,0,1,37748,11.0,40564,102,0,-2906,-3382,10.2,3774.8,0,0,1,33,19,83,0,0,0,0,40654,12.0,43946,106,0,2906,3382,10.6,4065.4
4834049956,1,23,0,0,23,18,71,0,0,0,0,38135,11.6,43418,100,0,4058,6365,10.0,3813.5,0,4,1,18,23,30,0,0,0,0,34077,10.4,37053,85,0,-4058,-6365,8.5,3407.7
4834027807,0,19,19,0,25,29,69,0,0,0,1,38575,11.4,43320,108,0,-1059,-436,10.8,3857.5,22,1,1,29,25,59,0,0,0,0,39634,11.6,43756,103,0,1059,436,10.3,3963.4
4833995790,1,7,0,1,19,19,37,0,0,0,0,35834,11.0,38735,104,0,957,1269,10.4,3583.4,0,0,0,19,19,29,0,0,0,0,34877,10.6,37466,78,0,-957,-1269,7.8,3487.7
4833973074,0,6,0,0,13,23,25,0,0,0,1,32159,10.2,34644,88,0,-4328,-5862,8.8,3215.9,0,3,1,23,13,65,0,0,0,0,36487,11.2,40506,95,0,4328,5862,9.5,3648.7
4833946425,0,0,0,1,29,32,75,0,0,0,2,39908,11.2,42802,99,0,1460,800,9.9,3990.8,0,0,0,32,29,79,0,0,0,0,38448,11.4,42002,87,0,-1460,-800,8.7,3844.8
4833926670,0,0,0,1,14,31,29,0,0,0,1,35854,10.8,38611,90,0,-5167,-5935,9.0,3585.4,75,0,0,31,14,94,0,0,0,0,41021,11.8,44546,103,0,5167,5935,10.3,4102.1
4828848755,1,95,0,1,20,15,59,0,0,0,0,34136,10.8,37630,89,0,-667,409,8.9,3413.6,1,0,0,15,20,43,0,0,0,0,34803,10.8,37221,96,0,667,-409,9.6,3480.3
4828816163,0,1,0,0,22,30,47,0,0,0,1,36570,11.2,40574,105,0,-2693,-3063,10.5,3657.0,0,0,1,30,22,76,0,0,0,0,39263,11.4,43637,104,0,2693,3063,10.4,3926.3
