gameId,blueWins,blueWardsPlaced,blueWardsDestroyed,blueFirstBlood,blueKills,blueDeaths,blueAssists,blueEliteMonsters,blueDragons,blueHeralds,blueTowersDestroyed,blueTotalGold,blueAvgLevel,blueTotalExperience,blueTotalMinionsKilled,blueTotalJungleMinionsKilled,blueGoldDiff,blueExperienceDiff,blueCSPerMin,blueGoldPerMin,redWardsPlaced,redWardsDestroyed,redFirstBlood,redKills,redDeaths,redAssists,redEliteMonsters,redDragons,redHeralds,redTowersDestroyed,redTotalGold,redAvgLevel,redTotalExperience,redTotalMinionsKilled,redTotalJungleMinionsKilled,redGoldDiff,redExperienceDiff,redCSPerMin,redGoldPerMin
4856946700,1,76,2,0,4,7,2,0,0,0,0,16833,6.8,17971,200,52,-860,-1183,25.2,1683.3,32,2,1,7,4,7,1,1,0,0,17693,7.2,19154,207,56,860,1183,26.3,1769.3
4856926921,0,14,0,0,3,5,4,0,0,0,0,15496,6.4,16973,204,60,-957,-719,26.4,1549.6,9,0,1,5,3,6,0,0,0,0,16453,6.8,17692,215,52,957,719,26.7,1645.3
4854833098,0,12,2,0,7,8,6,1,0,1,0,17778,6.8,17562,206,44,286,-104,25.0,1777.8,12,1,1,8,7,4,1,1,0,0,17492,7.0,17666,204,60,-286,104,26.4,1749.2
4854793671,0,15,1,1,4,4,1,0,0,0,0,15366,6.8,18017,218,40,-277,156,25.8,1536.6,7,2,0,4,4,5,0,0,0,0,15643,6.8,17861,193,68,277,-156,26.1,1564.3
4854070870,1,9,1,1,5,6,2,0,0,0,0,16460,6.6,17654,208,40,1281,479,24.8,1646.0,7,0,0,6,5,2,0,0,0,0,15179,6.6,17175,159,40,-1281,-479,19.9,1517.9
4854023319,0,8,0,0,2,4,2,0,0,0,0,12825,6.8,17183,149,36,-3800,-1859,18.5,1282.5,8,0,1,4,2,2,0,0,0,0,16625,7.2,19042,238,50,3800,1859,28.8,1662.5
4853979302,0,10,0,0,3,6,7,1,1,0,0,14225,6.4,16394,191,40,-2460,-1974,23.1,1422.5,9,1,1,6,3,6,0,0,0,0,16685,7.0,18368,201,56,2460,1974,25.7,1668.5
4851451006,0,337,0,0,20,25,37,0,0,0,0,36090,11.0,39665,121,0,-1191,-1525,12.1,3609.0,0,0,1,25,20,58,0,0,0,0,37281,11.0,41190,117,0,1191,1525,11.7,3728.1
4850582496,1,87,0,1,14,15,34,0,0,0,0,33964,10.6,36404,121,0,-978,-91,12.1,3396.4,0,0,0,15,14,39,0,0,0,0,34942,10.6,36495,111,0,978,91,11.1,3494.2
4850569018,0,0,0,0,34,25,100,0,0,0,1,40816,12.0,45707,104,0,2034,2426,10.4,4081.6,3,0,1,25,34,52,0,0,0,0,38782,11.6,43281,110,0,-2034,-2426,11.0,3878.2
4850552147,0,0,0,0,20,26,42,0,0,0,1,35784,10.8,38799,88,0,-4168,-3489,8.8,3578.4,2,0,1,26,20,46,0,0,0,0,39952,11.6,42288,120,0,4168,3489,12.0,3995.2
4850538972,0,45,0,1,35,20,83,0,0,0,1,40762,11.4,43970,117,0,6048,6033,11.7,4076.2,0,3,0,20,35,34,0,0,0,0,34714,10.8,37937,87,0,-6048,-6033,8.7,3471.4
4849936332,0,38,0,1,21,16,46,0,0,0,0,37023,11.2,41320,108,0,2500,4456,10.8,3702.3,0,9,0,16,21,46,0,0,0,0,34523,10.4,36864,118,0,-2500,-4456,11.8,3452.3
4849913941,1,0,0,0,22,18,56,0,0,0,1,35928,11.0,39590,87,0,-816,218,8.7,3592.8,0,0,1,18,22,38,0,0,0,0,36744,11.0,39372,106,0,816,-218,10.6,3674.4
4849682054,1,0,0,0,24,38,55,0,0,0,1,37360,11.0,40726,90,0,-4953,-5864,9.0,3736.0,7,0,1,38,24,75,0,0,0,0,42313,12.0,46590,111,0,4953,5864,11.1,4231.3
4849672747,0,0,0,1,25,30,65,0,0,0,1,38831,11.0,40294,120,0,262,-2028,12.0,3883.1,0,0,0,30,25,67,0,0,0,0,38569,11.4,42322,112,0,-262,2028,11.2,3856.9
4849657940,1,0,0,0,19,16,49,0,0,0,1,38380,11.0,41253,113,0,5405,7418,11.3,3838.0,0,0,1,16,19,46,0,0,0,0,32975,10.0,33835,77,0,-5405,-7418,7.7,3297.5
4848770169,1,10,0,1,10,2,10,0,0,0,0,17635,7.0,17916,191,48,2513,888,23.9,1763.5,64,0,0,2,10,1,0,0,0,0,15122,6.6,17028,178,52,-2513,-888,23.0,1512.2
4848750975,1,9,0,1,7,4,8,0,0,0,0,15780,6.6,17149,175,60,386,136,23.5,1578.0,12,0,0,4,7,4,1,1,0,0,15394,6.8,17013,179,44,-386,-136,22.3,1539.4
4848711680,0,7,1,0,1,8,0,0,0,0,0,13463,6.8,17406,179,56,-5470,-2682,23.5,1346.3,6,0,1,8,1,5,0,0,0,0,18933,7.6,20088,207,68,5470,2682,27.5,1893.3
4856666409,1,19,0,1,22,18,22,0,0,0,0,68312,12.8,61000,6,0,30730,25000,0.6,6831.2,33,0,0,12,16,10,0,0,0,0,37582,7.6,36000,0,0,-30730,-25000,0.0,3758.2
4856663902,1,0,0,1,25,13,23,0,0,0,0,64475,12.0,55000,1,0,29025,22000,0.1,6447.5,8,0,0,4,16,7,0,0,0,0,35450,7.2,33000,0,0,-29025,-22000,0.0,3545.0
4855570271,1,0,0,0,22,21,61,0,0,0,0,35294,10.8,38813,106,0,-1335,-1804,10.6,3529.4,80,0,1,21,22,46,0,0,0,0,36629,11.0,40617,116,0,1335,1804,11.6,3662.9
4855273943,0,17,0,0,31,39,80,0,0,0,1,38665,11.6,43143,104,0,-2514,-2367,10.4,3866.5,0,2,1,39,31,106,0,0,0,0,41179,11.8,45510,123,0,2514,2367,12.3,4117.9
4855104378,1,0,0,0,19,23,47,0,0,0,0,36980,10.8,39063,119,0,36,-2244,11.9,3698.0,0,0,1,23,19,64,0,0,0,0,36944,11.2,41307,121,0,-36,2244,12.1,3694.4
4855070897,0,5,0,1,23,29,47,0,0,0,0,37258,11.4,41175,111,0,-1463,-1133,11.1,3725.8,0,0,0,28,22,81,0,0,0,0,38721,11.4,42308,104,0,1463,1133,10.4,3872.1
4854575362,1,13,0,1,20,23,41,0,0,0,0,35928,11.2,40714,110,0,-1189,-440,11.0,3592.8,0,4,0,23,20,51,0,0,0,0,37117,11.4,41154,109,0,1189,440,10.9,3711.7
4854480825,1,68,0,0,16,19,40,0,0,0,1,34038,10.8,38487,102,0,-2574,87,10.2,3403.8,0,0,1,19,16,53,0,0,0,0,36612,11.0,38400,115,0,2574,-87,11.5,3661.2
4854427687,1,31,0,1,16,21,44,0,0,0,0,35358,10.8,38913,105,0,-997,-94,10.5,3535.8,207,0,0,21,16,48,0,0,0,0,36355,10.8,39007,110,0,997,94,11.0,3635.5
4854335268,1,34,0,0,28,29,64,0,0,0,1,38392,11.6,43614,107,0,402,661,10.7,3839.2,34,0,1,29,28,79,0,0,0,0,37990,11.4,42953,99,0,-402,-661,9.9,3799.0
4854317330,0,74,0,1,22,21,53,0,0,0,1,37559,11.2,41311,114,0,1950,3879,11.4,3755.9,0,0,0,21,22,39,0,0,0,0,35609,10.8,37432,104,0,-1950,-3879,10.4,3560.9
4853366527,1,0,1,0,22,24,53,0,0,0,1,37922,11.4,42331,132,0,338,2822,13.2,3792.2,4,0,1,24,22,55,0,0,0,0,37584,11.0,39509,115,0,-338,-2822,11.5,3758.4
4853298572,1,0,0,1,18,18,15,0,0,0,0,45965,10.0,47500,0,0,18115,19000,0.0,4596.5,0,0,0,10,10,9,0,0,0,0,27850,6.0,28500,0,0,-18115,-19000,0.0,2785.0
4853289632,1,0,1,1,15,14,16,0,0,0,0,45635,10.0,47500,2,0,18110,19000,0.2,4563.5,17,0,0,9,10,8,0,0,0,0,27525,6.0,28500,1,0,-18110,-19000,0.1,2752.5
4853283535,0,0,0,0,24,22,38,0,0,0,0,37084,11.2,41438,100,0,715,301,10.0,3708.4,91,0,1,21,23,45,0,0,0,0,36369,11.2,41137,105,0,-715,-301,10.5,3636.9
4853077878,1,34,0,0,14,21,42,0,0,0,0,34394,10.4,36668,75,0,-792,-2057,7.5,3439.4,34,0,1,21,14,67,0,0,0,0,35186,11.0,38725,61,0,792,2057,6.1,3518.6
4852600870,1,1,0,0,35,31,72,0,0,0,0,40634,11.8,44686,109,0,1477,-940,10.9,4063.4,0,0,1,31,35,66,0,0,0,0,39157,11.8,45626,91,0,-1477,940,9.1,3915.7
4851774864,1,0,0,0,36,28,75,0,0,0,1,41312,12.2,47356,96,0,3885,5075,9.6,4131.2,0,0,1,28,36,65,0,0,0,0,37427,11.6,42281,96,0,-3885,-5075,9.6,3742.7
4851747319,1,99,0,0,21,24,47,0,0,0,0,36325,10.6,39409,77,0,-102,-783,7.7,3632.5,0,0,1,24,21,63,0,0,0,0,36427,11.0,40192,111,0,102,783,11.1,3642.7
4851708077,1,131,0,0,30,29,71,0,0,0,1,40445,11.8,44216,120,0,2327,-1600,12.0,4044.5,0,0,1,29,30,65,0,0,0,0,38118,11.8,45816,77,0,-2327,1600,7.7,3811.8
4782405124,0,8,0,0,2,3,2,0,0,0,0,14619,6.6,16715,198,36,538,-1058,23.4,1461.9,12,0,1,3,2,1,0,0,0,0,14081,6.8,17773,153,72,-538,1058,22.5,1408.1
4782366679,1,12,0,1,7,3,4,0,0,0,0,16537,6.8,17879,186,52,1311,1443,23.8,1653.7,12,1,0,3,7,6,1,1,0,0,15226,6.4,16436,207,44,-1311,-1443,25.1,1522.6
4755203004,1,11,2,1,4,5,3,0,0,0,0,15614,6.8,16989,171,45,-807,-75,21.6,1561.4,16,1,0,5,4,3,0,0,0,0,16421,7.0,17064,165,51,807,75,21.6,1642.1
4749235054,1,7,0,0,18,24,48,0,0,0,0,36189,11.2,41179,107,0,-966,35,10.7,3618.9,0,0,1,24,18,42,0,0,0,0,37155,11.0,41144,85,0,966,-35,8.5,3715.5
4749207058,0,7,3,0,6,8,6,0,0,0,0,15123,6.6,16988,173,52,-4406,-2072,22.5,1512.3,13,0,1,8,6,5,2,1,1,0,19529,7.2,19060,214,51,4406,2072,26.5,1952.9
4749139588,0,90,0,1,20,16,67,0,0,0,0,36779,11.0,38931,88,0,1170,1495,8.8,3677.9,0,0,0,16,20,41,0,0,0,0,35609,10.6,37436,107,0,-1170,-1495,10.7,3560.9
4748915738,0,10,0,0,3,5,0,0,0,0,0,14244,6.8,17702,200,70,-3367,-660,27.0,1424.4,15,1,1,5,3,5,0,0,0,0,17611,7.2,18362,211,57,3367,660,26.8,1761.1
4748888985,0,19,1,0,0,5,0,0,0,0,0,13222,6.4,15973,183,56,-2116,-596,23.9,1322.2,11,1,1,5,0,3,1,1,0,0,15338,6.6,16569,192,44,2116,596,23.6,1533.8
4748875200,0,13,2,1,4,6,5,0,0,0,0,15814,6.6,17105,220,56,-1417,-862,27.6,1581.4,33,3,0,6,4,7,1,1,0,0,17231,7.0,17967,204,53,1417,862,25.7,1723.1
4748855447,1,12,5,0,5,6,9,1,0,1,0,16810,7.0,18199,209,52,-27,-1080,26.1,1681.0,81,5,1,6,5,6,1,1,0,0,16837,7.2,19279,208,67,27,1080,27.5,1683.7
4717033872,0,11,1,0,8,6,5,0,0,0,0,16528,6.8,17163,180,49,-759,-1320,22.9,1652.8,12,3,1,6,8,3,0,0,0,0,17287,7.0,18483,219,54,759,1320,27.3,1728.7
4716982681,1,9,0,0,3,9,2,0,0,0,0,15175,6.6,17537,210,52,-2888,-1001,26.2,1517.5,33,3,1,9,3,6,1,1,0,0,18063,7.0,18538,199,68,2888,1001,26.7,1806.3
4716940668,0,13,3,0,3,9,3,0,0,0,0,15669,6.6,16089,162,48,-2522,-2131,21.0,1566.9,11,4,1,9,3,3,0,0,0,0,18191,7.0,18220,200,60,2522,2131,26.0,1819.1
4716803781,0,12,0,1,6,9,4,0,0,0,0,16096,6.8,18315,237,52,-1484,364,28.9,1609.6,12,1,0,9,6,12,1,1,0,0,17580,7.0,17951,202,64,1484,-364,26.6,1758.0
4714765609,0,15,1,1,5,5,5,0,0,0,0,15495,6.8,16810,201,44,348,8,24.5,1549.5,13,1,0,5,5,5,1,1,0,0,15147,6.6,16802,195,54,-348,-8,24.9,1514.7
4714734871,1,36,1,0,8,4,6,0,0,0,0,17902,6.8,17749,218,39,667,1314,25.7,1790.2,13,12,1,4,8,4,0,0,0,0,17235,6.6,16435,202,52,-667,-1314,25.4,1723.5
4696789653,0,15,0,1,6,2,2,0,0,0,0,15599,7.2,17706,183,56,778,-53,23.9,1559.9,9,1,0,2,6,2,0,0,0,0,14821,6.8,17759,189,50,-778,53,23.9,1482.1
4696733252,1,17,5,1,6,6,7,0,0,0,0,16707,6.8,17354,207,51,-469,-921,25.8,1670.7,16,6,0,6,6,4,1,1,0,0,17176,7.2,18275,216,56,469,921,27.2,1717.6
4696689110,0,7,0,0,2,2,1,0,0,0,0,14261,6.8,17865,198,68,-1732,-1155,26.6,1426.1,12,1,1,2,2,2,1,1,0,0,15993,7.0,19020,225,63,1732,1155,28.8,1599.3
4854822074,1,3,0,1,20,16,12,0,0,0,0,45760,10.0,47500,5,0,17550,19000,0.5,4576.0,14,0,0,8,12,13,0,0,0,0,28210,6.0,28500,0,0,-17550,-19000,0.0,2821.0
4799074972,0,29,0,0,16,26,27,0,0,0,1,35731,11.0,39016,104,0,-2609,-3266,10.4,3573.1,84,3,1,26,16,72,0,0,0,0,38340,11.4,42282,120,0,2609,3266,12.0,3834.0
4799062432,1,0,0,1,24,22,60,0,0,0,2,38134,11.0,39179,130,0,-480,-759,13.0,3813.4,2,0,0,22,24,51,0,0,0,0,38614,11.0,39938,110,0,480,759,11.0,3861.4
4799060742,1,0,0,1,25,25,60,0,0,0,1,38433,11.2,41341,114,0,1494,1334,11.4,3843.3,2,0,0,25,25,61,0,0,0,0,36939,11.0,40007,99,0,-1494,-1334,9.9,3693.9
4799042376,0,14,0,0,18,20,46,0,0,0,0,33704,10.6,36632,93,0,-4417,-3564,9.3,3370.4,3,2,1,20,18,58,0,0,0,0,38121,11.0,40196,121,0,4417,3564,12.1,3812.1
4799025886,0,0,0,1,19,25,50,0,0,0,0,36713,11.0,38747,88,0,-2965,-3362,8.8,3671.3,0,0,0,25,19,71,0,0,0,0,39678,11.6,42109,122,0,2965,3362,12.2,3967.8
4799008062,1,0,14,1,22,16,48,0,0,0,0,36430,10.8,38587,120,0,1234,-18,12.0,3643.0,94,0,0,16,22,29,0,0,0,0,35196,11.0,38605,117,0,-1234,18,11.7,3519.6
4798983350,1,14,0,1,27,21,65,0,0,0,1,37673,11.0,39836,115,0,812,-983,11.5,3767.3,0,3,0,21,27,43,0,0,0,0,36861,11.4,40819,104,0,-812,983,10.4,3686.1
4798972077,1,0,0,1,30,19,79,0,0,0,0,40374,11.8,44776,86,0,2798,4442,8.6,4037.4,216,0,0,19,30,55,0,0,0,0,37576,11.2,40334,109,0,-2798,-4442,10.9,3757.6
4798957368,1,0,5,1,30,9,85,0,0,0,1,38166,11.2,40767,102,0,6234,7777,10.2,3816.6,9,0,0,9,30,19,0,0,0,0,31932,10.0,32990,98,0,-6234,-7777,9.8,3193.2
4798929692,0,19,0,1,13,12,41,0,0,0,1,33219,10.4,36716,79,0,-1722,949,7.9,3321.9,0,0,0,12,13,30,0,0,0,0,34941,10.4,35767,113,0,1722,-949,11.3,3494.1
4798901264,1,335,0,1,27,21,76,0,0,0,1,37462,11.4,41158,114,0,-144,-1461,11.4,3746.2,3,0,0,21,27,55,0,0,0,0,37606,11.4,42619,120,0,144,1461,12.0,3760.6
4798876261,0,1,0,0,19,30,36,0,0,0,2,36410,11.0,39484,74,0,-4291,-4728,7.4,3641.0,0,0,1,30,19,82,0,0,0,0,40701,12.0,44212,109,0,4291,4728,10.9,4070.1
4798840100,1,0,0,0,13,12,41,0,0,0,0,33585,10.4,35225,106,0,289,401,10.6,3358.5,0,0,1,12,13,33,0,0,0,0,33296,10.2,34824,87,0,-289,-401,8.7,3329.6
4796046432,1,13,1,1,3,5,2,0,0,0,0,14630,6.8,16748,185,52,-2185,-1732,23.7,1463.0,16,4,0,5,3,4,0,0,0,0,16815,7.2,18480,189,52,2185,1732,24.1,1681.5
4796002544,0,12,1,1,5,1,3,0,0,0,0,15958,7.2,18998,221,60,2597,1904,28.1,1595.8,10,0,0,1,5,1,0,0,0,0,13361,6.6,17094,177,60,-2597,-1904,23.7,1336.1
4795946692,1,15,0,1,4,6,5,0,0,0,0,15228,7.0,17361,190,60,-198,616,25.0,1522.8,7,1,0,6,4,6,0,0,0,0,15426,6.6,16745,165,48,198,-616,21.3,1542.6
4795916003,0,14,0,1,8,7,5,1,1,0,0,16052,6.6,16256,162,48,1004,220,21.0,1605.2,150,2,0,7,8,5,0,0,0,0,15048,6.2,16036,151,52,-1004,-220,20.3,1504.8
4795883384,0,10,1,0,1,8,1,0,0,0,0,13357,6.2,15414,145,44,-3143,-1464,18.9,1335.7,10,0,1,8,1,9,0,0,0,0,16500,6.6,16878,159,52,3143,1464,21.1,1650.0
4852419617,0,12,0,1,4,9,3,0,0,0,0,13820,6.2,15115,197,0,-3821,-4711,19.7,1382.0,29,0,0,8,3,3,2,1,1,0,17641,7.4,19826,231,63,3821,4711,29.4,1764.1
4852397548,1,13,1,1,6,2,5,0,0,0,0,16820,7.2,18446,230,60,2145,-318,29.0,1682.0,8,1,0,2,6,2,0,0,0,0,14675,7.2,18764,197,68,-2145,318,26.5,1467.5
4852350856,1,15,1,0,6,7,6,0,0,0,0,17149,7.0,17643,202,42,664,765,24.4,1714.9,78,3,1,7,6,3,0,0,0,0,16485,6.6,16878,185,56,-664,-765,24.1,1648.5
4852329752,1,20,1,0,3,3,1,1,1,0,0,14727,7.0,17970,200,65,-774,-686,26.5,1472.7,13,2,1,3,3,0,0,0,0,0,15501,7.0,18656,217,60,774,686,27.7,1550.1
4852287192,1,12,3,1,1,3,1,0,0,0,0,14246,6.6,16302,175,43,-1740,-1884,21.8,1424.6,10,3,0,3,1,3,0,0,0,0,15986,7.0,18186,221,46,1740,1884,26.7,1598.6
4852268226,1,100,2,1,7,1,5,0,0,0,0,17458,6.8,18042,216,52,3819,667,26.8,1745.8,13,15,0,1,7,0,0,0,0,0,13639,6.8,17375,172,66,-3819,-667,23.8,1363.9
4849621637,1,13,1,1,4,0,7,1,1,0,0,15981,7.0,18235,202,48,1968,600,25.0,1598.1,16,0,0,0,4,0,1,0,1,0,14013,6.8,17635,191,56,-1968,-600,24.7,1401.3
4849596652,0,19,12,0,3,5,3,0,0,0,0,15108,7.0,17761,177,68,-1711,-1500,24.5,1510.8,87,3,1,5,3,3,1,1,0,0,16819,7.2,19261,242,68,1711,1500,31.0,1681.9
4849468784,0,66,1,0,1,6,1,0,0,0,0,14315,6.8,17167,166,68,-2014,-746,23.4,1431.5,14,1,1,6,1,3,1,1,0,0,16329,6.8,17913,205,52,2014,746,25.7,1632.9
4849450379,1,14,1,1,8,3,6,0,0,0,0,16873,7.0,17161,204,48,2230,-902,25.2,1687.3,24,0,0,3,8,1,0,0,0,0,14643,7.0,18063,169,68,-2230,902,23.7,1464.3
4848726325,1,23,0,1,4,2,5,1,0,1,0,15390,6.8,16679,191,57,1778,-706,24.8,1539.0,13,0,0,2,4,3,1,1,0,0,13612,7.0,17385,168,44,-1778,706,21.2,1361.2
4848694701,1,17,1,0,2,2,2,0,0,0,0,14873,6.6,16914,191,40,-408,-651,23.1,1487.3,97,1,1,2,2,3,0,0,0,0,15281,7.0,17565,207,48,408,651,25.5,1528.1
4845543881,1,125,1,1,5,2,6,1,1,0,0,15990,7.2,18322,160,68,1638,1632,22.8,1599.0,206,1,0,2,5,1,0,0,0,0,14352,6.4,16690,186,64,-1638,-1632,25.0,1435.2
4844899891,1,8,0,1,3,1,3,0,0,0,0,15819,6.8,18344,188,56,2150,1766,24.4,1581.9,12,1,0,1,3,1,0,0,0,0,13669,6.6,16578,198,48,-2150,-1766,24.6,1366.9
4844802941,0,8,1,0,2,6,0,0,0,0,0,14371,6.6,15783,173,64,-1904,-2019,23.7,1437.1,10,2,1,6,2,4,1,1,0,0,16275,6.8,17802,212,56,1904,2019,26.8,1627.5
4844780201,0,11,1,0,2,5,3,1,0,1,0,14538,6.8,18180,204,48,-1745,76,25.2,1453.8,15,1,1,5,2,5,0,0,0,0,16283,6.8,18104,244,48,1745,-76,29.2,1628.3
4844756864,1,14,0,1,5,7,6,0,0,0,0,17900,7.2,18379,242,52,1113,1481,29.4,1790.0,13,3,0,7,5,7,0,0,0,0,16787,6.6,16898,213,46,-1113,-1481,25.9,1678.7
4844633178,1,12,2,0,0,3,0,1,1,0,0,13997,6.8,17419,211,48,-962,-382,25.9,1399.7,13,2,1,3,0,1,0,0,0,0,14959,6.8,17801,222,56,962,382,27.8,1495.9
4844628815,0,12,0,0,3,9,0,0,0,0,0,14160,6.8,17140,177,60,-4756,-2916,23.7,1416.0,12,2,1,9,3,4,1,1,0,0,18916,7.4,20056,211,64,4756,2916,27.5,1891.6
4855801503,1,7,2,1,16,17,14,0,0,0,0,45980,10.0,47500,3,0,18830,19000,0.3,4598.0,35,0,0,8,7,10,0,0,0,0,27150,6.0,28500,0,0,-18830,-19000,0.0,2715.0
4849725353,1,1,0,1,36,25,76,0,0,0,1,40995,12.0,46498,90,0,3907,4878,9.0,4099.5,3,0,0,25,36,79,0,0,0,0,37088,11.2,41620,80,0,-3907,-4878,8.0,3708.8
4848875364,0,0,0,1,28,28,65,0,0,0,1,40400,11.6,43280,105,0,2985,1160,10.5,4040.0,14,0,0,28,28,75,0,0,0,0,37415,11.2,42120,93,0,-2985,-1160,9.3,3741.5
4848538475,0,0,0,1,26,30,77,0,0,0,1,37907,11.4,42309,89,0,-1603,1741,8.9,3790.7,3,0,0,30,26,82,0,0,0,0,39510,11.2,40568,92,0,1603,-1741,9.2,3951.0
4848515168,1,0,0,1,28,17,90,0,0,0,0,36965,11.0,40558,99,0,1538,2964,9.9,3696.5,7,0,0,17,28,46,0,0,0,0,35427,10.6,37594,106,0,-1538,-2964,10.6,3542.7
4848028659,0,0,0,1,39,29,112,0,0,0,1,42450,11.8,45655,122,0,3802,1025,12.2,4245.0,0,0,0,29,39,70,0,0,0,0,38648,11.6,44630,101,0,-3802,-1025,10.1,3864.8
4848010481,0,0,0,1,17,25,56,0,0,0,0,34459,10.4,36011,108,0,-3986,-5667,10.8,3445.9,0,0,0,25,17,66,0,0,0,0,38445,11.2,41678,116,0,3986,5667,11.6,3844.5
4847057616,1,10,1,0,6,2,11,1,1,0,0,16545,7.0,17689,209,56,1969,1533,26.5,1654.5,10,1,1,2,6,1,0,0,0,0,14576,6.4,16156,201,44,-1969,-1533,24.5,1457.6
4843067774,0,0,0,1,34,34,84,0,0,0,0,40495,12.2,46071,116,0,266,1239,11.6,4049.5,0,0,0,34,34,78,0,0,0,0,40229,11.8,44832,95,0,-266,-1239,9.5,4022.9
4842548886,1,0,0,1,27,26,51,0,0,0,1,37659,11.4,41646,111,0,-368,-1327,11.1,3765.9,0,0,0,26,27,62,0,0,0,0,38027,11.6,42973,90,0,368,1327,9.0,3802.7
4840443047,0,10,0,0,22,17,55,0,0,0,0,31352,10.8,36518,56,45,-2863,-2509,10.1,3135.2,11,0,1,16,21,26,0,0,0,0,34215,11.2,39027,67,53,2863,2509,12.0,3421.5
4840419643,1,18,0,0,16,20,28,0,0,0,0,33632,10.6,37780,79,63,5467,3782,14.2,3363.2,9,0,1,20,16,38,0,0,0,0,28165,10.2,33998,57,39,-5467,-3782,9.6,2816.5
4840406953,1,6,1,1,31,5,58,0,0,0,0,38294,11.2,41926,63,68,8045,9438,13.1,3829.4,12,0,0,5,31,8,0,0,0,0,30249,10.0,32488,86,50,-8045,-9438,13.6,3024.9
4839377019,1,12,0,0,18,7,39,0,0,0,0,33984,11.2,40922,63,62,1578,4586,12.5,3398.4,12,0,1,7,18,10,0,0,0,0,32406,10.8,36336,63,72,-1578,-4586,13.5,3240.6
4838734087,1,12,0,1,19,8,33,0,0,0,0,37273,11.0,41042,110,52,9142,8100,16.2,3727.3,11,0,0,8,19,15,0,0,0,0,28131,10.2,32942,81,43,-9142,-8100,12.4,2813.1
4837933977,0,12,0,0,5,12,6,0,0,0,1,25868,9.6,31834,62,35,-6299,-6325,9.7,2586.8,27,1,1,11,4,31,0,0,0,0,32167,10.6,38159,69,61,6299,6325,13.0,3216.7
4837890651,1,32,0,1,26,16,60,0,0,0,3,38969,10.8,38507,76,48,2089,-2637,12.4,3896.9,11,0,0,16,26,28,0,0,0,0,36880,11.2,41144,79,38,-2089,2637,11.7,3688.0
4837883789,1,21,0,0,28,12,66,0,0,0,0,41063,11.8,42776,60,68,4608,2524,12.8,4106.3,10,0,1,12,28,20,0,0,0,0,36455,11.2,40252,73,53,-4608,-2524,12.6,3645.5
4837688956,1,17,0,1,19,18,35,0,0,0,0,39086,11.2,40370,76,55,6644,3065,13.1,3908.6,13,0,0,18,19,24,0,0,0,0,32442,10.8,37305,79,63,-6644,-3065,14.2,3244.2
4837592751,1,24,0,0,14,9,20,0,0,0,0,31046,10.2,35954,66,55,-1565,-1188,12.1,3104.6,18,1,1,9,14,11,0,0,0,0,32611,10.8,37142,99,59,1565,1188,15.8,3261.1
4856468372,1,19,2,1,8,9,8,1,1,0,0,16386,6.6,17012,175,44,-2726,-1347,21.9,1638.6,11,1,0,9,8,9,0,0,0,0,19112,7.0,18359,208,52,2726,1347,26.0,1911.2
4856426602,1,18,0,0,24,24,60,0,0,0,0,36905,11.0,39934,114,0,-1541,-1042,11.4,3690.5,0,0,1,24,24,58,0,0,0,0,38446,11.2,40976,111,0,1541,1042,11.1,3844.6
4856409017,0,0,0,0,27,26,64,0,0,0,0,36479,11.0,39558,100,0,-847,-1416,10.0,3647.9,77,0,1,25,26,62,0,0,0,0,37326,11.4,40974,107,0,847,1416,10.7,3732.6
4856354059,0,12,0,0,2,6,1,0,0,0,0,14077,6.6,16877,199,52,-2351,-2076,25.1,1407.7,10,0,1,6,2,4,0,0,0,0,16428,7.2,18953,188,60,2351,2076,24.8,1642.8
4855395344,1,1,0,1,28,28,74,0,0,0,1,38342,11.2,40879,122,0,1402,-1143,12.2,3834.2,38,0,0,27,27,78,0,0,0,0,36940,11.2,42022,96,0,-1402,1143,9.6,3694.0
4855379788,1,7,0,1,20,23,54,0,0,0,1,36282,11.0,38646,96,0,744,-1105,9.6,3628.2,0,0,0,23,20,56,0,0,0,0,35538,11.0,39751,91,0,-744,1105,9.1,3553.8
4855327098,1,10,0,1,2,6,2,0,0,0,0,15033,6.6,16906,165,44,-1735,-1284,20.9,1503.3,20,1,0,6,2,2,0,0,0,0,16768,6.8,18190,208,60,1735,1284,26.8,1676.8
4855299827,0,13,0,0,4,8,4,0,0,0,0,16634,6.8,17906,167,51,-1387,125,21.8,1663.4,11,0,1,8,4,7,0,0,0,0,18021,7.0,17781,180,40,1387,-125,22.0,1802.1
4855219165,0,10,1,1,5,2,4,0,0,0,0,16389,7.2,18238,191,67,2384,805,25.8,1638.9,13,0,0,2,5,3,0,0,0,0,14005,6.8,17433,182,57,-2384,-805,23.9,1400.5
4855186316,0,95,1,1,3,7,2,0,0,0,0,14688,6.6,16210,188,47,-1771,-1660,23.5,1468.8,29,1,0,7,3,5,0,0,0,0,16459,7.0,17870,156,64,1771,1660,22.0,1645.9
4855124137,1,12,0,0,1,1,0,0,0,0,0,14816,7.4,19641,224,72,333,2261,29.6,1481.6,76,0,1,1,1,0,1,1,0,0,14483,6.8,17380,215,56,-333,-2261,27.1,1448.3
4853036377,1,14,0,0,19,17,64,0,0,0,0,36415,11.0,40632,96,0,2840,5232,9.6,3641.5,1,3,1,17,19,39,0,0,0,0,33575,10.2,35400,92,0,-2840,-5232,9.2,3357.5
4853018962,1,13,0,1,26,16,61,0,0,0,1,38184,11.6,42395,105,0,4257,6731,10.5,3818.4,0,0,0,16,26,38,0,0,0,0,33927,10.4,35664,89,0,-4257,-6731,8.9,3392.7
4852952076,0,13,2,1,7,2,6,0,0,0,0,17707,7.2,18557,212,48,2901,413,26.0,1770.7,15,0,0,2,7,1,0,0,0,0,14806,6.6,18144,201,58,-2901,-413,25.9,1480.6
4852373822,1,79,0,0,13,16,31,0,0,0,0,35371,10.6,36926,106,0,-723,-2764,10.6,3537.1,0,0,1,16,13,41,0,0,0,0,36094,11.0,39690,114,0,723,2764,11.4,3609.4
4852352033,1,0,0,1,22,23,70,0,0,0,0,37855,11.4,42430,102,0,1970,3404,10.2,3785.5,0,0,0,23,22,67,0,0,0,0,35885,10.8,39026,83,0,-1970,-3404,8.3,3588.5
4851972486,0,0,0,0,18,24,41,0,0,0,1,34667,10.8,38430,83,0,-2315,-2812,8.3,3466.7,0,0,1,24,18,62,0,0,0,0,36982,11.2,41242,108,0,2315,2812,10.8,3698.2
4851962808,1,28,0,1,25,11,42,0,0,0,1,37852,11.2,41286,120,0,4866,5847,12.0,3785.2,0,11,0,11,25,24,0,0,0,0,32986,10.2,35439,107,0,-4866,-5847,10.7,3298.6
4849759486,0,14,0,0,5,6,3,0,0,0,0,16196,7.0,17586,189,60,-1089,-885,24.9,1619.6,12,3,1,6,5,7,1,1,0,0,17285,7.0,18471,195,60,1089,885,25.5,1728.5
4794174092,0,14,3,0,4,6,5,1,0,1,0,16235,6.8,17389,227,52,-336,545,27.9,1623.5,13,2,1,6,4,9,1,1,0,0,16571,6.6,16844,201,66,336,-545,26.7,1657.1
4794143547,0,9,4,0,5,12,5,0,0,0,0,15184,6.6,16246,183,44,-3530,-2133,22.7,1518.4,28,3,1,12,5,10,1,1,0,0,18714,7.0,18379,196,59,3530,2133,25.5,1871.4
4785273067,1,15,1,1,5,7,8,0,0,0,0,15597,6.6,16525,180,55,-1468,-1522,23.5,1559.7,17,2,0,7,5,5,1,1,0,0,17065,6.8,18047,228,52,1468,1522,28.0,1706.5
4785230172,0,12,5,0,9,15,10,0,0,0,0,18494,6.8,17499,218,44,-1409,53,26.2,1849.4,18,4,1,15,9,25,1,1,0,0,19903,6.8,17446,203,52,1409,-53,25.5,1990.3
4785133870,1,19,1,0,5,9,7,0,0,0,0,16003,7.0,17564,208,64,-2230,-957,27.2,1600.3,16,4,1,9,5,9,0,0,0,0,18233,7.2,18521,225,48,2230,957,27.3,1823.3
4781642707,0,12,20,0,3,10,0,0,0,0,0,15345,7.0,18128,206,64,-2440,31,27.0,1534.5,34,2,1,9,2,12,0,0,0,0,17785,7.0,18097,200,36,2440,-31,23.6,1778.5
4781603436,0,10,0,0,1,2,1,0,0,0,0,14280,7.0,18648,205,52,-2046,-292,25.7,1428.0,11,1,1,2,1,6,1,1,0,0,16326,7.2,18940,241,76,2046,292,31.7,1632.6
4781532511,1,52,2,0,3,6,2,0,0,0,0,15856,6.8,18485,192,64,-790,2194,25.6,1585.6,15,0,1,6,3,4,0,0,0,0,16646,6.6,16291,215,48,790,-2194,26.3,1664.6
4781508122,0,19,0,1,6,7,4,1,1,0,0,16150,7.0,17719,176,60,-593,-326,23.6,1615.0,9,1,0,7,6,5,0,0,0,0,16743,7.2,18045,201,56,593,326,25.7,1674.3
4781454357,1,21,0,0,4,3,3,0,0,0,0,16536,6.8,18253,218,55,1835,1463,27.3,1653.6,12,0,1,3,4,2,0,0,0,0,14701,6.6,16790,201,48,-1835,-1463,24.9,1470.1
4781423200,1,38,5,1,8,4,6,1,1,0,0,18342,7.2,19313,228,60,3218,2554,28.8,1834.2,13,9,0,4,8,3,0,0,0,0,15124,6.4,16759,213,56,-3218,-2554,26.9,1512.4
4775317296,0,84,2,1,6,7,2,0,0,0,0,14674,6.6,15811,154,57,-2376,-1947,21.1,1467.4,15,2,0,6,5,8,0,0,0,0,17050,7.0,17758,218,52,2376,1947,27.0,1705.0
4775277303,1,9,0,1,15,3,19,1,1,0,0,20278,7.2,18428,208,60,5272,2619,26.8,2027.8,21,0,0,3,15,1,0,0,0,0,15006,6.4,15809,148,44,-5272,-2619,19.2,1500.6
4775240522,1,15,0,1,8,0,10,1,1,0,0,17386,6.0,15195,171,52,3506,-1820,22.3,1738.6,10,2,0,0,8,0,0,0,0,0,13880,6.4,17015,229,60,-3506,1820,28.9,1388.0
4775198021,1,13,0,1,10,8,11,1,1,0,0,18196,6.6,16551,180,58,33,-1888,23.8,1819.6,10,0,0,8,10,8,0,0,0,0,18163,7.2,18439,197,46,-33,1888,24.3,1816.3
4590161014,1,0,2,1,36,33,79,0,0,0,1,42955,11.8,46153,122,0,5436,3171,12.2,4295.5,14,0,0,33,36,87,0,0,0,0,37519,11.6,42982,93,0,-5436,-3171,9.3,3751.9
4569722143,0,189,1,1,7,7,5,0,0,0,0,16318,6.8,17234,161,42,448,-220,20.3,1631.8,9,1,0,7,7,6,1,1,0,0,15870,6.6,17454,203,44,-448,220,24.7,1587.0
4569696768,1,10,6,1,4,4,7,1,0,1,0,15315,6.8,17505,195,52,-1157,-609,24.7,1531.5,16,0,0,4,4,4,1,1,0,0,16472,6.8,18114,214,68,1157,609,28.2,1647.2
4855856512,1,10,2,1,19,10,19,0,0,0,0,20971,7.0,18128,182,51,3466,675,23.3,2097.1,12,1,0,9,18,7,0,0,0,0,17505,6.6,17453,199,35,-3466,-675,23.4,1750.5
4855192927,0,12,1,0,8,3,8,1,1,0,0,17322,6.8,18501,205,52,2066,1008,25.7,1732.2,9,0,1,3,8,2,0,0,0,0,15256,6.8,17493,225,44,-2066,-1008,26.9,1525.6
4854724199,0,14,0,0,6,8,4,1,1,0,0,17290,7.0,17891,208,60,722,519,26.8,1729.0,10,2,1,8,6,7,0,0,0,0,16568,7.0,17372,207,52,-722,-519,25.9,1656.8
4854607830,0,12,2,0,7,10,8,0,0,0,0,17218,6.8,16926,187,40,-2747,-576,22.7,1721.8,12,1,1,10,7,9,1,1,0,0,19965,6.6,17502,190,60,2747,576,25.0,1996.5
4848383208,1,14,0,1,9,9,7,1,1,0,0,18153,7.0,17546,184,53,-1408,-1550,23.7,1815.3,8,0,0,9,9,6,0,0,0,0,19561,7.2,19096,210,48,1408,1550,25.8,1956.1
4847884647,0,11,2,1,8,5,7,0,0,0,0,17400,6.8,18267,207,61,1390,98,26.8,1740.0,15,0,0,5,8,6,1,1,0,0,16010,7.0,18169,210,67,-1390,-98,27.7,1601.0
4839741687,1,14,2,0,9,4,4,0,0,0,0,16885,6.8,17865,192,48,-190,-646,24.0,1688.5,68,1,1,4,9,5,0,0,0,0,17075,7.0,18511,198,67,190,646,26.5,1707.5
4839582174,1,10,2,1,4,4,0,0,0,0,0,16717,7.0,18205,225,60,1354,429,28.5,1671.7,24,1,0,4,4,4,0,0,0,0,15363,6.8,17776,197,52,-1354,-429,24.9,1536.3
4839107747,1,13,1,0,6,4,4,1,1,0,0,16858,6.8,17379,204,52,1916,460,25.6,1685.8,12,2,1,4,6,6,0,0,0,0,14942,6.8,16919,190,36,-1916,-460,22.6,1494.2
4839009927,1,14,1,0,5,9,6,0,0,0,0,17140,6.8,18018,208,52,-632,948,26.0,1714.0,16,2,1,9,5,9,1,1,0,0,17772,6.8,17070,191,40,632,-948,23.1,1777.2
4838935865,0,15,2,1,4,3,4,0,0,0,0,15724,6.8,17133,211,44,-560,-1945,25.5,1572.4,19,1,0,3,4,4,0,0,0,0,16284,7.2,19078,242,60,560,1945,30.2,1628.4
4838850755,0,12,1,1,5,3,5,1,1,0,0,15708,6.8,17443,206,52,436,-36,25.8,1570.8,9,1,0,3,5,4,0,0,0,0,15272,6.8,17479,189,48,-436,36,23.7,1527.2
4838682281,1,7,4,1,3,2,4,1,1,0,0,16203,7.0,18574,242,60,169,-374,30.2,1620.3,12,1,0,2,3,2,0,0,0,0,16034,7.2,18948,231,56,-169,374,28.7,1603.4
4838603810,0,9,0,1,5,8,6,0,0,0,0,16721,6.6,16946,242,40,-675,-1440,28.2,1672.1,10,1,0,8,5,8,1,1,0,0,17396,7.0,18386,169,64,675,1440,23.3,1739.6
4837703627,0,10,2,1,5,4,7,0,0,0,0,15243,6.2,15440,238,4,-531,-2624,24.2,1524.3,13,1,0,4,5,3,1,1,0,0,15774,6.8,18064,221,71,531,2624,29.2,1577.4
4836698198,1,4,2,1,5,6,2,0,0,0,0,15634,6.8,17024,187,56,-884,-630,24.3,1563.4,15,0,0,6,5,4,0,0,0,0,16518,7.0,17654,187,52,884,630,23.9,1651.8
4835926342,0,10,1,1,7,5,7,0,0,0,0,17062,6.8,17565,207,47,1247,73,25.4,1706.2,16,0,0,5,7,5,0,0,0,0,15815,6.8,17492,190,40,-1247,-73,23.0,1581.5
4834466669,0,11,0,0,2,6,1,0,0,0,0,14645,6.6,17289,207,56,-2436,-1390,26.3,1464.5,16,0,1,6,2,5,0,0,0,0,17081,7.0,18679,187,60,2436,1390,24.7,1708.1
4834447368,1,10,2,0,3,4,2,0,0,0,0,15151,7.0,17992,215,44,-1308,-1147,25.9,1515.1,27,0,1,4,3,3,0,0,0,0,16459,7.2,19139,235,64,1308,1147,29.9,1645.9
4844170879,0,11,3,0,6,5,6,1,1,0,0,17048,7.2,19314,212,41,1231,2936,25.3,1704.8,109,0,1,5,6,4,0,0,0,0,15817,6.4,16378,181,51,-1231,-2936,23.2,1581.7
4844104226,0,112,4,1,3,6,2,0,0,0,0,16491,6.8,18270,234,44,675,494,27.8,1649.1,82,0,0,6,3,7,0,0,0,0,15816,6.8,17776,176,56,-675,-494,23.2,1581.6
4837824126,1,10,0,1,7,6,11,0,0,0,0,17012,6.4,16221,182,48,-190,-918,23.0,1701.2,12,2,0,6,7,8,1,0,1,0,17202,6.8,17139,230,52,190,918,28.2,1720.2
4820476254,1,12,0,0,5,5,2,2,1,1,0,15458,6.6,16867,189,52,-438,374,24.1,1545.8,15,1,1,5,5,9,0,0,0,0,15896,6.4,16493,209,32,438,-374,24.1,1589.6
4820444567,0,11,1,0,6,5,2,1,1,0,0,16737,7.0,18328,235,48,814,676,28.3,1673.7,15,1,1,5,6,3,0,0,0,0,15923,7.0,17652,203,60,-814,-676,26.3,1592.3
4820431981,0,15,2,1,9,6,9,0,0,0,0,17057,6.8,17176,206,44,-577,-935,25.0,1705.7,12,1,0,5,8,4,1,1,0,0,17634,6.8,18111,203,48,577,935,25.1,1763.4
4820399688,1,13,0,0,1,2,0,0,0,0,0,14443,6.8,18103,189,64,-555,469,25.3,1444.3,13,2,1,2,1,3,0,0,0,0,14998,6.8,17634,254,44,555,-469,29.8,1499.8
4820375248,0,32,0,0,5,6,6,0,0,0,0,15587,6.6,17305,199,48,-2905,-1796,24.7,1558.7,15,5,1,6,5,6,0,0,0,0,18492,7.2,19101,223,64,2905,1796,28.7,1849.2
4811523084,0,12,17,1,5,2,6,0,0,0,0,15796,6.8,17060,160,40,722,-543,20.0,1579.6,40,0,0,2,5,1,0,0,0,0,15074,6.8,17603,213,60,-722,543,27.3,1507.4
4811467618,0,12,0,1,4,4,2,0,0,0,0,15136,6.6,17276,198,64,-22,602,26.2,1513.6,12,0,0,4,4,2,0,0,0,0,15158,6.4,16674,201,40,22,-602,24.1,1515.8
4810877944,0,13,1,1,4,9,4,1,1,0,0,15887,6.8,17382,173,55,-744,361,22.8,1588.7,14,1,0,9,4,4,0,0,0,0,16631,6.4,17021,205,48,744,-361,25.3,1663.1
4810845430,0,14,2,0,8,11,6,0,0,0,0,18063,7.0,17795,202,48,46,177,25.0,1806.3,17,1,1,11,8,8,0,0,0,0,18017,7.0,17618,168,54,-46,-177,22.2,1801.7
4810113398,0,14,2,1,6,6,3,0,0,0,0,17168,7.0,18445,220,56,1676,1234,27.6,1716.8,12,0,0,6,6,5,1,0,1,0,15492,6.8,17211,181,52,-1676,-1234,23.3,1549.2
4810078755,1,9,0,0,10,7,14,0,0,0,0,18220,7.2,18093,183,48,151,-92,23.1,1822.0,76,0,1,7,10,7,0,0,0,0,18069,7.0,18185,218,56,-151,92,27.4,1806.9
4810053492,1,12,5,1,5,0,4,1,1,0,0,16832,7.0,18626,210,52,3997,1974,26.2,1683.2,11,3,0,0,5,0,0,0,0,0,12835,6.8,16652,182,48,-3997,-1974,23.0,1283.5
4810032102,0,15,0,1,6,6,7,0,0,0,0,16422,6.8,17713,197,36,-1654,-1714,23.3,1642.2,16,3,0,6,6,5,0,0,0,0,18076,7.2,19427,211,72,1654,1714,28.3,1807.6
4809994499,0,11,0,1,4,1,0,0,0,0,0,15421,7.0,17901,201,54,991,-41,25.5,1542.1,12,1,0,1,4,0,2,1,1,0,14430,6.8,17942,214,60,-991,41,27.4,1443.0
4809964956,0,15,1,1,7,3,8,0,0,0,0,17726,7.0,18814,225,56,2920,440,28.1,1772.6,14,1,0,3,7,0,0,0,0,0,14806,7.0,18374,196,60,-2920,-440,25.6,1480.6
4809950747,0,10,2,1,7,5,1,0,0,0,0,16645,7.2,18315,223,56,892,1958,27.9,1664.5,14,1,0,5,7,2,0,0,0,0,15753,6.4,16357,199,48,-892,-1958,24.7,1575.3
4809919164,1,18,2,0,13,6,12,2,1,1,0,19139,6.6,16704,167,56,3231,415,22.3,1913.9,18,1,1,6,13,6,0,0,0,0,15908,6.4,16289,175,56,-3231,-415,23.1,1590.8
4806736775,0,106,0,1,3,6,3,0,0,0,0,14317,6.6,16551,170,40,-1307,-522,21.0,1431.7,73,2,0,6,3,2,0,0,0,0,15624,7.0,17073,173,48,1307,522,22.1,1562.4
4806712681,0,9,0,0,3,4,1,0,0,0,0,13959,6.6,16631,132,56,-3021,-652,18.8,1395.9,8,0,1,4,3,4,0,0,0,0,16980,6.6,17283,201,60,3021,652,26.1,1698.0
4806701642,0,0,0,1,24,19,58,0,0,0,1,37455,11.2,41245,99,0,672,1762,9.9,3745.5,0,0,0,19,24,46,0,0,0,0,36783,11.0,39483,105,0,-672,-1762,10.5,3678.3
4804760119,0,0,0,1,28,34,73,0,0,0,1,39600,11.6,43248,93,0,-1878,-2929,9.3,3960.0,0,0,0,34,28,99,0,0,0,0,41478,11.8,46177,109,0,1878,2929,10.9,4147.8
4804725117,0,290,0,1,27,17,75,0,0,0,2,38389,11.2,41961,115,0,2553,3091,11.5,3838.9,0,3,0,17,27,48,0,0,0,0,35836,10.6,38870,116,0,-2553,-3091,11.6,3583.6
4804714785,0,0,0,0,24,34,68,0,0,0,1,37204,11.4,41036,94,0,-3264,-4253,9.4,3720.4,0,0,1,34,24,96,0,0,0,0,40468,12.0,45289,103,0,3264,4253,10.3,4046.8
4803319407,1,0,0,1,25,23,62,0,0,0,0,36047,11.0,39309,113,0,-1741,-177,11.3,3604.7,11,0,0,23,25,60,0,0,0,0,37788,11.0,39486,104,0,1741,177,10.4,3778.8
4802987782,0,0,0,0,21,28,44,0,0,0,0,37626,11.0,39292,108,0,-250,-2972,10.8,3762.6,0,0,1,28,21,61,0,0,0,0,37876,11.2,42264,100,0,250,2972,10.0,3787.6
4802967072,1,0,0,0,18,20,51,0,0,0,1,36235,10.8,38097,115,0,-247,-508,11.5,3623.5,0,0,1,20,18,55,0,0,0,0,36482,11.0,38605,102,0,247,508,10.2,3648.2
4802958808,0,0,0,1,37,37,86,0,0,0,2,40832,12.0,45408,105,0,-1173,-3240,10.5,4083.2,0,0,0,37,37,108,0,0,0,0,42005,12.4,48648,107,0,1173,3240,10.7,4200.5
4802945749,1,21,14,1,31,25,76,0,0,0,1,41084,12.0,46456,124,0,3351,4349,12.4,4108.4,36,2,0,25,31,46,0,0,0,0,37733,11.4,42107,104,0,-3351,-4349,10.4,3773.3
4800932418,1,0,0,0,36,25,80,0,0,0,0,39595,11.8,44125,115,0,1511,3388,11.5,3959.5,0,0,1,25,36,52,0,0,0,0,38084,11.2,40737,101,0,-1511,-3388,10.1,3808.4
4800914118,0,0,0,0,21,33,54,0,0,0,1,35666,10.8,38387,101,0,-5693,-3537,10.1,3566.6,0,0,1,33,21,95,0,0,0,0,41359,11.0,41924,111,0,5693,3537,11.1,4135.9
4798961509,0,17,0,1,28,20,92,0,0,0,1,39088,11.2,41732,108,0,1296,874,10.8,3908.8,17,0,0,20,28,67,0,0,0,0,37792,11.2,40858,106,0,-1296,-874,10.6,3779.2
4798942588,1,0,0,0,43,35,116,0,0,0,1,44089,12.4,49481,117,0,1494,1286,11.7,4408.9,8,0,1,35,43,88,0,0,0,0,42595,12.2,48195,96,0,-1494,-1286,9.6,4259.5
4793364320,0,0,0,1,13,11,35,0,0,0,0,34341,10.4,36767,108,0,1180,1711,10.8,3434.1,0,0,0,11,13,33,0,0,0,0,33161,10.2,35056,101,0,-1180,-1711,10.1,3316.1
4793355015,1,7,0,1,30,16,81,0,0,0,1,41241,11.6,42862,108,0,5607,6253,10.8,4124.1,84,0,0,16,30,45,0,0,0,0,35634,10.6,36609,108,0,-5607,-6253,10.8,3563.4
4792602127,0,6,0,0,23,22,58,0,0,0,0,37105,10.8,38960,99,0,-2010,-2499,9.9,3710.5,100,0,1,22,23,62,0,0,0,0,39115,11.0,41459,113,0,2010,2499,11.3,3911.5
4790956700,0,0,0,0,13,29,31,0,0,0,0,36883,11.0,40177,111,0,283,-149,11.1,3688.3,0,0,1,29,13,79,0,0,0,0,36600,11.0,40326,114,0,-283,149,11.4,3660.0
4789397040,0,1,0,0,25,36,62,0,0,0,0,38432,11.4,42597,107,0,-1915,-2728,10.7,3843.2,44,0,1,36,25,95,0,0,0,0,40347,11.8,45325,110,0,1915,2728,11.0,4034.7
4823202647,1,11,3,1,2,4,1,1,1,0,0,15725,6.8,17211,224,68,189,-483,29.2,1572.5,12,1,0,4,2,3,0,0,0,0,15536,6.8,17694,193,56,-189,483,24.9,1553.6
4823184775,0,80,1,0,3,5,3,0,0,0,0,16292,6.8,18221,229,46,-582,216,27.5,1629.2,14,1,1,5,3,7,0,0,0,0,16874,7.0,18005,214,40,582,-216,25.4,1687.4
4823129725,0,13,1,0,3,5,4,0,0,0,0,16018,6.8,17366,210,51,1024,1511,26.1,1601.8,24,0,1,5,3,6,0,0,0,0,14994,6.4,15855,198,44,-1024,-1511,24.2,1499.4
4823097787,1,58,1,0,6,3,10,0,0,0,0,15354,6.4,16113,163,51,-147,-699,21.4,1535.4,63,0,1,3,6,5,0,0,0,0,15501,6.6,16812,214,52,147,699,26.6,1550.1
4823037525,1,22,1,0,0,0,0,0,0,0,0,15319,6.8,18727,231,60,1664,1218,29.1,1531.9,11,3,0,0,0,0,0,0,0,0,13655,6.8,17509,209,60,-1664,-1218,26.9,1365.5
4822924368,1,126,2,0,2,4,1,1,0,1,0,14096,6.8,17531,207,44,-1890,-51,25.1,1409.6,16,5,1,4,2,8,1,1,0,0,15986,6.8,17582,218,60,1890,51,27.8,1598.6
4822871355,0,16,0,0,2,3,3,0,0,0,0,14999,7.0,18497,205,60,662,1432,26.5,1499.9,23,0,1,3,2,0,1,1,0,0,14337,6.8,17065,208,56,-662,-1432,26.4,1433.7
4822800335,1,9,1,1,5,3,6,1,1,0,0,15589,7.0,17967,195,56,764,534,25.1,1558.9,14,0,0,3,5,3,0,0,0,0,14825,6.8,17433,202,35,-764,-534,23.7,1482.5
4743483891,0,11,0,0,6,4,6,1,1,0,0,16099,7.0,17391,190,64,648,-1328,25.4,1609.9,12,0,1,4,6,1,0,0,0,0,15451,7.0,18719,210,72,-648,1328,28.2,1545.1
4743443201,0,11,0,1,4,9,4,0,0,0,0,15811,6.6,17014,224,40,-2138,-631,26.4,1581.1,14,0,0,9,4,9,1,1,0,0,17949,6.6,17645,193,56,2138,631,24.9,1794.9
4743383352,1,20,0,1,5,4,4,0,0,0,0,17046,7.0,17620,185,56,1342,266,24.1,1704.6,10,0,0,4,5,3,0,0,0,0,15704,6.6,17354,218,60,-1342,-266,27.8,1570.4
4586687121,1,155,1,0,10,8,8,1,1,0,0,17226,7.0,17564,183,52,-929,-85,23.5,1722.6,13,1,1,8,10,6,0,0,0,0,18155,6.8,17649,205,52,929,85,25.7,1815.5
4572528030,0,12,7,1,6,11,2,0,0,0,0,15768,6.6,16620,171,64,-2996,-1774,23.5,1576.8,35,1,0,11,6,14,0,0,0,0,18764,7.2,18394,196,59,2996,1774,25.5,1876.4
4572359209,1,34,0,1,4,4,4,1,1,0,0,14927,6.4,15748,126,57,-896,-1253,18.3,1492.7,18,1,0,4,4,5,0,0,0,0,15823,6.6,17001,211,39,896,1253,25.0,1582.3
4572337041,0,11,3,1,4,12,4,0,0,0,0,14493,6.8,16308,184,72,-4203,-2025,25.6,1449.3,10,1,0,12,4,9,1,1,0,0,18696,6.8,18333,186,64,4203,2025,25.0,1869.6
4570246941,0,13,2,1,8,7,11,0,0,0,0,17534,6.6,17236,203,37,-248,-702,24.0,1753.4,24,1,0,7,8,6,1,1,0,0,17782,7.0,17938,177,60,248,702,23.7,1778.2
4553289263,1,12,1,0,4,3,4,0,0,0,0,15068,6.8,17486,218,44,-155,-652,26.2,1506.8,14,2,1,3,4,3,0,0,0,0,15223,7.2,18138,205,60,155,652,26.5,1522.3
4550748400,1,28,0,1,33,17,36,1,1,0,2,44878,10.6,35414,185,28,9649,5365,21.3,4487.8,20,1,0,17,33,16,0,0,0,0,35229,9.4,30049,177,0,-9649,-5365,17.7,3522.9
4550684291,1,14,0,1,7,0,11,1,1,0,0,17157,7.2,18237,216,48,3124,1373,26.4,1715.7,15,2,0,0,7,0,0,0,0,0,14033,6.6,16864,226,55,-3124,-1373,28.1,1403.3
4856138100,0,6,3,1,3,3,3,0,0,0,0,14653,7.0,16874,183,40,-459,-1099,22.3,1465.3,76,1,0,3,3,2,0,0,0,0,15112,6.8,17973,184,60,459,1099,24.4,1511.2
4856040774,1,178,0,1,4,10,4,1,1,0,0,15861,6.8,17633,212,44,-1752,972,25.6,1586.1,33,1,0,10,4,9,0,0,0,0,17613,6.6,16661,196,36,1752,-972,23.2,1761.3
4855122234,0,0,0,1,25,28,55,0,0,0,0,37983,11.6,43277,95,0,-1507,603,9.5,3798.3,0,0,0,28,25,57,0,0,0,0,39490,11.4,42674,102,0,1507,-603,10.2,3949.0
4854598258,0,15,0,0,4,8,4,0,0,0,0,14937,6.4,16125,140,52,-1903,-2898,19.2,1493.7,21,0,1,8,4,2,1,1,0,0,16840,7.0,19023,206,48,1903,2898,25.4,1684.0
4854578068,1,240,1,1,4,2,3,1,1,0,0,16062,7.0,19479,194,64,839,769,25.8,1606.2,11,15,0,2,4,1,0,0,0,0,15223,7.2,18710,228,56,-839,-769,28.4,1522.3
4849649695,0,12,1,0,4,5,2,0,0,0,0,14897,6.6,17476,163,56,-569,255,21.9,1489.7,73,0,1,5,4,3,1,1,0,0,15466,7.0,17221,185,64,569,-255,24.9,1546.6
4849617242,0,12,17,1,8,3,5,1,1,0,0,16896,7.0,17833,149,60,1129,352,20.9,1689.6,102,1,0,3,8,4,0,0,0,0,15767,6.8,17481,181,44,-1129,-352,22.5,1576.7
4849592097,1,70,1,0,15,9,15,0,0,0,0,21900,7.2,18276,200,56,4372,2586,25.6,2190.0,10,2,1,9,15,9,0,0,0,0,17528,6.4,15690,164,47,-4372,-2586,21.1,1752.8
4849029864,1,12,3,1,9,3,13,1,0,1,0,18590,7.4,19092,205,68,4142,2357,27.3,1859.0,14,1,0,3,9,3,0,0,0,0,14448,6.6,16735,220,54,-4142,-2357,27.4,1444.8
4848976896,0,12,1,1,7,3,7,1,1,0,0,17043,6.8,17730,196,53,963,293,24.9,1704.3,15,1,0,3,7,5,0,0,0,0,16080,7.0,17437,175,52,-963,-293,22.7,1608.0
4848918226,1,10,0,1,8,4,6,0,0,0,0,18265,7.0,19074,201,64,1681,-297,26.5,1826.5,15,0,0,4,8,4,0,0,0,0,16584,7.2,19371,223,72,-1681,297,29.5,1658.4
4847037419,1,12,2,0,1,5,1,0,0,0,0,15025,6.6,16930,165,58,-568,-1074,22.3,1502.5,12,1,1,5,1,3,0,0,0,0,15593,6.8,18004,201,46,568,1074,24.7,1559.3
4846980562,0,81,0,0,5,5,3,0,0,0,0,16557,6.8,17921,198,60,593,84,25.8,1655.7,9,0,1,5,5,7,1,1,0,0,15964,7.0,17837,222,56,-593,-84,27.8,1596.4
4846936987,1,12,0,1,4,4,3,0,0,0,0,15777,7.0,17984,233,64,-514,-621,29.7,1577.7,8,2,0,4,4,5,0,0,0,0,16291,7.0,18605,234,52,514,621,28.6,1629.1
4846883626,1,14,0,1,4,8,2,0,0,0,0,14517,6.6,16532,195,48,-3058,-1997,24.3,1451.7,13,0,0,8,4,8,1,1,0,0,17575,7.0,18529,237,43,3058,1997,28.0,1757.5
4845175685,1,9,0,0,7,7,5,0,0,0,0,15874,7.0,17933,172,52,-1587,-27,22.4,1587.4,6,0,1,7,7,10,1,1,0,0,17461,6.8,17960,192,52,1587,27,24.4,1746.1
4843769909,0,9,3,0,7,9,4,0,0,0,0,16137,6.8,17350,172,48,-1155,-117,22.0,1613.7,14,2,1,9,7,8,0,0,0,0,17292,7.0,17467,192,56,1155,117,24.8,1729.2
4835250213,1,10,0,0,8,7,8,1,1,0,0,16591,6.6,16814,167,52,-66,-584,21.9,1659.1,11,0,1,7,8,5,1,0,1,0,16657,6.8,17398,180,55,66,584,23.5,1665.7
4835134062,1,15,0,0,31,22,66,0,0,0,0,39691,12.0,45081,106,0,3404,5591,10.6,3969.1,0,0,1,22,31,42,0,0,0,0,36287,11.0,39490,111,0,-3404,-5591,11.1,3628.7
4856119602,1,126,0,1,24,27,72,0,0,0,2,39354,11.4,42005,114,0,1054,2097,11.4,3935.4,0,0,0,27,24,85,0,0,0,0,38300,11.0,39908,102,0,-1054,-2097,10.2,3830.0
4856085669,1,0,2,0,17,27,38,0,0,0,1,34666,10.8,37886,103,0,-2555,-2426,10.3,3466.6,8,0,1,27,17,61,0,0,0,0,37221,11.2,40312,112,0,2555,2426,11.2,3722.1
4855070203,0,0,0,0,25,36,63,0,0,0,1,37744,11.2,42803,92,0,-3374,-3101,9.2,3774.4,0,0,1,36,25,100,0,0,0,0,41118,12.0,45904,122,0,3374,3101,12.2,4111.8
4855037695,0,0,0,0,8,18,26,0,0,0,0,31637,10.0,32981,107,0,-5322,-5392,10.7,3163.7,0,0,1,18,8,55,0,0,0,0,36959,11.0,38373,110,0,5322,5392,11.0,3695.9
4855005685,0,0,0,1,25,31,79,0,0,0,0,37272,10.8,39254,106,0,-3003,-4805,10.6,3727.2,0,0,0,31,25,94,0,0,0,0,40275,11.8,44059,99,0,3003,4805,9.9,4027.5
4847824139,1,14,2,1,11,9,17,0,0,0,0,19760,6.8,17933,197,48,2384,1489,24.5,1976.0,19,1,0,9,11,7,0,0,0,0,17376,6.6,16444,197,44,-2384,-1489,24.1,1737.6
4847782155,0,13,2,1,11,5,6,1,1,0,0,16685,6.8,18097,155,56,547,1740,21.1,1668.5,14,0,0,5,11,5,0,0,0,0,16138,6.6,16357,212,40,-547,-1740,25.2,1613.8
4826664320,0,0,0,0,19,22,42,0,0,0,0,35499,10.6,38213,124,0,-345,-819,12.4,3549.9,0,0,1,22,19,68,0,0,0,0,35844,11.0,39032,115,0,345,819,11.5,3584.4
4826644809,1,0,0,1,28,23,71,0,0,0,0,40055,11.8,43624,124,0,3209,3766,12.4,4005.5,0,0,0,23,28,43,0,0,0,0,36846,11.0,39858,98,0,-3209,-3766,9.8,3684.6
4826607598,0,0,0,1,28,30,71,0,0,0,0,37368,11.0,40310,93,0,-2273,-3357,9.3,3736.8,0,0,0,30,28,75,0,0,0,0,39641,11.6,43667,112,0,2273,3357,11.2,3964.1
4821002882,0,20,1,1,1,1,2,1,1,0,0,16216,7.4,19183,237,56,1124,0,29.3,1621.6,12,0,0,1,1,1,0,0,0,0,15092,7.0,19183,258,64,-1124,0,32.2,1509.2
4820942414,0,14,5,0,1,3,1,0,0,0,0,15095,7.0,18251,234,72,-191,-347,30.6,1509.5,18,1,1,3,1,1,0,0,0,0,15286,7.2,18598,233,56,191,347,28.9,1528.6
4820879860,1,20,1,0,2,3,4,1,1,0,0,14549,6.8,18020,223,52,-1436,-1200,27.5,1454.9,9,1,1,3,2,2,0,0,0,0,15985,7.4,19220,234,56,1436,1200,29.0,1598.5
4820818558,0,11,3,0,3,9,2,0,0,0,0,14376,6.4,16371,206,52,-3902,-2244,25.8,1437.6,16,1,1,9,3,11,1,1,0,0,18278,7.0,18615,230,48,3902,2244,27.8,1827.8
4817126206,1,0,0,1,29,24,72,0,0,0,0,37569,11.2,41141,115,0,1704,1091,11.5,3756.9,0,0,0,24,29,54,0,0,0,0,35865,11.0,40050,119,0,-1704,-1091,11.9,3586.5
4817100464,1,17,0,0,27,28,65,0,0,0,0,39670,11.8,44441,102,0,1111,3914,10.2,3967.0,0,4,1,28,27,70,0,0,0,0,38559,11.2,40527,105,0,-1111,-3914,10.5,3855.9
4815289322,0,0,0,1,34,35,93,0,0,0,0,39295,12.0,45534,92,0,-1840,-2969,9.2,3929.5,0,0,0,35,34,57,0,0,0,0,41135,12.0,48503,99,0,1840,2969,9.9,4113.5
4815260929,1,46,0,1,32,14,55,0,0,0,1,41107,12.0,45512,64,70,4812,6426,13.4,4110.7,21,0,0,14,32,36,0,0,0,0,36295,11.0,39086,62,43,-4812,-6426,10.5,3629.5
4815217212,0,19,0,1,19,11,31,0,0,0,0,34300,11.0,39381,78,59,-60,-72,13.7,3430.0,11,0,0,11,19,13,0,0,0,0,34360,11.0,39453,70,59,60,72,12.9,3436.0
4815186097,0,50,0,1,17,14,28,0,0,0,0,33413,10.8,37189,72,55,-869,-729,12.7,3341.3,14,19,0,14,17,24,0,0,0,0,34282,11.0,37918,84,59,869,729,14.3,3428.2
4830349407,0,13,0,0,4,12,5,0,0,0,0,14594,6.0,14251,142,64,-3795,-2965,20.6,1459.4,201,1,1,12,4,12,1,1,0,0,18389,6.8,17216,215,48,3795,2965,26.3,1838.9
4811697124,0,9,0,1,10,16,13,0,0,0,0,27994,11.0,37823,82,44,-8020,-4072,12.6,2799.4,13,0,0,15,9,25,0,0,0,0,36014,11.4,41895,86,53,8020,4072,13.9,3601.4
4811686218,0,13,0,0,15,22,28,0,0,0,1,34409,11.0,40031,76,47,-5637,-358,12.3,3440.9,22,1,1,22,15,53,0,0,0,0,40046,11.2,40389,96,69,5637,358,16.5,4004.6
4811681315,1,64,0,1,24,16,41,0,0,0,0,36404,11.0,39936,64,63,2437,1920,12.7,3640.4,8,0,0,16,24,47,0,0,0,0,33967,10.8,38016,63,43,-2437,-1920,10.6,3396.7
4811672055,1,13,1,1,3,2,2,0,0,0,0,14800,6.8,18178,196,48,175,1576,24.4,1480.0,14,0,0,2,3,3,0,0,0,0,14625,6.6,16602,200,44,-175,-1576,24.4,1462.5
4811659880,0,13,0,0,4,8,3,0,0,0,0,14895,6.6,16964,181,48,-3445,-1989,22.9,1489.5,22,0,1,8,4,8,1,1,0,0,18340,7.2,18953,203,56,3445,1989,25.9,1834.0
4771057779,1,15,0,1,7,3,3,0,0,0,0,17199,7.0,19046,210,64,3061,2748,27.4,1719.9,10,1,0,3,7,2,1,1,0,0,14138,6.6,16298,182,40,-3061,-2748,22.2,1413.8
4766513470,0,0,0,1,25,17,65,0,0,0,1,37226,10.8,39354,103,0,468,711,10.3,3722.6,6,0,0,17,25,49,0,0,0,0,36758,11.0,38643,110,0,-468,-711,11.0,3675.8
4766181920,1,15,0,0,1,3,2,0,0,0,0,14415,7.0,18203,188,64,-1819,53,25.2,1441.5,13,2,1,3,1,2,0,0,0,0,16234,6.8,18150,219,56,1819,-53,27.5,1623.4
4762901700,0,14,1,1,3,3,0,0,0,0,0,14734,7.0,17472,210,64,-400,-256,27.4,1473.4,13,0,0,3,3,1,0,0,0,0,15134,7.0,17728,219,44,400,256,26.3,1513.4
4762828663,0,14,1,1,1,4,1,0,0,0,0,14767,6.8,17841,186,64,-2396,-928,25.0,1476.7,12,3,0,4,1,3,0,0,0,0,17163,6.8,18769,234,52,2396,928,28.6,1716.3
4762544512,0,71,0,0,6,8,4,1,1,0,0,16516,7.0,17434,197,54,-1909,963,25.1,1651.6,11,0,1,8,6,9,1,0,1,0,18425,6.4,16471,179,50,1909,-963,22.9,1842.5
4762522894,1,20,3,0,4,1,5,1,1,0,0,16319,7.2,19275,230,64,1183,1750,29.4,1631.9,72,0,1,1,4,1,0,0,0,0,15136,6.6,17525,223,52,-1183,-1750,27.5,1513.6
4759387274,0,13,0,1,4,4,4,0,0,0,0,16600,7.0,18521,222,68,1247,294,29.0,1660.0,66,0,0,4,4,4,1,1,0,0,15353,6.8,18227,209,56,-1247,-294,26.5,1535.3
4758646213,0,68,0,1,40,27,109,0,0,0,2,43201,12.4,48156,101,0,2921,4676,10.1,4320.1,0,0,0,27,40,54,0,0,0,0,40280,11.4,43480,102,0,-2921,-4676,10.2,4028.0
4757770100,1,13,2,1,3,0,2,2,1,1,0,16434,6.8,18597,228,48,2082,236,27.6,1643.4,16,3,0,0,3,0,0,0,0,0,14352,7.0,18361,198,68,-2082,-236,26.6,1435.2
4757528401,0,6,2,1,5,5,1,0,0,0,0,14843,7.0,18054,188,56,104,237,24.4,1484.3,72,0,0,4,4,1,1,1,0,0,14739,7.0,17817,174,56,-104,-237,23.0,1473.9
4757516141,0,16,1,1,4,4,2,0,0,0,0,15385,6.6,17320,225,55,-559,-841,28.0,1538.5,10,2,0,4,4,7,0,0,0,0,15944,6.8,18161,211,60,559,841,27.1,1594.4
4757278285,1,0,0,0,25,21,71,0,0,0,0,38052,11.2,41612,119,0,2008,1075,11.9,3805.2,0,0,1,21,25,53,0,0,0,0,36044,11.2,40537,88,0,-2008,-1075,8.8,3604.4
4756810771,1,17,3,0,7,4,8,1,1,0,0,17093,6.4,16682,191,50,1637,-653,24.1,1709.3,14,0,1,4,7,3,0,0,0,0,15456,6.8,17335,202,56,-1637,653,25.8,1545.6
4857130099,1,39,0,1,33,30,86,0,0,0,0,41811,12.0,46501,114,0,2289,2646,11.4,4181.1,0,0,0,30,33,84,0,0,0,0,39522,11.8,43855,103,0,-2289,-2646,10.3,3952.2
4857101154,1,17,0,0,18,20,54,0,0,0,1,36026,10.4,37669,126,0,451,295,12.6,3602.6,0,0,1,20,18,57,0,0,0,0,35575,10.8,37374,123,0,-451,-295,12.3,3557.5
4857088284,1,0,0,0,37,29,109,0,0,0,2,42767,11.8,44450,116,0,3903,4252,11.6,4276.7,0,0,1,29,37,77,0,0,0,0,38864,10.8,40198,82,0,-3903,-4252,8.2,3886.4
4854931361,1,0,0,1,13,17,23,0,0,0,0,35360,10.4,37337,107,0,156,-1164,10.7,3536.0,0,0,0,17,13,52,0,0,0,0,35204,10.8,38501,114,0,-156,1164,11.4,3520.4
4854911150,0,34,0,0,25,23,71,0,0,0,1,36831,11.6,42408,91,0,-2549,1935,9.1,3683.1,0,5,1,23,25,50,0,0,0,0,39380,11.0,40473,109,0,2549,-1935,10.9,3938.0
4852903533,1,0,0,0,13,14,19,0,0,0,0,62005,12.0,55000,8,0,24455,22000,0.8,6200.5,4,0,1,12,11,9,0,0,0,0,37550,7.2,33000,0,0,-24455,-22000,0.0,3755.0
4852880225,1,39,3,1,22,24,17,0,0,0,0,63490,12.0,55000,4,0,24170,22000,0.4,6349.0,7,3,0,13,11,20,0,0,0,0,39320,7.2,33000,0,0,-24170,-22000,0.0,3932.0
4852856441,1,0,0,1,26,21,24,0,0,0,0,65150,12.0,55000,0,0,26200,22000,0.0,6515.0,1,0,0,12,17,11,0,0,0,0,38950,7.2,33000,0,0,-26200,-22000,0.0,3895.0
4852837167,1,0,0,0,15,18,16,0,0,0,0,63100,12.0,55000,0,0,26244,22000,0.0,6310.0,0,0,1,11,8,9,0,0,0,0,36856,7.2,33000,0,0,-26244,-22000,0.0,3685.6
4851873622,0,32,2,0,6,10,6,0,0,0,0,14513,6.4,15010,136,50,-3309,-2792,18.6,1451.3,36,0,1,10,6,7,0,0,0,0,17822,7.2,17802,201,42,3309,2792,24.3,1782.2
4851818457,0,12,1,1,5,6,4,0,0,0,0,15930,6.8,17232,195,52,8,-460,24.7,1593.0,11,1,0,6,5,2,0,0,0,0,15922,6.8,17692,189,44,-8,460,23.3,1592.2
4851796256,1,0,0,1,33,26,104,0,0,0,0,38871,11.8,43573,106,0,567,166,10.6,3887.1,0,0,0,26,33,65,0,0,0,0,38304,11.6,43407,110,0,-567,-166,11.0,3830.4
4849913297,0,0,0,0,10,20,28,0,0,0,1,32149,10.0,33359,110,0,-2475,-4930,11.0,3214.9,0,0,1,20,10,55,0,0,0,0,34624,11.0,38289,92,0,2475,4930,9.2,3462.4
4849882179,0,0,0,1,21,8,54,0,0,0,2,35957,10.8,38323,103,0,3477,4643,10.3,3595.7,0,0,0,8,21,16,0,0,0,0,32480,10.0,33680,92,0,-3477,-4643,9.2,3248.0
4849853708,1,0,0,0,20,20,45,0,0,0,0,36304,11.0,40868,113,0,-641,2553,11.3,3630.4,0,0,1,20,20,47,0,0,0,0,36945,10.8,38315,116,0,641,-2553,11.6,3694.5
4849827956,0,0,0,0,33,21,82,0,0,0,2,42403,12.0,46660,119,0,5450,5969,11.9,4240.3,64,0,1,21,33,53,0,0,0,0,36953,11.0,40691,103,0,-5450,-5969,10.3,3695.3
4849194360,1,0,0,0,26,20,58,0,0,0,1,38365,11.4,40916,120,0,3061,2657,12.0,3836.5,17,0,1,20,26,46,0,0,0,0,35304,10.8,38259,94,0,-3061,-2657,9.4,3530.4
4849173699,1,0,0,0,11,16,24,0,0,0,0,33123,10.4,35004,103,0,-852,-1751,10.3,3312.3,75,0,1,16,11,44,0,0,0,0,33975,10.6,36755,92,0,852,1751,9.2,3397.5
4849158848,0,0,0,1,21,22,51,0,0,0,0,37853,11.2,41031,103,0,1200,759,10.3,3785.3,0,0,0,22,21,54,0,0,0,0,36653,11.2,40272,105,0,-1200,-759,10.5,3665.3
4849136750,1,0,0,1,21,21,46,0,0,0,1,37043,11.0,40389,114,0,370,215,11.4,3704.3,1,0,0,21,21,41,0,0,0,0,36673,11.0,40174,107,0,-370,-215,10.7,3667.3
4855423874,0,68,0,0,16,12,30,0,0,0,1,34889,10.8,38140,104,0,-566,1128,10.4,3488.9,0,0,1,12,16,27,0,0,0,0,35455,10.4,37012,116,0,566,-1128,11.6,3545.5
4855405888,1,10,0,1,31,26,84,0,0,0,2,40854,12.0,45902,125,0,1732,4631,12.5,4085.4,0,0,0,26,31,62,0,0,0,0,39122,11.6,41271,85,0,-1732,-4631,8.5,3912.2
4855380761,1,0,0,1,28,24,75,0,0,0,1,39134,11.2,41463,107,0,2484,633,10.7,3913.4,0,0,0,24,28,51,0,0,0,0,36650,11.4,40830,99,0,-2484,-633,9.9,3665.0
4855362744,0,0,0,0,16,18,41,0,0,0,0,33821,11.0,38463,98,0,-2247,922,9.8,3382.1,0,0,1,18,16,37,0,0,0,0,36068,10.8,37541,102,0,2247,-922,10.2,3606.8
4854146120,1,1,0,0,23,16,23,0,0,0,0,54525,13.0,62500,0,0,17419,25000,0.0,5452.5,0,0,1,7,14,9,0,0,0,0,37106,7.8,37500,0,0,-17419,-25000,0.0,3710.6
4853928380,1,0,2,0,26,27,68,0,0,0,1,37449,11.4,41020,113,0,-34,-563,11.3,3744.9,15,0,1,27,26,69,0,0,0,0,37483,11.4,41583,92,0,34,563,9.2,3748.3
4853905500,1,0,0,1,20,12,59,0,0,0,0,36361,11.0,39453,102,0,4183,5382,10.2,3636.1,0,0,0,12,20,26,0,0,0,0,32178,10.0,34071,83,0,-4183,-5382,8.3,3217.8
4853872211,1,14,0,1,18,19,44,0,0,0,0,35497,11.0,39295,98,0,22,190,9.8,3549.7,0,3,0,19,18,43,0,0,0,0,35475,11.0,39105,105,0,-22,-190,10.5,3547.5
4853849844,0,0,2,1,20,16,47,0,0,0,0,36265,10.8,39491,125,0,-250,-112,12.5,3626.5,19,0,0,16,20,41,0,0,0,0,36515,11.2,39603,110,0,250,112,11.0,3651.5
4853814432,1,0,0,0,27,15,76,0,0,0,1,37793,11.8,43567,94,0,3541,5792,9.4,3779.3,0,0,1,15,27,34,0,0,0,0,34252,10.8,37775,98,0,-3541,-5792,9.8,3425.2
4853120487,1,0,0,1,32,28,96,0,0,0,1,40340,11.8,45940,105,0,1287,4035,10.5,4034.0,0,0,0,28,32,81,0,0,0,0,39053,11.4,41905,117,0,-1287,-4035,11.7,3905.3
4853104589,1,19,0,0,23,19,52,0,0,0,0,36371,10.8,39807,88,0,-542,1109,8.8,3637.1,82,0,1,19,23,40,0,0,0,0,36913,10.6,38698,108,0,542,-1109,10.8,3691.3
4853089442,0,0,0,0,24,27,56,0,0,0,1,38091,11.2,41838,101,0,4,-430,10.1,3809.1,0,0,1,27,24,61,0,0,0,0,38087,11.4,42268,94,0,-4,430,9.4,3808.7
4853066547,0,13,0,1,32,24,90,0,0,0,1,40264,11.4,43529,77,0,2132,2089,7.7,4026.4,0,0,0,24,32,59,0,0,0,0,38132,11.2,41440,97,0,-2132,-2089,9.7,3813.2
4853043411,0,1,0,1,19,20,49,0,0,0,1,35871,11.0,39528,97,0,-1005,-272,9.7,3587.1,0,1,0,20,19,46,0,0,0,0,36876,11.2,39800,106,0,1005,272,10.6,3687.6
4853026261,0,3,0,1,24,23,74,0,0,0,1,38753,11.2,41665,105,0,1212,1135,10.5,3875.3,0,0,0,23,24,68,0,0,0,0,37541,11.2,40530,105,0,-1212,-1135,10.5,3754.1
4852988217,0,0,0,0,22,26,53,0,0,0,0,35478,10.8,39098,95,0,-732,175,9.5,3547.8,0,0,1,26,22,65,0,0,0,0,36210,10.8,38923,115,0,732,-175,11.5,3621.0
4852940473,1,0,0,0,29,24,82,0,0,0,1,39196,11.4,42706,114,0,1976,1731,11.4,3919.6,0,0,1,24,29,47,0,0,0,0,37220,11.4,40975,101,0,-1976,-1731,10.1,3722.0
4852917064,0,0,0,0,20,24,53,0,0,0,1,36409,11.2,40642,90,0,-2265,-754,9.0,3640.9,0,0,1,24,20,71,0,0,0,0,38674,11.4,41396,92,0,2265,754,9.2,3867.4
4852875388,1,3,0,1,24,26,50,0,0,0,0,36367,11.2,40095,110,0,-86,-1182,11.0,3636.7,0,0,0,26,24,55,0,0,0,0,36453,11.2,41277,117,0,86,1182,11.7,3645.3
4856372216,1,0,0,1,18,14,19,0,0,0,0,62350,12.0,55000,0,0,24800,22000,0.0,6235.0,0,0,0,8,12,10,0,0,0,0,37550,7.2,33000,0,0,-24800,-22000,0.0,3755.0
4856345460,1,8,0,0,19,23,17,0,0,0,0,54689,12.0,55000,0,0,20579,22000,0.0,5468.9,0,0,1,12,8,17,0,0,0,0,34110,7.2,33000,0,0,-20579,-22000,0.0,3411.0
4855359798,0,23,0,0,2,9,1,1,0,1,0,13657,6.6,16244,174,56,-5113,-3815,23.0,1365.7,12,3,1,9,2,6,1,1,0,0,18770,7.4,20059,226,64,5113,3815,29.0,1877.0
4853722806,1,0,0,1,19,18,19,0,0,0,0,45950,10.0,47500,0,0,18800,19000,0.0,4595.0,23,0,0,9,10,10,0,0,0,0,27150,6.0,28500,0,0,-18800,-19000,0.0,2715.0
4853533698,1,0,0,1,26,19,24,0,0,0,0,65308,12.0,55000,0,0,28438,21000,0.0,6530.8,0,0,0,8,15,8,0,0,0,0,36870,7.4,34000,0,0,-28438,-21000,0.0,3687.0
4851535297,0,49,1,0,5,5,3,0,0,0,0,15148,7.0,17908,182,52,-960,-229,23.4,1514.8,10,1,1,5,5,3,1,1,0,0,16108,7.0,18137,202,62,960,229,26.4,1610.8
4846366251,0,0,0,0,21,31,55,0,0,0,1,37171,11.0,40887,78,0,-2572,-2100,7.8,3717.1,0,0,1,31,21,83,0,0,0,0,39743,11.6,42987,109,0,2572,2100,10.9,3974.3
4836558995,1,13,0,1,4,2,5,1,1,0,0,15778,6.8,17935,227,54,155,-459,28.1,1577.8,9,1,0,1,3,1,1,0,1,0,15623,6.8,18394,212,56,-155,459,26.8,1562.3
4836187024,0,13,0,0,9,8,5,1,1,0,0,16560,6.8,17630,196,56,146,579,25.2,1656.0,14,0,1,8,9,7,0,0,0,0,16414,6.8,17051,205,52,-146,-579,25.7,1641.4
4836149268,1,13,2,1,10,0,7,1,0,1,0,19798,7.2,18743,227,44,6330,2466,27.1,1979.8,18,2,0,0,10,0,1,1,0,0,13468,6.6,16277,186,48,-6330,-2466,23.4,1346.8
4836115165,1,13,2,0,5,5,4,0,0,0,0,16636,6.8,18315,220,65,687,124,28.5,1663.6,17,2,1,5,5,5,0,0,0,0,15949,7.0,18191,194,48,-687,-124,24.2,1594.9
4836060305,0,14,0,1,7,8,8,0,0,0,0,16748,6.8,16875,158,48,552,-333,20.6,1674.8,11,0,0,8,7,4,0,0,0,0,16196,6.6,17208,171,48,-552,333,21.9,1619.6
4835684791,0,12,15,1,5,4,6,0,0,0,0,15362,6.8,16445,152,60,-732,-1021,21.2,1536.2,38,1,0,4,5,5,0,0,0,0,16094,6.6,17466,206,64,732,1021,27.0,1609.4
4835650252,0,8,1,1,6,9,5,0,0,0,0,16078,6.6,16453,177,32,-2261,-3181,20.9,1607.8,11,0,0,9,6,4,0,0,0,0,18339,7.2,19634,179,81,2261,3181,26.0,1833.9
4835623613,1,9,2,1,5,4,4,0,0,0,0,16314,6.6,16571,189,52,190,-222,24.1,1631.4,13,0,0,4,5,6,0,0,0,0,16124,6.6,16793,203,52,-190,222,25.5,1612.4
4834718070,1,15,2,0,6,3,7,1,1,0,0,17130,7.4,19582,205,68,1808,2320,27.3,1713.0,13,0,1,3,6,9,0,0,0,0,15322,6.8,17262,210,48,-1808,-2320,25.8,1532.2
4834696498,1,21,0,1,5,0,4,1,1,0,0,17354,7.4,19913,264,68,3920,1883,33.2,1735.4,90,10,0,0,5,0,0,0,0,0,13434,6.8,18030,212,54,-3920,-1883,26.6,1343.4
4834351082,0,8,0,0,5,2,5,1,1,0,0,15685,6.8,18105,206,56,873,798,26.2,1568.5,13,1,1,2,5,4,0,0,0,0,14812,6.8,17307,193,56,-873,-798,24.9,1481.2
4834328115,1,11,1,0,4,3,6,0,0,0,0,15764,6.8,16524,200,47,740,-1154,24.7,1576.4,11,3,1,3,4,1,0,0,0,0,15024,6.6,17678,198,52,-740,1154,25.0,1502.4
4833922849,1,0,0,0,22,23,57,0,0,0,0,37316,11.0,38818,111,0,565,-2299,11.1,3731.6,26,0,1,23,22,54,0,0,0,0,36751,11.2,41117,88,0,-565,2299,8.8,3675.1
4833904964,1,4,0,1,35,21,114,0,0,0,2,41609,12.0,45848,121,0,4540,5505,12.1,4160.9,0,0,0,21,35,48,0,0,0,0,37069,11.2,40343,90,0,-4540,-5505,9.0,3706.9
4833074802,0,0,0,0,18,22,56,0,0,0,0,36272,11.0,38636,96,0,-1411,-1682,9.6,3627.2,0,0,1,22,18,64,0,0,0,0,37683,11.2,40318,110,0,1411,1682,11.0,3768.3
4833048219,0,2,1,1,28,19,69,0,0,0,0,37879,11.6,43439,91,0,1303,5565,9.1,3787.9,1,0,0,19,28,44,0,0,0,0,36576,10.8,37874,93,0,-1303,-5565,9.3,3657.6
4833028667,0,0,0,0,19,35,42,0,0,0,1,34958,10.6,36734,93,0,-4798,-8173,9.3,3495.8,0,0,1,35,19,81,0,0,0,0,39756,11.8,44907,95,0,4798,8173,9.5,3975.6
4832983536,0,234,0,1,22,30,59,0,0,0,0,36654,11.0,39329,99,0,-4376,-4057,9.9,3665.4,0,0,0,30,22,83,0,0,0,0,41030,11.4,43386,95,0,4376,4057,9.5,4103.0
4832966996,0,0,0,0,20,25,58,0,0,0,1,37845,10.8,38187,112,0,812,-4073,11.2,3784.5,0,0,1,25,20,71,0,0,0,0,37033,11.2,42260,94,0,-812,4073,9.4,3703.3
4832944760,1,2,0,1,18,18,51,0,0,0,2,34128,10.4,36224,77,0,-1390,-5175,7.7,3412.8,0,0,0,18,18,45,0,0,0,0,35518,11.2,41399,100,0,1390,5175,10.0,3551.8
4832921275,1,0,0,0,24,27,59,0,0,0,2,38004,11.0,40788,103,0,-2539,-3350,10.3,3800.4,0,0,1,27,24,70,0,0,0,0,40543,11.8,44138,112,0,2539,3350,11.2,4054.3
4832897317,1,0,2,0,20,28,45,0,0,0,0,37208,10.8,39131,104,0,-869,-2304,10.4,3720.8,15,0,1,28,20,65,0,0,0,0,38077,11.4,41435,111,0,869,2304,11.1,3807.7
4825285034,0,20,0,0,28,31,81,0,0,0,0,38120,11.6,43619,81,0,-2527,371,8.1,3812.0,0,1,1,31,28,88,0,0,0,0,40647,11.6,43248,96,0,2527,-371,9.6,4064.7
4825269063,0,14,4,0,33,28,87,0,0,0,2,40473,11.6,44095,114,0,1510,857,11.4,4047.3,53,1,1,28,33,66,0,0,0,0,38963,11.6,43238,107,0,-1510,-857,10.7,3896.3
4825251606,0,144,0,1,25,25,66,0,0,0,1,38886,11.2,41055,120,0,2591,1176,12.0,3888.6,82,0,0,25,25,63,0,0,0,0,36295,11.0,39879,93,0,-2591,-1176,9.3,3629.5
4825251912,0,0,0,0,20,30,44,0,0,0,2,35670,10.8,38908,73,0,-5745,-6049,7.3,3567.0,0,0,1,30,20,91,0,0,0,0,41415,11.8,44957,115,0,5745,6049,11.5,4141.5
4825245853,1,0,0,1,20,23,42,0,0,0,1,36636,10.8,39533,102,0,1417,160,10.2,3663.6,0,0,0,23,20,53,0,0,0,0,35219,11.0,39373,87,0,-1417,-160,8.7,3521.9
4823336347,0,93,0,0,14,25,29,0,0,0,1,33105,10.8,38307,90,0,-5651,-4082,9.0,3310.5,30,0,1,25,14,84,0,0,0,0,38756,11.4,42389,108,0,5651,4082,10.8,3875.6
4823325726,0,17,0,0,22,32,59,0,0,0,1,35949,11.0,39853,81,0,-5887,-5517,8.1,3594.9,0,9,1,32,22,84,0,0,0,0,41836,11.8,45370,123,0,5887,5517,12.3,4183.6
4823326923,0,2,0,1,22,20,55,0,0,0,1,36532,10.8,37771,91,0,-543,-1237,9.1,3653.2,0,0,0,20,22,55,0,0,0,0,37075,11.0,39008,108,0,543,1237,10.8,3707.5
4823317034,1,49,0,0,34,28,80,0,0,0,1,38176,11.6,43399,98,0,298,-217,9.8,3817.6,0,1,1,27,33,55,0,0,0,0,37878,11.4,43616,110,0,-298,217,11.0,3787.8
4845117961,1,0,0,1,27,18,73,0,0,0,0,39035,11.4,42608,105,0,4346,4629,10.5,3903.5,0,0,0,18,27,45,0,0,0,0,34689,10.8,37979,96,0,-4346,-4629,9.6,3468.9
4845073552,1,0,4,1,27,25,75,0,0,0,1,38794,11.4,42392,105,0,1881,240,10.5,3879.4,16,0,0,25,27,56,0,0,0,0,36913,11.2,42152,91,0,-1881,-240,9.1,3691.3
4845044938,0,0,0,0,14,12,38,0,0,0,0,34921,10.6,37269,99,0,-185,-494,9.9,3492.1,80,0,1,12,14,25,0,0,0,0,35106,10.6,37763,116,0,185,494,11.6,3510.6
4842696186,1,14,0,0,4,2,3,0,0,0,0,15546,6.6,16642,213,51,1029,-611,26.4,1554.6,12,2,1,2,4,1,0,0,0,0,14517,6.6,17253,186,48,-1029,611,23.4,1451.7
4842679511,1,21,1,1,4,3,0,0,0,0,0,17437,7.4,19878,219,84,2989,3589,30.3,1743.7,10,0,0,3,4,2,0,0,0,0,14448,6.6,16289,167,52,-2989,-3589,21.9,1444.8
4842666672,1,10,0,1,6,4,2,0,0,0,0,17074,7.0,18828,224,64,1945,1427,28.8,1707.4,11,1,0,4,6,3,0,0,0,0,15129,7.0,17401,188,51,-1945,-1427,23.9,1512.9
4842644902,0,14,0,0,0,4,0,0,0,0,0,13529,6.8,17606,193,56,-1760,-36,24.9,1352.9,12,1,1,4,0,5,0,0,0,0,15289,6.8,17642,212,55,1760,36,26.7,1528.9
4842613484,0,32,0,0,4,7,5,0,0,0,0,15338,6.6,16804,199,40,-269,-217,23.9,1533.8,62,2,1,7,4,5,0,0,0,0,15607,6.6,17021,176,48,269,217,22.4,1560.7
4842592910,0,49,0,0,0,4,0,0,0,0,0,14452,6.6,16369,192,52,-2289,-2128,24.4,1445.2,109,0,1,4,0,3,0,0,0,0,16741,7.0,18497,206,56,2289,2128,26.2,1674.1
4841270662,1,9,0,1,14,16,27,0,0,0,0,36185,10.8,38079,118,0,2023,1418,11.8,3618.5,0,5,0,16,14,45,0,0,0,0,34162,10.6,36661,97,0,-2023,-1418,9.7,3416.2
4840492547,1,0,0,0,32,33,85,0,0,0,2,40558,11.8,45138,108,0,-821,85,10.8,4055.8,0,0,1,33,32,99,0,0,0,0,41379,11.8,45053,124,0,821,-85,12.4,4137.9
4840460128,0,9,2,1,5,8,3,0,0,0,0,15160,7.0,16983,195,36,-2163,-461,23.1,1516.0,12,2,0,8,5,8,0,0,0,0,17323,6.8,17444,175,34,2163,461,20.9,1732.3
4840414963,1,42,0,0,5,4,1,0,0,0,0,15260,6.4,17062,200,40,109,1268,24.0,1526.0,11,1,1,4,5,2,1,1,0,0,15151,6.6,15794,169,52,-109,-1268,22.1,1515.1
4840392148,0,9,1,0,3,12,2,0,0,0,0,13627,6.6,15193,115,54,-6096,-2811,16.9,1362.7,9,1,1,12,3,9,0,0,0,0,19723,7.0,18004,215,52,6096,2811,26.7,1972.3
4840358734,1,0,4,0,25,21,65,0,0,0,2,39795,11.0,39759,124,0,3631,1368,12.4,3979.5,24,0,1,20,24,60,0,0,0,0,36164,10.6,38391,112,0,-3631,-1368,11.2,3616.4
4840341871,1,34,0,1,30,30,76,0,0,0,0,40126,12.0,44666,116,0,-465,2605,11.6,4012.6,34,0,0,29,29,74,0,0,0,0,40591,11.4,42061,108,0,465,-2605,10.8,4059.1
4840317829,1,2,0,1,24,30,57,0,0,0,0,38033,11.6,42869,115,0,92,-228,11.5,3803.3,0,0,0,30,24,78,0,0,0,0,37941,11.6,43097,91,0,-92,228,9.1,3794.1
4840277565,0,0,0,1,18,19,45,0,0,0,0,34916,10.6,37400,117,0,918,18,11.7,3491.6,0,0,0,19,18,44,0,0,0,0,33998,10.8,37382,95,0,-918,-18,9.5,3399.8
4838351831,0,0,0,1,20,20,43,0,0,0,1,35753,10.6,37931,85,0,-1483,-3285,8.5,3575.3,0,0,0,20,20,44,0,0,0,0,37236,11.2,41216,120,0,1483,3285,12.0,3723.6
4854250208,1,78,1,1,3,4,1,0,0,0,0,15999,6.8,18073,216,60,216,-809,27.6,1599.9,10,0,0,4,3,3,0,0,0,0,15783,7.2,18882,191,60,-216,809,25.1,1578.3
4854235813,1,11,2,1,15,1,21,1,1,0,0,20401,7.0,18184,233,32,7307,3314,26.5,2040.1,44,1,0,1,15,2,0,0,0,0,13094,6.2,14870,169,56,-7307,-3314,22.5,1309.4
4854188688,0,16,0,1,7,3,11,0,0,0,0,16805,6.8,16522,211,48,1098,-3004,25.9,1680.5,13,1,0,3,7,0,0,0,0,0,15707,7.2,19526,189,60,-1098,3004,24.9,1570.7
4852419492,0,11,3,0,4,6,2,1,1,0,0,16253,7.0,17662,189,64,400,646,25.3,1625.3,15,2,1,6,4,2,0,0,0,0,15853,6.8,17016,182,48,-400,-646,23.0,1585.3
4852405459,1,11,1,1,6,5,6,0,0,0,0,18386,7.2,18268,223,56,1624,0,27.9,1838.6,22,3,0,5,6,4,0,0,0,0,16762,7.2,18268,216,56,-1624,0,27.2,1676.2
4852385018,1,17,1,1,11,3,7,0,0,0,0,18339,7.4,19641,190,60,4541,4339,25.0,1833.9,12,0,0,3,11,1,0,0,0,0,13798,6.0,15302,170,44,-4541,-4339,21.4,1379.8
4851381455,1,12,2,0,1,6,0,0,0,0,0,14849,6.6,17221,250,51,-2377,-1587,30.1,1484.9,10,3,1,6,1,2,1,1,0,0,17226,7.2,18808,238,60,2377,1587,29.8,1722.6
4851358366,0,14,2,0,6,5,7,0,0,0,0,16642,6.6,16828,157,46,-227,-77,20.3,1664.2,66,0,1,5,6,5,0,0,0,0,16869,6.6,16905,213,50,227,77,26.3,1686.9
4851329463,0,20,2,0,2,4,1,0,0,0,0,14103,6.8,17277,191,61,-1476,-303,25.2,1410.3,14,3,1,4,2,2,0,0,0,0,15579,7.0,17580,234,42,1476,303,27.6,1557.9
4850686505,1,15,1,1,6,9,6,0,0,0,0,15681,6.8,17211,205,44,-1886,-2079,24.9,1568.1,11,0,0,9,6,7,0,0,0,0,17567,7.4,19290,212,58,1886,2079,27.0,1756.7
4850489376,1,16,2,0,7,5,12,1,1,0,0,17671,7.0,18353,206,72,1716,1119,27.8,1767.1,14,0,1,5,7,5,0,0,0,0,15955,6.8,17234,208,52,-1716,-1119,26.0,1595.5
4850474849,1,12,1,0,3,7,3,1,1,0,0,15695,7.0,18704,232,64,-1651,-134,29.6,1569.5,15,1,1,7,3,8,0,0,0,0,17346,7.2,18838,241,56,1651,134,29.7,1734.6
4850452924,0,13,0,1,5,7,3,1,1,0,0,14959,6.2,15933,179,40,-2691,-2110,21.9,1495.9,10,2,0,6,4,8,0,0,0,0,17650,7.0,18043,221,52,2691,2110,27.3,1765.0
4850426681,1,30,1,0,7,8,11,0,0,0,0,18031,7.0,17953,199,64,-321,235,26.3,1803.1,12,3,1,8,7,7,0,0,0,0,18352,6.8,17718,190,56,321,-235,24.6,1835.2
4850106510,0,11,0,0,2,5,3,0,0,0,0,14109,6.6,16927,183,52,-2490,-2020,23.5,1410.9,14,0,1,5,2,3,0,0,0,0,16599,7.2,18947,225,60,2490,2020,28.5,1659.9
4850068495,0,10,0,1,3,3,2,0,0,0,0,15065,7.0,18416,206,48,-607,-831,25.4,1506.5,11,1,0,3,3,0,0,0,0,0,15672,7.2,19247,192,68,607,831,26.0,1567.2
4850042381,0,12,3,0,2,4,1,0,0,0,0,14268,6.8,17401,196,48,-1581,-511,24.4,1426.8,104,2,1,4,2,5,0,0,0,0,15849,7.0,17912,220,64,1581,511,28.4,1584.9
4850013290,0,12,1,0,1,5,1,0,0,0,0,13646,6.6,17535,174,58,-2358,-1556,23.2,1364.6,14,1,1,5,1,3,0,0,0,0,16004,7.0,19091,222,52,2358,1556,27.4,1600.4
4849839112,1,11,0,1,5,5,4,0,0,0,0,15878,6.8,17471,204,52,-1304,-1618,25.6,1587.8,11,1,0,5,5,6,1,1,0,0,17182,7.0,19089,188,60,1304,1618,24.8,1718.2
4849818764,0,11,0,0,7,13,4,0,0,0,0,14152,6.0,14241,116,44,-6104,-4439,16.0,1415.2,13,0,1,13,7,10,0,0,0,0,20256,7.2,18680,223,36,6104,4439,25.9,2025.6
4856372216,1,0,0,1,18,14,19,0,0,0,0,62350,12.0,55000,0,0,24800,22000,0.0,6235.0,0,0,0,8,12,10,0,0,0,0,37550,7.2,33000,0,0,-24800,-22000,0.0,3755.0
4856345460,1,8,0,0,19,23,17,0,0,0,0,54689,12.0,55000,0,0,20579,22000,0.0,5468.9,0,0,1,12,8,17,0,0,0,0,34110,7.2,33000,0,0,-20579,-22000,0.0,3411.0
4855359798,0,23,0,0,2,9,1,1,0,1,0,13657,6.6,16244,174,56,-5113,-3815,23.0,1365.7,12,3,1,9,2,6,1,1,0,0,18770,7.4,20059,226,64,5113,3815,29.0,1877.0
4853722806,1,0,0,1,19,18,19,0,0,0,0,45950,10.0,47500,0,0,18800,19000,0.0,4595.0,23,0,0,9,10,10,0,0,0,0,27150,6.0,28500,0,0,-18800,-19000,0.0,2715.0
4853533698,1,0,0,1,26,19,24,0,0,0,0,65308,12.0,55000,0,0,28438,21000,0.0,6530.8,0,0,0,8,15,8,0,0,0,0,36870,7.4,34000,0,0,-28438,-21000,0.0,3687.0
4851535297,0,49,1,0,5,5,3,0,0,0,0,15148,7.0,17908,182,52,-960,-229,23.4,1514.8,10,1,1,5,5,3,1,1,0,0,16108,7.0,18137,202,62,960,229,26.4,1610.8
4846366251,0,0,0,0,21,31,55,0,0,0,1,37171,11.0,40887,78,0,-2572,-2100,7.8,3717.1,0,0,1,31,21,83,0,0,0,0,39743,11.6,42987,109,0,2572,2100,10.9,3974.3
4836558995,1,13,0,1,4,2,5,1,1,0,0,15778,6.8,17935,227,54,155,-459,28.1,1577.8,9,1,0,1,3,1,1,0,1,0,15623,6.8,18394,212,56,-155,459,26.8,1562.3
4836187024,0,13,0,0,9,8,5,1,1,0,0,16560,6.8,17630,196,56,146,579,25.2,1656.0,14,0,1,8,9,7,0,0,0,0,16414,6.8,17051,205,52,-146,-579,25.7,1641.4
4836149268,1,13,2,1,10,0,7,1,0,1,0,19798,7.2,18743,227,44,6330,2466,27.1,1979.8,18,2,0,0,10,0,1,1,0,0,13468,6.6,16277,186,48,-6330,-2466,23.4,1346.8
4836115165,1,13,2,0,5,5,4,0,0,0,0,16636,6.8,18315,220,65,687,124,28.5,1663.6,17,2,1,5,5,5,0,0,0,0,15949,7.0,18191,194,48,-687,-124,24.2,1594.9
4836060305,0,14,0,1,7,8,8,0,0,0,0,16748,6.8,16875,158,48,552,-333,20.6,1674.8,11,0,0,8,7,4,0,0,0,0,16196,6.6,17208,171,48,-552,333,21.9,1619.6
4835684791,0,12,15,1,5,4,6,0,0,0,0,15362,6.8,16445,152,60,-732,-1021,21.2,1536.2,38,1,0,4,5,5,0,0,0,0,16094,6.6,17466,206,64,732,1021,27.0,1609.4
4835650252,0,8,1,1,6,9,5,0,0,0,0,16078,6.6,16453,177,32,-2261,-3181,20.9,1607.8,11,0,0,9,6,4,0,0,0,0,18339,7.2,19634,179,81,2261,3181,26.0,1833.9
4835623613,1,9,2,1,5,4,4,0,0,0,0,16314,6.6,16571,189,52,190,-222,24.1,1631.4,13,0,0,4,5,6,0,0,0,0,16124,6.6,16793,203,52,-190,222,25.5,1612.4
4834718070,1,15,2,0,6,3,7,1,1,0,0,17130,7.4,19582,205,68,1808,2320,27.3,1713.0,13,0,1,3,6,9,0,0,0,0,15322,6.8,17262,210,48,-1808,-2320,25.8,1532.2
4834696498,1,21,0,1,5,0,4,1,1,0,0,17354,7.4,19913,264,68,3920,1883,33.2,1735.4,90,10,0,0,5,0,0,0,0,0,13434,6.8,18030,212,54,-3920,-1883,26.6,1343.4
4834351082,0,8,0,0,5,2,5,1,1,0,0,15685,6.8,18105,206,56,873,798,26.2,1568.5,13,1,1,2,5,4,0,0,0,0,14812,6.8,17307,193,56,-873,-798,24.9,1481.2
4834328115,1,11,1,0,4,3,6,0,0,0,0,15764,6.8,16524,200,47,740,-1154,24.7,1576.4,11,3,1,3,4,1,0,0,0,0,15024,6.6,17678,198,52,-740,1154,25.0,1502.4
4857381402,1,15,2,1,5,7,5,1,1,0,0,15807,6.6,16874,194,48,11,-2486,24.2,1580.7,16,2,0,6,4,5,0,0,0,0,15796,7.4,19360,205,60,-11,2486,26.5,1579.6
4857329084,1,11,1,1,3,3,3,1,1,0,0,14461,6.6,16511,177,60,-1201,-1540,23.7,1446.1,12,0,0,3,3,3,0,0,0,0,15662,6.6,18051,190,60,1201,1540,25.0,1566.2
4857273504,1,13,18,1,5,6,5,0,0,0,0,15317,6.8,17565,170,44,-1115,-1048,21.4,1531.7,33,1,0,6,5,5,0,0,0,0,16432,7.2,18613,207,52,1115,1048,25.9,1643.2
4857223830,0,11,2,0,4,4,3,0,0,0,0,14251,6.6,16869,182,52,-1068,40,23.4,1425.1,13,0,1,4,4,2,1,1,0,0,15319,6.8,16829,170,48,1068,-40,21.8,1531.9
4857170610,0,14,2,0,4,6,4,0,0,0,0,15289,6.8,17608,215,48,-1163,234,26.3,1528.9,13,0,1,6,4,8,1,1,0,0,16452,6.8,17374,216,56,1163,-234,27.2,1645.2
4857136903,1,32,2,0,5,7,6,0,0,0,0,16775,6.8,17892,219,62,295,-124,28.1,1677.5,16,15,1,7,5,6,1,1,0,0,16480,6.8,18016,203,49,-295,124,25.2,1648.0
4857109837,0,72,2,0,3,8,3,0,0,0,0,14130,6.6,16428,161,47,-4489,-2605,20.8,1413.0,16,1,1,8,3,8,2,1,1,0,18619,7.4,19033,233,56,4489,2605,28.9,1861.9
4857067228,0,12,12,0,4,4,2,0,0,0,0,15567,6.8,17521,216,40,-66,-463,25.6,1556.7,34,0,1,4,4,2,0,0,0,0,15633,6.6,17984,168,55,66,463,22.3,1563.3
4856990730,1,13,1,0,11,6,7,0,0,0,0,19378,7.2,18067,191,76,2376,2232,26.7,1937.8,10,1,1,6,11,8,2,1,1,0,17002,6.6,15835,184,40,-2376,-2232,22.4,1700.2
4856968441,0,14,0,1,11,7,11,1,1,0,0,19507,6.8,16745,224,20,3394,-80,24.4,1950.7,14,1,0,6,10,1,0,0,0,0,16113,6.8,16825,170,51,-3394,80,22.1,1611.3
4856933430,0,49,0,0,5,7,2,0,0,0,0,16244,6.8,18180,220,54,-1029,377,27.4,1624.4,9,1,1,7,5,8,0,0,0,0,17273,7.0,17803,174,62,1029,-377,23.6,1727.3
4856906667,1,13,0,1,8,2,8,1,0,1,0,17796,6.8,18417,203,56,3543,1622,25.9,1779.6,10,2,0,2,8,0,1,1,0,0,14253,6.6,16795,174,60,-3543,-1622,23.4,1425.3
4854850307,0,10,1,0,1,3,0,2,1,1,0,13669,6.8,17793,179,76,-1887,165,25.5,1366.9,8,1,1,3,1,3,0,0,0,0,15556,6.8,17628,231,48,1887,-165,27.9,1555.6
4854816425,0,13,1,0,1,4,0,0,0,0,0,13927,6.6,16703,180,60,-1747,-1935,24.0,1392.7,14,0,1,4,1,3,1,1,0,0,15674,7.2,18638,219,64,1747,1935,28.3,1567.4
4854774721,0,15,1,0,7,9,10,0,0,0,0,17377,7.0,18024,217,68,-726,533,28.5,1737.7,11,5,1,9,7,11,0,0,0,0,18103,6.8,17491,203,67,726,-533,27.0,1810.3
4854739893,0,16,2,0,8,6,12,0,0,0,0,19135,7.0,17828,190,56,2907,111,24.6,1913.5,14,0,1,6,8,13,1,1,0,0,16228,6.8,17717,198,64,-2907,-111,26.2,1622.8
4854703213,0,35,2,1,4,3,5,0,0,0,0,15965,7.0,18247,220,64,855,-450,28.4,1596.5,32,1,0,3,4,1,0,0,0,0,15110,7.2,18697,216,60,-855,450,27.6,1511.0
4854676906,0,11,2,0,4,5,3,0,0,0,0,15129,7.0,17991,208,47,-1298,451,25.5,1512.9,15,3,1,5,4,5,1,1,0,0,16427,7.0,17540,232,64,1298,-451,29.6,1642.7
4854645519,0,211,1,1,4,4,4,1,1,0,0,17043,7.2,19472,221,80,359,-93,30.1,1704.3,11,0,0,4,4,3,0,0,0,0,16684,7.2,19565,241,72,-359,93,31.3,1668.4
4854616604,1,14,2,0,5,3,3,1,1,0,0,15562,6.8,17505,211,68,1013,626,27.9,1556.2,13,1,1,3,5,3,0,0,0,0,14549,6.6,16879,197,32,-1013,-626,22.9,1454.9
4856468372,1,19,2,1,8,9,8,1,1,0,0,16386,6.6,17012,175,44,-2726,-1347,21.9,1638.6,11,1,0,9,8,9,0,0,0,0,19112,7.0,18359,208,52,2726,1347,26.0,1911.2
4856426602,1,18,0,0,24,24,60,0,0,0,0,36905,11.0,39934,114,0,-1541,-1042,11.4,3690.5,0,0,1,24,24,58,0,0,0,0,38446,11.2,40976,111,0,1541,1042,11.1,3844.6
4856409017,0,0,0,0,27,26,64,0,0,0,0,36479,11.0,39558,100,0,-847,-1416,10.0,3647.9,77,0,1,25,26,62,0,0,0,0,37326,11.4,40974,107,0,847,1416,10.7,3732.6
4856354059,0,12,0,0,2,6,1,0,0,0,0,14077,6.6,16877,199,52,-2351,-2076,25.1,1407.7,10,0,1,6,2,4,0,0,0,0,16428,7.2,18953,188,60,2351,2076,24.8,1642.8
4855395344,1,1,0,1,28,28,74,0,0,0,1,38342,11.2,40879,122,0,1402,-1143,12.2,3834.2,38,0,0,27,27,78,0,0,0,0,36940,11.2,42022,96,0,-1402,1143,9.6,3694.0
4855379788,1,7,0,1,20,23,54,0,0,0,1,36282,11.0,38646,96,0,744,-1105,9.6,3628.2,0,0,0,23,20,56,0,0,0,0,35538,11.0,39751,91,0,-744,1105,9.1,3553.8
4855327098,1,10,0,1,2,6,2,0,0,0,0,15033,6.6,16906,165,44,-1735,-1284,20.9,1503.3,20,1,0,6,2,2,0,0,0,0,16768,6.8,18190,208,60,1735,1284,26.8,1676.8
4855299827,0,13,0,0,4,8,4,0,0,0,0,16634,6.8,17906,167,51,-1387,125,21.8,1663.4,11,0,1,8,4,7,0,0,0,0,18021,7.0,17781,180,40,1387,-125,22.0,1802.1
4855219165,0,10,1,1,5,2,4,0,0,0,0,16389,7.2,18238,191,67,2384,805,25.8,1638.9,13,0,0,2,5,3,0,0,0,0,14005,6.8,17433,182,57,-2384,-805,23.9,1400.5
4855186316,0,95,1,1,3,7,2,0,0,0,0,14688,6.6,16210,188,47,-1771,-1660,23.5,1468.8,29,1,0,7,3,5,0,0,0,0,16459,7.0,17870,156,64,1771,1660,22.0,1645.9
4855124137,1,12,0,0,1,1,0,0,0,0,0,14816,7.4,19641,224,72,333,2261,29.6,1481.6,76,0,1,1,1,0,1,1,0,0,14483,6.8,17380,215,56,-333,-2261,27.1,1448.3
4853036377,1,14,0,0,19,17,64,0,0,0,0,36415,11.0,40632,96,0,2840,5232,9.6,3641.5,1,3,1,17,19,39,0,0,0,0,33575,10.2,35400,92,0,-2840,-5232,9.2,3357.5
4853018962,1,13,0,1,26,16,61,0,0,0,1,38184,11.6,42395,105,0,4257,6731,10.5,3818.4,0,0,0,16,26,38,0,0,0,0,33927,10.4,35664,89,0,-4257,-6731,8.9,3392.7
4852952076,0,13,2,1,7,2,6,0,0,0,0,17707,7.2,18557,212,48,2901,413,26.0,1770.7,15,0,0,2,7,1,0,0,0,0,14806,6.6,18144,201,58,-2901,-413,25.9,1480.6
4852373822,1,79,0,0,13,16,31,0,0,0,0,35371,10.6,36926,106,0,-723,-2764,10.6,3537.1,0,0,1,16,13,41,0,0,0,0,36094,11.0,39690,114,0,723,2764,11.4,3609.4
4852352033,1,0,0,1,22,23,70,0,0,0,0,37855,11.4,42430,102,0,1970,3404,10.2,3785.5,0,0,0,23,22,67,0,0,0,0,35885,10.8,39026,83,0,-1970,-3404,8.3,3588.5
4851972486,0,0,0,0,18,24,41,0,0,0,1,34667,10.8,38430,83,0,-2315,-2812,8.3,3466.7,0,0,1,24,18,62,0,0,0,0,36982,11.2,41242,108,0,2315,2812,10.8,3698.2
4851962808,1,28,0,1,25,11,42,0,0,0,1,37852,11.2,41286,120,0,4866,5847,12.0,3785.2,0,11,0,11,25,24,0,0,0,0,32986,10.2,35439,107,0,-4866,-5847,10.7,3298.6
4849759486,0,14,0,0,5,6,3,0,0,0,0,16196,7.0,17586,189,60,-1089,-885,24.9,1619.6,12,3,1,6,5,7,1,1,0,0,17285,7.0,18471,195,60,1089,885,25.5,1728.5
4853383115,1,0,0,1,21,16,21,0,0,0,0,63115,12.0,55000,1,0,25483,22000,0.1,6311.5,0,0,0,9,14,9,0,0,0,0,37632,7.2,33000,1,0,-25483,-22000,0.1,3763.2
4853375977,1,0,0,1,23,15,30,0,0,0,0,66065,12.8,61000,4,0,29765,25000,0.4,6606.5,37,0,0,6,14,6,0,0,0,0,36300,7.6,36000,3,0,-29765,-25000,0.3,3630.0
4853365949,1,0,0,0,17,17,16,0,0,0,0,61325,12.2,56000,1,0,23425,23000,0.1,6132.5,0,0,1,11,11,9,0,0,0,0,37900,7.2,33000,0,0,-23425,-23000,0.0,3790.0
4853357098,1,0,0,1,24,29,16,0,0,0,0,64620,12.6,58000,0,0,21610,16000,0.0,6462.0,0,0,0,13,8,18,0,0,0,0,43010,9.0,42000,1,0,-21610,-16000,0.1,4301.0
4853019047,1,0,0,1,16,18,18,0,0,0,0,61755,12.0,55000,0,0,25545,22000,0.0,6175.5,0,0,0,11,9,8,0,0,0,0,36210,7.2,33000,0,0,-25545,-22000,0.0,3621.0
4853002041,1,3,0,1,18,12,20,0,0,0,0,63878,12.0,55000,0,0,28428,22000,0.0,6387.8,0,0,0,6,12,4,0,0,0,0,35450,7.2,33000,0,0,-28428,-22000,0.0,3545.0
4852974405,1,28,1,0,19,23,19,0,0,0,0,62210,12.0,55000,8,0,30295,22000,0.8,6221.0,3,3,1,12,8,13,0,0,0,0,31915,7.2,33000,0,0,-30295,-22000,0.0,3191.5
4852955114,1,0,0,1,15,12,18,0,0,0,0,47350,10.0,47500,0,0,20200,19000,0.0,4735.0,0,0,0,8,11,6,0,0,0,0,27150,6.0,28500,0,0,-20200,-19000,0.0,2715.0
4852927683,1,0,0,1,12,12,14,0,0,0,0,61100,12.0,55000,4,0,24900,22000,0.4,6110.0,0,0,0,8,8,6,0,0,0,0,36200,7.2,33000,1,0,-24900,-22000,0.1,3620.0
4852908761,1,4,0,1,9,19,19,0,0,0,0,44550,10.0,47500,0,0,16000,19000,0.0,4455.0,13,0,0,19,9,8,0,0,0,0,28550,6.0,28500,0,0,-16000,-19000,0.0,2855.0
4852598602,1,0,0,1,31,20,21,0,0,0,0,65946,12.0,55000,0,0,27638,20000,0.0,6594.6,0,0,0,8,19,13,0,0,0,0,38308,7.6,35000,0,0,-27638,-20000,0.0,3830.8
4852581476,1,43,0,0,16,16,20,0,0,0,0,62350,12.0,55000,0,0,25500,22000,0.0,6235.0,0,0,1,11,11,8,0,0,0,0,36850,7.2,33000,0,0,-25500,-22000,0.0,3685.0
4852479332,1,296,2,0,13,20,17,0,0,0,0,61762,12.0,55000,3,0,23426,22000,0.3,6176.2,1,1,1,14,7,11,0,0,0,0,38336,7.2,33000,2,0,-23426,-22000,0.2,3833.6
4852464677,1,10,0,1,30,23,21,0,0,0,0,65850,12.0,55000,0,0,26200,18000,0.0,6585.0,0,0,0,10,17,16,0,0,0,0,39650,8.0,37000,0,0,-26200,-18000,0.0,3965.0
4852453420,1,7,0,1,15,15,21,0,0,0,0,62815,12.0,55000,0,0,24999,22000,0.0,6281.5,0,0,0,11,11,8,0,0,0,0,37816,7.2,33000,0,0,-24999,-22000,0.0,3781.6
4852435469,1,0,0,1,18,23,17,0,0,0,0,62000,12.0,55000,0,0,24070,16000,0.0,6200.0,10,0,0,13,8,14,0,0,0,0,37930,8.4,39000,0,0,-24070,-16000,0.0,3793.0
4851969418,0,9,2,1,3,2,3,0,0,0,0,15271,6.6,17621,154,59,917,54,21.3,1527.1,14,1,0,2,3,2,1,1,0,0,14354,6.8,17567,168,60,-917,-54,22.8,1435.4
4851944539,1,11,0,1,12,4,8,0,0,0,0,18285,7.0,18309,176,48,3055,2414,22.4,1828.5,14,1,0,4,12,3,0,0,0,0,15230,6.4,15895,171,44,-3055,-2414,21.5,1523.0
4851912543,0,9,1,0,6,4,6,0,0,0,0,15599,7.0,18335,180,49,973,669,22.9,1559.9,8,0,1,4,6,1,0,0,0,0,14626,6.8,17666,196,60,-973,-669,25.6,1462.6
4851555338,1,85,1,0,3,4,2,0,0,0,0,15199,7.0,18548,208,68,448,2255,27.6,1519.9,15,2,1,4,3,2,1,1,0,0,14751,6.4,16293,192,52,-448,-2255,24.4,1475.1
4832159405,0,14,1,0,3,2,3,1,0,1,0,15052,6.6,16962,223,48,-588,-153,27.1,1505.2,88,2,1,2,3,1,0,0,0,0,15640,6.6,17115,199,44,588,153,24.3,1564.0
4734223421,0,13,0,1,4,4,1,0,0,0,0,15646,7.0,18446,216,56,-1006,395,27.2,1564.6,12,1,0,4,4,4,0,0,0,0,16652,7.0,18051,248,44,1006,-395,29.2,1665.2
4734200255,1,82,0,1,5,5,3,0,0,0,0,16837,6.8,16906,218,52,956,328,27.0,1683.7,12,1,0,5,5,7,1,1,0,0,15881,6.6,16578,184,48,-956,-328,23.2,1588.1
4725182718,0,13,1,0,4,5,3,0,0,0,0,15260,6.8,17359,213,52,-2095,-1450,26.5,1526.0,15,1,1,5,4,2,1,1,0,0,17355,7.0,18809,217,52,2095,1450,26.9,1735.5
4725155394,0,22,1,0,2,8,1,0,0,0,0,15254,7.0,18254,195,64,-2386,-635,25.9,1525.4,15,0,1,8,2,6,0,0,0,0,17640,7.2,18889,231,58,2386,635,28.9,1764.0
4718540655,1,12,3,1,5,2,9,1,1,0,0,16226,6.8,17471,215,63,1389,-666,27.8,1622.6,12,1,0,2,5,1,0,0,0,0,14837,6.6,18137,191,68,-1389,666,25.9,1483.7
4718502614,1,11,2,0,8,6,5,0,0,0,0,16620,6.8,17477,201,51,-382,-1136,25.2,1662.0,9,4,1,6,8,4,0,0,0,0,17002,7.2,18613,204,58,382,1136,26.2,1700.2
4715797222,1,10,1,0,3,3,1,1,0,1,0,16695,7.0,18363,251,72,2536,2049,32.3,1669.5,68,2,1,3,3,3,0,0,0,0,14159,6.4,16314,177,48,-2536,-2049,22.5,1415.9
4715765311,0,10,2,0,2,5,1,0,0,0,0,14668,6.6,17177,205,56,-2138,-2292,26.1,1466.8,11,1,1,5,2,3,1,1,0,0,16806,7.2,19469,225,60,2138,2292,28.5,1680.6
4714549591,0,9,1,0,7,6,1,0,0,0,0,16923,6.8,18857,176,60,-863,1309,23.6,1692.3,8,1,1,6,7,8,0,0,0,0,17786,7.0,17548,192,52,863,-1309,24.4,1778.6
4584488442,0,0,1,0,4,13,2,0,0,0,0,14653,6.4,15838,160,68,-6098,-2130,22.8,1465.3,0,4,1,13,4,16,1,1,0,0,20751,7.0,17968,203,60,6098,2130,26.3,2075.1
4583168830,1,0,2,0,3,4,4,0,0,0,0,16234,7.0,18016,211,48,178,174,25.9,1623.4,0,1,1,4,3,4,0,0,0,0,16056,7.2,17842,213,55,-178,-174,26.8,1605.6
4573242210,1,0,2,1,6,4,6,1,0,1,0,17524,7.4,20008,231,68,2672,672,29.9,1752.4,0,0,0,4,6,1,0,0,0,0,14852,7.0,19336,190,48,-2672,-672,23.8,1485.2
4572622790,1,20,0,0,14,15,34,0,0,0,1,34147,10.4,34932,97,0,-776,-1726,9.7,3414.7,0,1,1,15,14,38,0,0,0,0,34923,10.4,36658,120,0,776,1726,12.0,3492.3
4572601856,1,16,0,0,27,33,75,0,0,0,0,37140,11.2,41366,89,0,-1436,-1109,8.9,3714.0,0,1,1,33,27,86,0,0,0,0,38576,11.6,42475,107,0,1436,1109,10.7,3857.6
4572581429,1,18,3,0,26,20,73,0,0,0,4,41269,11.4,42669,103,0,4140,3151,10.3,4126.9,4,0,1,20,26,50,0,0,0,0,37129,11.0,39518,101,0,-4140,-3151,10.1,3712.9
4572564955,1,67,0,0,13,12,42,0,0,0,0,34030,10.4,35080,111,0,223,-1365,11.1,3403.0,7,0,1,12,13,31,0,0,0,0,33807,10.6,36445,79,0,-223,1365,7.9,3380.7
4572540811,1,10,0,0,30,26,79,0,0,0,1,38429,11.4,42513,85,0,310,980,8.5,3842.9,0,0,1,26,30,67,0,0,0,0,38119,11.4,41533,90,0,-310,-980,9.0,3811.9
4571015305,1,10,1,0,4,4,2,0,0,0,0,15778,7.0,18019,190,56,-36,-597,24.6,1577.8,13,0,1,4,4,0,1,1,0,0,15814,7.0,18616,204,64,36,597,26.8,1581.4
4855847610,1,0,0,1,26,15,26,0,0,0,0,67301,12.0,55000,0,0,31100,22000,0.0,6730.1,3,0,0,8,19,6,0,0,0,0,36201,7.2,33000,0,0,-31100,-22000,0.0,3620.1
4855833451,1,0,0,1,18,21,20,0,0,0,0,47003,10.4,49000,1,0,17403,20500,0.1,4700.3,0,0,0,15,12,15,0,0,0,0,29600,6.0,28500,0,0,-17403,-20500,0.0,2960.0
4855814297,1,34,1,1,23,18,16,0,0,0,0,47125,10.0,47500,8,0,18820,19000,0.8,4712.5,8,4,0,7,12,11,0,0,0,0,28305,6.0,28500,3,0,-18820,-19000,0.3,2830.5
4855799948,1,0,0,1,14,19,18,0,0,0,0,66200,12.0,55000,0,0,29000,22000,0.0,6620.0,0,0,0,14,9,12,0,0,0,0,37200,7.2,33000,0,0,-29000,-22000,0.0,3720.0
4855784507,1,2,0,1,25,18,25,0,0,0,0,65940,12.0,55000,0,0,29055,22000,0.0,6594.0,0,0,0,6,13,6,0,0,0,0,36885,7.2,33000,0,0,-29055,-22000,0.0,3688.5
4855770821,1,2,0,1,18,12,18,0,0,0,0,50150,10.0,47500,0,0,22300,19000,0.0,5015.0,0,0,0,7,13,5,0,0,0,0,27850,6.0,28500,0,0,-22300,-19000,0.0,2785.0
4855755334,1,0,0,1,15,21,19,0,0,0,0,46375,10.0,47500,1,0,17297,19000,0.1,4637.5,0,0,0,13,7,13,0,0,0,0,29078,6.0,28500,4,0,-17297,-19000,0.4,2907.8
4855746888,1,0,0,1,15,20,21,0,0,0,0,47708,12.0,55000,1,0,18804,22000,0.1,4770.8,27,0,0,13,8,5,0,0,0,0,28904,7.2,33000,0,0,-18804,-22000,0.0,2890.4
4855726395,1,0,0,1,19,14,16,0,0,0,0,48958,10.0,47500,0,0,21108,19000,0.0,4895.8,0,0,0,7,12,11,0,0,0,0,27850,6.0,28500,0,0,-21108,-19000,0.0,2785.0
4841137133,0,25,2,0,3,9,1,1,1,0,0,14754,6.0,14254,141,53,-3164,-4830,19.4,1475.4,19,1,1,9,3,1,0,0,0,0,17918,7.0,19084,211,56,3164,4830,26.7,1791.8
4841103960,1,26,1,1,10,5,9,0,0,0,0,17350,6.8,17460,201,32,2192,1443,23.3,1735.0,12,0,0,5,10,5,0,0,0,0,15158,6.6,16017,150,52,-2192,-1443,20.2,1515.8
4840088512,1,18,3,1,13,6,7,0,0,0,0,20356,7.2,18425,189,36,4354,3584,22.5,2035.6,15,1,0,6,13,9,1,1,0,0,16002,6.2,14841,160,48,-4354,-3584,20.8,1600.2
4840056634,0,16,1,0,2,6,3,0,0,0,0,15203,6.8,17595,213,62,-2041,-884,27.5,1520.3,22,3,1,6,2,7,1,1,0,0,17244,7.0,18479,190,50,2041,884,24.0,1724.4
4833021382,1,15,1,0,12,14,20,1,1,0,0,19302,6.8,16980,166,54,-778,-1052,22.0,1930.2,9,0,1,14,12,13,0,0,0,0,20080,7.0,18032,188,55,778,1052,24.3,2008.0
4832983898,1,12,1,0,5,6,5,1,1,0,0,16600,6.6,17576,213,58,241,496,27.1,1660.0,16,0,1,6,5,7,1,0,1,0,16359,6.6,17080,200,53,-241,-496,25.3,1635.9
4832942515,1,93,1,1,10,6,10,0,0,0,0,18410,6.6,17976,186,48,3979,3404,23.4,1841.0,15,3,0,6,10,6,0,0,0,0,14431,6.4,14572,140,40,-3979,-3404,18.0,1443.1
4831084358,0,26,0,0,3,6,2,0,0,0,0,14714,6.6,16504,155,48,-2669,-1661,20.3,1471.4,11,2,1,6,3,5,1,1,0,0,17383,7.0,18165,182,72,2669,1661,25.4,1738.3
4830924299,1,11,1,0,7,5,5,1,0,1,0,17794,7.0,18881,229,56,1725,3470,28.5,1779.4,13,3,1,5,7,5,0,0,0,0,16069,6.4,15411,167,36,-1725,-3470,20.3,1606.9
4830905962,1,13,2,0,7,5,5,0,0,0,0,16673,6.6,17596,198,52,961,429,25.0,1667.3,11,0,1,5,7,2,0,0,0,0,15712,6.8,17167,191,40,-961,-429,23.1,1571.2
4830893712,0,58,1,0,5,6,4,0,0,0,0,13337,6.6,16099,102,60,-3434,-2478,16.2,1333.7,9,1,1,6,5,2,0,0,0,0,16771,7.0,18577,238,46,3434,2478,28.4,1677.1
4854277905,1,11,0,1,26,20,54,0,0,0,0,37039,11.2,40773,105,0,572,26,10.5,3703.9,0,0,0,19,25,53,0,0,0,0,36467,11.2,40747,124,0,-572,-26,12.4,3646.7
4853629095,0,73,0,1,24,32,59,0,0,0,1,37141,10.8,39625,104,0,-3056,-5545,10.4,3714.1,0,0,0,31,23,81,0,0,0,0,40197,11.8,45170,114,0,3056,5545,11.4,4019.7
4853199391,0,8,1,0,4,3,4,0,0,0,0,15720,7.2,18578,205,62,-96,665,26.7,1572.0,13,1,1,3,4,1,2,1,1,0,15816,7.0,17913,238,56,96,-665,29.4,1581.6
4851178587,1,0,3,0,22,21,52,0,0,0,1,38163,11.0,40030,126,0,811,16,12.6,3816.3,9,0,1,21,22,50,0,0,0,0,37352,11.0,40014,110,0,-811,-16,11.0,3735.2
4850262711,1,41,1,1,35,26,98,0,0,0,2,40392,11.8,44724,100,0,471,1522,10.0,4039.2,4,0,0,26,35,71,0,0,0,0,39921,11.6,43202,88,0,-471,-1522,8.8,3992.1
4849649736,0,0,0,0,23,31,72,0,0,0,1,36982,11.4,42971,88,0,-810,529,8.8,3698.2,0,0,1,31,23,85,0,0,0,0,37792,11.6,42442,112,0,810,-529,11.2,3779.2
4849627487,0,0,0,0,23,25,60,0,0,0,0,36497,11.2,40719,99,0,-2051,-1533,9.9,3649.7,0,0,1,25,23,60,0,0,0,0,38548,11.2,42252,115,0,2051,1533,11.5,3854.8
4848706182,1,13,0,0,28,33,77,0,0,0,0,38053,11.8,44508,85,0,-1627,269,8.5,3805.3,0,0,1,33,28,79,0,0,0,0,39680,11.6,44239,93,0,1627,-269,9.3,3968.0
4846649967,1,0,0,0,18,27,41,0,0,0,0,35714,10.8,38228,111,0,-260,-1810,11.1,3571.4,0,0,1,27,18,80,0,0,0,0,35974,11.2,40038,118,0,260,1810,11.8,3597.4
4846628939,1,11,0,0,31,26,81,0,0,0,0,38436,11.6,43190,88,0,-576,-60,8.8,3843.6,0,0,1,26,31,66,0,0,0,0,39012,11.8,43250,101,0,576,60,10.1,3901.2
4846608218,0,0,0,1,26,30,68,0,0,0,0,38979,11.6,43188,114,0,-1933,-629,11.4,3897.9,16,0,0,30,26,62,0,0,0,0,40912,11.6,43817,104,0,1933,629,10.4,4091.2
4845429343,1,0,0,1,27,22,74,0,0,0,1,37977,11.4,41689,111,0,2798,934,11.1,3797.7,0,0,0,22,27,41,0,0,0,0,35179,11.2,40755,97,0,-2798,-934,9.7,3517.9
4845411670,0,260,0,0,16,24,27,0,0,0,1,34845,10.4,37401,74,0,-3497,-4989,7.4,3484.5,0,0,1,24,16,68,0,0,0,0,38342,11.4,42390,118,0,3497,4989,11.8,3834.2
4844815704,1,45,0,1,29,23,78,0,0,0,0,38191,11.6,43181,84,0,2522,2107,8.4,3819.1,17,0,0,23,29,50,0,0,0,0,35669,11.0,41074,86,0,-2522,-2107,8.6,3566.9
4844807160,1,0,4,0,27,17,78,0,0,0,1,38632,11.2,41813,121,0,4220,5563,12.1,3863.2,35,0,1,16,26,47,0,0,0,0,34412,10.6,36250,81,0,-4220,-5563,8.1,3441.2
4843942843,0,0,0,1,25,25,54,0,0,0,1,36843,11.4,40797,113,0,-1307,-231,11.3,3684.3,0,0,0,25,25,66,0,0,0,0,38150,11.0,41028,110,0,1307,231,11.0,3815.0
4843020415,1,0,0,1,26,28,59,0,0,0,1,37643,11.0,39954,95,0,-2013,-2817,9.5,3764.3,0,0,0,28,26,72,0,0,0,0,39656,11.6,42771,112,0,2013,2817,11.2,3965.6
4842996537,1,0,0,1,33,30,95,0,0,0,1,41996,11.8,45655,114,0,1726,1318,11.4,4199.6,0,0,0,30,33,73,0,0,0,0,40270,11.6,44337,76,0,-1726,-1318,7.6,4027.0
4842986150,0,25,3,0,24,40,64,0,0,0,0,37547,11.2,40309,110,0,-5703,-7781,11.0,3754.7,37,19,1,40,24,114,0,0,0,0,43250,12.2,48090,107,0,5703,7781,10.7,4325.0
4847471741,1,80,3,1,10,8,3,0,0,0,0,17722,7.0,18565,225,52,58,1058,27.7,1772.2,20,3,0,8,10,6,1,1,0,0,17664,6.8,17507,210,52,-58,-1058,26.2,1766.4
4846546121,0,14,2,0,2,4,3,0,0,0,0,14758,6.8,17316,215,42,-1512,-423,25.7,1475.8,13,0,1,4,2,6,0,0,0,0,16270,6.8,17739,232,62,1512,423,29.4,1627.0
4845718635,1,12,1,1,5,3,2,0,0,0,0,15995,7.2,18974,201,64,-239,642,26.5,1599.5,13,2,0,3,5,3,1,1,0,0,16234,6.8,18332,223,58,239,-642,28.1,1623.4
4845699586,0,10,8,0,2,9,3,0,0,0,0,13534,6.6,16220,154,52,-4674,-2304,20.6,1353.4,31,4,1,9,2,8,1,1,0,0,18208,7.2,18524,252,48,4674,2304,30.0,1820.8
4845677261,0,16,1,1,5,6,1,1,1,0,0,15706,6.8,17488,207,44,-1534,-958,25.1,1570.6,12,1,0,6,5,8,1,0,1,0,17240,7.0,18446,213,60,1534,958,27.3,1724.0
4845606175,0,11,1,0,7,10,7,0,0,0,0,16358,6.6,16437,182,48,-3339,-1609,23.0,1635.8,15,0,1,10,7,11,0,0,0,0,19697,6.8,18046,220,48,3339,1609,26.8,1969.7
4845591125,1,12,1,0,3,8,2,0,0,0,0,15178,7.0,17871,222,64,-2217,138,28.6,1517.8,84,1,1,8,3,8,1,1,0,0,17395,6.8,17733,216,48,2217,-138,26.4,1739.5
4845564284,0,31,3,0,0,5,0,0,0,0,0,13384,6.8,16736,203,52,-2701,-1256,25.5,1338.4,44,9,1,5,0,6,1,1,0,0,16085,7.0,17992,200,48,2701,1256,24.8,1608.5
4844763264,1,13,4,1,5,2,9,0,0,0,0,15655,6.6,16157,188,60,913,-702,24.8,1565.5,17,1,0,2,5,2,0,0,0,0,14742,6.6,16859,221,52,-913,702,27.3,1474.2
4843864405,1,12,2,0,10,4,7,0,0,0,0,17603,6.6,17475,212,44,2859,906,25.6,1760.3,8,3,1,3,9,2,1,1,0,0,14744,6.8,16569,185,56,-2859,-906,24.1,1474.4
4843106336,1,15,2,1,11,4,12,1,1,0,0,19221,6.8,17366,194,60,3619,410,25.4,1922.1,13,1,0,4,11,5,0,0,0,0,15602,6.6,16956,197,52,-3619,-410,24.9,1560.2
4843018437,0,15,3,1,6,7,5,0,0,0,0,17530,6.8,17251,210,48,26,-1792,25.8,1753.0,9,1,0,7,6,2,1,1,0,0,17504,7.4,19043,223,48,-26,1792,27.1,1750.4
4843000318,0,10,2,1,3,4,3,0,0,0,0,14663,6.6,17460,177,56,-1457,-1235,23.3,1466.3,13,2,0,4,3,5,0,0,0,0,16120,7.2,18695,223,60,1457,1235,28.3,1612.0
4842106858,1,15,1,1,2,3,0,1,1,0,0,15475,7.4,18991,216,64,383,1838,28.0,1547.5,7,0,0,3,2,4,0,0,0,0,15092,6.6,17153,182,56,-383,-1838,23.8,1509.2
4838751478,0,15,2,0,7,9,7,0,0,0,0,16673,6.6,16466,181,47,-1603,-1076,22.8,1667.3,36,0,1,9,7,12,1,1,0,0,18276,6.8,17542,210,44,1603,1076,25.4,1827.6
4836598159,1,6,0,1,7,3,11,1,1,0,0,17673,7.2,17917,219,60,2082,-37,27.9,1767.3,10,0,0,3,7,4,0,0,0,0,15591,6.6,17954,240,64,-2082,37,30.4,1559.1
4836560501,0,16,1,0,7,6,5,1,0,1,0,16579,6.8,17709,211,56,-802,-2070,26.7,1657.9,12,1,1,6,7,5,0,0,0,0,17381,7.2,19779,218,52,802,2070,27.0,1738.1
4834825031,1,11,13,1,4,7,3,0,0,0,0,15705,6.8,17995,160,64,-1150,-767,22.4,1570.5,37,1,0,7,4,5,0,0,0,0,16855,7.2,18762,229,64,1150,767,29.3,1685.5
4834781717,0,13,1,1,4,3,6,0,0,0,0,16195,6.8,17936,228,60,929,138,28.8,1619.5,13,2,0,3,4,3,1,1,0,0,15266,7.0,17798,240,52,-929,-138,29.2,1526.6
4834765043,1,15,1,1,14,6,15,1,1,0,0,20153,7.0,18954,224,52,3343,1013,27.6,2015.3,10,2,0,6,14,4,0,0,0,0,16810,7.0,17941,184,56,-3343,-1013,24.0,1681.0
4857277768,1,1,0,1,21,16,22,0,0,0,0,50350,10.0,47500,4,0,23530,19000,0.4,5035.0,0,0,0,7,12,4,0,0,0,0,26820,6.0,28500,0,0,-23530,-19000,0.0,2682.0
4856202486,1,27,2,1,26,17,61,0,0,0,0,36375,11.2,40847,102,0,2264,4222,10.2,3637.5,9,0,0,17,26,42,0,0,0,0,34111,10.6,36625,89,0,-2264,-4222,8.9,3411.1
4856156665,1,0,0,0,27,27,65,0,0,0,1,38354,11.4,41989,117,0,-587,-1959,11.7,3835.4,0,0,1,27,27,66,0,0,0,0,38941,11.6,43948,103,0,587,1959,10.3,3894.1
4856118991,0,8,1,1,33,21,87,0,0,0,0,38727,11.6,42986,109,0,796,1996,10.9,3872.7,4,1,0,21,33,56,0,0,0,0,37931,11.0,40990,102,0,-796,-1996,10.2,3793.1
4855990688,1,0,0,0,15,20,17,0,0,0,0,62000,12.4,57000,0,0,22700,24000,0.0,6200.0,0,0,1,13,8,12,0,0,0,0,39300,7.2,33000,0,0,-22700,-24000,0.0,3930.0
4855972976,1,0,0,0,12,21,18,0,0,0,0,47490,10.0,47500,0,0,18212,19000,0.0,4749.0,0,0,1,17,8,13,0,0,0,0,29278,6.0,28500,0,0,-18212,-19000,0.0,2927.8
4855953509,1,18,0,1,25,18,19,0,0,0,0,64450,12.0,55000,0,0,25500,20000,0.0,6445.0,0,0,0,7,14,16,0,0,0,0,38950,7.6,35000,0,0,-25500,-20000,0.0,3895.0
4855940535,1,17,0,1,27,10,28,0,0,0,0,64840,12.0,55000,0,0,30440,22000,0.0,6484.0,22,0,0,1,18,2,0,0,0,0,34400,7.2,33000,0,0,-30440,-22000,0.0,3440.0
4855887752,0,13,0,0,3,6,1,1,1,0,0,13756,6.8,17557,179,56,-3544,-2056,23.5,1375.6,20,0,1,6,3,6,0,0,0,0,17300,7.4,19613,212,60,3544,2056,27.2,1730.0
4855849178,1,12,0,0,4,3,2,0,0,0,0,14215,6.6,16564,174,44,-256,-1198,21.8,1421.5,9,2,1,3,4,1,0,0,0,0,14471,6.8,17762,145,60,256,1198,20.5,1447.1
4855710084,1,17,0,1,7,5,5,1,1,0,0,17676,7.4,19670,223,75,2240,2708,29.8,1767.6,12,0,0,5,7,5,0,0,0,0,15436,6.6,16962,208,33,-2240,-2708,24.1,1543.6
4853726781,1,3,0,1,21,17,14,0,0,0,0,59900,12.0,55000,0,0,22700,22000,0.0,5990.0,8,0,0,5,9,14,0,0,0,0,37200,7.2,33000,0,0,-22700,-22000,0.0,3720.0
4853709836,1,0,0,0,19,20,17,0,0,0,0,63050,12.0,55000,4,0,26200,22000,0.4,6305.0,1,0,1,10,9,9,0,0,0,0,36850,7.2,33000,7,0,-26200,-22000,0.7,3685.0
4853116658,1,559,0,1,20,21,18,0,0,0,0,62856,13.0,62500,2,0,23490,25000,0.2,6285.6,67,0,0,13,12,20,0,0,0,0,39366,7.8,37500,1,0,-23490,-25000,0.1,3936.6
4853105091,1,0,0,1,20,13,19,0,0,0,0,64100,12.8,61000,0,0,28300,27000,0.0,6410.0,0,0,0,7,14,3,0,0,0,0,35800,7.4,34000,0,0,-28300,-27000,0.0,3580.0
4853082718,1,14,0,1,18,18,18,0,0,0,0,62990,12.0,55000,0,0,25025,22000,0.0,6299.0,0,0,0,10,10,12,0,0,0,0,37965,7.2,33000,1,0,-25025,-22000,0.1,3796.5
4853071933,1,0,0,1,28,20,32,0,0,0,0,67646,13.8,66500,0,0,29716,29000,0.0,6764.6,0,0,0,10,18,7,0,0,0,0,37930,7.8,37500,0,0,-29716,-29000,0.0,3793.0
4853053834,1,0,0,0,23,13,20,0,0,0,0,63800,13.0,62500,1,0,26950,25000,0.1,6380.0,0,0,1,6,16,8,0,0,0,0,36850,7.8,37500,0,0,-26950,-25000,0.0,3685.0
4853030815,1,0,0,1,18,19,14,0,0,0,0,47915,10.0,47500,1,0,19925,19000,0.1,4791.5,0,0,0,12,11,12,0,0,0,0,27990,6.0,28500,2,0,-19925,-19000,0.2,2799.0
4853009976,1,17,0,1,15,25,17,0,0,0,0,54459,12.0,55000,0,0,15509,22000,0.0,5445.9,0,0,0,19,9,10,0,0,0,0,38950,7.2,33000,0,0,-15509,-22000,0.0,3895.0
4856119602,1,126,0,1,24,27,72,0,0,0,2,39354,11.4,42005,114,0,1054,2097,11.4,3935.4,0,0,0,27,24,85,0,0,0,0,38300,11.0,39908,102,0,-1054,-2097,10.2,3830.0
4856085669,1,0,2,0,17,27,38,0,0,0,1,34666,10.8,37886,103,0,-2555,-2426,10.3,3466.6,8,0,1,27,17,61,0,0,0,0,37221,11.2,40312,112,0,2555,2426,11.2,3722.1
4855070203,0,0,0,0,25,36,63,0,0,0,1,37744,11.2,42803,92,0,-3374,-3101,9.2,3774.4,0,0,1,36,25,100,0,0,0,0,41118,12.0,45904,122,0,3374,3101,12.2,4111.8
4855037695,0,0,0,0,8,18,26,0,0,0,0,31637,10.0,32981,107,0,-5322,-5392,10.7,3163.7,0,0,1,18,8,55,0,0,0,0,36959,11.0,38373,110,0,5322,5392,11.0,3695.9
4855005685,0,0,0,1,25,31,79,0,0,0,0,37272,10.8,39254,106,0,-3003,-4805,10.6,3727.2,0,0,0,31,25,94,0,0,0,0,40275,11.8,44059,99,0,3003,4805,9.9,4027.5
4847824139,1,14,2,1,11,9,17,0,0,0,0,19760,6.8,17933,197,48,2384,1489,24.5,1976.0,19,1,0,9,11,7,0,0,0,0,17376,6.6,16444,197,44,-2384,-1489,24.1,1737.6
4847782155,0,13,2,1,11,5,6,1,1,0,0,16685,6.8,18097,155,56,547,1740,21.1,1668.5,14,0,0,5,11,5,0,0,0,0,16138,6.6,16357,212,40,-547,-1740,25.2,1613.8
4826664320,0,0,0,0,19,22,42,0,0,0,0,35499,10.6,38213,124,0,-345,-819,12.4,3549.9,0,0,1,22,19,68,0,0,0,0,35844,11.0,39032,115,0,345,819,11.5,3584.4
4826644809,1,0,0,1,28,23,71,0,0,0,0,40055,11.8,43624,124,0,3209,3766,12.4,4005.5,0,0,0,23,28,43,0,0,0,0,36846,11.0,39858,98,0,-3209,-3766,9.8,3684.6
4826607598,0,0,0,1,28,30,71,0,0,0,0,37368,11.0,40310,93,0,-2273,-3357,9.3,3736.8,0,0,0,30,28,75,0,0,0,0,39641,11.6,43667,112,0,2273,3357,11.2,3964.1
4821002882,0,20,1,1,1,1,2,1,1,0,0,16216,7.4,19183,237,56,1124,0,29.3,1621.6,12,0,0,1,1,1,0,0,0,0,15092,7.0,19183,258,64,-1124,0,32.2,1509.2
4820942414,0,14,5,0,1,3,1,0,0,0,0,15095,7.0,18251,234,72,-191,-347,30.6,1509.5,18,1,1,3,1,1,0,0,0,0,15286,7.2,18598,233,56,191,347,28.9,1528.6
4820879860,1,20,1,0,2,3,4,1,1,0,0,14549,6.8,18020,223,52,-1436,-1200,27.5,1454.9,9,1,1,3,2,2,0,0,0,0,15985,7.4,19220,234,56,1436,1200,29.0,1598.5
4820818558,0,11,3,0,3,9,2,0,0,0,0,14376,6.4,16371,206,52,-3902,-2244,25.8,1437.6,16,1,1,9,3,11,1,1,0,0,18278,7.0,18615,230,48,3902,2244,27.8,1827.8
4817126206,1,0,0,1,29,24,72,0,0,0,0,37569,11.2,41141,115,0,1704,1091,11.5,3756.9,0,0,0,24,29,54,0,0,0,0,35865,11.0,40050,119,0,-1704,-1091,11.9,3586.5
4817100464,1,17,0,0,27,28,65,0,0,0,0,39670,11.8,44441,102,0,1111,3914,10.2,3967.0,0,4,1,28,27,70,0,0,0,0,38559,11.2,40527,105,0,-1111,-3914,10.5,3855.9
4815289322,0,0,0,1,34,35,93,0,0,0,0,39295,12.0,45534,92,0,-1840,-2969,9.2,3929.5,0,0,0,35,34,57,0,0,0,0,41135,12.0,48503,99,0,1840,2969,9.9,4113.5
4815260929,1,46,0,1,32,14,55,0,0,0,1,41107,12.0,45512,64,70,4812,6426,13.4,4110.7,21,0,0,14,32,36,0,0,0,0,36295,11.0,39086,62,43,-4812,-6426,10.5,3629.5
4815217212,0,19,0,1,19,11,31,0,0,0,0,34300,11.0,39381,78,59,-60,-72,13.7,3430.0,11,0,0,11,19,13,0,0,0,0,34360,11.0,39453,70,59,60,72,12.9,3436.0
4815186097,0,50,0,1,17,14,28,0,0,0,0,33413,10.8,37189,72,55,-869,-729,12.7,3341.3,14,19,0,14,17,24,0,0,0,0,34282,11.0,37918,84,59,869,729,14.3,3428.2
4783449341,1,11,0,1,8,7,7,0,0,0,0,16336,6.8,17190,182,51,-485,-628,23.3,1633.6,71,0,0,7,8,2,1,1,0,0,16821,6.8,17818,175,68,485,628,24.3,1682.1
4779612047,1,71,0,0,9,2,5,1,1,0,0,19663,7.2,19216,220,63,4673,2203,28.3,1966.3,10,1,1,2,9,0,0,0,0,0,14990,6.6,17013,193,52,-4673,-2203,24.5,1499.0
4779555642,1,76,0,1,8,3,7,1,1,0,0,17777,7.0,18391,205,44,2467,967,24.9,1777.7,9,2,0,3,8,2,0,0,0,0,15310,6.8,17424,191,48,-2467,-967,23.9,1531.0
4766936222,0,16,1,1,7,3,2,0,0,0,0,15309,6.6,16953,194,44,-270,-270,23.8,1530.9,76,0,0,2,6,2,0,0,0,0,15579,7.0,17223,180,48,270,270,22.8,1557.9
4766751766,1,15,0,1,7,6,9,0,0,0,0,16929,6.6,17244,186,64,852,349,25.0,1692.9,73,2,0,6,7,6,0,0,0,0,16077,6.6,16895,211,36,-852,-349,24.7,1607.7
4763844414,1,13,1,1,3,2,2,0,0,0,0,15762,7.0,18539,216,56,641,1105,27.2,1576.2,72,2,0,2,3,0,0,0,0,0,15121,6.6,17434,196,55,-641,-1105,25.1,1512.1
4760901255,0,12,0,0,2,4,1,0,0,0,0,14955,7.0,18275,187,64,-1770,-344,25.1,1495.5,12,2,1,4,2,1,0,0,0,0,16725,7.0,18619,218,67,1770,344,28.5,1672.5
4760886067,0,33,0,0,2,5,0,0,0,0,0,14000,6.8,17397,191,68,-2416,-411,25.9,1400.0,7,5,1,5,2,3,0,0,0,0,16416,6.8,17808,223,52,2416,411,27.5,1641.6
4760398343,1,10,2,0,1,4,0,0,0,0,0,14961,7.0,19463,227,64,-1143,1079,29.1,1496.1,12,0,1,4,1,3,0,0,0,0,16104,7.2,18384,214,56,1143,-1079,27.0,1610.4
4759356317,0,208,0,1,3,3,3,1,1,0,0,14268,6.6,16705,161,48,-1873,-1574,20.9,1426.8,13,2,0,3,3,1,1,0,1,0,16141,6.8,18279,208,64,1873,1574,27.2,1614.1
4759334933,0,10,0,0,6,8,10,1,1,0,0,16829,6.6,16906,187,60,-702,-1218,24.7,1682.9,10,2,1,8,6,5,0,0,0,0,17531,7.2,18124,222,60,702,1218,28.2,1753.1
4758563661,1,10,1,0,6,3,6,0,0,0,0,16815,7.2,18566,226,54,1133,1328,28.0,1681.5,14,0,1,3,6,2,0,0,0,0,15682,6.8,17238,221,40,-1133,-1328,26.1,1568.2
4758472513,1,10,5,1,10,4,16,2,1,1,0,19153,7.2,18821,202,52,4597,1812,25.4,1915.3,75,2,0,3,9,1,0,0,0,0,14556,6.8,17009,174,56,-4597,-1812,23.0,1455.6
4758441935,1,10,0,1,13,1,18,0,0,0,0,19687,7.0,18261,204,52,4213,512,25.6,1968.7,70,0,0,1,13,1,1,1,0,0,15474,7.0,17749,217,64,-4213,-512,28.1,1547.4
4758001012,0,76,0,1,3,5,3,1,0,1,0,15385,6.8,17430,206,32,-881,203,23.8,1538.5,13,1,0,5,3,7,1,1,0,0,16266,6.6,17227,215,52,881,-203,26.7,1626.6
4757962080,1,76,1,1,9,6,7,0,0,0,0,18498,6.8,18698,195,44,3358,2337,23.9,1849.8,8,0,0,6,9,4,0,0,0,0,15140,6.6,16361,160,44,-3358,-2337,20.4,1514.0
4757796284,0,72,0,0,6,9,1,1,1,0,0,15556,7.2,18080,213,51,-2901,-2116,26.4,1555.6,6,0,1,8,5,6,0,0,0,0,18457,7.2,20196,234,64,2901,2116,29.8,1845.7
4757019115,1,10,0,1,6,1,2,0,0,0,0,16041,7.0,18268,220,44,1426,1406,26.4,1604.1,72,2,0,1,6,0,0,0,0,0,14615,7.0,16862,194,56,-1426,-1406,25.0,1461.5
4756745156,0,81,2,1,8,9,11,0,0,0,0,16022,6.6,17094,161,31,-2578,-2671,19.2,1602.2,11,2,0,8,7,5,1,1,0,0,18600,7.2,19765,212,68,2578,2671,28.0,1860.0
4756329098,1,12,2,0,8,4,8,0,0,0,0,18009,7.0,18095,202,57,2939,1955,25.9,1800.9,358,0,1,4,8,1,0,0,0,0,15070,6.4,16140,170,52,-2939,-1955,22.2,1507.0
4856812299,1,11,4,0,2,3,2,1,1,0,0,14652,7.0,18196,204,52,-540,-295,25.6,1465.2,23,0,1,3,2,3,0,0,0,0,15192,7.0,18491,197,56,540,295,25.3,1519.2
4856214150,1,13,1,1,3,4,4,0,0,0,0,16269,6.8,17729,227,52,85,-126,27.9,1626.9,8,1,0,4,3,4,1,1,0,0,16184,6.8,17855,198,56,-85,126,25.4,1618.4
4856161875,0,49,12,1,9,4,6,0,0,0,0,18709,7.4,19225,202,68,3456,1782,27.0,1870.9,30,2,0,4,9,2,0,0,0,0,15253,6.8,17443,191,48,-3456,-1782,23.9,1525.3
4848618188,1,16,1,0,8,4,11,0,0,0,0,18089,7.0,18776,223,66,3076,1828,28.9,1808.9,16,1,1,4,8,7,0,0,0,0,15013,6.6,16948,213,37,-3076,-1828,25.0,1501.3
4848594208,1,13,0,0,4,5,4,0,0,0,0,17061,7.0,18813,216,60,494,1299,27.6,1706.1,15,2,1,5,4,5,0,0,0,0,16567,6.8,17514,209,48,-494,-1299,25.7,1656.7
4847907195,0,13,1,0,3,5,4,0,0,0,0,15100,6.8,17107,190,48,-1703,121,23.8,1510.0,7,1,1,5,3,7,0,0,0,0,16803,6.8,16986,206,45,1703,-121,25.1,1680.3
4847815846,0,158,0,1,8,3,6,1,1,0,0,15772,6.6,17272,194,46,1533,1216,24.0,1577.2,12,0,0,2,7,1,0,0,0,0,14239,6.6,16056,169,48,-1533,-1216,21.7,1423.9
4847788328,0,8,1,1,4,8,4,1,0,1,0,14679,6.4,15726,169,36,-3060,-1950,20.5,1467.9,11,1,0,8,4,10,1,1,0,0,17739,6.8,17676,181,64,3060,1950,24.5,1773.9
4840110724,1,10,0,1,8,3,7,0,0,0,0,18804,7.2,19267,247,48,4268,2459,29.5,1880.4,10,0,0,3,8,3,0,0,0,0,14536,6.6,16808,200,48,-4268,-2459,24.8,1453.6
4840047583,0,10,3,0,2,6,0,1,0,1,0,15481,7.2,19355,216,72,-21,1444,28.8,1548.1,19,2,1,6,2,5,1,1,0,0,15502,6.8,17911,170,52,21,-1444,22.2,1550.2
4787816494,1,12,10,0,3,6,3,0,0,0,0,14642,6.6,16343,196,60,-3093,-1896,25.6,1464.2,33,1,1,6,3,6,0,0,0,0,17735,7.0,18239,202,48,3093,1896,25.0,1773.5
4781543999,0,38,3,1,6,5,7,0,0,0,0,16873,7.0,18572,203,64,-266,-172,26.7,1687.3,16,11,0,5,6,2,0,0,0,0,17139,7.2,18744,218,56,266,172,27.4,1713.9
4767988684,0,31,1,0,2,3,2,1,0,1,0,14940,6.6,17755,213,56,-364,-628,26.9,1494.0,9,11,1,3,2,2,0,0,0,0,15304,7.0,18383,194,60,364,628,25.4,1530.4
4767953203,0,9,0,0,5,3,6,1,1,0,0,16289,7.0,17908,199,57,1613,1368,25.6,1628.9,11,0,1,3,5,2,1,0,1,0,14676,6.6,16540,185,51,-1613,-1368,23.6,1467.6
4764570539,0,35,2,1,6,5,7,0,0,0,0,16752,7.0,17796,223,50,-1229,-395,27.3,1675.2,12,14,0,5,6,8,0,0,0,0,17981,7.0,18191,233,49,1229,395,28.2,1798.1
4763814278,0,11,0,0,2,2,1,1,1,0,0,15087,6.8,17435,195,64,1292,1375,25.9,1508.7,11,1,1,2,2,2,0,0,0,0,13795,6.6,16060,164,56,-1292,-1375,22.0,1379.5
4763784986,0,20,1,0,5,5,1,0,0,0,0,14841,6.8,17289,190,60,-2259,-215,25.0,1484.1,12,1,1,5,5,8,1,1,0,0,17100,6.8,17504,229,50,2259,215,27.9,1710.0
4763653577,1,0,0,0,24,23,63,0,0,0,0,37750,11.0,41023,105,0,1161,432,10.5,3775.0,0,0,1,23,24,52,0,0,0,0,36589,11.4,40591,101,0,-1161,-432,10.1,3658.9
4763551906,0,12,1,0,6,8,3,1,1,0,0,17303,7.2,18342,212,55,495,8,26.7,1730.3,14,1,1,8,6,6,0,0,0,0,16808,7.0,18334,212,64,-495,-8,27.6,1680.8
4762765223,1,14,0,1,2,2,4,0,0,0,0,14986,6.8,16898,188,68,469,132,25.6,1498.6,14,0,0,2,2,3,1,1,0,0,14517,6.6,16766,196,44,-469,-132,24.0,1451.7
4857470376,1,5,0,1,19,11,17,0,0,0,0,46415,10.0,47500,1,0,18845,19000,0.1,4641.5,0,0,0,5,13,5,0,0,0,0,27570,6.0,28500,1,0,-18845,-19000,0.1,2757.0
4857423099,1,12,14,0,3,4,2,1,0,1,0,14570,6.8,18658,208,60,-844,514,26.8,1457.0,38,1,1,4,3,2,1,1,0,0,15414,7.0,18144,228,46,844,-514,27.4,1541.4
4857384035,1,13,2,1,4,3,4,1,1,0,0,17298,6.8,18350,229,52,1705,1366,28.1,1729.8,10,0,0,3,4,5,0,0,0,0,15593,6.6,16984,190,48,-1705,-1366,23.8,1559.3
4857348505,1,1,0,1,18,18,15,0,0,0,0,47650,10.0,47500,7,0,18300,19000,0.7,4765.0,47,0,0,10,10,12,0,0,0,0,29350,6.0,28500,5,0,-18300,-19000,0.5,2935.0
4856902016,1,13,0,0,5,8,4,1,1,0,0,17078,7.0,18475,193,68,-53,1060,26.1,1707.8,7,2,1,8,5,8,0,0,0,0,17131,6.6,17415,205,44,53,-1060,24.9,1713.1
4856884353,1,0,0,0,16,13,15,0,0,0,0,60950,12.0,55000,0,0,24790,22000,0.0,6095.0,21,0,1,7,10,8,0,0,0,0,36160,7.2,33000,1,0,-24790,-22000,0.1,3616.0
4854125843,1,5,0,1,17,13,18,0,0,0,0,61650,12.0,55000,0,0,26152,22000,0.0,6165.0,0,0,0,7,11,8,0,0,0,0,35498,7.2,33000,0,0,-26152,-22000,0.0,3549.8
4854090712,1,1,0,1,17,16,22,0,0,0,0,62220,12.0,55000,0,0,30320,22000,0.0,6222.0,55,0,0,12,13,11,0,0,0,0,31900,7.2,33000,0,0,-30320,-22000,0.0,3190.0
4854072605,1,9,0,0,25,18,27,0,0,0,0,63648,12.0,55000,5,0,25958,18000,0.5,6364.8,0,0,1,11,18,9,0,0,0,0,37690,8.0,37000,4,0,-25958,-18000,0.4,3769.0
4854041321,1,43,0,0,11,20,18,0,0,0,0,46300,10.0,47500,0,0,18100,19000,0.0,4630.0,0,0,1,14,5,11,0,0,0,0,28200,6.0,28500,0,0,-18100,-19000,0.0,2820.0
4854017807,1,7,0,1,16,14,17,0,0,0,0,44907,10.0,47500,4,0,17757,19000,0.4,4490.7,45,0,0,7,9,10,0,0,0,0,27150,6.0,28500,0,0,-17757,-19000,0.0,2715.0
4853987455,1,34,2,1,17,14,22,0,0,0,0,46460,10.0,47500,6,0,18935,17820,0.6,4646.0,53,4,0,9,12,6,0,0,0,0,27525,6.2,29680,0,0,-18935,-17820,0.0,2752.5
4853967954,1,5,0,0,19,19,19,0,0,0,0,62000,12.2,56000,0,0,24100,23000,0.0,6200.0,0,0,1,12,12,11,0,0,0,0,37900,7.2,33000,0,0,-24100,-23000,0.0,3790.0
4853485402,1,29,3,1,17,18,17,0,0,0,0,46090,10.0,47500,5,0,18235,19000,0.5,4609.0,49,1,0,11,10,9,0,0,0,0,27855,6.0,28500,0,0,-18235,-19000,0.0,2785.5
4853470343,1,0,0,0,17,21,23,0,0,0,0,49450,10.0,47500,0,0,20900,19000,0.0,4945.0,0,0,1,16,12,9,0,0,0,0,28550,6.0,28500,0,0,-20900,-19000,0.0,2855.0
4853463873,1,0,0,1,25,16,23,0,0,0,0,63130,12.0,55000,0,0,26980,22000,0.0,6313.0,0,0,0,4,13,6,0,0,0,0,36150,7.2,33000,0,0,-26980,-22000,0.0,3615.0
4853364858,1,44,0,0,21,17,20,0,0,0,0,46650,10.0,47500,0,0,19475,19000,0.0,4665.0,0,0,1,8,12,7,0,0,0,0,27175,6.0,28500,1,0,-19475,-19000,0.1,2717.5
4853338204,1,0,0,1,20,19,23,0,0,0,0,63400,12.0,55000,0,0,25500,22000,0.0,6340.0,0,0,0,12,13,9,0,0,0,0,37900,7.2,33000,0,0,-25500,-22000,0.0,3790.0
4852800970,1,0,0,1,15,22,14,0,0,0,0,62700,12.4,57000,0,0,24100,24000,0.0,6270.0,0,0,0,16,9,16,0,0,0,0,38600,7.2,33000,0,0,-24100,-24000,0.0,3860.0
4852776860,1,0,0,1,11,21,15,0,0,0,0,46300,10.0,47500,0,0,17400,16000,0.0,4630.0,0,0,0,15,5,13,0,0,0,0,28900,6.6,31500,0,0,-17400,-16000,0.0,2890.0
4857213784,1,0,1,0,32,24,89,0,0,0,0,41184,12.0,45524,114,0,2596,3323,11.4,4118.4,3,0,1,24,32,47,0,0,0,0,38588,11.2,42201,95,0,-2596,-3323,9.5,3858.8
4857151735,0,34,0,0,21,26,50,0,0,0,0,35123,10.4,37311,99,0,-1143,-3040,9.9,3512.3,34,0,1,26,21,73,0,0,0,0,36266,11.2,40351,86,0,1143,3040,8.6,3626.6
4857107648,1,0,0,0,17,21,18,0,0,0,0,61300,12.0,55000,0,0,23275,22000,0.0,6130.0,0,0,1,11,7,13,0,0,0,0,38025,7.2,33000,0,0,-23275,-22000,0.0,3802.5
4857097861,1,0,0,0,15,18,15,0,0,0,0,45250,10.0,47500,0,0,17400,19000,0.0,4525.0,10,0,1,10,7,10,0,0,0,0,27850,6.0,28500,0,0,-17400,-19000,0.0,2785.0
4857058968,1,0,0,1,40,23,116,0,0,0,2,42479,12.0,46322,104,0,5174,3112,10.4,4247.9,0,0,0,23,40,52,0,0,0,0,37305,11.6,43210,102,0,-5174,-3112,10.2,3730.5
4857031406,1,0,0,1,22,14,52,0,0,0,0,36275,11.0,40147,109,0,1467,4924,10.9,3627.5,0,0,0,14,22,28,0,0,0,0,34808,10.0,35223,107,0,-1467,-4924,10.7,3480.8
4856960978,0,0,0,1,28,26,73,0,0,0,0,36786,11.0,40689,92,0,-2146,-2099,9.2,3678.6,7,0,0,26,28,65,0,0,0,0,38932,11.6,42788,96,0,2146,2099,9.6,3893.2
4856196548,1,0,0,0,25,19,20,0,0,0,0,47412,10.2,48680,5,0,18812,18680,0.5,4741.2,3,0,1,9,15,12,0,0,0,0,28600,6.4,30000,1,0,-18812,-18680,0.1,2860.0
4856171122,1,6,0,1,22,21,23,0,0,0,0,50411,10.0,47500,0,0,23611,19000,0.0,5041.1,5,0,0,8,9,9,0,0,0,0,26800,6.0,28500,0,0,-23611,-19000,0.0,2680.0
4856157129,1,19,0,0,20,21,27,0,0,0,0,74350,14.4,67000,0,0,30100,28000,0.0,7435.0,6,0,1,13,12,11,0,0,0,0,44250,8.4,39000,0,0,-30100,-28000,0.0,4425.0
4856136272,1,13,0,1,15,21,17,0,0,0,0,61300,12.0,55000,0,0,23400,22000,0.0,6130.0,8,0,0,12,6,11,0,0,0,0,37900,7.2,33000,0,0,-23400,-22000,0.0,3790.0
4856089715,1,0,0,0,30,33,65,0,0,0,1,40322,11.6,43747,106,0,906,1253,10.6,4032.2,15,0,1,33,30,75,0,0,0,0,39416,11.4,42494,86,0,-906,-1253,8.6,3941.6
4855934357,0,0,0,0,24,28,60,0,0,0,2,39507,11.4,42322,119,0,-1123,-244,11.9,3950.7,2,0,1,28,24,81,0,0,0,0,40630,11.4,42566,98,0,1123,244,9.8,4063.0
4855921783,1,78,0,0,36,34,88,0,0,0,2,41804,11.6,43684,103,0,-720,-2692,10.3,4180.4,0,0,1,34,36,97,0,0,0,0,42524,12.2,46376,112,0,720,2692,11.2,4252.4
4854993781,1,2,0,1,38,20,96,0,0,0,0,40110,11.8,44274,101,0,4337,4754,10.1,4011.0,0,0,0,20,38,43,0,0,0,0,35773,11.0,39520,112,0,-4337,-4754,11.2,3577.3
4854948688,0,0,0,1,29,17,69,0,0,0,1,39387,11.4,41165,92,0,3045,-39,9.2,3938.7,0,0,0,17,29,42,0,0,0,0,36342,11.2,41204,102,0,-3045,39,10.2,3634.2
4850736174,1,0,0,1,32,23,67,0,0,0,0,38337,11.2,42409,108,0,2224,2851,10.8,3833.7,18,0,0,23,32,53,0,0,0,0,36113,11.0,39558,103,0,-2224,-2851,10.3,3611.3
4847777640,0,52,0,0,5,3,6,0,0,0,0,14946,6.6,16116,159,40,-2318,-1496,19.9,1494.6,13,1,1,3,5,3,0,0,0,0,17264,6.8,17612,175,60,2318,1496,23.5,1726.4
4847738153,0,50,1,0,3,4,3,1,1,0,0,14722,6.6,17635,175,56,-1566,-478,23.1,1472.2,22,2,1,4,3,4,0,0,0,0,16288,6.8,18113,195,60,1566,478,25.5,1628.8
4847012534,1,11,1,1,4,6,3,1,1,0,0,16202,7.2,18343,253,52,-233,250,30.5,1620.2,13,0,0,6,4,8,0,0,0,0,16435,6.8,18093,215,60,233,-250,27.5,1643.5
4854389084,1,48,0,0,23,20,23,0,0,0,0,48140,10.4,49000,0,0,19570,20500,0.0,4814.0,0,0,1,13,16,8,0,0,0,0,28570,6.0,28500,0,0,-19570,-20500,0.0,2857.0
4854380167,1,40,0,1,19,17,19,0,0,0,0,57560,12.0,55000,0,0,22990,22000,0.0,5756.0,6,0,0,9,11,11,0,0,0,0,34570,7.2,33000,1,0,-22990,-22000,0.1,3457.0
4854374086,1,92,0,1,17,15,15,0,0,0,0,46022,10.0,47500,0,0,19539,19000,0.0,4602.2,0,0,0,7,9,7,0,0,0,0,26483,6.0,28500,0,0,-19539,-19000,0.0,2648.3
4854359446,1,7,0,0,13,16,10,0,0,0,0,45950,10.2,48680,0,0,17400,20180,0.0,4595.0,0,0,1,10,7,12,0,0,0,0,28550,6.0,28500,0,0,-17400,-20180,0.0,2855.0
4854346794,1,12,0,0,11,5,17,0,0,0,0,19239,6.8,18040,189,40,3498,2510,22.9,1923.9,9,0,1,5,11,6,0,0,0,0,15741,6.4,15530,202,44,-3498,-2510,24.6,1574.1
4854316486,0,11,1,1,11,6,9,0,0,0,0,19317,7.0,18800,211,56,2929,2055,26.7,1931.7,13,0,0,6,11,6,0,0,0,0,16388,7.0,16745,172,56,-2929,-2055,22.8,1638.8
4854262690,0,14,5,1,5,3,3,0,0,0,0,16086,6.6,17521,184,52,1472,812,23.6,1608.6,32,2,0,3,5,0,0,0,0,0,14614,6.8,16709,164,60,-1472,-812,22.4,1461.4
4854226402,0,15,1,0,2,4,3,0,0,0,0,14807,6.8,17709,211,54,-2717,-607,26.5,1480.7,11,2,1,4,2,4,0,0,0,0,17524,7.0,18316,231,48,2717,607,27.9,1752.4
4854168710,1,13,0,0,4,8,3,0,0,0,0,16320,7.2,18358,213,60,-1032,759,27.3,1632.0,14,0,1,8,4,8,0,0,0,0,17352,7.0,17599,174,60,1032,-759,23.4,1735.2
4854126226,0,59,0,0,6,8,10,0,0,0,0,17284,7.0,17812,185,44,-770,253,22.9,1728.4,9,0,1,8,6,7,1,1,0,0,18054,7.0,17559,224,53,770,-253,27.7,1805.4
4854083509,1,20,0,1,13,2,18,0,0,0,0,21552,7.0,18463,222,36,7622,1981,25.8,2155.2,8,2,0,2,13,1,1,1,0,0,13930,6.6,16482,173,60,-7622,-1981,23.3,1393.0
4854048873,0,10,1,0,0,7,0,1,0,1,0,14311,6.6,16455,191,44,-3933,-2198,23.5,1431.1,31,2,1,7,0,6,0,0,0,0,18244,7.0,18653,228,64,3933,2198,29.2,1824.4
4853985384,0,13,0,0,3,5,3,1,0,1,0,16388,7.0,18138,228,60,-435,-1113,28.8,1638.8,11,0,1,5,3,9,1,1,0,0,16823,7.2,19251,233,68,435,1113,30.1,1682.3
4853630749,1,0,0,1,22,20,24,0,0,0,0,66044,12.0,55000,2,0,25169,22000,0.2,6604.4,0,0,0,13,15,10,0,0,0,0,40875,7.2,33000,1,0,-25169,-22000,0.1,4087.5
4853605494,1,0,0,1,10,17,10,0,0,0,0,45250,10.4,49860,0,0,17400,21360,0.0,4525.0,0,0,0,12,5,9,0,0,0,0,27850,6.0,28500,0,0,-17400,-21360,0.0,2785.0
4853190835,1,0,0,1,22,17,15,0,0,0,0,62700,12.0,55000,0,0,26900,22000,0.0,6270.0,7,0,0,5,10,12,0,0,0,0,35800,7.2,33000,0,0,-26900,-22000,0.0,3580.0
4853145312,1,8,0,1,5,4,5,0,0,0,0,15769,7.0,18387,176,48,1402,1289,22.4,1576.9,139,0,0,4,5,4,0,0,0,0,14367,6.6,17098,181,52,-1402,-1289,23.3,1436.7
4852996088,1,32,2,0,16,15,22,0,0,0,0,46410,10.4,49000,4,0,18900,20500,0.4,4641.0,0,2,1,9,10,5,0,0,0,0,27510,6.0,28500,0,0,-18900,-20500,0.0,2751.0
4852970981,1,0,0,1,19,11,23,0,0,0,0,63451,13.0,62500,0,0,28280,28000,0.0,6345.1,0,0,0,6,14,3,0,0,0,0,35171,7.4,34500,0,0,-28280,-28000,0.0,3517.1
4851333215,0,80,2,1,1,0,1,0,0,0,0,14639,6.8,17811,225,52,309,-70,27.7,1463.9,8,0,0,0,1,0,1,1,0,0,14330,7.0,17881,200,68,-309,70,26.8,1433.0
4845764483,0,0,0,0,22,20,53,0,0,0,0,35905,11.0,39998,99,0,789,213,9.9,3590.5,0,0,1,20,22,48,0,0,0,0,35116,11.2,39785,108,0,-789,-213,10.8,3511.6
4844716500,1,10,2,0,4,8,1,0,0,0,0,16254,7.2,18873,205,60,-173,1012,26.5,1625.4,14,1,1,8,4,3,1,1,0,0,16427,6.8,17861,161,56,173,-1012,21.7,1642.7
4844668525,0,17,0,0,3,9,1,0,0,0,1,15457,7.2,17756,202,52,-4044,-1355,25.4,1545.7,7,1,1,9,3,8,1,1,0,0,19501,7.2,19111,204,52,4044,1355,25.6,1950.1
4842958500,1,13,1,1,6,5,4,1,1,0,0,16609,7.0,17580,172,50,641,482,22.2,1660.9,12,0,0,5,6,6,0,0,0,0,15968,6.8,17098,186,42,-641,-482,22.8,1596.8
4842941858,1,13,2,1,4,2,3,0,0,0,0,14882,7.0,18006,180,60,-82,92,24.0,1488.2,13,1,0,2,4,3,1,1,0,0,14964,6.8,17914,191,72,82,-92,26.3,1496.4
4842917973,1,13,0,1,4,2,3,2,1,1,0,15435,7.0,17706,183,72,833,836,25.5,1543.5,21,1,0,2,4,2,0,0,0,0,14602,6.8,16870,193,48,-833,-836,24.1,1460.2
4836673582,0,5,1,1,4,9,6,0,0,0,0,15896,6.6,16403,182,40,-1381,-651,22.2,1589.6,14,0,0,9,4,2,0,0,0,0,17277,6.8,17054,170,59,1381,651,22.9,1727.7
4836629458,0,35,1,1,5,10,5,0,0,0,0,14499,6.0,14514,131,36,-3935,-4366,16.7,1449.9,11,0,0,10,5,8,0,0,0,0,18434,7.0,18880,192,68,3935,4366,26.0,1843.4
4836524343,1,15,2,1,2,5,3,0,0,0,0,15956,6.8,17616,205,54,271,-528,25.9,1595.6,13,1,0,5,2,3,0,0,0,0,15685,7.0,18144,197,58,-271,528,25.5,1568.5
4836409389,0,9,1,1,2,6,1,0,0,0,0,16311,7.0,18106,181,52,-592,-276,23.3,1631.1,13,2,0,6,2,8,2,1,1,0,16903,7.0,18382,222,60,592,276,28.2,1690.3
4835494187,1,33,1,0,8,3,5,0,0,0,0,18692,7.0,18624,208,52,3293,1341,26.0,1869.2,28,3,1,3,8,2,0,0,0,0,15399,6.8,17283,155,48,-3293,-1341,20.3,1539.9
4833543420,1,32,2,0,2,3,3,1,1,0,0,15157,7.2,18030,216,64,-198,636,28.0,1515.7,14,1,1,3,2,3,0,0,0,0,15355,6.8,17394,227,44,198,-636,27.1,1535.5
4832663104,1,13,2,1,4,4,6,0,0,0,0,16040,6.6,16430,207,48,750,707,25.5,1604.0,14,2,0,4,4,5,0,0,0,0,15290,6.2,15723,160,56,-750,-707,21.6,1529.0
4831040757,0,12,1,0,6,3,6,1,1,0,0,16412,6.8,18642,207,56,1384,1169,26.3,1641.2,14,1,1,3,6,1,1,0,1,0,15028,6.8,17473,178,44,-1384,-1169,22.2,1502.8
4830013037,1,14,0,1,17,11,41,0,0,0,0,34477,10.8,37868,85,0,1653,1736,8.5,3447.7,0,0,0,11,17,20,0,0,0,0,32824,10.4,36132,80,0,-1653,-1736,8.0,3282.4
4810834980,0,0,0,0,23,44,52,0,0,0,1,39463,11.4,42287,87,0,-4185,-6599,8.7,3946.3,47,0,1,44,23,95,0,0,0,0,43648,12.4,48886,120,0,4185,6599,12.0,4364.8
4805949156,0,17,2,0,3,5,4,1,1,0,0,14492,6.8,17084,188,59,-1246,-362,24.7,1449.2,10,0,1,5,3,5,0,0,0,0,15738,6.8,17446,209,40,1246,362,24.9,1573.8
4789360282,1,18,0,1,9,4,7,0,0,0,0,18385,6.8,17686,209,48,4395,2448,25.7,1838.5,15,1,0,4,9,3,0,0,0,0,13990,6.2,15238,144,48,-4395,-2448,19.2,1399.0
4789343041,0,123,1,0,2,4,2,0,0,0,0,15226,6.8,18036,204,64,-1526,-628,26.8,1522.6,12,0,1,4,2,3,1,1,0,0,16752,7.2,18664,223,62,1526,628,28.5,1675.2
4857440562,0,9,1,0,6,4,5,0,0,0,0,14332,6.6,16788,146,40,-575,-1272,18.6,1433.2,15,1,1,4,6,3,0,0,0,0,14907,6.8,18060,174,64,575,1272,23.8,1490.7
4857364703,0,73,2,1,4,7,3,0,0,0,0,16612,6.8,17485,194,48,1451,953,24.2,1661.2,11,0,0,7,4,5,0,0,0,0,15161,6.4,16532,166,39,-1451,-953,20.5,1516.1
4857329896,0,116,2,0,1,7,0,0,0,0,0,13783,6.6,16517,158,48,-2214,-1948,20.6,1378.3,13,0,1,7,1,4,0,0,0,0,15997,7.0,18465,177,56,2214,1948,23.3,1599.7
4857114737,1,9,0,0,2,6,2,0,0,0,0,15570,6.8,18989,226,56,-876,1634,28.2,1557.0,11,0,1,6,2,10,1,1,0,0,16446,6.8,17355,181,48,876,-1634,22.9,1644.6
4857074074,1,46,1,1,4,2,4,0,0,0,0,15451,7.0,17828,170,42,-584,-672,21.2,1545.1,12,0,0,2,4,1,1,1,0,0,16035,7.0,18500,204,64,584,672,26.8,1603.5
4857057979,1,22,0,1,14,15,11,0,0,0,0,45250,10.0,47500,0,0,17400,19000,0.0,4525.0,0,0,0,9,8,7,0,0,0,0,27850,6.0,28500,0,0,-17400,-19000,0.0,2785.0
4856883920,0,22,0,1,5,5,4,0,0,0,0,16243,6.8,18167,211,44,781,867,25.5,1624.3,12,1,0,5,5,6,0,0,0,0,15462,6.8,17300,185,52,-781,-867,23.7,1546.2
4856773148,0,0,0,1,24,22,65,0,0,0,1,37349,11.2,41561,102,0,469,2988,10.2,3734.9,0,0,0,22,24,52,0,0,0,0,36880,10.8,38573,104,0,-469,-2988,10.4,3688.0
4856761476,0,0,0,0,13,26,22,0,0,0,0,36878,11.0,39231,121,0,-2702,-5054,12.1,3687.8,0,0,1,26,13,57,0,0,0,0,39580,11.4,44285,108,0,2702,5054,10.8,3958.0
4855208640,0,12,0,0,5,4,4,0,0,0,0,14906,7.0,18092,211,45,-1209,-880,25.6,1490.6,17,1,1,3,4,2,0,0,0,0,16115,6.8,18972,232,58,1209,880,29.0,1611.5
4855111233,1,97,1,1,7,2,6,1,0,1,0,16852,6.8,17515,166,59,1812,152,22.5,1685.2,14,1,0,2,7,1,0,0,0,0,15040,6.8,17363,215,36,-1812,-152,25.1,1504.0
4853500417,0,10,1,0,5,3,4,0,0,0,0,15712,6.8,17615,187,46,863,422,23.3,1571.2,12,0,1,3,5,1,0,0,0,0,14849,6.6,17193,201,58,-863,-422,25.9,1484.9
4853472280,0,12,2,1,5,4,3,1,1,0,0,16020,7.0,17830,185,48,135,440,23.3,1602.0,10,1,0,4,5,4,1,0,1,0,15885,7.0,17390,208,56,-135,-440,26.4,1588.5
4853447178,1,11,1,0,7,6,4,1,0,1,0,17011,6.8,18001,201,54,1411,673,25.5,1701.1,17,1,1,6,7,8,1,1,0,0,15600,6.8,17328,182,55,-1411,-673,23.7,1560.0
4851525754,0,8,1,0,4,5,2,0,0,0,0,14154,6.8,16892,199,44,-2651,-1471,24.3,1415.4,10,0,1,5,4,4,0,0,0,0,16805,6.8,18363,234,48,2651,1471,28.2,1680.5
4850636285,1,18,1,1,4,3,2,0,0,0,0,15471,6.8,16856,196,44,1193,709,24.0,1547.1,13,1,0,3,4,3,0,0,0,0,14278,6.6,16147,167,44,-1193,-709,21.1,1427.8
4850617834,1,52,1,0,5,5,5,1,0,1,0,16604,7.2,18480,219,60,444,1024,27.9,1660.4,15,0,1,5,5,6,1,1,0,0,16160,6.8,17456,197,40,-444,-1024,23.7,1616.0
4850593104,0,11,2,0,1,6,1,2,1,1,0,13557,6.6,16670,171,56,-3260,-1325,22.7,1355.7,12,1,1,6,1,2,0,0,0,0,16817,6.8,17995,189,56,3260,1325,24.5,1681.7
4847906468,1,21,0,1,8,6,6,0,0,0,0,16777,6.8,17032,199,40,-685,-1518,23.9,1677.7,20,2,0,6,8,4,0,0,0,0,17462,7.0,18550,217,47,685,1518,26.4,1746.2
4846941778,1,10,1,0,3,3,5,0,0,0,0,15125,6.8,17495,215,48,707,40,26.3,1512.5,14,1,1,3,3,0,1,1,0,0,14418,7.0,17455,212,40,-707,-40,25.2,1441.8
4833384170,0,13,1,0,5,7,5,0,0,0,0,15456,6.8,18059,197,54,-1001,79,25.1,1545.6,10,1,1,7,5,4,0,0,0,0,16457,6.8,17980,217,49,1001,-79,26.6,1645.7
4829501738,0,13,0,0,4,3,4,0,0,0,0,17093,6.8,18511,217,52,1401,1631,26.9,1709.3,12,0,1,3,4,2,0,0,0,0,15692,6.8,16880,186,56,-1401,-1631,24.2,1569.2
4828885739,1,12,2,1,3,2,5,1,1,0,0,16476,6.8,18250,222,44,1319,-1000,26.6,1647.6,15,2,0,2,3,2,0,0,0,0,15157,7.2,19250,219,68,-1319,1000,28.7,1515.7
4828845319,1,74,1,1,4,6,3,0,0,0,0,16288,6.8,17995,202,58,173,669,26.0,1628.8,14,1,0,6,4,6,0,0,0,0,16115,6.6,17326,213,54,-173,-669,26.7,1611.5
4777324009,1,13,0,1,2,0,1,1,0,1,0,16381,7.0,19335,247,52,1807,1824,29.9,1638.1,13,0,0,0,2,0,0,0,0,0,14574,6.8,17511,204,48,-1807,-1824,25.2,1457.4
4777297927,0,0,0,1,22,25,55,0,0,0,0,36374,11.2,39021,90,0,-1896,-3261,9.0,3637.4,0,0,0,25,22,63,0,0,0,0,38270,11.6,42282,99,0,1896,3261,9.9,3827.0
4732845820,0,0,0,0,20,25,51,0,0,0,1,36317,11.2,39910,103,0,-1639,-2520,10.3,3631.7,0,0,1,25,20,52,0,0,0,0,37956,11.4,42430,106,0,1639,2520,10.6,3795.6
4732827023,0,47,0,0,31,28,75,0,0,0,0,38089,11.6,42432,93,0,529,2742,9.3,3808.9,0,0,1,28,31,75,0,0,0,0,37560,10.8,39690,71,0,-529,-2742,7.1,3756.0
4732812092,1,4,0,1,36,26,104,0,0,0,2,42594,12.2,47477,99,0,4065,3369,9.9,4259.4,0,0,0,26,36,66,0,0,0,0,38529,11.6,44108,105,0,-4065,-3369,10.5,3852.9
4732797299,1,0,0,1,25,16,66,0,0,0,2,38380,11.4,41798,99,0,4702,5053,9.9,3838.0,0,0,0,15,24,28,0,0,0,0,33678,10.4,36745,79,0,-4702,-5053,7.9,3367.8
4732042474,0,55,1,1,8,8,6,0,0,0,0,16152,6.6,16147,180,40,-3195,-1730,22.0,1615.2,8,4,0,8,8,3,0,0,0,0,19347,7.0,17877,221,55,3195,1730,27.6,1934.7
4732015657,0,12,16,0,13,9,8,0,0,0,0,18522,7.0,17743,162,48,72,-165,21.0,1852.2,164,2,1,9,13,3,0,0,0,0,18450,6.6,17908,221,28,-72,165,24.9,1845.0
4732002745,1,10,0,1,12,6,8,0,0,0,0,18953,7.2,17996,184,44,2259,1575,22.8,1895.3,8,0,0,6,12,5,0,0,0,0,16694,6.6,16421,209,0,-2259,-1575,20.9,1669.4
4731076187,1,12,1,1,13,11,7,0,0,0,0,19712,6.8,16958,191,60,676,388,25.1,1971.2,10,2,0,11,13,13,0,0,0,0,19036,6.6,16570,205,4,-676,-388,20.9,1903.6
4639024936,1,11,1,0,4,7,6,0,0,0,0,16945,6.6,17160,239,48,-521,292,28.7,1694.5,40,1,1,7,4,8,0,0,0,0,17466,6.6,16868,205,48,521,-292,25.3,1746.6
4628658165,0,12,0,1,5,7,3,0,0,0,0,16367,6.6,16703,201,56,-1424,-807,25.7,1636.7,12,1,0,7,5,8,0,0,0,0,17791,7.0,17510,206,48,1424,807,25.4,1779.1
4628641969,0,13,1,1,4,9,1,0,0,0,0,15917,6.6,17422,226,56,-2050,-1360,28.2,1591.7,14,1,0,9,4,7,0,0,0,0,17967,7.2,18782,220,67,2050,1360,28.7,1796.7
4628623290,0,45,2,1,7,9,12,0,0,0,0,17376,7.0,18185,183,60,-3902,-466,24.3,1737.6,15,1,0,9,7,15,0,0,0,0,21278,7.0,18651,225,52,3902,466,27.7,2127.8
4628584462,1,86,2,1,4,6,4,1,1,0,0,16875,6.8,17581,223,56,566,548,27.9,1687.5,13,1,0,6,4,1,0,0,0,0,16309,6.6,17033,213,48,-566,-548,26.1,1630.9
4857411794,0,0,0,0,16,21,37,0,0,0,1,33624,10.8,37815,82,0,-3724,-3794,8.2,3362.4,0,0,1,21,16,49,0,0,0,0,37348,11.0,41609,122,0,3724,3794,12.2,3734.8
4857380420,1,0,4,0,27,30,79,0,0,0,1,39225,11.6,42792,105,0,1272,1637,10.5,3922.5,17,0,1,30,27,70,0,0,0,0,37953,11.4,41155,80,0,-1272,-1637,8.0,3795.3
4857356904,1,19,0,1,19,16,54,0,0,0,1,38476,11.2,39553,111,0,4342,2517,11.1,3847.6,0,3,0,16,19,50,0,0,0,0,34134,10.6,37036,102,0,-4342,-2517,10.2,3413.4
4857318554,1,18,0,1,23,20,71,0,0,0,1,38616,11.0,39911,119,0,2081,1013,11.9,3861.6,0,0,0,20,23,40,0,0,0,0,36535,10.6,38898,96,0,-2081,-1013,9.6,3653.5
4856762461,0,8,0,1,6,2,7,0,0,0,0,15840,6.8,17737,174,60,184,-212,23.4,1584.0,17,1,0,2,6,1,0,0,0,0,15656,6.8,17949,200,52,-184,212,25.2,1565.6
4856749540,0,13,0,0,0,8,0,0,0,0,0,13524,6.6,16737,203,60,-5366,-2530,26.3,1352.4,11,1,1,8,0,7,1,0,1,0,18890,7.2,19267,257,48,5366,2530,30.5,1889.0
4856295450,0,24,0,1,26,27,67,0,0,0,0,37531,11.4,41854,97,0,-353,-2243,9.7,3753.1,0,1,0,27,26,71,0,0,0,0,37884,11.6,44097,111,0,353,2243,11.1,3788.4
4856254202,1,16,0,0,8,3,7,1,1,0,0,18196,7.2,18519,199,59,4359,2252,25.8,1819.6,15,1,1,3,8,1,0,0,0,0,13837,6.4,16267,167,44,-4359,-2252,21.1,1383.7
4856183171,0,0,0,1,21,24,46,0,0,0,0,36359,11.2,41583,93,0,698,2429,9.3,3635.9,2,0,0,24,21,57,0,0,0,0,35661,11.0,39154,107,0,-698,-2429,10.7,3566.1
4856160867,1,0,0,0,33,22,87,0,0,0,0,39188,12.0,44821,92,0,3721,5718,9.2,3918.8,0,0,1,22,33,51,0,0,0,0,35467,10.8,39103,90,0,-3721,-5718,9.0,3546.7
4856135058,1,0,0,0,27,23,66,0,0,0,0,37541,11.0,41780,96,0,909,-532,9.6,3754.1,0,0,1,23,27,42,0,0,0,0,36632,11.2,42312,73,0,-909,532,7.3,3663.2
4856099065,1,0,0,1,30,23,67,0,0,0,2,40714,11.8,45131,96,0,5468,5109,9.6,4071.4,1,0,0,23,30,36,0,0,0,0,35246,11.2,40022,73,0,-5468,-5109,7.3,3524.6
4855821310,0,78,2,1,4,2,4,0,0,0,0,16735,7.2,19115,213,80,3074,1608,29.3,1673.5,15,0,0,2,4,1,0,0,0,0,13661,6.6,17507,183,48,-3074,-1608,23.1,1366.1
4855786049,0,6,2,0,6,8,5,0,0,0,0,16316,6.8,17921,183,68,-334,-715,25.1,1631.6,19,0,1,8,6,3,2,1,1,0,16650,7.0,18636,187,48,334,715,23.5,1665.0
4855761068,0,73,0,0,2,5,3,0,0,0,0,14067,6.4,16646,174,59,-1471,-2394,23.3,1406.7,8,0,1,5,2,1,0,0,0,0,15538,7.2,19040,205,52,1471,2394,25.7,1553.8
4855731120,1,74,0,0,3,2,5,0,0,0,0,14210,6.8,17087,159,64,-1863,-1728,22.3,1421.0,12,0,1,2,3,2,1,1,0,0,16073,7.0,18815,227,51,1863,1728,27.8,1607.3
4855131492,0,15,0,0,22,21,59,0,0,0,1,36799,10.8,40671,91,0,707,767,9.1,3679.9,0,0,1,21,22,47,0,0,0,0,36092,11.0,39904,83,0,-707,-767,8.3,3609.2
4855093230,0,3,2,1,18,13,40,0,0,0,1,34956,10.4,35618,82,0,527,-1841,8.2,3495.6,14,0,0,13,18,27,0,0,0,0,34429,10.6,37459,103,0,-527,1841,10.3,3442.9
4855062056,0,18,0,1,35,29,82,0,0,0,0,39030,11.4,43104,109,0,1139,1645,10.9,3903.0,0,3,0,29,35,63,0,0,0,0,37891,11.2,41459,113,0,-1139,-1645,11.3,3789.1
4855023123,1,0,0,0,33,22,79,0,0,0,1,39807,11.8,45044,99,0,4349,6902,9.9,3980.7,0,0,1,21,32,43,0,0,0,0,35458,10.8,38142,82,0,-4349,-6902,8.2,3545.8
4786508660,1,12,1,1,9,4,4,1,1,0,0,18053,7.0,18478,228,64,2132,1269,29.2,1805.3,12,1,0,4,9,4,0,0,0,0,15921,6.8,17209,182,40,-2132,-1269,22.2,1592.1
4786501067,1,9,2,1,9,5,7,0,0,0,0,18159,7.2,18913,220,60,2614,843,28.0,1815.9,11,0,0,5,9,4,0,0,0,0,15545,6.8,18070,203,60,-2614,-843,26.3,1554.5
4786480668,0,53,1,1,7,8,5,0,0,0,0,16429,6.6,17504,203,60,-436,-486,26.3,1642.9,14,0,0,8,7,5,0,0,0,0,16865,6.8,17990,215,44,436,486,25.9,1686.5
4779838876,1,12,0,1,8,3,10,1,1,0,0,17522,6.8,17779,202,48,1875,-1199,25.0,1752.2,12,2,0,3,8,0,0,0,0,0,15647,7.0,18978,216,72,-1875,1199,28.8,1564.7
4779772209,0,63,1,0,1,4,1,0,0,0,0,13714,6.4,16513,182,60,-2725,-1678,24.2,1371.4,12,0,1,4,1,2,1,1,0,0,16439,7.0,18191,204,60,2725,1678,26.4,1643.9
4779722563,1,21,2,1,8,6,5,0,0,0,0,17195,6.6,17822,201,52,1119,611,25.3,1719.5,14,4,0,6,8,2,0,0,0,0,16076,6.8,17211,227,60,-1119,-611,28.7,1607.6
4716432393,1,12,0,1,6,2,1,1,1,0,0,14854,6.8,16842,203,34,198,-798,23.7,1485.4,8,0,0,2,6,1,0,0,0,0,14656,6.8,17640,202,51,-198,798,25.3,1465.6
4704469016,0,17,3,0,2,4,1,0,0,0,0,15928,6.6,17858,207,56,-579,-539,26.3,1592.8,75,2,1,4,2,1,1,1,0,0,16507,7.0,18397,218,56,579,539,27.4,1650.7
4704393546,1,11,3,0,11,5,7,0,0,0,0,20048,6.8,18512,199,45,4770,1446,24.4,2004.8,12,0,1,5,11,4,0,0,0,0,15278,6.8,17066,169,56,-4770,-1446,22.5,1527.8
4704350720,1,17,1,0,7,5,6,1,1,0,0,17319,6.8,18063,154,52,1713,935,20.6,1731.9,12,2,1,5,7,1,1,0,1,0,15606,6.6,17128,190,51,-1713,-935,24.1,1560.6
4704321028,1,13,2,1,7,3,4,0,0,0,0,17855,7.0,19578,243,52,3039,2561,29.5,1785.5,8,1,0,3,7,3,1,1,0,0,14816,6.6,17017,211,60,-3039,-2561,27.1,1481.6
4704293389,1,16,1,1,8,2,6,1,1,0,0,16858,6.8,17973,191,57,881,-15,24.8,1685.8,71,2,0,2,8,1,0,0,0,0,15977,6.8,17988,197,50,-881,15,24.7,1597.7
4704267475,0,12,1,0,3,8,4,0,0,0,0,14751,6.6,16958,187,52,-3403,-3097,23.9,1475.1,12,0,1,8,3,4,1,1,0,0,18154,7.4,20055,230,72,3403,3097,30.2,1815.4
4704225635,0,11,12,0,3,4,1,0,0,0,0,16350,7.0,18325,222,56,1178,339,27.8,1635.0,99,1,1,4,3,5,1,1,0,0,15172,6.8,17986,203,54,-1178,-339,25.7,1517.2
4704194682,0,11,0,1,8,9,6,0,0,0,0,18215,6.8,18430,226,63,1094,-260,28.9,1821.5,12,0,0,8,7,7,0,0,0,0,17121,7.2,18690,209,68,-1094,260,27.7,1712.1
4704162932,1,11,2,1,8,6,13,1,1,0,0,18208,7.4,19249,244,51,273,2778,29.5,1820.8,94,2,0,6,8,8,0,0,0,0,17935,6.6,16471,192,53,-273,-2778,24.5,1793.5
4704131050,1,23,0,1,5,2,3,0,0,0,0,16619,7.0,18581,242,56,1735,665,29.8,1661.9,11,1,0,2,5,0,0,0,0,0,14884,6.8,17916,212,47,-1735,-665,25.9,1488.4
4703571034,1,16,6,1,4,2,2,1,1,0,0,15962,6.8,18219,227,48,1664,217,27.5,1596.2,33,0,0,2,4,1,0,0,0,0,14298,7.0,18002,206,60,-1664,-217,26.6,1429.8
4703523260,0,14,2,0,4,8,3,0,0,0,0,14532,6.6,16522,189,60,-3501,-2187,24.9,1453.2,17,2,1,8,4,10,1,1,0,0,18033,7.0,18709,234,48,3501,2187,28.2,1803.3
4703503783,1,15,1,1,9,1,5,0,0,0,0,18735,7.4,20299,230,60,5897,5797,29.0,1873.5,9,0,0,1,9,1,0,0,0,0,12838,6.4,14502,166,44,-5897,-5797,21.0,1283.8
4855966502,1,0,0,1,15,17,16,0,0,0,0,56350,12.0,55000,0,0,21700,22000,0.0,5635.0,0,0,0,12,10,9,0,0,0,0,34650,7.2,33000,0,0,-21700,-22000,0.0,3465.0
4855950314,1,0,0,0,16,14,21,0,0,0,0,61348,12.0,55000,0,0,24821,22000,0.0,6134.8,0,0,1,11,13,6,0,0,0,0,36527,7.2,33000,0,0,-24821,-22000,0.0,3652.7
4855934798,1,23,0,1,10,13,12,0,0,0,0,46550,10.0,47500,0,0,18700,19000,0.0,4655.0,3,0,0,10,7,6,0,0,0,0,27850,6.0,28500,0,0,-18700,-19000,0.0,2785.0
4855915030,1,0,0,1,15,20,16,0,0,0,0,63750,12.0,55000,0,0,26200,22000,0.0,6375.0,0,0,0,14,9,8,0,0,0,0,37550,7.2,33000,0,0,-26200,-22000,0.0,3755.0
4855445595,1,0,0,1,25,21,59,0,0,0,0,37588,11.4,42799,118,0,1887,4416,11.8,3758.8,0,0,0,21,25,61,0,0,0,0,35701,11.0,38383,91,0,-1887,-4416,9.1,3570.1
4855434881,0,0,0,1,19,16,54,0,0,0,0,35064,10.8,37564,90,0,-835,-997,9.0,3506.4,2,0,0,16,19,46,0,0,0,0,35899,10.8,38561,126,0,835,997,12.6,3589.9
4855401362,1,86,0,1,13,13,37,0,0,0,1,33833,10.0,34409,113,0,-51,847,11.3,3383.3,2,0,0,13,13,31,0,0,0,0,33884,9.8,33562,104,0,51,-847,10.4,3388.4
4854739442,0,68,2,0,0,4,0,0,0,0,0,14754,6.6,17294,201,45,-859,1118,24.6,1475.4,13,1,1,4,0,2,0,0,0,0,15613,6.4,16176,186,55,859,-1118,24.1,1561.3
4854707124,0,8,0,0,7,8,5,0,0,0,0,17578,6.8,17330,199,48,350,1185,24.7,1757.8,12,1,1,8,7,12,1,1,0,0,17228,6.6,16145,174,44,-350,-1185,21.8,1722.8
4854370351,1,37,0,0,14,20,13,0,0,0,0,62500,12.0,55000,0,0,24600,22000,0.0,6250.0,0,0,1,14,8,12,0,0,0,0,37900,7.2,33000,0,0,-24600,-22000,0.0,3790.0
4854368855,1,0,0,1,17,19,23,0,0,0,0,62700,12.0,55000,0,0,24800,22000,0.0,6270.0,0,0,0,13,11,7,0,0,0,0,37900,7.2,33000,7,0,-24800,-22000,0.7,3790.0
4854356929,1,3,0,1,15,23,15,0,0,0,0,47750,10.0,47500,0,0,19200,19000,0.0,4775.0,0,0,0,14,6,11,0,0,0,0,28550,6.0,28500,0,0,-19200,-19000,0.0,2855.0
4854348137,1,1,0,0,18,19,16,0,0,0,0,63060,12.0,55000,0,0,24810,22000,0.0,6306.0,30,0,1,11,10,12,0,0,0,0,38250,7.2,33000,0,0,-24810,-22000,0.0,3825.0
4854330043,1,9,1,1,9,2,11,0,0,0,0,18864,7.4,19269,248,60,3390,2170,30.8,1886.4,12,1,0,2,9,2,0,0,0,0,15474,6.6,17099,189,56,-3390,-2170,24.5,1547.4
4854303660,0,33,3,1,9,3,5,0,0,0,0,16271,6.6,17469,192,51,1359,527,24.3,1627.1,14,11,0,2,8,3,1,1,0,0,14912,6.8,16942,195,52,-1359,-527,24.7,1491.2
4854280992,1,8,1,1,3,2,3,0,0,0,0,14655,6.4,15744,167,46,-180,-1210,21.3,1465.5,12,1,0,2,3,2,0,0,0,0,14835,6.6,16954,205,50,180,1210,25.5,1483.5
4854249085,0,55,1,1,9,7,6,0,0,0,0,16330,6.8,17539,173,52,-1035,-1150,22.5,1633.0,14,0,0,7,9,5,1,1,0,0,17365,7.2,18689,182,67,1035,1150,24.9,1736.5
4854223533,1,34,0,1,8,4,12,0,0,0,0,17446,6.8,17480,179,52,2464,613,23.1,1744.6,19,0,0,4,8,3,0,0,0,0,14982,6.6,16867,148,60,-2464,-613,20.8,1498.2
4854188798,0,9,1,1,3,5,3,0,0,0,0,14222,7.0,17400,201,48,-1968,-270,24.9,1422.2,17,1,0,5,3,5,0,0,0,0,16190,6.8,17670,198,52,1968,270,25.0,1619.0
4854148567,0,7,0,0,3,4,1,0,0,0,0,15281,7.0,18408,193,58,-360,829,25.1,1528.1,13,0,1,4,3,1,0,0,0,0,15641,6.8,17579,176,52,360,-829,22.8,1564.1
4857459286,1,0,0,1,16,16,21,0,0,0,0,45950,10.0,47500,0,0,18100,19000,0.0,4595.0,0,0,0,10,10,7,0,0,0,0,27850,6.0,28500,0,0,-18100,-19000,0.0,2785.0
4857432579,1,5,0,0,21,19,21,0,0,0,0,63750,12.0,55000,0,0,26200,22000,0.0,6375.0,21,0,1,8,10,11,0,0,0,0,37550,7.2,33000,0,0,-26200,-22000,0.0,3755.0
4857411423,1,34,1,1,27,15,27,0,0,0,0,65065,13.0,62500,11,0,29255,28000,1.1,6506.5,0,2,0,5,17,6,0,0,0,0,35810,7.4,34500,0,0,-29255,-28000,0.0,3581.0
4857393991,1,0,0,1,29,17,21,0,0,0,0,62700,13.0,62500,0,0,26200,28000,0.0,6270.0,0,0,0,5,17,11,0,0,0,0,36500,7.4,34500,0,0,-26200,-28000,0.0,3650.0
4857289715,1,363,0,1,19,15,22,0,0,0,0,52282,10.0,47500,0,0,25808,19000,0.0,5228.2,0,0,0,8,12,5,0,0,0,0,26474,6.0,28500,0,0,-25808,-19000,0.0,2647.4
4857267389,1,0,0,0,11,20,15,0,0,0,0,61400,12.0,55000,2,0,23410,22000,0.2,6140.0,0,0,1,14,5,11,0,0,0,0,37990,7.2,33000,2,0,-23410,-22000,0.2,3799.0
4856333754,1,81,0,1,13,18,16,0,0,0,0,45688,10.0,47500,0,0,18176,19000,0.0,4568.8,4,0,0,12,7,9,0,0,0,0,27512,6.0,28500,0,0,-18176,-19000,0.0,2751.2
4856288570,0,9,1,1,1,3,2,0,0,0,0,13788,7.0,17272,196,55,-2953,-1719,25.1,1378.8,67,2,0,3,1,8,1,1,0,0,16741,7.0,18991,210,76,2953,1719,28.6,1674.1
4856245783,0,8,0,1,5,5,2,0,0,0,0,16068,7.0,18217,235,56,-386,-619,29.1,1606.8,9,0,0,4,4,4,0,0,0,0,16454,7.2,18836,210,51,386,619,26.1,1645.4
4855492880,0,12,3,0,6,3,2,0,0,0,0,15857,6.6,16960,193,48,433,-522,24.1,1585.7,23,1,1,3,6,2,1,1,0,0,15424,6.8,17482,209,52,-433,522,26.1,1542.4
4855267154,1,11,0,0,8,8,10,0,0,0,0,17790,6.8,17865,190,36,546,-510,22.6,1779.0,10,1,1,8,8,5,1,1,0,0,17244,6.8,18375,200,58,-546,510,25.8,1724.4
4855073622,0,180,2,1,7,15,7,0,0,0,0,15735,6.8,16489,171,44,-4028,-1664,21.5,1573.5,10,1,0,14,6,15,0,0,0,0,19763,7.2,18153,206,56,4028,1664,26.2,1976.3
4854928603,1,15,6,0,7,4,5,1,1,0,0,16927,6.8,18051,223,48,465,482,27.1,1692.7,28,0,1,4,7,3,1,0,1,0,16462,7.0,17569,188,66,-465,-482,25.4,1646.2
4854899884,1,9,1,1,8,4,9,0,0,0,0,18040,7.0,18783,255,56,3195,2192,31.1,1804.0,9,0,0,4,8,5,0,0,0,0,14845,6.6,16591,189,55,-3195,-2192,24.4,1484.5
4854343026,0,17,1,1,8,7,5,1,1,0,0,16366,6.6,16642,208,68,-187,-107,27.6,1636.6,14,0,0,7,8,6,0,0,0,0,16553,6.8,16749,177,59,187,107,23.6,1655.3
4854296183,0,11,0,0,2,2,2,0,0,0,0,14429,7.0,17997,200,44,-2203,-1579,24.4,1442.9,15,1,1,2,2,2,1,1,0,0,16632,7.2,19576,246,72,2203,1579,31.8,1663.2
4854097929,1,0,0,1,19,22,15,0,0,0,0,62000,12.6,59500,0,0,23352,22000,0.0,6200.0,0,0,0,13,10,15,0,0,0,0,38648,7.8,37500,0,0,-23352,-22000,0.0,3864.8
4854061119,1,1,0,0,18,14,21,0,0,0,0,63050,12.2,56000,0,0,26900,23000,0.0,6305.0,0,0,1,5,9,8,0,0,0,0,36150,7.2,33000,0,0,-26900,-23000,0.0,3615.0
4854040829,1,0,0,1,15,22,20,0,0,0,0,63050,13.0,62500,0,0,22816,25000,0.0,6305.0,0,0,0,18,11,14,0,0,0,0,40234,7.8,37500,0,0,-22816,-25000,0.0,4023.4
4817419364,0,20,1,0,2,6,3,0,0,0,0,13770,6.4,16733,178,42,-4012,-2904,22.0,1377.0,14,0,1,6,2,3,1,1,0,0,17782,7.2,19637,232,75,4012,2904,30.7,1778.2
4765048411,0,11,1,1,3,11,2,0,0,0,0,14562,6.4,15703,155,52,-3528,-3906,20.7,1456.2,12,1,0,11,3,6,1,1,0,0,18090,7.2,19609,217,48,3528,3906,26.5,1809.0
4762044286,0,13,2,1,7,5,8,0,0,0,0,16559,6.6,16741,199,40,-439,-1055,23.9,1655.9,74,0,0,5,7,5,0,0,0,0,16998,7.0,17796,192,43,439,1055,23.5,1699.8
4761791444,0,10,1,0,7,10,4,0,0,0,0,16582,6.6,17920,231,43,-3146,-1630,27.4,1658.2,17,0,1,10,7,11,1,1,0,0,19728,7.4,19550,226,71,3146,1630,29.7,1972.8
4755533080,0,17,2,1,7,3,6,0,0,0,0,16657,6.6,16726,210,53,1312,-794,26.3,1665.7,233,3,0,3,7,3,0,0,0,0,15345,6.8,17520,193,31,-1312,794,22.4,1534.5
4755493759,0,78,1,0,0,3,0,0,0,0,0,13181,6.8,17467,204,48,-2124,-237,25.2,1318.1,8,0,1,3,0,5,0,0,0,0,15305,7.0,17704,219,64,2124,237,28.3,1530.5
4744706911,0,13,11,0,5,5,6,1,1,0,0,16176,7.0,18215,202,55,-1887,-938,25.7,1617.6,37,1,1,5,5,2,0,0,0,0,18063,7.2,19153,231,58,1887,938,28.9,1806.3
4744352040,0,15,2,0,2,6,3,0,0,0,0,14116,6.8,16660,179,52,-855,371,23.1,1411.6,14,0,1,6,2,4,0,0,0,0,14971,6.6,16289,184,51,855,-371,23.5,1497.1
4623222161,1,0,0,0,13,17,35,0,0,0,1,33875,9.8,33843,116,0,-192,-1366,11.6,3387.5,1,0,1,17,13,39,0,0,0,0,34067,10.2,35209,111,0,192,1366,11.1,3406.7
4506093924,1,14,1,1,7,3,5,0,0,0,0,17313,7.0,18298,215,64,1533,872,27.9,1731.3,7,2,0,3,7,1,1,1,0,0,15780,6.8,17426,209,64,-1533,-872,27.3,1578.0
4506061477,1,11,1,0,5,6,5,0,0,0,0,17122,7.0,17752,194,52,411,312,24.6,1712.2,12,1,1,6,5,4,2,1,1,0,16711,6.8,17440,157,72,-411,-312,22.9,1671.1
4501562265,1,156,2,1,7,2,4,1,1,0,0,16269,7.4,19986,228,42,1340,1704,27.0,1626.9,11,1,0,2,7,2,0,0,0,0,14929,7.0,18282,222,62,-1340,-1704,28.4,1492.9
4501536468,1,9,1,1,7,3,7,0,0,0,0,17963,7.2,19727,221,63,2250,1250,28.4,1796.3,15,1,0,3,7,2,0,0,0,0,15713,6.8,18477,226,52,-2250,-1250,27.8,1571.3
4501509916,0,14,2,0,3,7,3,1,1,0,0,15831,7.0,17816,188,60,-2050,-1692,24.8,1583.1,10,4,1,7,3,4,0,0,0,0,17881,7.2,19508,207,56,2050,1692,26.3,1788.1
4285853634,0,13,1,0,4,8,4,0,0,0,0,14773,7.0,17129,182,52,-3317,-1620,23.4,1477.3,12,1,1,8,4,11,0,0,0,0,18090,7.2,18749,211,62,3317,1620,27.3,1809.0
4189596561,1,203,0,0,9,6,8,0,0,0,0,18877,7.0,18087,210,44,2916,390,25.4,1887.7,8,0,1,6,9,4,0,0,0,0,15961,7.0,17697,217,56,-2916,-390,27.3,1596.1
4189380670,0,14,1,1,3,2,0,0,0,0,0,15157,7.0,17823,208,56,1191,41,26.4,1515.7,10,1,0,2,3,1,0,0,0,0,13966,6.8,17782,180,55,-1191,-41,23.5,1396.6
4189252195,1,12,2,1,10,9,11,1,1,0,0,16998,6.8,16916,195,51,-1460,-843,24.6,1699.8,15,0,0,9,10,7,1,0,1,0,18458,7.0,17759,188,64,1460,843,25.2,1845.8
4180404994,1,43,1,0,7,5,7,1,1,0,0,17353,6.8,18237,196,57,1168,913,25.3,1735.3,8,2,1,5,7,5,0,0,0,0,16185,6.8,17324,199,48,-1168,-913,24.7,1618.5
4180378582,0,9,1,0,6,8,5,1,1,0,0,16177,6.8,17568,186,60,-2325,-1676,24.6,1617.7,23,0,1,8,6,8,0,0,0,0,18502,7.0,19244,239,64,2325,1676,30.3,1850.2
4857378892,1,34,0,1,7,6,8,0,0,0,0,18025,7.0,18367,214,52,1508,574,26.6,1802.5,12,11,0,6,7,5,0,0,0,0,16517,6.8,17793,202,52,-1508,-574,25.4,1651.7
4857326172,0,14,0,1,5,1,2,0,0,0,0,15770,7.0,18559,193,57,1453,363,25.0,1577.0,12,0,0,1,5,1,0,0,0,0,14317,7.0,18196,235,44,-1453,-363,27.9,1431.7
4857135849,0,82,1,1,3,1,2,1,0,1,0,15775,6.8,17461,226,48,2172,-486,27.4,1577.5,14,0,0,1,3,0,0,0,0,0,13603,6.8,17947,189,60,-2172,486,24.9,1360.3
4857097358,0,69,0,0,2,7,0,0,0,0,0,14052,6.6,15658,146,45,-2025,-3131,19.1,1405.2,12,0,1,7,2,2,0,0,0,0,16077,7.2,18789,190,62,2025,3131,25.2,1607.7
4856604537,0,13,0,0,6,6,8,0,0,0,0,17263,7.0,18522,216,52,1300,795,26.8,1726.3,18,1,1,6,6,4,1,1,0,0,15963,6.8,17727,203,68,-1300,-795,27.1,1596.3
4856579351,0,7,15,0,5,4,7,0,0,0,0,14845,6.8,16449,165,46,-217,-768,21.1,1484.5,92,1,1,4,5,0,0,0,0,0,15062,6.6,17217,208,58,217,768,26.6,1506.2
4856557613,1,53,1,0,9,7,9,1,1,0,0,17795,7.2,18388,190,60,965,667,25.0,1779.5,14,1,1,7,9,5,0,0,0,0,16830,6.8,17721,211,46,-965,-667,25.7,1683.0
4856521150,0,183,0,0,3,7,1,0,0,0,0,14002,6.6,16494,177,56,-2260,-500,23.3,1400.2,13,2,1,7,3,11,1,0,1,0,16262,6.8,16994,150,64,2260,500,21.4,1626.2
4856321381,1,30,2,0,4,9,5,1,1,0,0,16008,6.8,17482,200,56,-989,-170,25.6,1600.8,15,10,1,9,4,9,0,0,0,0,16997,6.8,17652,153,60,989,170,21.3,1699.7
4856274245,1,17,2,0,6,4,4,0,0,0,0,16206,7.0,18079,203,52,332,760,25.5,1620.6,12,3,1,4,6,6,0,0,0,0,15874,6.8,17319,191,48,-332,-760,23.9,1587.4
4856209116,0,29,0,1,9,6,14,0,0,0,0,18234,7.2,18754,208,56,612,36,26.4,1823.4,10,11,0,6,9,5,0,0,0,0,17622,7.2,18718,219,48,-612,-36,26.7,1762.2
4856180794,1,16,19,1,7,3,11,0,0,0,0,17170,7.0,18548,191,64,2631,2001,25.5,1717.0,31,0,0,3,7,4,0,0,0,0,14539,6.4,16547,171,36,-2631,-2001,20.7,1453.9
4856060782,1,15,2,0,5,4,4,0,0,0,0,16025,6.8,17524,192,40,429,-1043,23.2,1602.5,11,0,1,4,5,0,0,0,0,0,15596,7.0,18567,202,48,-429,1043,25.0,1559.6
4855999123,1,10,0,1,10,3,13,1,1,0,0,17989,7.0,17058,173,48,5106,1623,22.1,1798.9,10,0,0,3,10,1,0,0,0,0,12883,6.2,15435,107,60,-5106,-1623,16.7,1288.3
4855855590,1,35,2,0,5,8,10,0,0,0,0,16187,7.0,17293,172,59,134,505,23.1,1618.7,11,6,1,8,5,6,0,0,0,0,16053,6.6,16788,180,44,-134,-505,22.4,1605.3
4855808576,1,11,19,1,5,1,5,1,0,1,0,15499,6.8,17773,175,64,2374,369,23.9,1549.9,270,1,0,1,5,1,1,1,0,0,13125,6.8,17404,190,44,-2374,-369,23.4,1312.5
4855545024,1,6,0,1,25,24,56,0,0,0,1,39201,11.4,42499,100,0,2224,928,10.0,3920.1,20,0,0,24,25,48,0,0,0,0,36977,11.4,41571,87,0,-2224,-928,8.7,3697.7
4855541775,1,29,1,1,4,2,2,0,0,0,0,17329,7.2,19429,213,56,2474,949,26.9,1732.9,9,12,0,2,4,1,0,0,0,0,14855,7.2,18480,163,56,-2474,-949,21.9,1485.5
4743651975,1,73,3,0,5,5,1,1,1,0,0,16658,7.0,19055,244,60,1364,952,30.4,1665.8,13,2,1,4,4,3,0,0,0,0,15294,7.0,18103,204,52,-1364,-952,25.6,1529.4
4726592148,1,13,0,1,7,7,8,1,1,0,0,17454,6.8,17221,203,42,1010,489,24.5,1745.4,75,0,0,7,7,7,1,0,1,0,16444,6.6,16732,176,52,-1010,-489,22.8,1644.4
4726298689,0,12,5,1,2,1,2,1,1,0,0,15160,6.8,17538,220,56,334,-418,27.6,1516.0,15,3,0,1,2,0,0,0,0,0,14826,6.8,17956,207,72,-334,418,27.9,1482.6
4726280384,1,19,2,0,14,5,19,1,1,0,0,20623,7.2,19336,233,56,4027,2633,28.9,2062.3,11,2,1,5,14,3,0,0,0,0,16596,6.6,16703,205,48,-4027,-2633,25.3,1659.6
4726269205,1,15,2,1,3,1,5,1,1,0,0,16464,7.2,18264,224,60,1605,-16,28.4,1646.4,13,3,0,1,3,1,0,0,0,0,14859,6.8,18280,232,68,-1605,16,30.0,1485.9
4713366132,0,206,0,0,6,5,3,0,0,0,0,16359,6.8,16622,212,44,-1209,-992,25.6,1635.9,13,1,1,5,6,3,0,0,0,0,17568,7.0,17614,191,51,1209,992,24.2,1756.8
4707904241,0,10,1,0,4,8,1,0,0,0,0,15225,6.8,17207,180,68,-2715,-273,24.8,1522.5,10,1,1,8,4,11,1,0,1,0,17940,6.8,17480,233,44,2715,273,27.7,1794.0
4707872227,1,13,3,1,6,5,3,1,0,1,0,16669,6.8,18195,211,56,311,1184,26.7,1666.9,13,1,0,5,6,2,1,1,0,0,16358,6.6,17011,203,64,-311,-1184,26.7,1635.8
4707852125,0,13,1,1,6,14,4,0,0,0,0,16425,6.4,16680,184,37,-3303,-2023,22.1,1642.5,12,1,0,14,6,13,1,1,0,0,19728,7.4,18703,202,58,3303,2023,26.0,1972.8
4682344217,1,14,1,1,6,1,8,1,1,0,0,16929,7.0,18052,201,52,1059,-822,25.3,1692.9,13,2,0,1,6,0,0,0,0,0,15870,7.2,18874,239,57,-1059,822,29.6,1587.0
4681134874,0,11,1,0,2,6,3,1,1,0,0,13744,6.6,16264,190,36,-3280,-3317,22.6,1374.4,13,1,1,6,2,2,1,0,1,0,17024,7.2,19581,215,76,3280,3317,29.1,1702.4
4681088553,0,10,1,1,9,3,7,1,1,0,0,16785,7.0,17657,195,39,424,-879,23.4,1678.5,12,1,0,3,9,1,0,0,0,0,16361,7.2,18536,206,72,-424,879,27.8,1636.1
4681072078,1,22,1,0,11,4,10,1,0,1,0,18412,7.2,19358,219,65,4067,2421,28.4,1841.2,185,3,1,4,11,2,0,0,0,0,14345,6.6,16937,192,42,-4067,-2421,23.4,1434.5
4618148905,0,20,1,0,4,4,2,1,1,0,0,15789,7.0,18098,218,52,143,87,27.0,1578.9,10,0,1,4,4,2,0,0,0,0,15646,6.8,18011,237,59,-143,-87,29.6,1564.6
4611706230,1,72,1,1,5,4,1,1,1,0,0,15262,7.0,17843,179,80,-273,-86,25.9,1526.2,17,1,0,3,4,2,0,0,0,0,15535,6.8,17929,223,44,273,86,26.7,1553.5
4611659683,0,11,2,1,5,8,6,0,0,0,0,16104,6.6,16949,159,44,-1746,-2283,20.3,1610.4,13,2,0,8,5,3,1,1,0,0,17850,7.0,19232,232,56,1746,2283,28.8,1785.0
4610013021,1,15,0,0,6,7,0,1,1,0,0,14531,6.6,15966,182,40,-2267,-2453,22.2,1453.1,7,2,1,7,6,2,0,0,0,0,16798,7.0,18419,220,52,2267,2453,27.2,1679.8
4609979202,1,13,4,0,7,4,6,1,0,1,0,16371,6.8,16875,186,44,-633,-870,23.0,1637.1,10,1,1,4,7,2,0,0,0,0,17004,7.0,17745,224,59,633,870,28.3,1700.4
4609393883,0,12,0,0,4,4,7,0,0,0,0,15425,7.0,17656,206,64,-311,608,27.0,1542.5,13,1,1,4,4,5,1,1,0,0,15736,6.8,17048,219,52,311,-608,27.1,1573.6
4609363221,1,15,1,1,6,5,5,1,0,1,0,17631,6.8,17581,215,48,1731,193,26.3,1763.1,15,1,0,5,6,2,0,0,0,0,15900,6.6,17388,173,68,-1731,-193,24.1,1590.0
4857409557,0,17,2,0,0,0,0,1,1,0,0,13884,7.0,18171,190,60,-1555,-531,25.0,1388.4,8,3,0,0,0,0,0,0,0,0,15439,7.0,18702,233,56,1555,531,28.9,1543.9
4857328317,1,12,3,0,5,4,4,1,0,1,0,17216,7.2,19118,220,47,1635,1566,26.7,1721.6,9,1,1,4,5,3,0,0,0,0,15581,6.8,17552,203,64,-1635,-1566,26.7,1558.1
4857285651,0,20,1,1,6,6,6,0,0,0,0,16636,6.8,17754,240,52,108,-430,29.2,1663.6,9,2,0,6,6,7,0,0,0,0,16528,7.0,18184,229,60,-108,430,28.9,1652.8
4857240302,1,12,1,1,8,5,9,0,0,0,0,17621,7.0,18581,234,51,1199,1545,28.5,1762.1,16,0,0,5,8,10,0,0,0,0,16422,6.8,17036,221,60,-1199,-1545,28.1,1642.2
4857188227,0,9,1,1,5,3,3,0,0,0,0,15513,6.8,17278,212,60,535,-594,27.2,1551.3,15,0,0,3,5,4,0,0,0,0,14978,7.0,17872,228,47,-535,594,27.5,1497.8
4857095565,1,12,2,1,5,3,4,0,0,0,0,16402,6.8,17636,195,56,1143,-173,25.1,1640.2,10,2,0,3,5,3,1,1,0,0,15259,6.8,17809,219,56,-1143,173,27.5,1525.9
4856542838,0,9,14,0,2,3,2,0,0,0,0,15680,7.0,18215,232,67,1656,2087,29.9,1568.0,36,1,1,3,2,5,0,0,0,0,14024,6.2,16128,177,36,-1656,-2087,21.3,1402.4
4856423773,0,8,0,1,4,3,1,1,0,1,0,15168,7.2,18066,195,56,-1169,-869,25.1,1516.8,11,0,0,3,4,2,0,0,0,0,16337,7.0,18935,225,56,1169,869,28.1,1633.7
4856397774,1,5,1,1,4,3,3,0,0,0,0,15856,6.8,18061,166,60,693,160,22.6,1585.6,10,0,0,3,4,2,0,0,0,0,15163,7.0,17901,195,54,-693,-160,24.9,1516.3
4856343723,1,17,1,1,4,3,4,1,0,1,0,14837,6.8,17313,172,62,-52,326,23.4,1483.7,11,0,0,3,4,2,0,0,0,0,14889,6.6,16987,184,57,52,-326,24.1,1488.9
4856202503,0,11,2,0,8,8,3,0,0,0,0,18024,7.0,18185,196,52,-428,717,24.8,1802.4,11,0,1,8,8,8,0,0,0,0,18452,6.8,17468,182,55,428,-717,23.7,1845.2
4856158951,0,15,1,0,7,6,6,0,0,0,0,16891,6.6,16391,191,48,109,-1667,23.9,1689.1,12,0,1,6,7,5,0,0,0,0,16782,7.0,18058,195,55,-109,1667,25.0,1678.2
4856120886,1,11,0,0,9,7,7,0,0,0,0,17416,7.0,18108,202,51,-342,1269,25.3,1741.6,10,1,1,7,9,10,1,1,0,0,17758,6.6,16839,183,52,342,-1269,23.5,1775.8
4856070257,0,17,2,0,2,6,1,0,0,0,0,13155,6.4,15566,166,48,-4191,-2229,21.4,1315.5,12,3,1,6,2,6,0,0,0,0,17346,6.8,17795,213,52,4191,2229,26.5,1734.6
4856032067,0,20,3,1,3,5,4,0,0,0,0,15355,7.0,17759,206,72,-823,562,27.8,1535.5,16,2,0,5,3,5,0,0,0,0,16178,6.8,17197,207,52,823,-562,25.9,1617.8
4855998040,1,12,0,1,5,2,8,1,1,0,0,16911,7.2,18717,219,60,1849,761,27.9,1691.1,12,1,0,2,5,2,0,0,0,0,15062,6.8,17956,214,56,-1849,-761,27.0,1506.2
4855956430,0,11,3,0,4,5,4,1,1,0,0,15326,6.6,16904,196,54,-199,-256,25.0,1532.6,16,0,1,5,4,5,0,0,0,0,15525,6.8,17160,178,61,199,256,23.9,1552.5
4855929773,1,12,0,1,3,2,4,1,0,1,0,17101,6.8,17760,216,52,3971,1171,26.8,1710.1,10,0,0,2,3,0,0,0,0,0,13130,6.8,16589,172,52,-3971,-1171,22.4,1313.0
4855563285,0,14,1,1,5,9,4,0,0,0,0,15963,6.6,16641,144,52,-1988,-1289,19.6,1596.3,11,1,0,9,5,7,0,0,0,0,17951,7.0,17930,211,56,1988,1289,26.7,1795.1
4856532525,1,106,0,0,21,11,17,0,0,0,0,62176,12.0,55000,7,0,26300,22000,0.7,6217.6,0,0,1,3,13,5,0,0,0,0,35876,7.2,33000,3,0,-26300,-22000,0.3,3587.6
4856513362,1,0,0,0,12,17,9,0,0,0,0,45250,10.0,47500,0,0,16700,19000,0.0,4525.0,18,0,1,12,7,11,0,0,0,0,28550,6.0,28500,0,0,-16700,-19000,0.0,2855.0
4845420778,1,0,0,1,29,29,61,0,0,0,1,40120,12.0,45721,115,0,976,3299,11.5,4012.0,0,0,0,29,29,73,0,0,0,0,39144,11.4,42422,113,0,-976,-3299,11.3,3914.4
4844534684,0,38,0,0,24,22,64,0,0,0,1,36323,11.2,39586,93,0,-2323,-3328,9.3,3632.3,0,4,1,22,24,46,0,0,0,0,38646,11.6,42914,117,0,2323,3328,11.7,3864.6
4844310623,1,0,0,1,25,21,64,0,0,0,1,38069,11.4,41695,110,0,1802,1572,11.0,3806.9,0,0,0,21,25,55,0,0,0,0,36267,11.0,40123,112,0,-1802,-1572,11.2,3626.7
4844274378,0,0,0,1,35,26,92,0,0,0,1,40995,11.8,44997,119,0,3692,3714,11.9,4099.5,0,0,0,26,35,63,0,0,0,0,37303,11.0,41283,96,0,-3692,-3714,9.6,3730.3
4844258814,0,13,0,0,20,19,43,0,0,0,0,36198,10.4,37665,113,0,-1320,-1742,11.3,3619.8,0,1,1,19,20,39,0,0,0,0,37518,11.0,39407,112,0,1320,1742,11.2,3751.8
4843611474,1,0,0,1,31,16,90,0,0,0,1,39900,11.0,40196,116,0,5832,3999,11.6,3990.0,0,0,0,16,31,45,0,0,0,0,34068,10.4,36197,87,0,-5832,-3999,8.7,3406.8
4842689370,0,0,0,0,25,19,69,0,0,0,0,36751,11.2,40800,104,0,276,2400,10.4,3675.1,0,0,1,19,25,50,0,0,0,0,36475,11.0,38400,103,0,-276,-2400,10.3,3647.5
4840291995,0,14,2,0,1,2,0,0,0,0,0,13261,6.4,16661,203,44,-1815,-769,24.7,1326.1,75,1,1,2,1,1,1,1,0,0,15076,6.8,17430,199,60,1815,769,25.9,1507.6
4840253996,1,12,2,0,4,2,3,1,1,0,0,16187,6.8,17963,201,40,1929,126,24.1,1618.7,8,1,1,2,4,2,0,0,0,0,14258,6.8,17837,198,52,-1929,-126,25.0,1425.8
4839605175,1,16,0,1,33,30,66,0,0,0,2,41589,12.0,46139,112,0,2896,4458,11.2,4158.9,0,0,0,30,33,76,0,0,0,0,38693,11.2,41681,91,0,-2896,-4458,9.1,3869.3
4839484222,0,7,0,0,26,31,63,0,0,0,1,37482,11.4,42647,102,0,-3563,-2793,10.2,3748.2,0,2,1,31,26,69,0,0,0,0,41045,11.8,45440,128,0,3563,2793,12.8,4104.5
4836922752,1,12,1,0,8,3,6,1,1,0,0,16564,7.0,18254,177,64,1131,-421,24.1,1656.4,11,1,1,3,8,2,0,0,0,0,15433,7.0,18675,231,60,-1131,421,29.1,1543.3
4836864743,0,56,1,0,5,10,2,0,0,0,0,15267,6.8,17635,202,52,-3445,-1576,25.4,1526.7,15,1,1,10,5,6,0,0,0,0,18712,7.4,19211,212,72,3445,1576,28.4,1871.2
4832141213,1,13,0,0,9,4,8,0,0,0,0,18853,7.0,17327,181,48,3590,644,22.9,1885.3,9,1,1,4,9,7,0,0,0,0,15263,6.4,16683,170,48,-3590,-644,21.8,1526.3
4832001268,1,19,3,0,4,8,5,0,0,0,0,16755,6.8,18095,251,53,-811,166,30.4,1675.5,35,2,1,8,4,9,1,1,0,0,17566,6.8,17929,201,60,811,-166,26.1,1756.6
4830222614,1,12,0,1,22,23,50,0,0,0,0,37760,11.2,41125,50,60,884,687,11.0,3776.0,10,0,0,23,22,50,0,0,0,0,36876,11.2,40438,57,61,-884,-687,11.8,3687.6
4828966744,1,15,1,1,5,1,1,0,0,0,0,15424,7.2,18438,203,51,1729,1313,25.4,1542.4,11,0,0,1,5,1,0,0,0,0,13695,6.6,17125,195,52,-1729,-1313,24.7,1369.5
4828940994,1,11,0,0,3,8,4,1,0,1,0,15041,6.6,16450,204,44,-2424,-2277,24.8,1504.1,19,0,1,8,3,7,1,1,0,0,17465,7.2,18727,198,64,2424,2277,26.2,1746.5
4821027936,0,16,0,1,15,15,30,0,0,0,0,31981,10.6,35491,61,59,-651,1948,12.0,3198.1,30,0,0,15,15,26,0,0,0,0,32632,10.0,33543,49,43,651,-1948,9.2,3263.2
4820985470,1,55,1,0,22,10,45,0,0,0,0,40284,11.4,43672,109,71,7965,8406,18.0,4028.4,133,1,1,9,21,18,0,0,0,0,32319,10.4,35266,79,60,-7965,-8406,13.9,3231.9
4820955987,0,19,2,0,5,24,8,0,0,0,2,36250,11.0,39059,83,67,-2593,-3710,15.0,3625.0,27,3,1,24,5,44,0,0,0,0,38843,11.6,42769,108,68,2593,3710,17.6,3884.3
4820931569,1,81,2,1,22,10,49,0,0,0,1,41682,12.0,45908,104,76,12207,7598,18.0,4168.2,20,0,0,9,21,13,0,0,0,0,29475,10.6,38310,69,55,-12207,-7598,12.4,2947.5
4820911827,0,26,0,1,18,15,55,0,0,0,0,36354,10.6,36238,89,50,1047,517,13.9,3635.4,12,0,0,15,18,24,0,0,0,0,35307,10.2,35721,86,54,-1047,-517,14.0,3530.7
4813244370,0,13,23,1,3,13,3,0,0,0,2,30249,11.0,38438,112,51,-8082,-6081,16.3,3024.9,43,1,0,13,3,29,0,0,0,0,38331,11.8,44519,115,91,8082,6081,20.6,3833.1
4813219181,0,21,0,0,17,16,38,0,0,0,0,35179,11.6,43751,99,44,-2064,235,14.3,3517.9,16,3,1,16,17,29,0,0,0,0,37243,11.6,43516,76,72,2064,-235,14.8,3724.3
4813187351,0,13,2,0,3,9,6,0,0,0,0,25613,10.2,32730,105,43,-5688,-6686,14.8,2561.3,19,0,1,9,3,12,0,0,0,0,31301,11.2,39416,120,63,5688,6686,18.3,3130.1
4788734918,1,0,0,1,15,25,30,0,0,0,0,35814,10.8,38379,107,0,721,-184,10.7,3581.4,0,0,0,25,15,62,0,0,0,0,35093,11.0,38563,113,0,-721,184,11.3,3509.3
4788711007,0,0,0,1,18,14,50,0,0,0,1,34269,10.0,35978,102,0,218,-381,10.2,3426.9,0,0,0,14,18,36,0,0,0,0,34051,10.6,36359,118,0,-218,381,11.8,3405.1
4788683297,1,16,3,0,19,15,57,0,0,0,0,35974,11.0,38892,115,0,1300,2402,11.5,3597.4,24,0,1,15,19,30,0,0,0,0,34674,10.6,36490,99,0,-1300,-2402,9.9,3467.4
4763879255,0,0,0,1,28,21,84,0,0,0,1,38501,11.2,42371,110,0,-826,-94,11.0,3850.1,0,0,0,21,28,42,0,0,0,0,39327,11.2,42465,102,0,826,94,10.2,3932.7
4763855660,0,0,0,1,24,21,65,0,0,0,1,38796,11.4,42687,128,0,2569,2637,12.8,3879.6,6,0,0,21,24,59,0,0,0,0,36227,11.2,40050,87,0,-2569,-2637,8.7,3622.7
4763553556,1,0,0,1,40,32,99,0,0,0,2,43001,12.4,48652,123,0,1854,3400,12.3,4300.1,4,0,0,32,40,85,0,0,0,0,41147,11.8,45252,109,0,-1854,-3400,10.9,4114.7
4763409870,1,0,0,1,29,25,82,0,0,0,1,41207,11.8,43229,125,0,2883,1625,12.5,4120.7,7,0,0,25,29,68,0,0,0,0,38324,11.2,41604,89,0,-2883,-1625,8.9,3832.4
4763215706,1,23,3,0,30,19,68,0,0,0,1,38251,12.0,44126,120,0,902,3972,12.0,3825.1,19,17,1,19,30,38,0,0,0,0,37349,11.0,40154,90,0,-902,-3972,9.0,3734.9
4763202483,1,14,0,0,34,31,67,0,0,0,1,41988,11.8,44375,113,0,2363,-2249,11.3,4198.8,0,1,1,31,34,72,0,0,0,0,39625,12.2,46624,111,0,-2363,2249,11.1,3962.5
4762673098,1,68,0,0,21,16,46,0,0,0,0,37834,11.0,40438,116,0,3294,3313,11.6,3783.4,69,0,1,16,21,31,0,0,0,0,34540,10.6,37125,99,0,-3294,-3313,9.9,3454.0
4762659907,1,0,0,1,30,21,83,0,0,0,2,39428,11.6,43056,108,0,938,1001,10.8,3942.8,12,0,0,21,30,39,0,0,0,0,38490,11.4,42055,115,0,-938,-1001,11.5,3849.0
4856693999,1,10,2,0,2,4,4,0,0,0,0,14885,7.0,18342,242,40,-1328,7,28.2,1488.5,18,0,1,4,2,7,0,0,0,0,16213,7.0,18335,224,64,1328,-7,28.8,1621.3
4849223181,0,0,0,0,13,29,27,0,0,0,0,35021,10.8,39173,91,0,-2387,-2556,9.1,3502.1,0,0,1,29,13,53,0,0,0,0,37408,11.4,41729,97,0,2387,2556,9.7,3740.8
4849202738,1,8,0,1,30,18,62,0,0,0,1,39477,11.4,43737,105,0,3476,4506,10.5,3947.7,0,0,0,18,30,29,0,0,0,0,36001,10.8,39231,94,0,-3476,-4506,9.4,3600.1
4849078183,0,0,0,1,19,21,48,0,0,0,0,36810,11.2,39325,96,0,1502,621,9.6,3681.0,0,0,0,21,19,64,0,0,0,0,35308,10.8,38704,89,0,-1502,-621,8.9,3530.8
4843508106,1,0,0,1,28,18,75,0,0,0,0,37420,11.2,40757,96,0,403,1309,9.6,3742.0,0,0,0,18,28,36,0,0,0,0,37017,11.0,39448,100,0,-403,-1309,10.0,3701.7
4842718991,0,14,0,1,24,25,62,0,0,0,1,37183,11.2,40909,102,0,-1194,-139,10.2,3718.3,0,0,0,25,24,54,0,0,0,0,38377,11.4,41048,105,0,1194,139,10.5,3837.7
4842707604,1,39,0,1,25,24,65,0,0,0,0,39680,11.4,43471,109,0,3050,2346,10.9,3968.0,34,0,0,24,25,54,0,0,0,0,36630,11.0,41125,83,0,-3050,-2346,8.3,3663.0
4842702401,0,16,0,1,27,18,82,0,0,0,1,38007,11.2,40399,106,0,2707,959,10.6,3800.7,29,1,0,18,27,44,0,0,0,0,35300,11.0,39440,102,0,-2707,-959,10.2,3530.0
4842690711,1,9,1,0,2,2,0,1,1,0,0,15465,7.6,19712,236,64,621,1436,30.0,1546.5,17,1,1,2,2,3,0,0,0,0,14844,7.0,18276,192,71,-621,-1436,26.3,1484.4
4842404805,0,16,1,0,2,5,1,1,1,0,0,14847,6.8,17912,218,51,-1384,-135,26.9,1484.7,12,2,1,5,2,4,1,0,1,0,16231,6.8,18047,229,56,1384,135,28.5,1623.1
4841655464,0,0,0,0,9,28,21,0,0,0,0,33434,10.4,36244,105,0,-4395,-4625,10.5,3343.4,0,0,1,28,9,96,0,0,0,0,37829,11.2,40869,88,0,4395,4625,8.8,3782.9
4841648691,1,0,1,0,19,15,58,0,0,0,1,35163,10.8,37660,83,0,-742,-144,8.3,3516.3,532,0,1,15,19,39,0,0,0,0,35905,10.8,37804,103,0,742,144,10.3,3590.5
4841634706,0,10,0,0,1,6,1,0,0,0,0,15971,6.8,17479,205,51,-712,-417,25.6,1597.1,12,1,1,6,1,3,0,0,0,0,16683,7.0,17896,228,55,712,417,28.3,1668.3
4832774764,1,7,3,1,4,6,7,1,0,1,0,17829,7.0,17511,215,40,1608,-870,25.5,1782.9,12,1,0,6,4,5,0,0,0,0,16221,7.2,18381,214,70,-1608,870,28.4,1622.1
4832502390,0,11,1,0,10,10,11,0,0,0,0,17994,6.6,16498,213,44,-1377,-1420,25.7,1799.4,12,0,1,10,10,12,1,1,0,0,19371,6.8,17918,224,54,1377,1420,27.8,1937.1
4831572827,1,167,0,0,7,6,2,0,0,0,0,16712,6.8,18290,209,44,831,508,25.3,1671.2,11,0,1,6,7,4,0,0,0,0,15881,7.0,17782,175,64,-831,-508,23.9,1588.1
4831522241,0,0,7,1,18,15,31,0,0,0,0,35156,10.6,37881,104,0,40,-253,10.4,3515.6,36,0,0,15,18,35,0,0,0,0,35116,11.0,38134,119,0,-40,253,11.9,3511.6
4831313345,0,13,11,1,2,3,1,0,0,0,0,13972,6.8,16874,179,48,-1905,-584,22.7,1397.2,41,0,0,3,2,4,1,1,0,0,15877,6.8,17458,181,68,1905,584,24.9,1587.7
4830726458,0,149,1,1,9,4,7,0,0,0,0,17071,6.6,16456,168,53,1042,224,22.1,1707.1,14,1,0,4,9,5,0,0,0,0,16029,6.4,16232,193,45,-1042,-224,23.8,1602.9
4830561894,1,11,2,0,4,3,5,0,0,0,0,16104,7.0,17703,229,51,269,-1263,28.0,1610.4,15,0,1,3,4,3,0,0,0,0,15835,7.2,18966,222,64,-269,1263,28.6,1583.5
4852419617,0,12,0,1,4,9,3,0,0,0,0,13820,6.2,15115,197,0,-3821,-4711,19.7,1382.0,29,0,0,8,3,3,2,1,1,0,17641,7.4,19826,231,63,3821,4711,29.4,1764.1
4852397548,1,13,1,1,6,2,5,0,0,0,0,16820,7.2,18446,230,60,2145,-318,29.0,1682.0,8,1,0,2,6,2,0,0,0,0,14675,7.2,18764,197,68,-2145,318,26.5,1467.5
4852350856,1,15,1,0,6,7,6,0,0,0,0,17149,7.0,17643,202,42,664,765,24.4,1714.9,78,3,1,7,6,3,0,0,0,0,16485,6.6,16878,185,56,-664,-765,24.1,1648.5
4852329752,1,20,1,0,3,3,1,1,1,0,0,14727,7.0,17970,200,65,-774,-686,26.5,1472.7,13,2,1,3,3,0,0,0,0,0,15501,7.0,18656,217,60,774,686,27.7,1550.1
4852287192,1,12,3,1,1,3,1,0,0,0,0,14246,6.6,16302,175,43,-1740,-1884,21.8,1424.6,10,3,0,3,1,3,0,0,0,0,15986,7.0,18186,221,46,1740,1884,26.7,1598.6
4852268226,1,100,2,1,7,1,5,0,0,0,0,17458,6.8,18042,216,52,3819,667,26.8,1745.8,13,15,0,1,7,0,0,0,0,0,13639,6.8,17375,172,66,-3819,-667,23.8,1363.9
4849621637,1,13,1,1,4,0,7,1,1,0,0,15981,7.0,18235,202,48,1968,600,25.0,1598.1,16,0,0,0,4,0,1,0,1,0,14013,6.8,17635,191,56,-1968,-600,24.7,1401.3
4849596652,0,19,12,0,3,5,3,0,0,0,0,15108,7.0,17761,177,68,-1711,-1500,24.5,1510.8,87,3,1,5,3,3,1,1,0,0,16819,7.2,19261,242,68,1711,1500,31.0,1681.9
4849468784,0,66,1,0,1,6,1,0,0,0,0,14315,6.8,17167,166,68,-2014,-746,23.4,1431.5,14,1,1,6,1,3,1,1,0,0,16329,6.8,17913,205,52,2014,746,25.7,1632.9
4849450379,1,14,1,1,8,3,6,0,0,0,0,16873,7.0,17161,204,48,2230,-902,25.2,1687.3,24,0,0,3,8,1,0,0,0,0,14643,7.0,18063,169,68,-2230,902,23.7,1464.3
4848726325,1,23,0,1,4,2,5,1,0,1,0,15390,6.8,16679,191,57,1778,-706,24.8,1539.0,13,0,0,2,4,3,1,1,0,0,13612,7.0,17385,168,44,-1778,706,21.2,1361.2
4848694701,1,17,1,0,2,2,2,0,0,0,0,14873,6.6,16914,191,40,-408,-651,23.1,1487.3,97,1,1,2,2,3,0,0,0,0,15281,7.0,17565,207,48,408,651,25.5,1528.1
4845543881,1,125,1,1,5,2,6,1,1,0,0,15990,7.2,18322,160,68,1638,1632,22.8,1599.0,206,1,0,2,5,1,0,0,0,0,14352,6.4,16690,186,64,-1638,-1632,25.0,1435.2
4844899891,1,8,0,1,3,1,3,0,0,0,0,15819,6.8,18344,188,56,2150,1766,24.4,1581.9,12,1,0,1,3,1,0,0,0,0,13669,6.6,16578,198,48,-2150,-1766,24.6,1366.9
4844802941,0,8,1,0,2,6,0,0,0,0,0,14371,6.6,15783,173,64,-1904,-2019,23.7,1437.1,10,2,1,6,2,4,1,1,0,0,16275,6.8,17802,212,56,1904,2019,26.8,1627.5
4844780201,0,11,1,0,2,5,3,1,0,1,0,14538,6.8,18180,204,48,-1745,76,25.2,1453.8,15,1,1,5,2,5,0,0,0,0,16283,6.8,18104,244,48,1745,-76,29.2,1628.3
4844756864,1,14,0,1,5,7,6,0,0,0,0,17900,7.2,18379,242,52,1113,1481,29.4,1790.0,13,3,0,7,5,7,0,0,0,0,16787,6.6,16898,213,46,-1113,-1481,25.9,1678.7
4844633178,1,12,2,0,0,3,0,1,1,0,0,13997,6.8,17419,211,48,-962,-382,25.9,1399.7,13,2,1,3,0,1,0,0,0,0,14959,6.8,17801,222,56,962,382,27.8,1495.9
4844628815,0,12,0,0,3,9,0,0,0,0,0,14160,6.8,17140,177,60,-4756,-2916,23.7,1416.0,12,2,1,9,3,4,1,1,0,0,18916,7.4,20056,211,64,4756,2916,27.5,1891.6
4828357478,1,25,0,1,28,30,62,0,0,0,1,39932,11.8,44807,92,0,-1967,689,9.2,3993.2,92,6,0,30,28,89,0,0,0,0,41899,11.6,44118,110,0,1967,-689,11.0,4189.9
4828340531,1,27,0,0,19,18,52,0,0,0,1,35414,10.6,38177,98,0,-1118,560,9.8,3541.4,0,9,1,18,19,58,0,0,0,0,36532,10.8,37617,133,0,1118,-560,13.3,3653.2
4828330107,0,1,0,1,28,25,66,0,0,0,2,37648,11.0,41191,104,0,-1731,-771,10.4,3764.8,0,0,0,25,28,68,0,0,0,0,39379,11.6,41962,111,0,1731,771,11.1,3937.9
4828309344,0,21,0,0,22,18,65,0,0,0,0,35084,10.8,38878,106,0,-1106,412,10.6,3508.4,0,4,1,18,22,53,0,0,0,0,36190,10.8,38466,95,0,1106,-412,9.5,3619.0
4828294227,1,0,0,1,32,32,82,0,0,0,2,41642,12.0,45930,121,0,1737,256,12.1,4164.2,17,0,0,32,32,72,0,0,0,0,39905,11.8,45674,104,0,-1737,-256,10.4,3990.5
4826288891,1,0,0,0,27,29,84,0,0,0,1,38432,11.4,41396,125,0,999,-770,12.5,3843.2,0,0,1,29,27,73,0,0,0,0,37433,11.4,42166,103,0,-999,770,10.3,3743.3
4826269431,0,97,0,0,25,25,59,0,0,0,0,37017,11.0,38899,111,0,-1521,-4532,11.1,3701.7,0,0,1,25,25,67,0,0,0,0,38538,11.6,43431,106,0,1521,4532,10.6,3853.8
4826264971,1,0,0,0,32,25,87,0,0,0,1,39747,11.8,45620,122,0,2436,3676,12.2,3974.7,0,0,1,25,32,51,0,0,0,0,37311,11.2,41944,87,0,-2436,-3676,8.7,3731.1
4826249392,1,0,0,1,37,24,93,0,0,0,1,42016,12.4,48697,113,0,4631,6811,11.3,4201.6,0,0,0,24,37,62,0,0,0,0,37385,11.6,41886,90,0,-4631,-6811,9.0,3738.5
4826239803,1,0,0,1,33,37,102,0,0,0,0,40383,11.6,43401,112,0,-185,-356,11.2,4038.3,0,0,0,37,33,100,0,0,0,0,40568,11.6,43757,108,0,185,356,10.8,4056.8
4826225975,0,0,0,0,26,29,72,0,0,0,1,36307,11.2,40341,93,0,-1542,-62,9.3,3630.7,0,0,1,29,26,76,0,0,0,0,37849,11.2,40403,103,0,1542,62,10.3,3784.9
4812067976,1,0,0,0,24,17,61,0,0,0,0,35970,11.0,39741,114,0,1161,1507,11.4,3597.0,33,0,1,17,24,36,0,0,0,0,34809,10.8,38234,108,0,-1161,-1507,10.8,3480.9
4812048317,0,14,0,1,19,18,49,0,0,0,1,35280,10.8,38603,85,0,-1804,-1238,8.5,3528.0,12,4,0,18,19,42,0,0,0,0,37084,11.0,39841,125,0,1804,1238,12.5,3708.4
4812036757,1,0,0,1,16,18,53,0,0,0,1,35450,10.4,36683,96,0,1269,-389,9.6,3545.0,0,0,0,18,16,58,0,0,0,0,34181,10.4,37072,97,0,-1269,389,9.7,3418.1
4807060535,1,15,0,1,30,23,87,0,0,0,2,39952,11.6,44402,115,0,1244,2490,11.5,3995.2,20,0,0,23,30,54,0,0,0,0,38708,11.2,41912,93,0,-1244,-2490,9.3,3870.8
4807044449,1,0,0,1,32,23,77,0,0,0,2,41859,12.0,45769,118,0,3972,4653,11.8,4185.9,0,0,0,23,32,49,0,0,0,0,37887,11.2,41116,109,0,-3972,-4653,10.9,3788.7
4807035128,0,20,0,0,32,37,83,0,0,0,0,40533,12.0,46181,99,0,-548,931,9.9,4053.3,0,2,1,37,32,92,0,0,0,0,41081,12.0,45250,120,0,548,-931,12.0,4108.1
4807013608,0,0,0,0,22,26,55,0,0,0,0,37788,11.2,40284,111,0,-292,-2018,11.1,3778.8,0,0,1,26,22,63,0,0,0,0,38080,11.4,42302,122,0,292,2018,12.2,3808.0
4804334140,0,0,0,0,29,25,66,0,0,0,1,40674,11.6,43310,108,0,2959,2179,10.8,4067.4,0,0,1,25,29,71,0,0,0,0,37715,11.2,41131,118,0,-2959,-2179,11.8,3771.5
4804317963,0,15,0,0,18,26,47,0,0,0,2,36759,10.8,38648,100,0,-3402,-3620,10.0,3675.9,0,4,1,26,18,72,0,0,0,0,40161,11.4,42268,132,0,3402,3620,13.2,4016.1
4807232674,0,14,2,0,3,5,2,0,0,0,0,15224,6.8,17741,181,60,-558,-890,24.1,1522.4,22,0,1,5,3,1,1,0,1,0,15782,7.0,18631,187,60,558,890,24.7,1578.2
4807097948,0,13,0,0,5,7,5,0,0,0,0,15676,6.6,15705,173,56,-1862,-3325,22.9,1567.6,6,2,1,7,5,1,0,0,0,0,17538,7.2,19030,190,60,1862,3325,25.0,1753.8
4807052343,0,11,4,0,4,8,4,1,0,1,0,16112,6.8,18005,212,52,214,637,26.4,1611.2,15,1,1,8,4,6,1,1,0,0,15898,6.8,17368,157,56,-214,-637,21.3,1589.8
4806996731,0,15,0,0,3,7,3,0,0,0,0,14437,6.6,17038,192,44,-1868,-1321,23.6,1443.7,7,4,1,7,3,6,1,1,0,0,16305,7.2,18359,208,55,1868,1321,26.3,1630.5
4788714549,1,15,0,1,6,3,5,0,0,0,0,17082,6.8,17459,211,48,1877,418,25.9,1708.2,8,2,0,3,6,2,0,0,0,0,15205,6.8,17041,195,55,-1877,-418,25.0,1520.5
4788677499,1,32,3,0,7,4,6,0,0,0,0,16519,6.8,17348,221,56,1497,1346,27.7,1651.9,32,9,1,4,7,3,0,0,0,0,15022,6.6,16002,169,36,-1497,-1346,20.5,1502.2
4788630695,0,15,2,1,7,6,3,0,0,0,0,16651,7.2,18409,224,68,-708,-238,29.2,1665.1,12,1,0,6,7,7,0,0,0,0,17359,7.0,18647,225,48,708,238,27.3,1735.9
4788608145,1,10,3,1,8,4,5,0,0,0,0,17636,6.8,18279,207,52,1203,1151,25.9,1763.6,17,0,0,4,8,3,1,1,0,0,16433,6.8,17128,193,55,-1203,-1151,24.8,1643.3
4788573360,1,8,0,1,10,4,8,0,0,0,0,20496,7.2,19937,255,68,5179,1779,32.3,2049.6,7,0,0,4,10,7,0,0,0,0,15317,7.0,18158,200,56,-5179,-1779,25.6,1531.7
4788528355,1,8,2,0,5,5,3,1,1,0,0,15936,6.8,17645,229,56,74,1188,28.5,1593.6,14,0,1,5,5,5,0,0,0,0,15862,6.6,16457,153,44,-74,-1188,19.7,1586.2
4787766928,1,15,0,0,6,8,5,1,0,1,0,16871,6.8,17446,189,64,-1095,-414,25.3,1687.1,9,2,1,8,6,10,1,1,0,0,17966,6.8,17860,204,52,1095,414,25.6,1796.6
4786874157,1,16,1,1,7,6,7,0,0,0,0,17111,7.2,18474,218,56,89,-186,27.4,1711.1,9,0,0,6,7,2,1,1,0,0,17022,7.0,18660,216,64,-89,186,28.0,1702.2
4773781145,1,11,0,0,5,8,6,0,0,0,0,16846,6.8,18251,207,56,-2088,-498,26.3,1684.6,6,4,1,8,5,6,1,1,0,0,18934,7.2,18749,238,48,2088,498,28.6,1893.4
4773129596,1,6,6,0,8,9,9,1,1,0,0,18866,7.0,18704,220,55,-345,1567,27.5,1886.6,21,0,1,9,8,9,0,0,0,0,19211,6.8,17137,198,48,345,-1567,24.6,1921.1
4773086009,0,28,1,1,6,8,6,0,0,0,0,17336,6.6,17138,214,52,-524,-578,26.6,1733.6,31,1,0,8,6,7,0,0,0,0,17860,7.0,17716,172,56,524,578,22.8,1786.0
4753760175,0,8,2,0,8,6,6,0,0,0,0,17011,6.8,17338,213,46,1004,14,25.9,1701.1,14,2,1,6,8,6,0,0,0,0,16007,6.6,17324,184,56,-1004,-14,24.0,1600.7
4753717695,1,12,0,1,12,4,16,0,0,0,0,20905,7.2,18729,219,68,3452,1639,28.7,2090.5,10,0,0,4,12,5,1,0,1,0,17453,6.6,17090,189,60,-3452,-1639,24.9,1745.3
4750936742,1,86,0,1,5,5,5,0,0,0,0,16739,6.8,18032,219,64,113,1265,28.3,1673.9,11,2,0,5,5,7,1,1,0,0,16626,6.8,16767,195,52,-113,-1265,24.7,1662.6
4750740159,0,35,2,1,7,8,7,0,0,0,0,17438,6.6,17422,179,56,575,-423,23.5,1743.8,12,10,0,8,7,6,1,1,0,0,16863,6.8,17845,179,52,-575,423,23.1,1686.3
4750707788,1,79,0,1,5,3,5,0,0,0,0,17361,7.0,18472,228,68,3252,2679,29.6,1736.1,5,1,0,3,5,4,0,0,0,0,14109,6.6,15793,200,40,-3252,-2679,24.0,1410.9
4839973116,0,73,3,1,3,9,4,0,0,0,0,16894,7.4,18467,202,56,-3427,-1588,25.8,1689.4,21,3,0,9,3,10,2,1,1,0,20321,7.2,20055,242,60,3427,1588,30.2,2032.1
4839798673,0,16,2,1,4,6,2,0,0,0,0,15061,6.6,17186,221,44,-3437,-1220,26.5,1506.1,15,1,0,6,4,6,1,1,0,0,18498,7.0,18406,198,64,3437,1220,26.2,1849.8
4839775131,0,9,0,1,6,4,4,1,0,1,0,16526,6.8,18207,231,48,1198,1533,27.9,1652.6,16,2,0,4,6,3,1,1,0,0,15328,6.6,16674,178,56,-1198,-1533,23.4,1532.8
4839737024,0,10,2,0,0,7,0,0,0,0,0,14519,6.6,17158,206,68,-2102,-918,27.4,1451.9,11,1,1,7,0,9,1,1,0,0,16621,7.0,18076,194,72,2102,918,26.6,1662.1
4836968622,0,18,2,0,4,9,3,0,0,0,0,15655,7.0,17566,216,44,-1567,-1450,26.0,1565.5,17,1,1,9,4,6,0,0,0,0,17222,7.0,19016,197,56,1567,1450,25.3,1722.2
4835601117,0,64,1,1,4,2,2,0,0,0,0,14858,6.6,16836,181,56,-439,-563,23.7,1485.8,11,0,0,2,4,3,1,1,0,0,15297,6.8,17399,186,56,439,563,24.2,1529.7
4835582824,0,15,2,1,9,2,7,0,0,0,0,18087,7.2,18940,216,64,2677,1018,28.0,1808.7,16,3,0,2,9,3,1,1,0,0,15410,7.0,17922,232,56,-2677,-1018,28.8,1541.0
4828241383,1,17,2,1,7,3,12,1,1,0,0,17632,6.8,17768,186,52,2404,181,23.8,1763.2,13,2,0,3,7,1,0,0,0,0,15228,6.6,17587,204,56,-2404,-181,26.0,1522.8
4816048491,0,16,2,1,7,6,5,0,0,0,0,16843,6.8,18128,222,52,403,1250,27.4,1684.3,13,3,0,6,7,10,1,1,0,0,16440,6.6,16878,200,51,-403,-1250,25.1,1644.0
4815885110,0,9,7,0,2,4,1,0,0,0,0,14709,6.6,16708,198,51,-997,-1597,24.9,1470.9,30,0,1,4,2,1,0,0,0,0,15706,6.8,18305,217,60,997,1597,27.7,1570.6
4815871031,0,14,0,1,6,5,8,0,0,0,0,15513,6.6,16184,194,37,-1546,-2658,23.1,1551.3,11,1,0,5,6,2,0,0,0,0,17059,7.0,18842,213,62,1546,2658,27.5,1705.9
4815848633,1,42,0,1,6,7,6,0,0,0,0,16542,7.0,18529,205,64,-308,459,26.9,1654.2,75,1,0,7,6,9,1,1,0,0,16850,6.8,18070,187,64,308,-459,25.1,1685.0
4815827726,1,19,2,1,3,2,2,0,0,0,0,17067,7.0,18063,200,56,2656,1343,25.6,1706.7,11,1,0,2,3,2,0,0,0,0,14411,6.6,16720,207,52,-2656,-1343,25.9,1441.1
4815239846,1,91,1,1,4,1,4,0,0,0,0,15665,6.8,17800,204,52,1525,-389,25.6,1566.5,11,1,0,1,4,0,1,1,0,0,14140,7.0,18189,189,76,-1525,389,26.5,1414.0
4814800219,1,11,0,1,9,5,7,1,1,0,0,16897,6.6,16737,161,56,1274,953,21.7,1689.7,12,0,0,5,9,5,0,0,0,0,15623,6.4,15784,171,44,-1274,-953,21.5,1562.3
4813315302,0,14,0,0,22,22,52,0,0,0,0,35617,11.0,39956,85,47,-2272,-1231,13.2,3561.7,12,0,1,22,22,44,0,0,0,0,37889,11.2,41187,102,61,2272,1231,16.3,3788.9
4802363179,0,12,0,0,4,8,0,0,0,0,0,13400,6.6,16272,146,50,-5248,-2737,19.6,1340.0,84,0,1,8,4,7,0,0,0,0,18648,7.2,19009,183,57,5248,2737,24.0,1864.8
4801554697,0,11,0,1,8,11,7,0,0,0,0,16425,6.4,15572,156,56,-2084,-1630,21.2,1642.5,17,0,0,11,8,6,1,1,0,0,18509,6.8,17202,170,40,2084,1630,21.0,1850.9
4797924080,0,14,1,0,2,6,1,0,0,0,0,14876,6.6,16637,201,55,-2525,-1791,25.6,1487.6,14,1,1,6,2,6,0,0,0,0,17401,7.4,18428,222,48,2525,1791,27.0,1740.1
4797888602,1,12,2,1,10,5,12,0,0,0,0,19927,7.0,18721,226,44,2940,1459,27.0,1992.7,17,2,0,5,10,4,0,0,0,0,16987,6.6,17262,191,40,-2940,-1459,23.1,1698.7
4847932445,0,9,0,0,6,7,6,1,1,0,0,15242,6.6,16431,174,52,-808,-1472,22.6,1524.2,8,0,1,7,6,4,1,0,1,0,16050,7.0,17903,179,60,808,1472,23.9,1605.0
4847894171,0,132,0,0,6,3,6,0,0,0,0,16596,6.2,16101,165,44,-1100,-2284,20.9,1659.6,10,2,1,3,6,3,0,0,0,0,17696,7.0,18385,205,48,1100,2284,25.3,1769.6
4845082116,1,12,1,1,10,9,10,0,0,0,0,19375,7.0,18184,202,60,2412,3697,26.2,1937.5,15,1,0,9,10,9,0,0,0,0,16963,6.0,14487,139,28,-2412,-3697,16.7,1696.3
4845037241,0,13,2,1,6,9,3,0,0,0,0,16420,6.8,17438,199,56,-2141,-1807,25.5,1642.0,11,1,0,9,6,7,1,1,0,0,18561,7.4,19245,174,72,2141,1807,24.6,1856.1
4844687969,0,11,2,0,3,3,3,0,0,0,0,15689,6.8,18085,182,50,1663,1019,23.2,1568.9,12,1,1,3,3,2,0,0,0,0,14026,6.6,17066,184,50,-1663,-1019,23.4,1402.6
4843737586,1,13,1,0,5,8,2,0,0,0,0,16422,6.8,17433,192,64,-368,931,25.6,1642.2,18,1,1,8,5,9,1,1,0,0,16790,6.8,16502,187,56,368,-931,24.3,1679.0
4843727321,1,17,2,0,7,6,9,1,1,0,0,17511,7.2,18286,212,56,108,-629,26.8,1751.1,12,0,1,6,7,5,0,0,0,0,17403,7.0,18915,225,67,-108,629,29.2,1740.3
4843290047,0,16,1,1,1,6,0,1,1,0,0,14858,6.8,17269,221,60,-1760,-1300,28.1,1485.8,13,2,0,6,1,5,0,0,0,0,16618,7.2,18569,177,67,1760,1300,24.4,1661.8
4843243320,1,11,1,0,3,4,3,0,0,0,0,17331,6.8,17865,220,48,1905,1138,26.8,1733.1,13,1,1,4,3,3,0,0,0,0,15426,6.8,16727,200,64,-1905,-1138,26.4,1542.6
4842129928,0,13,1,1,5,2,5,0,0,0,0,17206,7.2,18382,191,60,3772,1655,25.1,1720.6,8,1,0,2,5,1,1,1,0,0,13434,6.6,16727,179,52,-3772,-1655,23.1,1343.4
4841336949,0,11,0,1,11,12,13,0,0,0,0,18156,6.2,14743,163,39,-54,-2126,20.2,1815.6,11,3,0,12,11,11,1,1,0,0,18210,6.6,16869,190,48,54,2126,23.8,1821.0
4841286335,1,6,1,0,4,2,2,1,1,0,0,15275,6.8,18388,187,48,365,702,23.5,1527.5,9,1,1,2,4,0,0,0,0,0,14910,6.8,17686,182,58,-365,-702,24.0,1491.0
4841250611,1,20,1,0,3,3,3,1,1,0,0,14943,6.8,17403,178,48,-1173,-920,22.6,1494.3,16,4,1,3,3,2,0,0,0,0,16116,7.0,18323,180,56,1173,920,23.6,1611.6
4841212904,1,8,1,1,5,1,5,0,0,0,0,15304,6.8,17494,175,37,1630,1328,21.2,1530.4,15,3,0,1,5,1,0,0,0,0,13674,6.2,16166,149,47,-1630,-1328,19.6,1367.4
4841179250,1,77,0,1,3,0,2,0,0,0,0,15937,7.2,19367,175,54,2370,1680,22.9,1593.7,10,1,0,0,3,0,0,0,0,0,13567,6.8,17687,183,56,-2370,-1680,23.9,1356.7
4840630918,1,10,3,1,11,6,8,1,1,0,0,18855,7.2,19378,226,56,1699,1396,28.2,1885.5,74,1,0,6,11,13,0,0,0,0,17156,7.2,17982,192,64,-1699,-1396,25.6,1715.6
4840330603,0,12,0,1,4,12,5,1,1,0,0,17000,6.8,17761,189,48,-716,-156,23.7,1700.0,8,2,0,12,4,10,1,0,1,0,17716,6.8,17917,161,44,716,156,20.5,1771.6
4840273010,0,8,0,0,7,4,2,0,0,0,0,15913,6.6,17261,162,52,1657,1559,21.4,1591.3,9,1,1,4,7,2,1,1,0,0,14256,6.2,15702,145,44,-1657,-1559,18.9,1425.6
4839856624,1,18,0,1,8,4,2,0,0,0,0,17305,7.0,18897,223,70,2424,2464,29.3,1730.5,23,1,0,3,7,3,0,0,0,0,14881,6.6,16433,199,44,-2424,-2464,24.3,1488.1
4839831361,0,13,1,1,4,2,5,1,1,0,0,15989,7.0,17825,207,64,1823,469,27.1,1598.9,15,0,0,2,4,2,0,0,0,0,14166,6.8,17356,215,40,-1823,-469,25.5,1416.6
4823202647,1,11,3,1,2,4,1,1,1,0,0,15725,6.8,17211,224,68,189,-483,29.2,1572.5,12,1,0,4,2,3,0,0,0,0,15536,6.8,17694,193,56,-189,483,24.9,1553.6
4823184775,0,80,1,0,3,5,3,0,0,0,0,16292,6.8,18221,229,46,-582,216,27.5,1629.2,14,1,1,5,3,7,0,0,0,0,16874,7.0,18005,214,40,582,-216,25.4,1687.4
4823129725,0,13,1,0,3,5,4,0,0,0,0,16018,6.8,17366,210,51,1024,1511,26.1,1601.8,24,0,1,5,3,6,0,0,0,0,14994,6.4,15855,198,44,-1024,-1511,24.2,1499.4
4823097787,1,58,1,0,6,3,10,0,0,0,0,15354,6.4,16113,163,51,-147,-699,21.4,1535.4,63,0,1,3,6,5,0,0,0,0,15501,6.6,16812,214,52,147,699,26.6,1550.1
4823037525,1,22,1,0,0,0,0,0,0,0,0,15319,6.8,18727,231,60,1664,1218,29.1,1531.9,11,3,0,0,0,0,0,0,0,0,13655,6.8,17509,209,60,-1664,-1218,26.9,1365.5
4822924368,1,126,2,0,2,4,1,1,0,1,0,14096,6.8,17531,207,44,-1890,-51,25.1,1409.6,16,5,1,4,2,8,1,1,0,0,15986,6.8,17582,218,60,1890,51,27.8,1598.6
4822871355,0,16,0,0,2,3,3,0,0,0,0,14999,7.0,18497,205,60,662,1432,26.5,1499.9,23,0,1,3,2,0,1,1,0,0,14337,6.8,17065,208,56,-662,-1432,26.4,1433.7
4822800335,1,9,1,1,5,3,6,1,1,0,0,15589,7.0,17967,195,56,764,534,25.1,1558.9,14,0,0,3,5,3,0,0,0,0,14825,6.8,17433,202,35,-764,-534,23.7,1482.5
4743483891,0,11,0,0,6,4,6,1,1,0,0,16099,7.0,17391,190,64,648,-1328,25.4,1609.9,12,0,1,4,6,1,0,0,0,0,15451,7.0,18719,210,72,-648,1328,28.2,1545.1
4743443201,0,11,0,1,4,9,4,0,0,0,0,15811,6.6,17014,224,40,-2138,-631,26.4,1581.1,14,0,0,9,4,9,1,1,0,0,17949,6.6,17645,193,56,2138,631,24.9,1794.9
4743383352,1,20,0,1,5,4,4,0,0,0,0,17046,7.0,17620,185,56,1342,266,24.1,1704.6,10,0,0,4,5,3,0,0,0,0,15704,6.6,17354,218,60,-1342,-266,27.8,1570.4
4586687121,1,155,1,0,10,8,8,1,1,0,0,17226,7.0,17564,183,52,-929,-85,23.5,1722.6,13,1,1,8,10,6,0,0,0,0,18155,6.8,17649,205,52,929,85,25.7,1815.5
4572528030,0,12,7,1,6,11,2,0,0,0,0,15768,6.6,16620,171,64,-2996,-1774,23.5,1576.8,35,1,0,11,6,14,0,0,0,0,18764,7.2,18394,196,59,2996,1774,25.5,1876.4
4572359209,1,34,0,1,4,4,4,1,1,0,0,14927,6.4,15748,126,57,-896,-1253,18.3,1492.7,18,1,0,4,4,5,0,0,0,0,15823,6.6,17001,211,39,896,1253,25.0,1582.3
4572337041,0,11,3,1,4,12,4,0,0,0,0,14493,6.8,16308,184,72,-4203,-2025,25.6,1449.3,10,1,0,12,4,9,1,1,0,0,18696,6.8,18333,186,64,4203,2025,25.0,1869.6
4570246941,0,13,2,1,8,7,11,0,0,0,0,17534,6.6,17236,203,37,-248,-702,24.0,1753.4,24,1,0,7,8,6,1,1,0,0,17782,7.0,17938,177,60,248,702,23.7,1778.2
4553289263,1,12,1,0,4,3,4,0,0,0,0,15068,6.8,17486,218,44,-155,-652,26.2,1506.8,14,2,1,3,4,3,0,0,0,0,15223,7.2,18138,205,60,155,652,26.5,1522.3
4550748400,1,28,0,1,33,17,36,1,1,0,2,44878,10.6,35414,185,28,9649,5365,21.3,4487.8,20,1,0,17,33,16,0,0,0,0,35229,9.4,30049,177,0,-9649,-5365,17.7,3522.9
4550684291,1,14,0,1,7,0,11,1,1,0,0,17157,7.2,18237,216,48,3124,1373,26.4,1715.7,15,2,0,0,7,0,0,0,0,0,14033,6.6,16864,226,55,-3124,-1373,28.1,1403.3
4785052526,0,12,1,0,3,5,4,0,0,0,0,16832,7.2,18333,242,56,858,-107,29.8,1683.2,15,2,1,5,3,2,0,0,0,0,15974,7.0,18440,221,56,-858,107,27.7,1597.4
4784990484,0,11,0,0,5,5,1,0,0,0,0,17905,7.6,19611,208,56,1496,2717,26.4,1790.5,11,0,1,5,5,3,0,0,0,0,16409,6.8,16894,215,48,-1496,-2717,26.3,1640.9
4784971853,1,31,3,1,9,6,7,0,0,0,0,19053,7.2,18604,218,58,2198,1279,27.6,1905.3,35,2,0,6,9,5,0,0,0,0,16855,6.8,17325,190,41,-2198,-1279,23.1,1685.5
4784944247,0,155,2,0,7,6,4,1,1,0,0,16342,6.8,17289,206,40,-765,-1220,24.6,1634.2,34,2,1,6,7,2,0,0,0,0,17107,6.8,18509,212,64,765,1220,27.6,1710.7
4784927530,0,15,2,0,4,7,5,1,1,0,0,15957,6.4,16230,185,56,-2492,-1435,24.1,1595.7,76,4,1,7,4,3,0,0,0,0,18449,6.6,17665,219,40,2492,1435,25.9,1844.9
4784917099,1,12,1,1,5,4,4,0,0,0,0,15556,6.6,16726,190,48,-35,253,23.8,1555.6,14,0,0,4,5,5,0,0,0,0,15591,6.6,16473,203,56,35,-253,25.9,1559.1
4784895986,0,13,0,0,3,4,3,0,0,0,0,15014,6.8,18275,208,52,-416,-41,26.0,1501.4,12,1,1,4,3,5,1,1,0,0,15430,6.8,18316,202,60,416,41,26.2,1543.0
4783321951,0,16,0,1,8,9,8,0,0,0,0,16903,6.4,15681,180,48,-1531,-1778,22.8,1690.3,11,3,0,9,8,8,1,1,0,0,18434,6.8,17459,228,36,1531,1778,26.4,1843.4
4783269298,1,11,0,0,4,9,3,0,0,0,0,15510,7.0,17483,198,64,-2562,-1273,26.2,1551.0,8,0,1,9,4,14,1,1,0,0,18072,7.0,18756,224,58,2562,1273,28.2,1807.2
4783240458,0,15,2,1,4,4,1,0,0,0,0,14955,6.6,16864,192,56,-2165,-1157,24.8,1495.5,14,1,0,4,4,4,0,0,0,0,17120,6.8,18021,251,44,2165,1157,29.5,1712.0
4715516278,1,14,2,1,15,8,12,1,1,0,0,21203,7.0,18123,198,40,4387,1331,23.8,2120.3,10,2,0,8,15,3,0,0,0,0,16816,6.6,16792,188,48,-4387,-1331,23.6,1681.6
4715497289,0,12,2,0,4,10,4,0,0,0,0,15725,6.8,17392,191,52,-3154,-2445,24.3,1572.5,12,1,1,10,4,5,0,0,0,0,18879,7.4,19837,216,52,3154,2445,26.8,1887.9
4715476965,1,10,0,0,8,11,8,0,0,0,0,17566,6.4,15733,223,28,-1031,-377,25.1,1756.6,11,0,1,11,8,9,1,1,0,0,18597,6.6,16110,172,48,1031,377,22.0,1859.7
4715016263,1,11,1,1,8,3,4,0,0,0,0,17380,6.8,18253,231,56,1744,1408,28.7,1738.0,8,1,0,3,8,2,1,1,0,0,15636,6.6,16845,184,60,-1744,-1408,24.4,1563.6
4714943836,1,9,2,1,4,7,0,0,0,0,0,15795,7.0,18483,186,64,-1016,160,25.0,1579.5,13,2,0,7,4,5,0,0,0,0,16811,6.8,18323,182,48,1016,-160,23.0,1681.1
4714908022,1,15,1,1,6,5,3,0,0,0,0,17904,7.0,18241,192,56,2848,901,24.8,1790.4,13,0,0,5,6,4,0,0,0,0,15056,6.8,17340,159,52,-2848,-901,21.1,1505.6
4714512804,0,35,4,1,9,8,11,0,0,0,0,17957,6.8,16747,201,43,492,-1862,24.4,1795.7,21,11,0,8,9,8,0,0,0,0,17465,7.2,18609,208,68,-492,1862,27.6,1746.5
4714480237,1,15,1,1,6,10,3,1,1,0,0,17093,7.0,18109,228,61,724,2166,28.9,1709.3,13,2,0,10,6,7,1,0,1,0,16369,6.4,15943,176,34,-724,-2166,21.0,1636.9
4714445787,1,8,0,1,6,7,5,1,0,1,0,16672,6.6,17191,175,50,880,-254,22.5,1667.2,10,1,0,7,6,6,1,1,0,0,15792,6.8,17445,198,52,-880,254,25.0,1579.2
4712639543,1,12,2,0,3,3,5,1,0,1,0,15445,7.0,18077,199,62,80,872,26.1,1544.5,17,1,1,3,3,4,1,1,0,0,15365,6.8,17205,198,63,-80,-872,26.1,1536.5
4857474764,0,14,18,0,4,4,2,1,1,0,0,14380,6.4,16278,173,44,-2232,-3271,21.7,1438.0,34,1,1,4,4,3,0,0,0,0,16612,7.2,19549,187,75,2232,3271,26.2,1661.2
4857440254,1,8,0,1,36,32,101,0,0,0,1,41548,12.0,45328,117,0,684,-995,11.7,4154.8,12,0,0,32,36,80,0,0,0,0,40864,12.2,46323,98,0,-684,995,9.8,4086.4
4857414504,1,39,4,1,25,16,17,0,0,0,0,65255,13.0,62500,11,0,28725,28000,1.1,6525.5,0,0,0,3,12,10,0,0,0,0,36530,7.4,34500,0,0,-28725,-28000,0.0,3653.0
4857390543,1,0,0,1,25,14,27,0,0,0,0,64450,12.0,55000,0,0,28275,22000,0.0,6445.0,5,0,0,6,17,6,0,0,0,0,36175,7.2,33000,1,0,-28275,-22000,0.1,3617.5
4857088787,1,13,0,1,7,2,5,1,1,0,0,17460,7.0,18848,219,68,2745,1667,28.7,1746.0,15,0,0,2,7,2,0,0,0,0,14715,6.6,17181,228,52,-2745,-1667,28.0,1471.5
4856596845,0,82,2,0,11,6,9,1,1,0,0,19126,7.0,18535,183,56,2811,1989,23.9,1912.6,15,1,1,6,11,10,0,0,0,0,16315,6.6,16546,162,60,-2811,-1989,22.2,1631.5
4856573853,1,10,2,0,6,10,6,1,1,0,0,15757,6.6,16937,193,38,-3256,-745,23.1,1575.7,16,2,1,10,6,17,0,0,0,0,19013,6.8,17682,206,64,3256,745,27.0,1901.3
4856547467,0,12,2,0,4,7,3,0,0,0,0,15548,6.8,18119,211,56,-1303,-804,26.7,1554.8,18,1,1,7,4,4,1,0,1,0,16851,7.2,18923,203,52,1303,804,25.5,1685.1
4856521096,0,12,0,0,6,6,2,0,0,0,0,15534,6.8,17842,193,56,-1158,-542,24.9,1553.4,20,1,1,6,6,3,1,1,0,0,16692,7.0,18384,200,68,1158,542,26.8,1669.2
4856481154,1,12,3,1,6,4,5,1,1,0,0,17508,7.2,18833,221,56,2076,2782,27.7,1750.8,14,1,0,4,6,4,0,0,0,0,15432,6.4,16051,174,48,-2076,-2782,22.2,1543.2
4856432071,1,14,0,1,6,5,4,1,1,0,0,16271,7.0,18237,204,48,-696,316,25.2,1627.1,13,2,0,5,6,3,0,0,0,0,16967,6.8,17921,239,44,696,-316,28.3,1696.7
4856385307,1,16,2,1,6,5,7,0,0,0,0,18614,7.0,17800,196,60,2627,1620,25.6,1861.4,18,0,0,5,6,7,0,0,0,0,15987,6.4,16180,158,48,-2627,-1620,20.6,1598.7
4854370614,1,31,2,1,19,15,21,0,0,0,0,64181,12.0,55000,2,0,25891,22000,0.2,6418.1,0,3,0,9,13,8,0,0,0,0,38290,7.2,33000,0,0,-25891,-22000,0.0,3829.0
4854369903,1,0,0,1,22,13,21,0,0,0,0,62430,12.0,55000,0,0,25555,22000,0.0,6243.0,0,0,0,9,18,8,0,0,0,0,36875,7.2,33000,1,0,-25555,-22000,0.1,3687.5
4854349654,0,13,0,0,6,10,6,0,0,0,0,16965,6.8,16644,171,56,-1704,-1328,22.7,1696.5,14,2,1,10,6,13,1,1,0,0,18669,6.8,17972,200,52,1704,1328,25.2,1866.9
4854332521,0,14,1,0,4,5,2,0,0,0,0,16404,7.2,18853,208,52,-704,973,26.0,1640.4,12,1,1,5,4,6,0,0,0,0,17108,6.8,17880,180,68,704,-973,24.8,1710.8
4854313880,1,9,0,1,8,10,7,0,0,0,0,17999,7.0,17468,190,52,-844,-20,24.2,1799.9,47,2,0,10,8,11,2,1,1,0,18843,6.8,17488,173,64,844,20,23.7,1884.3
4854273377,1,11,2,0,3,5,4,0,0,0,0,15064,6.6,16933,218,40,-1622,-1451,25.8,1506.4,11,2,1,5,3,3,2,1,1,0,16686,7.0,18384,192,56,1622,1451,24.8,1668.6
4854253051,1,18,3,1,8,3,7,0,0,0,0,18698,7.0,18419,233,44,3214,2986,27.7,1869.8,11,5,0,3,8,4,0,0,0,0,15484,6.2,15433,151,48,-3214,-2986,19.9,1548.4
4854213491,1,15,0,0,7,9,5,2,1,1,0,17350,6.6,17634,187,60,428,-173,24.7,1735.0,9,0,1,9,7,7,0,0,0,0,16922,7.0,17807,163,52,-428,173,21.5,1692.2
4857427373,0,15,0,1,22,36,67,0,0,0,1,36423,10.8,39320,79,0,-5461,-5889,7.9,3642.3,0,2,0,36,22,103,0,0,0,0,41884,12.0,45209,119,0,5461,5889,11.9,4188.4
4857400267,1,34,0,1,32,22,92,0,0,0,0,38940,11.6,43877,92,0,1165,3393,9.2,3894.0,34,0,0,21,31,62,0,0,0,0,37775,11.2,40484,112,0,-1165,-3393,11.2,3777.5
4857117270,1,85,0,0,19,14,19,0,0,0,0,48300,10.0,47500,0,0,20800,19000,0.0,4830.0,0,0,1,7,12,8,0,0,0,0,27500,6.0,28500,0,0,-20800,-19000,0.0,2750.0
4856319212,1,0,0,0,13,21,9,0,0,0,0,44550,10.6,50500,0,0,15300,22000,0.0,4455.0,5,0,1,14,6,15,0,0,0,0,29250,6.0,28500,0,0,-15300,-22000,0.0,2925.0
4856292843,1,0,0,1,17,14,11,0,0,0,0,48500,12.0,55000,0,0,20100,22000,0.0,4850.0,0,0,0,6,9,12,0,0,0,0,28400,7.2,33000,0,0,-20100,-22000,0.0,2840.0
4856255592,1,0,0,1,16,14,14,0,0,0,0,46238,10.0,47500,4,0,15503,17820,0.4,4623.8,0,0,0,7,9,11,0,0,0,0,30735,6.2,29680,1,0,-15503,-17820,0.1,3073.5
4856230267,1,0,0,1,17,14,18,0,0,0,0,47750,10.0,47500,0,0,20115,17820,0.0,4775.0,0,0,0,8,11,7,0,0,0,0,27635,6.2,29680,2,0,-20115,-17820,0.2,2763.5
4856032784,1,0,0,1,11,20,10,0,0,0,0,44550,10.0,47500,4,0,15204,19000,0.4,4455.0,0,0,0,13,4,14,0,0,0,0,29346,6.0,28500,3,0,-15204,-19000,0.3,2934.6
4856013061,1,0,0,1,17,13,21,0,0,0,0,60990,12.0,55000,0,0,21720,22000,0.0,6099.0,0,0,0,7,11,7,0,0,0,0,39270,7.2,33000,0,0,-21720,-22000,0.0,3927.0
4855987424,1,204,6,0,16,21,13,0,0,0,0,45930,10.0,47500,12,0,17015,18600,1.2,4593.0,176,2,1,11,6,15,0,0,0,0,28915,6.0,28900,0,0,-17015,-18600,0.0,2891.5
4855964637,1,8,0,0,13,17,13,0,0,0,0,46000,10.0,47500,1,0,17400,19000,0.1,4600.0,6,0,1,10,6,8,0,0,0,0,28600,6.0,28500,1,0,-17400,-19000,0.1,2860.0
4855941626,1,0,0,1,19,19,15,0,0,0,0,47400,10.0,47500,0,0,18237,19000,0.0,4740.0,0,0,0,8,8,13,0,0,0,0,29163,6.0,28500,0,0,-18237,-19000,0.0,2916.3
4855267123,1,20,0,1,37,23,84,0,0,0,0,39723,11.8,44149,98,0,2033,746,9.8,3972.3,0,0,0,23,37,62,0,0,0,0,37690,11.6,43403,101,0,-2033,-746,10.1,3769.0
4854868478,1,0,0,1,18,16,17,0,0,0,0,62000,12.0,55000,0,0,24800,22000,0.0,6200.0,0,0,0,10,12,10,0,0,0,0,37200,7.2,33000,0,0,-24800,-22000,0.0,3720.0
4854849188,1,0,0,1,22,10,25,0,0,0,0,63400,12.0,55000,0,0,29000,22000,0.0,6340.0,5,0,0,5,17,1,0,0,0,0,34400,7.2,33000,0,0,-29000,-22000,0.0,3440.0
4854814234,1,0,0,1,23,16,28,0,0,0,0,47560,10.0,47500,4,0,21050,19000,0.4,4756.0,0,0,0,8,15,4,0,0,0,0,26510,6.0,28500,0,0,-21050,-19000,0.0,2651.0
4854795342,1,0,0,1,17,17,21,0,0,0,0,62395,12.0,55000,0,0,24800,22000,0.0,6239.5,0,0,0,10,10,8,0,0,0,0,37595,7.2,33000,0,0,-24800,-22000,0.0,3759.5
4854779002,1,27,2,1,20,11,19,0,0,0,0,67010,12.0,55000,4,0,31205,22000,0.4,6701.0,135,1,0,7,16,7,0,0,0,0,35805,7.2,33000,0,0,-31205,-22000,0.0,3580.5
4854764035,1,0,0,1,21,25,23,0,0,0,0,80500,15.0,70000,0,0,39600,31000,0.0,8050.0,0,0,0,15,11,12,0,0,0,0,40900,8.2,39000,0,0,-39600,-31000,0.0,4090.0
4854741086,1,0,0,1,21,20,15,0,0,0,0,61650,12.0,55000,0,0,24800,22000,0.0,6165.0,17,0,0,9,10,9,0,0,0,0,36850,7.2,33000,0,0,-24800,-22000,0.0,3685.0
4857453055,0,12,1,0,4,8,2,0,0,0,0,14664,7.0,17079,175,64,-2700,-870,23.9,1466.4,15,0,1,8,4,5,1,1,0,0,17364,7.0,17949,194,52,2700,870,24.6,1736.4
4857393566,0,8,1,0,3,2,1,1,1,0,0,14199,6.6,17130,203,59,-1003,-273,26.2,1419.9,10,0,1,2,3,4,0,0,0,0,15202,6.8,17403,182,47,1003,273,22.9,1520.2
4857333883,0,18,1,0,12,5,16,0,0,0,0,18402,7.0,18256,202,52,952,105,25.4,1840.2,13,2,1,5,12,4,1,1,0,0,17450,7.0,18151,199,56,-952,-105,25.5,1745.0
4856880225,0,102,0,1,4,3,3,0,0,0,0,15295,6.8,17134,171,60,501,-727,23.1,1529.5,14,0,0,3,4,1,1,1,0,0,14794,6.8,17861,211,60,-501,727,27.1,1479.4
4856861334,1,13,1,1,6,7,7,0,0,0,0,17023,6.6,16731,219,38,-304,-1058,25.7,1702.3,10,1,0,7,6,6,0,0,0,0,17327,7.0,17789,173,49,304,1058,22.2,1732.7
4856845902,1,19,1,1,6,3,5,1,1,0,0,17238,7.2,18752,223,60,2859,1846,28.3,1723.8,18,1,0,3,6,3,0,0,0,0,14379,6.8,16906,182,56,-2859,-1846,23.8,1437.9
4856822133,1,14,1,0,4,10,4,0,0,0,0,15254,6.6,17191,198,62,-2590,-1779,26.0,1525.4,13,2,1,10,4,7,0,0,0,0,17844,7.0,18970,209,58,2590,1779,26.7,1784.4
4856810085,1,0,0,1,24,23,66,0,0,0,1,37320,11.2,40645,83,0,1527,771,8.3,3732.0,0,0,0,23,24,47,0,0,0,0,35793,11.0,39874,94,0,-1527,-771,9.4,3579.3
4856386277,1,14,0,1,6,5,9,0,0,0,0,15411,6.4,15839,187,36,-1358,-2048,22.3,1541.1,13,2,0,5,6,7,0,0,0,0,16769,7.0,17887,182,48,1358,2048,23.0,1676.9
4856330324,1,11,0,0,3,7,1,0,0,0,0,14694,6.6,16871,187,47,-1437,-1067,23.4,1469.4,12,0,1,7,3,4,0,0,0,0,16131,7.0,17938,177,65,1437,1067,24.2,1613.1
4856279893,0,44,0,1,5,5,2,0,0,0,0,16469,7.2,18488,247,44,1312,1907,29.1,1646.9,11,13,0,5,5,7,0,0,0,0,15157,6.6,16581,158,52,-1312,-1907,21.0,1515.7
4856202459,1,11,1,1,11,9,14,0,0,0,1,19776,7.0,18743,211,52,2759,750,26.3,1977.6,14,0,0,9,11,5,1,1,0,0,17017,7.0,17993,185,64,-2759,-750,24.9,1701.7
4855231948,0,13,1,0,8,6,10,0,0,0,0,18106,7.0,17993,160,64,1659,435,22.4,1810.6,11,1,1,6,8,5,1,1,0,0,16447,6.6,17558,215,40,-1659,-435,25.5,1644.7
4855174742,0,12,0,1,9,6,6,0,0,0,0,18202,7.0,18510,189,52,3038,2639,24.1,1820.2,9,0,0,6,9,8,1,1,0,0,15164,6.6,15871,153,56,-3038,-2639,20.9,1516.4
4855109333,0,243,1,1,10,8,19,1,1,0,0,17476,6.8,17467,184,44,134,118,22.8,1747.6,19,2,0,8,10,7,1,0,1,0,17342,6.8,17349,181,48,-134,-118,22.9,1734.2
4854135615,0,10,0,0,5,8,4,0,0,0,0,15161,6.8,17016,176,48,-2787,-2534,22.4,1516.1,11,1,1,8,5,5,0,0,0,0,17948,7.2,19550,210,68,2787,2534,27.8,1794.8
4854089011,1,27,0,0,5,6,2,0,0,0,0,15749,6.8,18368,210,54,-173,732,26.4,1574.9,32,0,1,6,5,9,0,0,0,0,15922,6.8,17636,198,40,173,-732,23.8,1592.2
4854025432,1,14,2,0,6,17,8,0,0,0,0,16173,6.4,16122,161,45,-4768,-3266,20.6,1617.3,21,1,1,17,6,14,0,0,0,0,20941,7.4,19388,197,47,4768,3266,24.4,2094.1
4855847610,1,0,0,1,26,15,26,0,0,0,0,67301,12.0,55000,0,0,31100,22000,0.0,6730.1,3,0,0,8,19,6,0,0,0,0,36201,7.2,33000,0,0,-31100,-22000,0.0,3620.1
4855833451,1,0,0,1,18,21,20,0,0,0,0,47003,10.4,49000,1,0,17403,20500,0.1,4700.3,0,0,0,15,12,15,0,0,0,0,29600,6.0,28500,0,0,-17403,-20500,0.0,2960.0
4855814297,1,34,1,1,23,18,16,0,0,0,0,47125,10.0,47500,8,0,18820,19000,0.8,4712.5,8,4,0,7,12,11,0,0,0,0,28305,6.0,28500,3,0,-18820,-19000,0.3,2830.5
4855799948,1,0,0,1,14,19,18,0,0,0,0,66200,12.0,55000,0,0,29000,22000,0.0,6620.0,0,0,0,14,9,12,0,0,0,0,37200,7.2,33000,0,0,-29000,-22000,0.0,3720.0
4855784507,1,2,0,1,25,18,25,0,0,0,0,65940,12.0,55000,0,0,29055,22000,0.0,6594.0,0,0,0,6,13,6,0,0,0,0,36885,7.2,33000,0,0,-29055,-22000,0.0,3688.5
4855770821,1,2,0,1,18,12,18,0,0,0,0,50150,10.0,47500,0,0,22300,19000,0.0,5015.0,0,0,0,7,13,5,0,0,0,0,27850,6.0,28500,0,0,-22300,-19000,0.0,2785.0
4855755334,1,0,0,1,15,21,19,0,0,0,0,46375,10.0,47500,1,0,17297,19000,0.1,4637.5,0,0,0,13,7,13,0,0,0,0,29078,6.0,28500,4,0,-17297,-19000,0.4,2907.8
4855746888,1,0,0,1,15,20,21,0,0,0,0,47708,12.0,55000,1,0,18804,22000,0.1,4770.8,27,0,0,13,8,5,0,0,0,0,28904,7.2,33000,0,0,-18804,-22000,0.0,2890.4
4855726395,1,0,0,1,19,14,16,0,0,0,0,48958,10.0,47500,0,0,21108,19000,0.0,4895.8,0,0,0,7,12,11,0,0,0,0,27850,6.0,28500,0,0,-21108,-19000,0.0,2785.0
4841137133,0,25,2,0,3,9,1,1,1,0,0,14754,6.0,14254,141,53,-3164,-4830,19.4,1475.4,19,1,1,9,3,1,0,0,0,0,17918,7.0,19084,211,56,3164,4830,26.7,1791.8
4841103960,1,26,1,1,10,5,9,0,0,0,0,17350,6.8,17460,201,32,2192,1443,23.3,1735.0,12,0,0,5,10,5,0,0,0,0,15158,6.6,16017,150,52,-2192,-1443,20.2,1515.8
4840088512,1,18,3,1,13,6,7,0,0,0,0,20356,7.2,18425,189,36,4354,3584,22.5,2035.6,15,1,0,6,13,9,1,1,0,0,16002,6.2,14841,160,48,-4354,-3584,20.8,1600.2
4840056634,0,16,1,0,2,6,3,0,0,0,0,15203,6.8,17595,213,62,-2041,-884,27.5,1520.3,22,3,1,6,2,7,1,1,0,0,17244,7.0,18479,190,50,2041,884,24.0,1724.4
4833021382,1,15,1,0,12,14,20,1,1,0,0,19302,6.8,16980,166,54,-778,-1052,22.0,1930.2,9,0,1,14,12,13,0,0,0,0,20080,7.0,18032,188,55,778,1052,24.3,2008.0
4832983898,1,12,1,0,5,6,5,1,1,0,0,16600,6.6,17576,213,58,241,496,27.1,1660.0,16,0,1,6,5,7,1,0,1,0,16359,6.6,17080,200,53,-241,-496,25.3,1635.9
4832942515,1,93,1,1,10,6,10,0,0,0,0,18410,6.6,17976,186,48,3979,3404,23.4,1841.0,15,3,0,6,10,6,0,0,0,0,14431,6.4,14572,140,40,-3979,-3404,18.0,1443.1
4831084358,0,26,0,0,3,6,2,0,0,0,0,14714,6.6,16504,155,48,-2669,-1661,20.3,1471.4,11,2,1,6,3,5,1,1,0,0,17383,7.0,18165,182,72,2669,1661,25.4,1738.3
4830924299,1,11,1,0,7,5,5,1,0,1,0,17794,7.0,18881,229,56,1725,3470,28.5,1779.4,13,3,1,5,7,5,0,0,0,0,16069,6.4,15411,167,36,-1725,-3470,20.3,1606.9
4830905962,1,13,2,0,7,5,5,0,0,0,0,16673,6.6,17596,198,52,961,429,25.0,1667.3,11,0,1,5,7,2,0,0,0,0,15712,6.8,17167,191,40,-961,-429,23.1,1571.2
4830893712,0,58,1,0,5,6,4,0,0,0,0,13337,6.6,16099,102,60,-3434,-2478,16.2,1333.7,9,1,1,6,5,2,0,0,0,0,16771,7.0,18577,238,46,3434,2478,28.4,1677.1
4782405124,0,8,0,0,2,3,2,0,0,0,0,14619,6.6,16715,198,36,538,-1058,23.4,1461.9,12,0,1,3,2,1,0,0,0,0,14081,6.8,17773,153,72,-538,1058,22.5,1408.1
4782366679,1,12,0,1,7,3,4,0,0,0,0,16537,6.8,17879,186,52,1311,1443,23.8,1653.7,12,1,0,3,7,6,1,1,0,0,15226,6.4,16436,207,44,-1311,-1443,25.1,1522.6
4755203004,1,11,2,1,4,5,3,0,0,0,0,15614,6.8,16989,171,45,-807,-75,21.6,1561.4,16,1,0,5,4,3,0,0,0,0,16421,7.0,17064,165,51,807,75,21.6,1642.1
4749235054,1,7,0,0,18,24,48,0,0,0,0,36189,11.2,41179,107,0,-966,35,10.7,3618.9,0,0,1,24,18,42,0,0,0,0,37155,11.0,41144,85,0,966,-35,8.5,3715.5
4749207058,0,7,3,0,6,8,6,0,0,0,0,15123,6.6,16988,173,52,-4406,-2072,22.5,1512.3,13,0,1,8,6,5,2,1,1,0,19529,7.2,19060,214,51,4406,2072,26.5,1952.9
4749139588,0,90,0,1,20,16,67,0,0,0,0,36779,11.0,38931,88,0,1170,1495,8.8,3677.9,0,0,0,16,20,41,0,0,0,0,35609,10.6,37436,107,0,-1170,-1495,10.7,3560.9
4748915738,0,10,0,0,3,5,0,0,0,0,0,14244,6.8,17702,200,70,-3367,-660,27.0,1424.4,15,1,1,5,3,5,0,0,0,0,17611,7.2,18362,211,57,3367,660,26.8,1761.1
4748888985,0,19,1,0,0,5,0,0,0,0,0,13222,6.4,15973,183,56,-2116,-596,23.9,1322.2,11,1,1,5,0,3,1,1,0,0,15338,6.6,16569,192,44,2116,596,23.6,1533.8
4748875200,0,13,2,1,4,6,5,0,0,0,0,15814,6.6,17105,220,56,-1417,-862,27.6,1581.4,33,3,0,6,4,7,1,1,0,0,17231,7.0,17967,204,53,1417,862,25.7,1723.1
4748855447,1,12,5,0,5,6,9,1,0,1,0,16810,7.0,18199,209,52,-27,-1080,26.1,1681.0,81,5,1,6,5,6,1,1,0,0,16837,7.2,19279,208,67,27,1080,27.5,1683.7
4717033872,0,11,1,0,8,6,5,0,0,0,0,16528,6.8,17163,180,49,-759,-1320,22.9,1652.8,12,3,1,6,8,3,0,0,0,0,17287,7.0,18483,219,54,759,1320,27.3,1728.7
4716982681,1,9,0,0,3,9,2,0,0,0,0,15175,6.6,17537,210,52,-2888,-1001,26.2,1517.5,33,3,1,9,3,6,1,1,0,0,18063,7.0,18538,199,68,2888,1001,26.7,1806.3
4716940668,0,13,3,0,3,9,3,0,0,0,0,15669,6.6,16089,162,48,-2522,-2131,21.0,1566.9,11,4,1,9,3,3,0,0,0,0,18191,7.0,18220,200,60,2522,2131,26.0,1819.1
4716803781,0,12,0,1,6,9,4,0,0,0,0,16096,6.8,18315,237,52,-1484,364,28.9,1609.6,12,1,0,9,6,12,1,1,0,0,17580,7.0,17951,202,64,1484,-364,26.6,1758.0
4714765609,0,15,1,1,5,5,5,0,0,0,0,15495,6.8,16810,201,44,348,8,24.5,1549.5,13,1,0,5,5,5,1,1,0,0,15147,6.6,16802,195,54,-348,-8,24.9,1514.7
4714734871,1,36,1,0,8,4,6,0,0,0,0,17902,6.8,17749,218,39,667,1314,25.7,1790.2,13,12,1,4,8,4,0,0,0,0,17235,6.6,16435,202,52,-667,-1314,25.4,1723.5
4696789653,0,15,0,1,6,2,2,0,0,0,0,15599,7.2,17706,183,56,778,-53,23.9,1559.9,9,1,0,2,6,2,0,0,0,0,14821,6.8,17759,189,50,-778,53,23.9,1482.1
4696733252,1,17,5,1,6,6,7,0,0,0,0,16707,6.8,17354,207,51,-469,-921,25.8,1670.7,16,6,0,6,6,4,1,1,0,0,17176,7.2,18275,216,56,469,921,27.2,1717.6
4696689110,0,7,0,0,2,2,1,0,0,0,0,14261,6.8,17865,198,68,-1732,-1155,26.6,1426.1,12,1,1,2,2,2,1,1,0,0,15993,7.0,19020,225,63,1732,1155,28.8,1599.3
4856464536,0,14,4,1,10,4,6,1,1,0,0,18844,7.2,19099,205,57,3113,1273,26.2,1884.4,143,2,0,4,10,2,0,0,0,0,15731,7.2,17826,178,62,-3113,-1273,24.0,1573.1
4855355923,1,16,0,0,13,12,11,0,0,0,0,18609,6.8,16964,154,54,1032,975,20.8,1860.9,12,1,1,12,13,17,0,0,0,0,17577,6.4,15989,173,46,-1032,-975,21.9,1757.7
4855300278,0,35,0,1,4,6,3,0,0,0,0,16521,6.6,16939,201,56,1041,900,25.7,1652.1,12,1,0,6,4,7,0,0,0,0,15480,6.6,16039,178,39,-1041,-900,21.7,1548.0
4854759347,0,12,1,0,6,8,4,0,0,0,0,17078,7.2,18178,202,61,37,1453,26.3,1707.8,28,2,1,8,6,12,0,0,0,0,17041,6.6,16725,189,39,-37,-1453,22.8,1704.1
4849261418,0,11,1,1,4,7,6,0,0,0,0,16128,7.0,18548,260,56,-1046,91,31.6,1612.8,10,1,0,7,4,5,0,0,0,0,17174,7.2,18457,230,48,1046,-91,27.8,1717.4
4849241195,1,14,0,1,12,3,6,0,0,0,0,19346,7.4,19209,197,52,4564,4113,24.9,1934.6,14,0,0,3,12,3,0,0,0,0,14782,6.2,15096,170,55,-4564,-4113,22.5,1478.2
4849208930,0,10,2,0,4,4,6,0,0,0,0,15110,7.0,18013,202,60,-44,806,26.2,1511.0,14,0,1,4,4,3,0,0,0,0,15154,6.8,17207,195,48,44,-806,24.3,1515.4
4848065555,0,10,0,1,9,7,11,0,0,0,0,16782,6.8,17157,184,56,-93,-383,24.0,1678.2,10,1,0,7,9,5,0,0,0,0,16875,7.0,17540,204,52,93,383,25.6,1687.5
4848022464,0,21,0,1,3,6,4,0,0,0,0,15771,6.6,16573,171,60,-1317,105,23.1,1577.1,84,1,0,6,3,8,1,1,0,0,17088,6.4,16468,169,60,1317,-105,22.9,1708.8
4847157497,1,0,8,1,22,17,58,0,0,0,0,37230,11.2,40774,109,0,2669,3425,10.9,3723.0,24,0,0,17,22,29,0,0,0,0,34561,10.6,37349,90,0,-2669,-3425,9.0,3456.1
4845176738,0,44,2,1,6,5,5,0,0,0,0,15765,6.8,17761,188,44,-150,632,23.2,1576.5,11,0,0,4,5,4,0,0,0,0,15915,6.6,17129,211,52,150,-632,26.3,1591.5
4844846045,1,12,1,0,7,9,5,0,0,0,0,17699,6.8,17817,196,52,-1315,-1338,24.8,1769.9,8,0,1,9,7,7,0,0,0,0,19014,7.2,19155,203,60,1315,1338,26.3,1901.4
4844804854,0,15,1,1,5,5,5,0,0,0,0,15806,6.6,17117,181,52,-963,-468,23.3,1580.6,25,0,0,5,5,5,1,1,0,0,16769,6.8,17585,195,56,963,468,25.1,1676.9
4844412186,1,14,0,1,10,7,9,2,1,1,0,18075,6.8,17104,174,52,-306,-1222,22.6,1807.5,10,1,0,7,10,2,0,0,0,0,18381,7.0,18326,190,60,306,1222,25.0,1838.1
4844364443,1,12,1,1,3,6,4,1,1,0,0,16276,6.8,17394,180,64,1105,1665,24.4,1627.6,61,2,0,6,3,5,0,0,0,0,15171,6.4,15729,178,36,-1105,-1665,21.4,1517.1
4844318205,0,13,2,0,4,8,1,1,0,1,0,16682,6.6,17067,207,56,1408,1316,26.3,1668.2,77,2,1,8,4,3,1,1,0,0,15274,6.6,15751,146,60,-1408,-1316,20.6,1527.4
4843457004,1,11,1,1,2,2,4,0,0,0,0,15100,6.8,17133,187,44,699,-809,23.1,1510.0,13,0,0,2,2,1,0,0,0,0,14401,6.8,17942,191,60,-699,809,25.1,1440.1
4843402444,1,11,0,0,4,7,1,0,0,0,0,14704,6.8,18113,195,55,-3534,-987,25.0,1470.4,9,3,1,7,4,7,1,1,0,0,18238,7.4,19100,211,64,3534,987,27.5,1823.8
4843359412,1,8,2,0,9,6,8,0,0,0,0,18126,6.8,17729,197,52,42,547,24.9,1812.6,20,0,1,6,9,1,1,1,0,0,18084,6.8,17182,183,64,-42,-547,24.7,1808.4
4841432693,0,14,1,1,5,12,3,1,1,0,0,15398,6.0,14536,176,32,-3865,-3362,20.8,1539.8,10,0,0,12,5,10,0,0,0,0,19263,7.0,17898,203,58,3865,3362,26.1,1926.3
4854277905,1,11,0,1,26,20,54,0,0,0,0,37039,11.2,40773,105,0,572,26,10.5,3703.9,0,0,0,19,25,53,0,0,0,0,36467,11.2,40747,124,0,-572,-26,12.4,3646.7
4853629095,0,73,0,1,24,32,59,0,0,0,1,37141,10.8,39625,104,0,-3056,-5545,10.4,3714.1,0,0,0,31,23,81,0,0,0,0,40197,11.8,45170,114,0,3056,5545,11.4,4019.7
4853199391,0,8,1,0,4,3,4,0,0,0,0,15720,7.2,18578,205,62,-96,665,26.7,1572.0,13,1,1,3,4,1,2,1,1,0,15816,7.0,17913,238,56,96,-665,29.4,1581.6
4851178587,1,0,3,0,22,21,52,0,0,0,1,38163,11.0,40030,126,0,811,16,12.6,3816.3,9,0,1,21,22,50,0,0,0,0,37352,11.0,40014,110,0,-811,-16,11.0,3735.2
4850262711,1,41,1,1,35,26,98,0,0,0,2,40392,11.8,44724,100,0,471,1522,10.0,4039.2,4,0,0,26,35,71,0,0,0,0,39921,11.6,43202,88,0,-471,-1522,8.8,3992.1
4849649736,0,0,0,0,23,31,72,0,0,0,1,36982,11.4,42971,88,0,-810,529,8.8,3698.2,0,0,1,31,23,85,0,0,0,0,37792,11.6,42442,112,0,810,-529,11.2,3779.2
4849627487,0,0,0,0,23,25,60,0,0,0,0,36497,11.2,40719,99,0,-2051,-1533,9.9,3649.7,0,0,1,25,23,60,0,0,0,0,38548,11.2,42252,115,0,2051,1533,11.5,3854.8
4848706182,1,13,0,0,28,33,77,0,0,0,0,38053,11.8,44508,85,0,-1627,269,8.5,3805.3,0,0,1,33,28,79,0,0,0,0,39680,11.6,44239,93,0,1627,-269,9.3,3968.0
4846649967,1,0,0,0,18,27,41,0,0,0,0,35714,10.8,38228,111,0,-260,-1810,11.1,3571.4,0,0,1,27,18,80,0,0,0,0,35974,11.2,40038,118,0,260,1810,11.8,3597.4
4846628939,1,11,0,0,31,26,81,0,0,0,0,38436,11.6,43190,88,0,-576,-60,8.8,3843.6,0,0,1,26,31,66,0,0,0,0,39012,11.8,43250,101,0,576,60,10.1,3901.2
4846608218,0,0,0,1,26,30,68,0,0,0,0,38979,11.6,43188,114,0,-1933,-629,11.4,3897.9,16,0,0,30,26,62,0,0,0,0,40912,11.6,43817,104,0,1933,629,10.4,4091.2
4845429343,1,0,0,1,27,22,74,0,0,0,1,37977,11.4,41689,111,0,2798,934,11.1,3797.7,0,0,0,22,27,41,0,0,0,0,35179,11.2,40755,97,0,-2798,-934,9.7,3517.9
4845411670,0,260,0,0,16,24,27,0,0,0,1,34845,10.4,37401,74,0,-3497,-4989,7.4,3484.5,0,0,1,24,16,68,0,0,0,0,38342,11.4,42390,118,0,3497,4989,11.8,3834.2
4844815704,1,45,0,1,29,23,78,0,0,0,0,38191,11.6,43181,84,0,2522,2107,8.4,3819.1,17,0,0,23,29,50,0,0,0,0,35669,11.0,41074,86,0,-2522,-2107,8.6,3566.9
4844807160,1,0,4,0,27,17,78,0,0,0,1,38632,11.2,41813,121,0,4220,5563,12.1,3863.2,35,0,1,16,26,47,0,0,0,0,34412,10.6,36250,81,0,-4220,-5563,8.1,3441.2
4843942843,0,0,0,1,25,25,54,0,0,0,1,36843,11.4,40797,113,0,-1307,-231,11.3,3684.3,0,0,0,25,25,66,0,0,0,0,38150,11.0,41028,110,0,1307,231,11.0,3815.0
4843020415,1,0,0,1,26,28,59,0,0,0,1,37643,11.0,39954,95,0,-2013,-2817,9.5,3764.3,0,0,0,28,26,72,0,0,0,0,39656,11.6,42771,112,0,2013,2817,11.2,3965.6
4842996537,1,0,0,1,33,30,95,0,0,0,1,41996,11.8,45655,114,0,1726,1318,11.4,4199.6,0,0,0,30,33,73,0,0,0,0,40270,11.6,44337,76,0,-1726,-1318,7.6,4027.0
4842986150,0,25,3,0,24,40,64,0,0,0,0,37547,11.2,40309,110,0,-5703,-7781,11.0,3754.7,37,19,1,40,24,114,0,0,0,0,43250,12.2,48090,107,0,5703,7781,10.7,4325.0
4856999149,1,76,3,0,4,2,3,0,0,0,0,16677,7.2,19122,209,56,2228,1858,26.5,1667.7,17,2,1,2,4,1,0,0,0,0,14449,6.6,17264,205,56,-2228,-1858,26.1,1444.9
4856902934,0,68,0,1,3,6,0,1,0,1,0,14208,6.6,16736,173,52,-2039,-1107,22.5,1420.8,12,1,0,6,3,3,0,0,0,0,16247,6.8,17843,191,59,2039,1107,25.0,1624.7
4856873500,1,26,1,1,8,4,7,1,1,0,0,19416,7.2,18291,188,56,5439,2749,24.4,1941.6,10,0,0,4,8,1,0,0,0,0,13977,6.4,15542,185,44,-5439,-2749,22.9,1397.7
4855626589,1,10,1,0,4,4,3,0,0,0,0,16971,6.8,17303,212,36,372,767,24.8,1697.1,18,0,1,4,4,3,0,0,0,0,16599,6.6,16536,191,48,-372,-767,23.9,1659.9
4855620870,0,12,0,1,4,8,2,0,0,0,0,15645,6.6,16901,187,55,-2142,-1055,24.2,1564.5,12,0,0,8,4,12,1,1,0,0,17787,6.8,17956,215,48,2142,1055,26.3,1778.7
4853708135,1,0,0,0,29,26,82,0,0,0,2,40974,11.8,45404,124,0,3747,4442,12.4,4097.4,1,0,1,26,29,68,0,0,0,0,37227,11.2,40962,78,0,-3747,-4442,7.8,3722.7
4853662096,0,69,0,1,3,4,0,1,1,0,0,14788,7.0,17901,197,52,-992,-512,24.9,1478.8,17,6,0,4,3,3,0,0,0,0,15780,7.2,18413,193,51,992,512,24.4,1578.0
4853625883,1,0,5,1,31,12,106,0,0,0,0,38554,11.0,41248,101,0,4092,4996,10.1,3855.4,281,0,0,12,31,33,0,0,0,0,34462,10.4,36252,85,0,-4092,-4996,8.5,3446.2
4848790729,0,18,1,0,5,7,6,1,1,0,0,15402,6.8,17578,179,53,-840,433,23.2,1540.2,83,2,1,7,5,8,0,0,0,0,16242,7.0,17145,182,46,840,-433,22.8,1624.2
4847876333,1,20,11,0,6,4,8,0,0,0,0,17012,6.4,16534,185,40,24,-825,22.5,1701.2,32,1,1,4,6,7,1,1,0,0,16988,6.8,17359,191,48,-24,825,23.9,1698.8
4846622451,1,9,1,1,1,1,1,2,1,1,0,14380,7.0,18261,182,64,-250,-111,24.6,1438.0,12,2,0,1,1,0,0,0,0,0,14630,7.0,18372,181,64,250,111,24.5,1463.0
4846041490,1,8,0,0,22,22,53,0,0,0,0,35790,10.8,39215,111,0,-243,-226,11.1,3579.0,0,0,1,22,22,45,0,0,0,0,36033,11.0,39441,99,0,243,226,9.9,3603.3
4841197339,1,18,0,0,32,25,95,0,0,0,1,40485,11.4,43501,104,0,2459,4145,10.4,4048.5,5,1,1,25,32,58,0,0,0,0,38026,11.0,39356,107,0,-2459,-4145,10.7,3802.6
4841142221,1,9,2,1,4,2,5,1,1,0,0,16721,7.0,18366,196,52,1568,-153,24.8,1672.1,16,0,0,2,4,3,0,0,0,0,15153,7.2,18519,198,52,-1568,153,25.0,1515.3
4839894653,0,15,0,0,2,2,2,1,1,0,0,15649,6.8,17092,216,52,-586,-1670,26.8,1564.9,10,0,1,2,2,2,0,0,0,0,16235,7.0,18762,242,56,586,1670,29.8,1623.5
4838851247,1,12,1,0,7,4,6,0,0,0,0,16498,6.8,17649,207,44,1625,1010,25.1,1649.8,11,1,1,4,7,3,0,0,0,0,14873,6.6,16639,201,44,-1625,-1010,24.5,1487.3
4838687993,0,10,0,0,9,4,5,1,1,0,0,17866,6.8,18620,205,56,1485,402,26.1,1786.6,15,1,1,4,9,4,0,0,0,0,16381,7.2,18218,185,60,-1485,-402,24.5,1638.1
4837654259,0,10,1,1,8,6,6,0,0,0,0,16083,6.8,17080,194,44,-510,15,23.8,1608.3,20,1,0,6,8,6,0,0,0,0,16593,6.8,17065,191,55,510,-15,24.6,1659.3
4837622975,0,13,0,0,7,4,4,0,0,0,0,16126,6.6,16825,167,56,-2376,-1431,22.3,1612.6,13,2,1,4,7,6,0,0,0,0,18502,7.0,18256,214,52,2376,1431,26.6,1850.2
4834030015,0,22,0,1,1,2,2,0,0,0,0,15077,6.8,17327,217,56,-70,-436,27.3,1507.7,19,1,0,2,1,3,1,1,0,0,15147,6.8,17763,186,60,70,436,24.6,1514.7
4775783161,0,9,0,0,4,8,5,1,1,0,0,14952,6.6,16702,161,44,-3550,-2508,20.5,1495.2,139,0,1,8,4,7,1,0,1,0,18502,7.2,19210,227,68,3550,2508,29.5,1850.2
4775758482,0,13,4,0,3,5,3,0,0,0,0,15774,7.0,18001,186,64,-692,-286,25.0,1577.4,16,1,1,5,3,6,0,0,0,0,16466,6.8,18287,236,60,692,286,29.6,1646.6
4775734086,0,128,3,0,6,7,5,0,0,0,0,16510,6.4,15833,194,52,-915,-1046,24.6,1651.0,13,3,1,7,6,11,1,1,0,0,17425,6.8,16879,185,52,915,1046,23.7,1742.5
4775273581,0,116,2,0,4,4,2,1,1,0,0,14409,6.2,15128,163,48,-1109,-2448,21.1,1440.9,12,1,1,4,4,1,0,0,0,0,15518,7.0,17576,203,52,1109,2448,25.5,1551.8
4775217011,1,65,0,0,7,6,6,0,0,0,0,16448,6.8,17635,197,52,-2963,-2274,24.9,1644.8,10,3,1,6,7,4,0,0,0,0,19411,7.2,19909,220,72,2963,2274,29.2,1941.1
4775102134,0,14,1,0,3,2,4,1,1,0,0,16336,7.0,18135,227,66,915,-45,29.3,1633.6,11,0,1,2,3,2,0,0,0,0,15421,7.0,18180,210,58,-915,45,26.8,1542.1
4775052313,1,9,1,0,5,6,1,0,0,0,0,16577,7.0,18764,230,72,532,1915,30.2,1657.7,17,1,1,6,5,7,0,0,0,0,16045,6.6,16849,176,44,-532,-1915,22.0,1604.5
4774951712,0,21,1,0,7,7,3,0,0,0,0,16985,7.0,18296,195,53,-701,751,24.8,1698.5,10,2,1,7,7,10,1,1,0,0,17686,6.8,17545,218,52,701,-751,27.0,1768.6
4774900183,1,19,0,1,9,1,12,1,0,1,0,18686,7.2,18482,199,52,4455,1943,25.1,1868.6,12,0,0,1,9,0,0,0,0,0,14231,6.6,16539,211,60,-4455,-1943,27.1,1423.1
4774878794,0,11,0,0,5,7,5,0,0,0,0,16385,6.6,17120,241,45,-1248,-1077,28.6,1638.5,12,0,1,7,5,7,0,0,0,0,17633,7.0,18197,217,64,1248,1077,28.1,1763.3
4774678080,1,12,12,0,4,2,5,1,1,0,0,16669,7.0,18178,211,64,2539,1229,27.5,1666.9,29,1,1,2,4,1,0,0,0,0,14130,6.6,16949,210,44,-2539,-1229,25.4,1413.0
4774660344,1,10,1,1,6,1,9,1,1,0,0,16415,6.8,17892,227,56,1930,976,28.3,1641.5,15,0,0,1,6,2,0,0,0,0,14485,6.8,16916,204,56,-1930,-976,26.0,1448.5
4773781734,1,9,1,0,4,3,2,1,1,0,0,15963,7.0,18788,216,60,-75,812,27.6,1596.3,12,0,1,3,4,4,0,0,0,0,16038,6.8,17976,222,50,75,-812,27.2,1603.8
4773758388,1,15,1,1,8,4,9,0,0,0,0,19572,7.4,19211,196,64,4559,1949,26.0,1957.2,11,1,0,4,8,3,0,0,0,0,15013,6.6,17262,154,64,-4559,-1949,21.8,1501.3
4766919165,0,13,0,0,4,2,3,0,0,0,0,16712,7.0,17855,186,49,-116,491,23.5,1671.2,12,0,1,2,4,3,0,0,0,0,16828,6.8,17364,208,58,116,-491,26.6,1682.8
4766902341,0,11,0,0,0,4,0,0,0,0,0,13474,6.6,16709,199,50,-4267,-2769,24.9,1347.4,11,0,1,4,0,5,1,1,0,0,17741,7.4,19478,243,66,4267,2769,30.9,1774.1
4766890222,0,85,1,0,3,12,3,1,1,0,0,14898,6.6,16744,182,62,-4431,-2871,24.4,1489.8,11,1,1,12,3,9,1,0,1,0,19329,7.2,19615,211,68,4431,2871,27.9,1932.9
4765394024,1,7,1,1,7,7,3,0,0,0,0,17355,6.4,16920,206,49,1119,-440,25.5,1735.5,12,0,0,7,7,6,1,1,0,0,16236,7.0,17360,179,38,-1119,440,21.7,1623.6
4845117961,1,0,0,1,27,18,73,0,0,0,0,39035,11.4,42608,105,0,4346,4629,10.5,3903.5,0,0,0,18,27,45,0,0,0,0,34689,10.8,37979,96,0,-4346,-4629,9.6,3468.9
4845073552,1,0,4,1,27,25,75,0,0,0,1,38794,11.4,42392,105,0,1881,240,10.5,3879.4,16,0,0,25,27,56,0,0,0,0,36913,11.2,42152,91,0,-1881,-240,9.1,3691.3
4845044938,0,0,0,0,14,12,38,0,0,0,0,34921,10.6,37269,99,0,-185,-494,9.9,3492.1,80,0,1,12,14,25,0,0,0,0,35106,10.6,37763,116,0,185,494,11.6,3510.6
4842696186,1,14,0,0,4,2,3,0,0,0,0,15546,6.6,16642,213,51,1029,-611,26.4,1554.6,12,2,1,2,4,1,0,0,0,0,14517,6.6,17253,186,48,-1029,611,23.4,1451.7
4842679511,1,21,1,1,4,3,0,0,0,0,0,17437,7.4,19878,219,84,2989,3589,30.3,1743.7,10,0,0,3,4,2,0,0,0,0,14448,6.6,16289,167,52,-2989,-3589,21.9,1444.8
4842666672,1,10,0,1,6,4,2,0,0,0,0,17074,7.0,18828,224,64,1945,1427,28.8,1707.4,11,1,0,4,6,3,0,0,0,0,15129,7.0,17401,188,51,-1945,-1427,23.9,1512.9
4842644902,0,14,0,0,0,4,0,0,0,0,0,13529,6.8,17606,193,56,-1760,-36,24.9,1352.9,12,1,1,4,0,5,0,0,0,0,15289,6.8,17642,212,55,1760,36,26.7,1528.9
4842613484,0,32,0,0,4,7,5,0,0,0,0,15338,6.6,16804,199,40,-269,-217,23.9,1533.8,62,2,1,7,4,5,0,0,0,0,15607,6.6,17021,176,48,269,217,22.4,1560.7
4842592910,0,49,0,0,0,4,0,0,0,0,0,14452,6.6,16369,192,52,-2289,-2128,24.4,1445.2,109,0,1,4,0,3,0,0,0,0,16741,7.0,18497,206,56,2289,2128,26.2,1674.1
4841270662,1,9,0,1,14,16,27,0,0,0,0,36185,10.8,38079,118,0,2023,1418,11.8,3618.5,0,5,0,16,14,45,0,0,0,0,34162,10.6,36661,97,0,-2023,-1418,9.7,3416.2
4840492547,1,0,0,0,32,33,85,0,0,0,2,40558,11.8,45138,108,0,-821,85,10.8,4055.8,0,0,1,33,32,99,0,0,0,0,41379,11.8,45053,124,0,821,-85,12.4,4137.9
4840460128,0,9,2,1,5,8,3,0,0,0,0,15160,7.0,16983,195,36,-2163,-461,23.1,1516.0,12,2,0,8,5,8,0,0,0,0,17323,6.8,17444,175,34,2163,461,20.9,1732.3
4840414963,1,42,0,0,5,4,1,0,0,0,0,15260,6.4,17062,200,40,109,1268,24.0,1526.0,11,1,1,4,5,2,1,1,0,0,15151,6.6,15794,169,52,-109,-1268,22.1,1515.1
4840392148,0,9,1,0,3,12,2,0,0,0,0,13627,6.6,15193,115,54,-6096,-2811,16.9,1362.7,9,1,1,12,3,9,0,0,0,0,19723,7.0,18004,215,52,6096,2811,26.7,1972.3
4840358734,1,0,4,0,25,21,65,0,0,0,2,39795,11.0,39759,124,0,3631,1368,12.4,3979.5,24,0,1,20,24,60,0,0,0,0,36164,10.6,38391,112,0,-3631,-1368,11.2,3616.4
4840341871,1,34,0,1,30,30,76,0,0,0,0,40126,12.0,44666,116,0,-465,2605,11.6,4012.6,34,0,0,29,29,74,0,0,0,0,40591,11.4,42061,108,0,465,-2605,10.8,4059.1
4840317829,1,2,0,1,24,30,57,0,0,0,0,38033,11.6,42869,115,0,92,-228,11.5,3803.3,0,0,0,30,24,78,0,0,0,0,37941,11.6,43097,91,0,-92,228,9.1,3794.1
4840277565,0,0,0,1,18,19,45,0,0,0,0,34916,10.6,37400,117,0,918,18,11.7,3491.6,0,0,0,19,18,44,0,0,0,0,33998,10.8,37382,95,0,-918,-18,9.5,3399.8
4838351831,0,0,0,1,20,20,43,0,0,0,1,35753,10.6,37931,85,0,-1483,-3285,8.5,3575.3,0,0,0,20,20,44,0,0,0,0,37236,11.2,41216,120,0,1483,3285,12.0,3723.6
4857427373,0,15,0,1,22,36,67,0,0,0,1,36423,10.8,39320,79,0,-5461,-5889,7.9,3642.3,0,2,0,36,22,103,0,0,0,0,41884,12.0,45209,119,0,5461,5889,11.9,4188.4
4857400267,1,34,0,1,32,22,92,0,0,0,0,38940,11.6,43877,92,0,1165,3393,9.2,3894.0,34,0,0,21,31,62,0,0,0,0,37775,11.2,40484,112,0,-1165,-3393,11.2,3777.5
4857117270,1,85,0,0,19,14,19,0,0,0,0,48300,10.0,47500,0,0,20800,19000,0.0,4830.0,0,0,1,7,12,8,0,0,0,0,27500,6.0,28500,0,0,-20800,-19000,0.0,2750.0
4856319212,1,0,0,0,13,21,9,0,0,0,0,44550,10.6,50500,0,0,15300,22000,0.0,4455.0,5,0,1,14,6,15,0,0,0,0,29250,6.0,28500,0,0,-15300,-22000,0.0,2925.0
4856292843,1,0,0,1,17,14,11,0,0,0,0,48500,12.0,55000,0,0,20100,22000,0.0,4850.0,0,0,0,6,9,12,0,0,0,0,28400,7.2,33000,0,0,-20100,-22000,0.0,2840.0
4856255592,1,0,0,1,16,14,14,0,0,0,0,46238,10.0,47500,4,0,15503,17820,0.4,4623.8,0,0,0,7,9,11,0,0,0,0,30735,6.2,29680,1,0,-15503,-17820,0.1,3073.5
4856230267,1,0,0,1,17,14,18,0,0,0,0,47750,10.0,47500,0,0,20115,17820,0.0,4775.0,0,0,0,8,11,7,0,0,0,0,27635,6.2,29680,2,0,-20115,-17820,0.2,2763.5
4856032784,1,0,0,1,11,20,10,0,0,0,0,44550,10.0,47500,4,0,15204,19000,0.4,4455.0,0,0,0,13,4,14,0,0,0,0,29346,6.0,28500,3,0,-15204,-19000,0.3,2934.6
4856013061,1,0,0,1,17,13,21,0,0,0,0,60990,12.0,55000,0,0,21720,22000,0.0,6099.0,0,0,0,7,11,7,0,0,0,0,39270,7.2,33000,0,0,-21720,-22000,0.0,3927.0
4855987424,1,204,6,0,16,21,13,0,0,0,0,45930,10.0,47500,12,0,17015,18600,1.2,4593.0,176,2,1,11,6,15,0,0,0,0,28915,6.0,28900,0,0,-17015,-18600,0.0,2891.5
4855964637,1,8,0,0,13,17,13,0,0,0,0,46000,10.0,47500,1,0,17400,19000,0.1,4600.0,6,0,1,10,6,8,0,0,0,0,28600,6.0,28500,1,0,-17400,-19000,0.1,2860.0
4855941626,1,0,0,1,19,19,15,0,0,0,0,47400,10.0,47500,0,0,18237,19000,0.0,4740.0,0,0,0,8,8,13,0,0,0,0,29163,6.0,28500,0,0,-18237,-19000,0.0,2916.3
4855267123,1,20,0,1,37,23,84,0,0,0,0,39723,11.8,44149,98,0,2033,746,9.8,3972.3,0,0,0,23,37,62,0,0,0,0,37690,11.6,43403,101,0,-2033,-746,10.1,3769.0
4854868478,1,0,0,1,18,16,17,0,0,0,0,62000,12.0,55000,0,0,24800,22000,0.0,6200.0,0,0,0,10,12,10,0,0,0,0,37200,7.2,33000,0,0,-24800,-22000,0.0,3720.0
4854849188,1,0,0,1,22,10,25,0,0,0,0,63400,12.0,55000,0,0,29000,22000,0.0,6340.0,5,0,0,5,17,1,0,0,0,0,34400,7.2,33000,0,0,-29000,-22000,0.0,3440.0
4854814234,1,0,0,1,23,16,28,0,0,0,0,47560,10.0,47500,4,0,21050,19000,0.4,4756.0,0,0,0,8,15,4,0,0,0,0,26510,6.0,28500,0,0,-21050,-19000,0.0,2651.0
4854795342,1,0,0,1,17,17,21,0,0,0,0,62395,12.0,55000,0,0,24800,22000,0.0,6239.5,0,0,0,10,10,8,0,0,0,0,37595,7.2,33000,0,0,-24800,-22000,0.0,3759.5
4854779002,1,27,2,1,20,11,19,0,0,0,0,67010,12.0,55000,4,0,31205,22000,0.4,6701.0,135,1,0,7,16,7,0,0,0,0,35805,7.2,33000,0,0,-31205,-22000,0.0,3580.5
4854764035,1,0,0,1,21,25,23,0,0,0,0,80500,15.0,70000,0,0,39600,31000,0.0,8050.0,0,0,0,15,11,12,0,0,0,0,40900,8.2,39000,0,0,-39600,-31000,0.0,4090.0
4854741086,1,0,0,1,21,20,15,0,0,0,0,61650,12.0,55000,0,0,24800,22000,0.0,6165.0,17,0,0,9,10,9,0,0,0,0,36850,7.2,33000,0,0,-24800,-22000,0.0,3685.0
4856372355,1,0,0,1,20,14,22,0,0,0,0,62741,12.0,55000,0,0,26941,22000,0.0,6274.1,0,0,0,8,14,7,0,0,0,0,35800,7.2,33000,0,0,-26941,-22000,0.0,3580.0
4856356032,1,35,0,1,24,16,24,0,0,0,0,65163,12.8,61000,5,0,28635,25000,0.5,6516.3,0,4,0,7,15,8,0,0,0,0,36528,7.6,36000,0,0,-28635,-25000,0.0,3652.8
4856330949,1,0,0,1,13,15,11,0,0,0,0,45465,10.0,47500,3,0,16760,19000,0.3,4546.5,0,0,0,9,7,10,0,0,0,0,28705,6.0,28500,1,0,-16760,-19000,0.1,2870.5
4856302379,1,0,0,0,23,18,15,0,0,0,0,47810,10.0,47500,0,0,18900,19000,0.0,4781.0,0,0,1,8,13,11,0,0,0,0,28910,6.0,28500,0,0,-18900,-19000,0.0,2891.0
4856277318,1,6,0,1,18,18,20,0,0,0,0,47000,10.0,47500,8,0,18800,19000,0.8,4700.0,0,0,0,11,11,12,0,0,0,0,28200,6.0,28500,1,0,-18800,-19000,0.1,2820.0
4856254023,1,0,0,0,14,18,17,0,0,0,0,60950,12.0,55000,0,0,22700,22000,0.0,6095.0,0,0,1,14,10,11,0,0,0,0,38250,7.2,33000,0,0,-22700,-22000,0.0,3825.0
4856229527,1,0,0,0,18,21,22,0,0,0,0,63100,12.0,55000,1,0,24850,22000,0.1,6310.0,0,0,1,15,12,9,0,0,0,0,38250,7.2,33000,0,0,-24850,-22000,0.0,3825.0
4856213938,1,0,0,1,22,9,21,0,0,0,0,67950,12.0,55000,0,0,33200,22000,0.0,6795.0,4,0,0,2,15,3,0,0,0,0,34750,7.2,33000,0,0,-33200,-22000,0.0,3475.0
4856062457,1,0,0,0,13,18,12,0,0,0,0,60950,12.0,55000,0,0,23400,21000,0.0,6095.0,17,0,1,10,5,12,0,0,0,0,37550,7.4,34000,0,0,-23400,-21000,0.0,3755.0
4856039729,1,0,0,1,18,16,14,0,0,0,0,63062,12.0,55000,3,0,24809,22000,0.3,6306.2,0,0,0,9,11,10,0,0,0,0,38253,7.2,33000,0,0,-24809,-22000,0.0,3825.3
4856021172,1,27,3,1,15,21,19,0,0,0,0,63089,12.0,55000,11,0,25153,22000,1.1,6308.9,34,2,0,15,9,10,0,0,0,0,37936,7.2,33000,0,0,-25153,-22000,0.0,3793.6
4856006845,1,0,0,0,10,18,12,0,0,0,0,58970,12.0,55000,1,0,21270,22000,0.1,5897.0,0,0,1,13,5,13,0,0,0,0,37700,7.2,33000,2,0,-21270,-22000,0.2,3770.0
4855980965,1,0,0,1,12,17,13,0,0,0,0,60250,12.0,55000,0,0,22000,22000,0.0,6025.0,2,0,0,13,8,9,0,0,0,0,38250,7.2,33000,0,0,-22000,-22000,0.0,3825.0
4855948594,0,55,0,1,6,8,8,0,0,0,0,15122,6.2,15977,176,44,-3289,-3285,22.0,1512.2,22,2,0,8,6,7,1,1,0,0,18411,7.2,19262,213,64,3289,3285,27.7,1841.1
4855910587,1,12,5,1,9,3,7,1,1,0,0,17621,6.8,18519,214,56,1813,2134,27.0,1762.1,25,0,0,3,9,4,0,0,0,0,15808,6.8,16385,163,42,-1813,-2134,20.5,1580.8
4855870519,0,9,0,0,7,11,4,0,0,0,0,18081,7.0,18317,213,56,103,-158,26.9,1808.1,17,0,1,10,6,12,1,1,0,0,17978,7.0,18475,177,60,-103,158,23.7,1797.8
4855755247,0,9,0,0,10,9,7,1,0,1,0,19219,7.4,19286,201,56,188,996,25.7,1921.9,146,1,1,9,10,9,1,1,0,0,19031,7.2,18290,197,52,-188,-996,24.9,1903.1
4855722697,1,12,1,1,12,5,10,1,1,0,0,18363,6.6,17753,181,60,3278,1966,24.1,1836.3,11,0,0,5,12,4,0,0,0,0,15085,6.4,15787,170,52,-3278,-1966,22.2,1508.5
4855401160,0,23,1,1,6,10,5,0,0,0,0,17691,6.8,17180,210,50,-693,-1191,26.0,1769.1,12,1,0,10,6,8,1,1,0,0,18384,7.0,18371,207,48,693,1191,25.5,1838.4
4855375107,0,103,0,0,8,8,7,0,0,0,0,18018,6.8,17016,180,40,329,-374,22.0,1801.8,14,1,1,8,8,6,2,1,1,0,17689,7.0,17390,188,60,-329,374,24.8,1768.9
4856169515,0,0,0,0,16,20,39,0,0,0,0,36125,11.0,38797,116,0,303,1188,11.6,3612.5,0,0,1,20,16,64,0,0,0,0,35822,10.6,37609,112,0,-303,-1188,11.2,3582.2
4856139154,1,0,0,1,29,28,76,0,0,0,2,41261,12.0,44980,119,0,4713,5461,11.9,4126.1,0,0,0,28,29,75,0,0,0,0,36548,11.0,39519,97,0,-4713,-5461,9.7,3654.8
4851456544,1,11,0,1,18,12,17,0,0,0,0,22703,7.2,19028,188,56,3844,3346,24.4,2270.3,13,1,0,10,16,12,0,0,0,0,18859,6.2,15682,155,38,-3844,-3346,19.3,1885.9
4845886351,0,139,0,0,5,11,3,0,0,0,0,16417,6.6,16436,203,44,-3155,-1022,24.7,1641.7,18,1,1,11,5,12,0,0,0,0,19572,7.0,17458,176,58,3155,1022,23.4,1957.2
4839115785,1,78,1,0,5,8,3,0,0,0,0,15596,7.0,18188,163,60,-2657,-754,22.3,1559.6,14,0,1,8,5,8,0,0,0,0,18253,7.0,18942,202,75,2657,754,27.7,1825.3
4839073090,0,9,1,0,5,8,7,0,0,0,0,16533,7.0,17557,180,58,-1644,-403,23.8,1653.3,18,0,1,8,5,10,0,0,0,0,18177,6.8,17960,192,58,1644,403,25.0,1817.7
4837255647,1,14,2,1,7,3,5,0,0,0,0,17090,7.0,18247,194,60,1952,498,25.4,1709.0,11,1,0,3,7,2,0,0,0,0,15138,6.8,17749,211,52,-1952,-498,26.3,1513.8
4835165923,1,15,3,0,3,3,3,0,0,0,0,16154,6.8,17731,219,48,1160,-555,26.7,1615.4,11,0,1,3,3,0,0,0,0,0,14994,7.0,18286,198,64,-1160,555,26.2,1499.4
4834732250,1,15,3,1,9,7,8,0,0,0,0,17447,6.8,18152,195,44,181,-1432,23.9,1744.7,75,1,0,7,9,5,0,0,0,0,17266,7.4,19584,216,68,-181,1432,28.4,1726.6
4834570413,0,30,0,0,0,6,0,0,0,0,0,13204,6.6,15846,190,52,-4389,-3273,24.2,1320.4,33,0,1,6,0,7,0,0,0,0,17593,7.2,19119,207,76,4389,3273,28.3,1759.3
4834144789,1,10,1,1,8,5,5,0,0,0,0,17292,6.8,17738,205,40,971,692,24.5,1729.2,13,0,0,5,8,1,1,1,0,0,16321,6.6,17046,181,52,-971,-692,23.3,1632.1
4834110774,0,16,0,1,5,10,3,0,0,0,0,15490,6.6,17155,189,64,-2879,-1133,25.3,1549.0,12,1,0,10,5,13,1,1,0,0,18369,7.0,18288,228,40,2879,1133,26.8,1836.9
4834060699,1,11,0,0,2,4,1,0,0,0,0,14790,7.0,17776,187,60,-1479,-1394,24.7,1479.0,9,0,1,4,2,3,1,1,0,0,16269,7.2,19170,223,65,1479,1394,28.8,1626.9
4828820362,1,82,3,1,9,4,7,0,0,0,0,18042,6.8,18471,208,52,528,173,26.0,1804.2,19,3,0,4,9,5,0,0,0,0,17514,7.2,18298,233,64,-528,-173,29.7,1751.4
4828676245,1,54,1,0,2,3,1,1,1,0,0,15326,7.2,18452,193,60,26,116,25.3,1532.6,13,1,1,3,2,2,0,0,0,0,15300,6.8,18336,193,68,-26,-116,26.1,1530.0
4827626232,0,8,0,0,4,6,1,0,0,0,0,15640,7.2,18517,209,52,-1276,196,26.1,1564.0,10,0,1,6,4,3,1,1,0,0,16916,7.2,18321,214,72,1276,-196,28.6,1691.6
4800624093,1,13,1,0,11,8,1,1,0,1,0,17942,7.2,18494,198,57,242,1416,25.5,1794.2,16,2,1,8,11,3,0,0,0,0,17700,6.8,17078,187,46,-242,-1416,23.3,1770.0
4797477484,0,52,0,0,6,11,3,0,0,0,0,16758,6.8,17310,205,50,-1732,-636,25.5,1675.8,74,0,1,10,5,8,1,0,1,0,18490,6.8,17946,189,54,1732,636,24.3,1849.0
4797460821,0,133,3,0,5,6,5,0,0,0,0,15907,7.2,18136,211,59,-1324,-599,27.0,1590.7,9,1,1,6,5,4,0,0,0,0,17231,7.2,18735,208,56,1324,599,26.4,1723.1
4796174175,0,12,0,0,5,6,6,0,0,0,0,17358,6.8,16966,193,52,-98,-2104,24.5,1735.8,11,1,1,6,5,2,0,0,0,0,17456,7.0,19070,216,60,98,2104,27.6,1745.6
4832707311,0,14,0,0,6,6,6,0,0,0,0,16065,6.8,17557,172,64,-1584,-1758,23.6,1606.5,9,1,1,6,6,3,1,1,0,0,17649,7.4,19315,234,56,1584,1758,29.0,1764.9
4832429828,1,12,0,0,6,6,3,0,0,0,0,16492,7.0,18735,206,60,349,865,26.6,1649.2,49,0,1,6,6,5,1,1,0,0,16143,6.8,17870,176,67,-349,-865,24.3,1614.3
4832411758,0,15,1,1,6,5,6,1,1,0,0,16096,6.8,17660,186,59,-338,-338,24.5,1609.6,13,0,0,5,6,5,0,0,0,0,16434,6.6,17998,229,56,338,338,28.5,1643.4
4832388397,1,15,3,1,5,2,5,0,0,0,0,17640,6.2,16093,191,52,2348,-687,24.3,1764.0,17,1,0,2,5,0,0,0,0,0,15292,6.6,16780,207,60,-2348,687,26.7,1529.2
4829234283,1,18,0,0,6,2,4,1,1,0,0,16290,6.8,17557,217,51,1653,728,26.8,1629.0,13,0,1,2,6,5,0,0,0,0,14637,6.6,16829,226,60,-1653,-728,28.6,1463.7
4829218580,0,8,7,0,0,8,0,0,0,0,0,14106,6.6,17441,239,58,-3316,-2079,29.7,1410.6,23,2,1,8,0,7,1,1,0,0,17422,7.4,19520,194,56,3316,2079,25.0,1742.2
4828818512,1,17,1,1,4,2,3,0,0,0,0,16638,7.0,18372,240,56,3644,1751,29.6,1663.8,10,1,0,2,4,1,0,0,0,0,12994,6.4,16621,175,36,-3644,-1751,21.1,1299.4
4826941590,0,40,1,0,8,12,6,0,0,0,0,17904,6.8,17517,196,60,-2027,-956,25.6,1790.4,31,1,1,12,8,11,1,1,0,0,19931,7.0,18473,196,60,2027,956,25.6,1993.1
4826917233,0,17,0,0,6,5,5,1,1,0,0,17426,7.0,18728,201,60,-505,-1420,26.1,1742.6,7,0,1,5,6,5,0,0,0,0,17931,7.2,20148,208,68,505,1420,27.6,1793.1
4826891001,1,14,3,1,7,1,6,1,1,0,0,16652,7.0,18387,192,47,3026,2912,23.9,1665.2,10,1,0,1,7,1,0,0,0,0,13626,6.4,15475,171,48,-3026,-2912,21.9,1362.6
4826856957,0,35,2,0,3,3,2,0,0,0,0,16101,7.0,19007,207,68,415,1088,27.5,1610.1,17,16,1,3,3,3,1,1,0,0,15686,7.0,17919,186,44,-415,-1088,23.0,1568.6
4821528224,0,16,3,0,6,3,8,1,1,0,0,17306,7.0,18297,220,52,1507,-355,27.2,1730.6,8,2,1,3,6,1,0,0,0,0,15799,7.0,18652,232,68,-1507,355,30.0,1579.9
4821493349,0,10,2,0,6,2,2,0,0,0,0,16531,7.2,18459,216,60,2714,1868,27.6,1653.1,85,0,1,2,6,2,1,1,0,0,13817,6.8,16591,153,48,-2714,-1868,20.1,1381.7
4817931792,0,14,1,0,9,5,9,0,0,0,0,17909,7.2,18274,185,65,1761,535,25.0,1790.9,10,1,1,5,9,4,0,0,0,0,16148,7.0,17739,199,48,-1761,-535,24.7,1614.8
4817893481,0,74,0,1,2,9,1,0,0,0,0,14651,6.6,17345,176,61,-3473,-2113,23.7,1465.1,13,2,0,9,2,7,2,1,1,0,18124,7.2,19458,217,52,3473,2113,26.9,1812.4
4817318115,1,7,0,0,1,7,0,1,1,0,0,14577,7.4,19266,214,68,-2376,283,28.2,1457.7,7,0,1,7,1,5,0,0,0,0,16953,7.0,18983,215,56,2376,-283,27.1,1695.3
4815204468,1,11,11,1,6,4,2,0,0,0,0,17399,7.0,18516,222,52,1154,586,27.4,1739.9,34,0,0,4,6,2,1,1,0,0,16245,6.8,17930,175,64,-1154,-586,23.9,1624.5
4808157435,1,31,5,0,3,2,2,0,0,0,0,17307,7.4,19453,237,64,3453,3350,30.1,1730.7,33,3,1,2,3,2,0,0,0,0,13854,6.6,16103,165,56,-3453,-3350,22.1,1385.4
4798899932,1,9,1,1,6,4,5,1,0,1,0,17140,7.2,17814,203,52,2116,1495,25.5,1714.0,12,0,0,4,6,1,1,1,0,0,15024,6.8,16319,163,66,-2116,-1495,22.9,1502.4
4798861166,0,13,0,1,9,3,13,0,0,0,0,17349,7.2,18058,187,56,1625,347,24.3,1734.9,10,2,0,3,9,3,0,0,0,0,15724,7.0,17711,204,56,-1625,-347,26.0,1572.4
4833994853,0,11,0,1,4,3,4,0,0,0,0,15618,6.8,16550,220,48,857,-710,26.8,1561.8,11,2,0,3,4,4,0,0,0,0,14761,6.8,17260,206,48,-857,710,25.4,1476.1
4833971057,1,11,0,1,4,2,5,0,0,0,0,15469,7.0,18213,224,60,65,357,28.4,1546.9,10,0,0,2,4,3,0,0,0,0,15404,6.8,17856,229,53,-65,-357,28.2,1540.4
4833526595,0,10,2,0,3,4,2,0,0,0,0,15244,6.8,17921,229,48,-138,-537,27.7,1524.4,14,1,1,4,3,4,1,1,0,0,15382,7.0,18458,214,48,138,537,26.2,1538.2
4833517866,0,12,0,1,5,9,6,0,0,0,0,15305,6.6,16918,185,60,-2789,-1635,24.5,1530.5,83,1,0,9,5,8,1,1,0,0,18094,7.2,18553,224,55,2789,1635,27.9,1809.4
4829780427,1,12,1,0,3,7,0,0,0,0,0,15904,6.8,18430,222,48,-817,585,27.0,1590.4,12,1,1,7,3,9,1,1,0,0,16721,7.0,17845,219,59,817,-585,27.8,1672.1
4829742815,1,15,0,0,4,3,2,0,0,0,0,15384,6.4,16117,217,56,583,-1770,27.3,1538.4,15,1,1,3,4,2,1,1,0,0,14801,6.8,17887,206,50,-583,1770,25.6,1480.1
4829717830,1,16,1,1,6,1,10,1,1,0,0,17804,7.0,18770,230,50,3527,1999,28.0,1780.4,14,3,0,1,6,0,0,0,0,0,14277,6.6,16771,209,56,-3527,-1999,26.5,1427.7
4808929908,1,10,0,0,4,9,5,1,0,1,1,17108,6.8,17959,214,55,-1629,-154,26.9,1710.8,68,0,1,9,4,9,1,1,0,0,18737,7.0,18113,202,48,1629,154,25.0,1873.7
4808274585,1,43,1,0,8,8,16,0,0,0,0,18751,6.6,18195,209,68,1688,396,27.7,1875.1,11,1,1,8,8,4,1,1,0,0,17063,6.6,17799,202,48,-1688,-396,25.0,1706.3
4807390605,1,14,1,1,6,3,11,0,0,0,0,17588,7.2,19064,222,60,2969,2377,28.2,1758.8,9,2,0,3,6,4,0,0,0,0,14619,6.8,16687,212,60,-2969,-2377,27.2,1461.9
4656082689,0,20,2,0,5,7,5,0,0,0,0,15869,6.8,17928,151,62,-516,-274,21.3,1586.9,7,3,1,7,5,3,1,1,0,0,16385,7.0,18202,212,64,516,274,27.6,1638.5
4656045569,1,10,13,1,7,2,9,1,1,0,0,17644,7.2,19571,226,60,3706,2468,28.6,1764.4,40,2,0,2,7,1,0,0,0,0,13938,6.6,17103,195,60,-3706,-2468,25.5,1393.8
4656000668,1,11,2,0,3,3,1,0,0,0,0,15035,6.8,17398,211,56,-1448,-967,26.7,1503.5,13,0,1,3,3,4,1,1,0,0,16483,7.0,18365,249,47,1448,967,29.6,1648.3
4655974171,0,18,2,0,2,5,0,0,0,0,0,13563,6.8,16532,181,42,-1972,-501,22.3,1356.3,13,5,1,5,2,6,1,1,0,0,15535,6.6,17033,183,63,1972,501,24.6,1553.5
4655941452,1,12,1,1,10,4,9,0,0,0,0,18500,7.0,18274,219,44,4609,2774,26.3,1850.0,26,2,0,4,10,1,0,0,0,0,13891,6.4,15500,166,44,-4609,-2774,21.0,1389.1
4655899943,0,14,1,1,3,2,1,1,1,0,0,14988,6.8,18020,227,56,82,1024,28.3,1498.8,15,2,0,2,3,1,0,0,0,0,14906,6.6,16996,231,48,-82,-1024,27.9,1490.6
4655506575,1,84,2,0,7,3,8,1,1,0,0,16643,7.0,17662,204,48,1345,145,25.2,1664.3,13,0,1,3,7,5,0,0,0,0,15298,6.6,17517,221,56,-1345,-145,27.7,1529.8
4655491385,0,10,0,0,7,7,0,1,1,0,0,16322,6.8,18114,204,64,-441,1958,26.8,1632.2,15,0,1,7,7,11,0,0,0,0,16763,6.4,16156,175,50,441,-1958,22.5,1676.3
4655471460,1,14,2,0,10,4,12,1,1,0,0,20119,7.0,19020,211,64,5503,2768,27.5,2011.9,12,1,1,4,10,4,0,0,0,0,14616,6.6,16252,185,48,-5503,-2768,23.3,1461.6
4857515917,0,0,5,1,27,28,71,0,0,0,2,39015,11.2,41072,113,0,-1028,-2755,11.3,3901.5,43,0,0,28,27,86,0,0,0,0,40043,11.8,43827,117,0,1028,2755,11.7,4004.3
4855966502,1,0,0,1,15,17,16,0,0,0,0,56350,12.0,55000,0,0,21700,22000,0.0,5635.0,0,0,0,12,10,9,0,0,0,0,34650,7.2,33000,0,0,-21700,-22000,0.0,3465.0
4855950314,1,0,0,0,16,14,21,0,0,0,0,61348,12.0,55000,0,0,24821,22000,0.0,6134.8,0,0,1,11,13,6,0,0,0,0,36527,7.2,33000,0,0,-24821,-22000,0.0,3652.7
4855934798,1,23,0,1,10,13,12,0,0,0,0,46550,10.0,47500,0,0,18700,19000,0.0,4655.0,3,0,0,10,7,6,0,0,0,0,27850,6.0,28500,0,0,-18700,-19000,0.0,2785.0
4855915030,1,0,0,1,15,20,16,0,0,0,0,63750,12.0,55000,0,0,26200,22000,0.0,6375.0,0,0,0,14,9,8,0,0,0,0,37550,7.2,33000,0,0,-26200,-22000,0.0,3755.0
4855445595,1,0,0,1,25,21,59,0,0,0,0,37588,11.4,42799,118,0,1887,4416,11.8,3758.8,0,0,0,21,25,61,0,0,0,0,35701,11.0,38383,91,0,-1887,-4416,9.1,3570.1
4855434881,0,0,0,1,19,16,54,0,0,0,0,35064,10.8,37564,90,0,-835,-997,9.0,3506.4,2,0,0,16,19,46,0,0,0,0,35899,10.8,38561,126,0,835,997,12.6,3589.9
4855401362,1,86,0,1,13,13,37,0,0,0,1,33833,10.0,34409,113,0,-51,847,11.3,3383.3,2,0,0,13,13,31,0,0,0,0,33884,9.8,33562,104,0,51,-847,10.4,3388.4
4854739442,0,68,2,0,0,4,0,0,0,0,0,14754,6.6,17294,201,45,-859,1118,24.6,1475.4,13,1,1,4,0,2,0,0,0,0,15613,6.4,16176,186,55,859,-1118,24.1,1561.3
4854707124,0,8,0,0,7,8,5,0,0,0,0,17578,6.8,17330,199,48,350,1185,24.7,1757.8,12,1,1,8,7,12,1,1,0,0,17228,6.6,16145,174,44,-350,-1185,21.8,1722.8
4854370351,1,37,0,0,14,20,13,0,0,0,0,62500,12.0,55000,0,0,24600,22000,0.0,6250.0,0,0,1,14,8,12,0,0,0,0,37900,7.2,33000,0,0,-24600,-22000,0.0,3790.0
4854368855,1,0,0,1,17,19,23,0,0,0,0,62700,12.0,55000,0,0,24800,22000,0.0,6270.0,0,0,0,13,11,7,0,0,0,0,37900,7.2,33000,7,0,-24800,-22000,0.7,3790.0
4854356929,1,3,0,1,15,23,15,0,0,0,0,47750,10.0,47500,0,0,19200,19000,0.0,4775.0,0,0,0,14,6,11,0,0,0,0,28550,6.0,28500,0,0,-19200,-19000,0.0,2855.0
4854348137,1,1,0,0,18,19,16,0,0,0,0,63060,12.0,55000,0,0,24810,22000,0.0,6306.0,30,0,1,11,10,12,0,0,0,0,38250,7.2,33000,0,0,-24810,-22000,0.0,3825.0
4854330043,1,9,1,1,9,2,11,0,0,0,0,18864,7.4,19269,248,60,3390,2170,30.8,1886.4,12,1,0,2,9,2,0,0,0,0,15474,6.6,17099,189,56,-3390,-2170,24.5,1547.4
4854303660,0,33,3,1,9,3,5,0,0,0,0,16271,6.6,17469,192,51,1359,527,24.3,1627.1,14,11,0,2,8,3,1,1,0,0,14912,6.8,16942,195,52,-1359,-527,24.7,1491.2
4854280992,1,8,1,1,3,2,3,0,0,0,0,14655,6.4,15744,167,46,-180,-1210,21.3,1465.5,12,1,0,2,3,2,0,0,0,0,14835,6.6,16954,205,50,180,1210,25.5,1483.5
4854249085,0,55,1,1,9,7,6,0,0,0,0,16330,6.8,17539,173,52,-1035,-1150,22.5,1633.0,14,0,0,7,9,5,1,1,0,0,17365,7.2,18689,182,67,1035,1150,24.9,1736.5
4854223533,1,34,0,1,8,4,12,0,0,0,0,17446,6.8,17480,179,52,2464,613,23.1,1744.6,19,0,0,4,8,3,0,0,0,0,14982,6.6,16867,148,60,-2464,-613,20.8,1498.2
4854188798,0,9,1,1,3,5,3,0,0,0,0,14222,7.0,17400,201,48,-1968,-270,24.9,1422.2,17,1,0,5,3,5,0,0,0,0,16190,6.8,17670,198,52,1968,270,25.0,1619.0
4770869442,0,75,2,0,6,7,4,0,0,0,0,16918,6.8,17633,188,59,-155,789,24.7,1691.8,12,1,1,7,6,6,0,0,0,0,17073,6.8,16844,190,51,155,-789,24.1,1707.3
4770206693,1,11,1,1,3,4,3,0,0,0,0,16164,7.0,18099,222,48,1742,851,27.0,1616.4,14,2,0,4,3,2,0,0,0,0,14422,6.6,17248,200,40,-1742,-851,24.0,1442.2
4770198878,0,20,0,1,8,6,5,0,0,0,0,17747,7.0,18867,252,53,1864,1678,30.5,1774.7,9,1,0,6,8,5,1,1,0,0,15883,6.8,17189,173,60,-1864,-1678,23.3,1588.3
4770165303,0,12,3,0,2,7,2,0,0,0,0,16120,6.8,17326,234,48,-492,-459,28.2,1612.0,14,2,1,7,2,7,1,1,0,0,16612,7.0,17785,202,68,492,459,27.0,1661.2
4770148503,0,19,1,1,3,1,2,1,1,0,0,14512,6.8,17681,197,60,-613,-407,25.7,1451.2,15,0,0,1,3,0,0,0,0,0,15125,6.8,18088,201,52,613,407,25.3,1512.5
4770138347,0,57,1,1,3,5,4,1,1,0,0,14740,6.8,16659,187,48,-488,-1287,23.5,1474.0,10,0,0,5,3,3,0,0,0,0,15228,6.8,17946,177,64,488,1287,24.1,1522.8
4770132174,0,12,0,0,2,5,0,0,0,0,0,13663,6.6,16872,191,49,-4444,-1185,24.0,1366.3,9,1,1,5,2,5,0,0,0,0,18107,6.8,18057,199,56,4444,1185,25.5,1810.7
4769131208,0,10,1,0,5,5,1,0,0,0,0,16292,7.0,18088,200,48,57,510,24.8,1629.2,96,1,1,5,5,2,0,0,0,0,16235,6.8,17578,199,56,-57,-510,25.5,1623.5
4769110740,0,17,4,1,7,9,12,0,0,0,0,16498,6.6,16519,168,52,-952,-658,22.0,1649.8,17,2,0,9,7,6,0,0,0,0,17450,6.6,17177,182,56,952,658,23.8,1745.0
4768864082,1,17,2,1,9,7,12,0,0,0,0,17907,6.4,15867,192,51,1031,-36,24.3,1790.7,14,2,0,7,9,9,0,0,0,0,16876,6.4,15903,199,52,-1031,36,25.1,1687.6
4768635450,1,12,0,0,9,1,7,0,0,0,0,18020,7.2,18732,217,68,3965,1848,28.5,1802.0,15,0,1,1,9,0,1,1,0,0,14055,6.8,16884,199,52,-3965,-1848,25.1,1405.5
4768295345,1,232,3,1,7,7,3,0,0,0,0,17697,6.8,17531,194,51,415,974,24.5,1769.7,14,0,0,7,7,5,0,0,0,0,17282,6.6,16557,196,48,-415,-974,24.4,1728.2
4768284851,1,20,0,1,9,7,10,0,0,0,0,17103,6.6,16322,170,48,-625,-987,21.8,1710.3,12,0,0,7,9,7,0,0,0,0,17728,6.8,17309,188,44,625,987,23.2,1772.8
4768265031,1,10,0,1,5,5,4,1,1,0,0,17023,6.8,17837,206,60,1366,560,26.6,1702.3,11,0,0,5,5,4,0,0,0,0,15657,6.6,17277,213,52,-1366,-560,26.5,1565.7
4768239134,0,13,1,1,4,4,1,1,1,0,0,15138,6.8,17797,216,56,295,-274,27.2,1513.8,12,1,0,3,3,4,0,0,0,0,14843,7.0,18071,196,64,-295,274,26.0,1484.3
4768218330,0,12,0,0,7,4,6,1,0,1,0,17316,7.0,18075,191,64,1751,-27,25.5,1731.6,11,0,1,4,7,4,0,0,0,0,15565,6.8,18102,184,46,-1751,27,23.0,1556.5
4768196195,0,10,1,0,4,8,1,0,0,0,0,15835,6.6,17628,191,60,-3068,-1367,25.1,1583.5,14,0,1,8,4,7,0,0,0,0,18903,7.0,18995,223,68,3068,1367,29.1,1890.3
4768156317,0,13,0,1,8,1,5,0,0,0,0,16679,7.2,18915,201,60,2886,2923,26.1,1667.9,21,2,0,1,8,2,0,0,0,0,13793,6.6,15992,196,56,-2886,-2923,25.2,1379.3
4768124323,0,10,1,0,5,5,3,0,0,0,0,15972,6.4,16175,193,48,-1301,-1977,24.1,1597.2,99,1,1,5,5,6,1,1,0,0,17273,6.8,18152,209,62,1301,1977,27.1,1727.3
4768091477,0,48,1,0,3,4,2,0,0,0,0,14825,7.0,18034,184,55,-1994,-2151,23.9,1482.5,12,0,1,4,3,1,1,1,0,0,16819,7.6,20185,220,80,1994,2151,30.0,1681.9
4855674053,1,6,0,1,19,17,19,0,0,0,0,62700,12.0,55000,0,0,26900,22000,0.0,6270.0,0,0,0,7,9,7,0,0,0,0,35800,7.2,33000,0,0,-26900,-22000,0.0,3580.0
4855663327,1,24,0,0,22,22,18,0,0,0,0,63113,12.0,55000,0,0,33418,22000,0.0,6311.3,0,0,1,11,11,13,0,0,0,0,29695,7.2,33000,0,0,-33418,-22000,0.0,2969.5
4855650478,1,89,0,1,14,22,16,0,0,0,0,46318,10.0,47500,0,0,16697,17820,0.0,4631.8,19,0,0,15,7,13,0,0,0,0,29621,6.2,29680,0,0,-16697,-17820,0.0,2962.1
4855645069,1,0,0,0,22,16,30,0,0,0,0,64450,12.8,61000,0,0,27600,25000,0.0,6445.0,82,0,1,11,17,2,0,0,0,0,36850,7.6,36000,0,0,-27600,-25000,0.0,3685.0
4854888904,1,4,0,1,22,13,24,0,0,0,0,63400,12.0,55000,0,0,27600,22000,0.0,6340.0,0,0,0,6,15,5,0,0,0,0,35800,7.2,33000,0,0,-27600,-22000,0.0,3580.0
4854863429,1,0,0,0,18,20,23,0,0,0,0,64793,12.0,55000,0,0,27243,22000,0.0,6479.3,0,0,1,12,10,9,0,0,0,0,37550,7.2,33000,0,0,-27243,-22000,0.0,3755.0
4854847324,1,10,0,0,12,14,20,0,0,0,0,59952,12.0,55000,0,0,22032,22000,0.0,5995.2,3,0,1,12,10,7,0,0,0,0,37920,7.2,33000,0,0,-22032,-22000,0.0,3792.0
4852733761,1,14,10,0,7,4,3,0,0,0,0,18081,6.8,17188,160,48,2096,-219,20.8,1808.1,36,3,1,4,7,2,0,0,0,0,15985,6.6,17407,201,48,-2096,219,24.9,1598.5
4852687986,1,11,0,1,7,7,3,0,0,0,0,17675,7.2,19176,227,48,2382,1890,27.5,1767.5,11,0,0,7,7,3,0,0,0,0,15293,6.8,17286,199,35,-2382,-1890,23.4,1529.3
4851828497,0,14,6,0,3,4,1,1,1,0,0,14704,6.8,17021,160,56,-1923,-1188,21.6,1470.4,37,1,1,4,3,2,0,0,0,0,16627,7.2,18209,228,56,1923,1188,28.4,1662.7
4851788184,0,16,4,0,5,11,2,0,0,0,0,14756,6.6,16669,164,52,-3230,-1180,21.6,1475.6,13,1,1,11,5,12,0,0,0,0,17986,6.8,17849,185,52,3230,1180,23.7,1798.6
4847411839,0,22,2,1,6,7,9,1,1,0,0,18574,7.0,17446,198,56,1320,262,25.4,1857.4,13,3,0,7,6,6,0,0,0,0,17254,6.8,17184,189,48,-1320,-262,23.7,1725.4
4847381624,0,11,3,0,3,8,3,0,0,0,0,15077,6.4,15922,165,44,-1137,-1939,20.9,1507.7,19,1,1,8,3,2,0,0,0,0,16214,6.8,17861,187,52,1137,1939,23.9,1621.4
4847373167,0,14,1,0,2,7,1,0,0,0,0,15449,7.0,17920,239,48,-2643,-903,28.7,1544.9,14,0,1,7,2,6,1,1,0,0,18092,7.2,18823,216,52,2643,903,26.8,1809.2
4847353323,0,13,1,0,5,9,9,0,0,0,0,16781,6.6,16051,193,40,-155,-1261,23.3,1678.1,25,0,1,9,5,9,1,1,0,0,16936,6.6,17312,177,56,155,1261,23.3,1693.6
4845971543,1,14,5,0,3,4,2,1,0,1,0,14878,7.0,18116,201,77,-1673,604,27.8,1487.8,16,1,1,4,3,5,0,0,0,0,16551,6.8,17512,213,42,1673,-604,25.5,1655.1
4845144908,0,15,2,1,8,8,10,1,1,0,0,16658,6.4,15923,188,52,-1975,-1523,24.0,1665.8,14,1,0,8,8,9,0,0,0,0,18633,6.8,17446,213,52,1975,1523,26.5,1863.3
4845102478,0,17,0,1,3,6,1,0,0,0,0,14168,6.6,16232,161,51,-4547,-2728,21.2,1416.8,16,1,0,6,3,10,1,1,0,0,18715,7.2,18960,226,72,4547,2728,29.8,1871.5
4845045015,1,15,0,0,6,3,4,0,0,0,0,16166,7.0,17481,203,60,-619,-899,26.3,1616.6,18,1,1,3,6,7,1,1,0,0,16785,7.0,18380,220,64,619,899,28.4,1678.5
4844985801,1,16,1,1,6,3,9,1,1,0,0,16143,6.8,17156,192,52,867,-1181,24.4,1614.3,102,1,0,3,6,1,0,0,0,0,15276,7.0,18337,185,68,-867,1181,25.3,1527.6
4856372216,1,0,0,1,18,14,19,0,0,0,0,62350,12.0,55000,0,0,24800,22000,0.0,6235.0,0,0,0,8,12,10,0,0,0,0,37550,7.2,33000,0,0,-24800,-22000,0.0,3755.0
4856345460,1,8,0,0,19,23,17,0,0,0,0,54689,12.0,55000,0,0,20579,22000,0.0,5468.9,0,0,1,12,8,17,0,0,0,0,34110,7.2,33000,0,0,-20579,-22000,0.0,3411.0
4855359798,0,23,0,0,2,9,1,1,0,1,0,13657,6.6,16244,174,56,-5113,-3815,23.0,1365.7,12,3,1,9,2,6,1,1,0,0,18770,7.4,20059,226,64,5113,3815,29.0,1877.0
4853722806,1,0,0,1,19,18,19,0,0,0,0,45950,10.0,47500,0,0,18800,19000,0.0,4595.0,23,0,0,9,10,10,0,0,0,0,27150,6.0,28500,0,0,-18800,-19000,0.0,2715.0
4853533698,1,0,0,1,26,19,24,0,0,0,0,65308,12.0,55000,0,0,28438,21000,0.0,6530.8,0,0,0,8,15,8,0,0,0,0,36870,7.4,34000,0,0,-28438,-21000,0.0,3687.0
4851535297,0,49,1,0,5,5,3,0,0,0,0,15148,7.0,17908,182,52,-960,-229,23.4,1514.8,10,1,1,5,5,3,1,1,0,0,16108,7.0,18137,202,62,960,229,26.4,1610.8
4846366251,0,0,0,0,21,31,55,0,0,0,1,37171,11.0,40887,78,0,-2572,-2100,7.8,3717.1,0,0,1,31,21,83,0,0,0,0,39743,11.6,42987,109,0,2572,2100,10.9,3974.3
4836558995,1,13,0,1,4,2,5,1,1,0,0,15778,6.8,17935,227,54,155,-459,28.1,1577.8,9,1,0,1,3,1,1,0,1,0,15623,6.8,18394,212,56,-155,459,26.8,1562.3
4836187024,0,13,0,0,9,8,5,1,1,0,0,16560,6.8,17630,196,56,146,579,25.2,1656.0,14,0,1,8,9,7,0,0,0,0,16414,6.8,17051,205,52,-146,-579,25.7,1641.4
4836149268,1,13,2,1,10,0,7,1,0,1,0,19798,7.2,18743,227,44,6330,2466,27.1,1979.8,18,2,0,0,10,0,1,1,0,0,13468,6.6,16277,186,48,-6330,-2466,23.4,1346.8
4836115165,1,13,2,0,5,5,4,0,0,0,0,16636,6.8,18315,220,65,687,124,28.5,1663.6,17,2,1,5,5,5,0,0,0,0,15949,7.0,18191,194,48,-687,-124,24.2,1594.9
4836060305,0,14,0,1,7,8,8,0,0,0,0,16748,6.8,16875,158,48,552,-333,20.6,1674.8,11,0,0,8,7,4,0,0,0,0,16196,6.6,17208,171,48,-552,333,21.9,1619.6
4835684791,0,12,15,1,5,4,6,0,0,0,0,15362,6.8,16445,152,60,-732,-1021,21.2,1536.2,38,1,0,4,5,5,0,0,0,0,16094,6.6,17466,206,64,732,1021,27.0,1609.4
4835650252,0,8,1,1,6,9,5,0,0,0,0,16078,6.6,16453,177,32,-2261,-3181,20.9,1607.8,11,0,0,9,6,4,0,0,0,0,18339,7.2,19634,179,81,2261,3181,26.0,1833.9
4835623613,1,9,2,1,5,4,4,0,0,0,0,16314,6.6,16571,189,52,190,-222,24.1,1631.4,13,0,0,4,5,6,0,0,0,0,16124,6.6,16793,203,52,-190,222,25.5,1612.4
4834718070,1,15,2,0,6,3,7,1,1,0,0,17130,7.4,19582,205,68,1808,2320,27.3,1713.0,13,0,1,3,6,9,0,0,0,0,15322,6.8,17262,210,48,-1808,-2320,25.8,1532.2
4834696498,1,21,0,1,5,0,4,1,1,0,0,17354,7.4,19913,264,68,3920,1883,33.2,1735.4,90,10,0,0,5,0,0,0,0,0,13434,6.8,18030,212,54,-3920,-1883,26.6,1343.4
4834351082,0,8,0,0,5,2,5,1,1,0,0,15685,6.8,18105,206,56,873,798,26.2,1568.5,13,1,1,2,5,4,0,0,0,0,14812,6.8,17307,193,56,-873,-798,24.9,1481.2
4834328115,1,11,1,0,4,3,6,0,0,0,0,15764,6.8,16524,200,47,740,-1154,24.7,1576.4,11,3,1,3,4,1,0,0,0,0,15024,6.6,17678,198,52,-740,1154,25.0,1502.4
4854879047,1,0,0,1,31,30,68,0,0,0,0,41853,11.8,46408,107,0,2809,2949,10.7,4185.3,4,0,0,30,31,68,0,0,0,0,39044,11.4,43459,97,0,-2809,-2949,9.7,3904.4
4853957340,1,15,0,1,6,4,0,1,1,0,0,15825,7.6,20090,212,68,2476,5583,28.0,1582.5,8,1,0,4,6,3,0,0,0,0,13349,5.8,14507,169,12,-2476,-5583,18.1,1334.9
4853912463,0,11,0,1,6,4,5,1,1,0,0,16324,6.8,17379,220,51,702,-468,27.1,1632.4,18,2,0,4,6,2,0,0,0,0,15622,6.8,17847,171,52,-702,468,22.3,1562.2
4853872112,1,15,1,1,11,6,9,1,1,0,0,17705,6.8,16858,196,47,2595,36,24.3,1770.5,183,2,0,6,11,1,0,0,0,0,15110,6.6,16822,178,36,-2595,-36,21.4,1511.0
4853840704,1,8,0,1,19,23,22,0,0,0,0,63400,12.6,59500,0,0,24800,22000,0.0,6340.0,0,0,0,14,10,11,0,0,0,0,38600,7.8,37500,0,0,-24800,-22000,0.0,3860.0
4853024523,1,16,0,1,22,12,27,0,0,0,0,48768,10.0,47500,1,0,22218,19000,0.1,4876.8,0,0,0,5,15,2,0,0,0,0,26550,6.0,28500,2,0,-22218,-19000,0.2,2655.0
4853005787,1,7,0,1,26,10,24,0,0,0,0,64100,13.0,62500,0,0,29700,28000,0.0,6410.0,5,0,0,1,17,6,0,0,0,0,34400,7.4,34500,0,0,-29700,-28000,0.0,3440.0
4852968875,1,0,0,0,16,16,22,0,0,0,0,62715,12.2,56000,0,0,26185,22000,0.0,6271.5,0,0,1,9,9,7,0,0,0,0,36530,7.4,34000,0,0,-26185,-22000,0.0,3653.0
4852918582,1,4,0,1,22,18,30,0,0,0,0,63050,12.0,55000,0,0,26900,22000,0.0,6305.0,4,0,0,10,14,6,0,0,0,0,36150,7.2,33000,0,0,-26900,-22000,0.0,3615.0
4851920578,1,18,1,1,9,1,8,0,0,0,0,17409,7.2,19375,203,56,3193,2018,25.9,1740.9,15,2,0,1,9,0,0,0,0,0,14216,6.8,17357,200,40,-3193,-2018,24.0,1421.6
4851865763,0,12,0,1,4,2,1,0,0,0,0,14322,6.6,16912,146,48,483,1383,19.4,1432.2,15,0,0,2,4,2,0,0,0,0,13839,6.6,15529,185,0,-483,-1383,18.5,1383.9
4851815371,1,10,1,1,9,2,4,1,1,0,0,17082,7.2,19280,219,57,2070,2465,27.6,1708.2,11,0,0,2,9,2,0,0,0,0,15012,6.8,16815,182,51,-2070,-2465,23.3,1501.2
4851787836,0,9,1,0,5,6,1,1,1,0,0,15635,6.8,17429,170,52,-1190,-877,22.2,1563.5,11,0,1,6,5,3,0,0,0,0,16825,7.0,18306,194,51,1190,877,24.5,1682.5
4850772963,1,0,0,1,22,29,36,0,0,0,1,36431,10.8,40165,99,0,-3095,-2516,9.9,3643.1,0,0,0,29,22,73,0,0,0,0,39526,11.6,42681,117,0,3095,2516,11.7,3952.6
4850051377,1,14,0,1,11,7,8,0,0,0,0,18818,6.8,18049,187,48,2837,1525,23.5,1881.8,8,0,0,7,11,2,0,0,0,0,15981,6.8,16524,143,40,-2837,-1525,18.3,1598.1
4850004328,0,12,1,1,3,4,3,0,0,0,0,13530,6.0,14095,129,42,-2683,-1506,17.1,1353.0,185,1,0,4,3,4,0,0,0,0,16213,6.6,15601,156,46,2683,1506,20.2,1621.3
4849966387,0,10,0,0,7,12,5,0,0,0,0,16502,6.6,17047,184,52,-2925,-2411,23.6,1650.2,10,0,1,12,7,9,1,1,0,0,19427,7.2,19458,197,44,2925,2411,24.1,1942.7
4849920319,0,15,0,1,4,7,1,0,0,0,0,15822,6.6,16931,193,46,-1744,-791,23.9,1582.2,16,0,0,7,4,8,1,1,0,0,17566,6.6,17722,204,51,1744,791,25.5,1756.6
4849796468,0,80,0,1,30,20,83,0,0,0,0,38555,11.4,42431,110,0,1984,3247,11.0,3855.5,0,0,0,20,30,48,0,0,0,0,36571,11.0,39184,106,0,-1984,-3247,10.6,3657.1
4856585518,1,0,0,1,20,17,13,0,0,0,0,46315,10.0,47500,0,0,18115,19000,0.0,4631.5,0,0,0,9,12,16,0,0,0,0,28200,6.0,28500,0,0,-18115,-19000,0.0,2820.0
4856571098,1,3,0,1,13,17,15,0,0,0,0,32000,10.0,47500,0,0,12800,19000,0.0,3200.0,0,0,0,12,8,8,0,0,0,0,19200,6.0,28500,0,0,-12800,-19000,0.0,1920.0
4856540035,1,11,2,1,4,4,4,0,0,0,0,15874,7.2,18637,206,64,1251,-60,27.0,1587.4,12,0,0,4,4,1,0,0,0,0,14623,7.2,18697,182,68,-1251,60,25.0,1462.3
4856523323,1,0,0,1,15,13,16,0,0,0,0,45600,10.0,47500,0,0,18100,19000,0.0,4560.0,0,0,0,7,9,8,0,0,0,0,27500,6.0,28500,0,0,-18100,-19000,0.0,2750.0
4856502469,1,0,0,1,14,19,14,0,0,0,0,60980,12.0,55000,0,0,22650,22000,0.0,6098.0,20,0,0,13,8,12,0,0,0,0,38330,7.2,33000,0,0,-22650,-22000,0.0,3833.0
4856484540,1,0,0,1,16,20,10,0,0,0,0,45950,10.0,47500,0,0,17400,19000,0.0,4595.0,7,0,0,11,7,12,0,0,0,0,28550,6.0,28500,0,0,-17400,-19000,0.0,2855.0
4856067667,1,0,0,1,19,19,14,0,0,0,0,62872,12.0,55000,0,0,24622,22000,0.0,6287.2,0,0,0,12,12,14,0,0,0,0,38250,7.2,33000,0,0,-24622,-22000,0.0,3825.0
4856031748,1,0,0,0,21,14,17,0,0,0,0,63819,12.4,57000,0,0,26954,23000,0.0,6381.9,0,0,1,8,15,10,0,0,0,0,36865,7.4,34000,0,0,-26954,-23000,0.0,3686.5
4855997504,1,0,0,0,14,21,9,0,0,0,0,59215,12.0,55000,0,0,20615,22000,0.0,5921.5,0,0,1,10,3,17,0,0,0,0,38600,7.2,33000,0,0,-20615,-22000,0.0,3860.0
4855544812,1,83,0,0,13,20,15,0,0,0,0,45834,10.0,47500,0,0,17628,19000,0.0,4583.4,162,0,1,13,6,9,0,0,0,0,28206,6.0,28500,0,0,-17628,-19000,0.0,2820.6
4855532516,1,392,2,1,18,14,25,0,0,0,0,63460,12.0,55000,2,0,27645,22000,0.2,6346.0,0,3,0,8,12,2,0,0,0,0,35815,7.2,33000,0,0,-27645,-22000,0.0,3581.5
4855528118,1,33,0,0,14,19,21,0,0,0,0,61580,12.0,55000,8,0,23541,18000,0.8,6158.0,0,5,1,14,9,10,0,0,0,0,38039,8.0,37000,0,0,-23541,-18000,0.0,3803.9
4855516395,1,0,0,1,21,15,17,0,0,0,0,62574,12.2,56000,0,0,25724,23000,0.0,6257.4,0,0,0,7,13,12,0,0,0,0,36850,7.2,33000,0,0,-25724,-23000,0.0,3685.0
4855496204,0,13,0,0,3,8,0,0,0,0,0,15162,6.6,17576,197,56,-1476,-876,25.3,1516.2,9,1,1,8,3,6,0,0,0,0,16638,7.2,18452,200,64,1476,876,26.4,1663.8
4855479886,1,13,2,1,2,1,1,0,0,0,0,15392,6.8,18001,201,64,1058,-2,26.5,1539.2,15,1,0,1,2,0,0,0,0,0,14334,6.8,18003,217,60,-1058,2,27.7,1433.4
4855463288,1,30,1,0,15,21,19,0,0,0,0,63105,12.0,55000,1,0,24780,22000,0.1,6310.5,49,0,1,13,7,12,0,0,0,0,38325,7.2,33000,2,0,-24780,-22000,0.2,3832.5
4855441693,1,0,0,1,18,16,16,0,0,0,0,47000,10.0,47500,0,0,19500,19000,0.0,4700.0,0,0,0,7,9,6,0,0,0,0,27500,6.0,28500,0,0,-19500,-19000,0.0,2750.0
4855436914,1,0,0,0,18,15,24,0,0,0,0,47775,10.0,47500,0,0,20275,19000,0.0,4777.5,15,0,1,8,11,6,0,0,0,0,27500,6.0,28500,0,0,-20275,-19000,0.0,2750.0
4855411296,1,0,0,1,16,21,17,0,0,0,0,47350,10.0,47500,0,0,18800,17820,0.0,4735.0,0,0,0,11,6,10,0,0,0,0,28550,6.2,29680,0,0,-18800,-17820,0.0,2855.0
4854371955,1,0,0,0,21,20,16,0,0,0,0,48250,10.0,47500,0,0,19652,19000,0.0,4825.0,0,0,1,14,15,15,0,0,0,0,28598,6.0,28500,0,1,-19652,-19000,0.1,2859.8
4841970927,1,15,0,1,4,4,6,2,1,1,0,16719,6.8,16933,179,56,1682,0,23.5,1671.9,120,0,0,4,4,4,0,0,0,0,15037,6.8,16933,195,52,-1682,0,24.7,1503.7
4841506409,1,17,4,0,3,3,3,1,1,0,0,14732,6.6,17040,200,52,-2481,-768,25.2,1473.2,68,0,1,3,3,3,0,0,0,0,17213,7.0,17808,227,60,2481,768,28.7,1721.3
4841343998,1,14,2,1,6,12,6,0,0,0,0,16246,6.4,15502,168,52,-3160,-2012,22.0,1624.6,8,1,0,12,6,13,0,0,0,0,19406,6.6,17514,194,52,3160,2012,24.6,1940.6
4840967585,0,14,4,1,4,5,4,0,0,0,0,16326,7.0,18504,253,72,-1351,-404,32.5,1632.6,20,2,0,5,4,4,1,1,0,0,17677,7.2,18908,239,56,1351,404,29.5,1767.7
4840601765,0,22,11,0,5,4,7,1,1,0,0,16717,6.6,16652,213,44,1627,117,25.7,1671.7,41,0,1,4,5,5,0,0,0,0,15090,6.6,16535,181,51,-1627,-117,23.2,1509.0
4840587922,1,14,0,1,4,4,2,0,0,0,0,15067,6.6,17006,200,40,-1070,-393,24.0,1506.7,17,1,0,4,4,3,0,0,0,0,16137,6.8,17399,163,60,1070,393,22.3,1613.7
4839846347,0,11,2,0,5,4,7,0,0,0,0,16022,7.0,18332,212,52,-319,-180,26.4,1602.2,14,1,1,4,5,5,1,1,0,0,16341,7.2,18512,242,51,319,180,29.3,1634.1
4839822774,0,153,0,1,9,5,8,0,0,0,0,16991,6.8,16743,180,38,2133,1041,21.8,1699.1,14,1,0,5,9,2,1,1,0,0,14858,6.4,15702,176,50,-2133,-1041,22.6,1485.8
4839799903,1,20,1,1,3,3,2,0,0,0,0,16861,6.8,18479,217,60,1204,-334,27.7,1686.1,14,3,0,3,3,4,0,0,0,0,15657,6.8,18813,189,52,-1204,334,24.1,1565.7
4839308103,0,9,0,0,4,4,2,0,0,0,0,15242,6.8,17196,224,54,-838,-1519,27.8,1524.2,11,1,1,4,4,1,0,0,0,0,16080,7.2,18715,244,54,838,1519,29.8,1608.0
4838518235,0,9,0,0,2,5,2,0,0,0,0,15270,7.2,18578,202,55,-2683,-1734,25.7,1527.0,7,2,1,5,2,1,1,1,0,0,17953,7.2,20312,247,76,2683,1734,32.3,1795.3
4838499761,1,13,3,1,5,5,3,0,0,0,0,16226,6.8,17555,196,52,-588,-77,24.8,1622.6,27,1,0,5,5,2,0,0,0,0,16814,6.8,17632,191,50,588,77,24.1,1681.4
4838473371,1,18,2,1,6,9,5,1,1,0,0,16707,7.0,17732,205,60,-1381,-415,26.5,1670.7,11,3,0,9,6,10,0,0,0,0,18088,6.8,18147,211,58,1381,415,26.9,1808.8
4773007403,0,12,0,1,3,6,1,0,0,0,0,14305,6.6,16804,188,52,-3449,-2741,24.0,1430.5,8,2,0,6,3,3,0,0,0,0,17754,7.4,19545,243,60,3449,2741,30.3,1775.4
4772937075,0,16,3,0,0,4,0,0,0,0,0,16362,7.2,18567,259,44,611,972,30.3,1636.2,15,4,1,4,0,5,0,0,0,0,15751,6.8,17595,220,48,-611,-972,26.8,1575.1
4756199517,1,457,0,1,15,16,13,0,0,0,0,62730,12.0,55000,0,0,24830,22000,0.0,6273.0,0,0,0,9,8,12,0,0,0,0,37900,7.2,33000,0,0,-24830,-22000,0.0,3790.0
4756181442,1,39,1,0,12,22,22,0,0,0,0,63455,12.0,55000,2,0,24140,22000,0.2,6345.5,6,1,1,18,8,11,0,0,0,0,39315,7.2,33000,0,0,-24140,-22000,0.0,3931.5
4756168781,1,47,0,0,16,20,20,0,0,0,0,63265,13.0,62500,7,0,21413,25000,0.7,6326.5,0,0,1,13,9,7,0,0,0,0,41852,7.8,37500,0,0,-21413,-25000,0.0,4185.2
4756146438,1,8,0,0,20,14,17,0,0,0,0,63050,13.0,62500,9,0,25500,25000,0.9,6305.0,0,0,1,7,13,8,0,0,0,0,37550,7.8,37500,6,0,-25500,-25000,0.6,3755.0
4857134770,0,0,0,0,17,21,36,0,0,0,1,35037,10.8,39032,103,0,-2822,724,10.3,3503.7,0,0,1,21,17,61,0,0,0,0,37859,10.8,38308,120,0,2822,-724,12.0,3785.9
4857100505,1,16,0,1,22,18,53,0,0,0,1,38722,11.4,41578,117,0,2970,898,11.7,3872.2,252,0,0,17,21,39,0,0,0,0,35752,11.0,40680,96,0,-2970,-898,9.6,3575.2
4857072711,0,0,0,0,19,18,33,0,0,0,1,35877,11.0,39952,102,0,1029,1218,10.2,3587.7,18,0,1,18,19,31,0,0,0,0,34848,11.0,38734,108,0,-1029,-1218,10.8,3484.8
4856499668,1,78,1,0,24,25,55,0,0,0,2,40785,11.6,43920,111,0,3189,3286,11.1,4078.5,20,0,1,25,24,69,0,0,0,0,37596,11.0,40634,91,0,-3189,-3286,9.1,3759.6
4856232236,1,0,0,1,26,19,52,0,0,0,0,37947,11.4,42707,109,0,1025,3147,10.9,3794.7,0,0,0,19,26,42,0,0,0,0,36922,10.8,39560,117,0,-1025,-3147,11.7,3692.2
4855487237,1,23,0,0,24,27,69,0,0,0,0,37666,11.0,39498,112,0,-957,-4006,11.2,3766.6,0,4,1,27,24,71,0,0,0,0,38623,11.4,43504,109,0,957,4006,10.9,3862.3
4854396358,1,19,0,0,26,29,63,0,0,0,0,39055,11.4,43463,109,0,611,131,10.9,3905.5,0,1,1,29,26,67,0,0,0,0,38444,11.8,43332,97,0,-611,-131,9.7,3844.4
4854391206,1,4,0,0,31,23,78,0,0,0,1,39338,11.6,43499,120,0,2723,3971,12.0,3933.8,0,0,1,23,31,53,0,0,0,0,36615,10.8,39528,102,0,-2723,-3971,10.2,3661.5
4854380422,1,22,0,0,36,21,77,0,0,0,1,42059,11.8,47266,115,0,5258,6515,11.5,4205.9,0,0,1,21,36,42,0,0,0,0,36801,11.2,40751,99,0,-5258,-6515,9.9,3680.1
4854372476,1,0,0,0,20,19,50,0,0,0,1,36371,11.0,37719,116,0,-46,-2387,11.6,3637.1,0,0,1,19,20,49,0,0,0,0,36417,11.0,40106,97,0,46,2387,9.7,3641.7
4854104799,0,68,0,0,23,20,49,0,0,0,0,34646,11.0,38849,106,0,-2047,207,10.6,3464.6,0,0,1,20,23,49,0,0,0,0,36693,10.8,38642,123,0,2047,-207,12.3,3669.3
4854074781,1,29,0,1,28,24,81,0,0,0,0,38275,11.0,41080,112,0,1190,1901,11.2,3827.5,0,3,0,24,28,60,0,0,0,0,37085,11.0,39179,104,0,-1190,-1901,10.4,3708.5
4854034475,1,0,0,0,30,20,66,0,0,0,0,39393,11.4,42959,104,0,4007,3680,10.4,3939.3,0,0,1,20,30,47,0,0,0,0,35386,10.8,39279,85,0,-4007,-3680,8.5,3538.6
4854001177,0,11,0,1,25,35,56,0,0,0,0,37898,11.0,40496,123,0,-930,-3648,12.3,3789.8,0,0,0,35,25,91,0,0,0,0,38828,11.8,44144,98,0,930,3648,9.8,3882.8
4853977581,1,0,0,0,33,19,100,0,0,0,2,41272,11.8,44453,123,0,3792,5202,12.3,4127.2,0,0,1,19,33,41,0,0,0,0,37480,11.2,39251,84,0,-3792,-5202,8.4,3748.0
4853925569,1,0,0,0,20,25,57,0,0,0,0,38051,11.0,40505,99,0,183,-2858,9.9,3805.1,0,0,1,25,20,79,0,0,0,0,37868,11.6,43363,116,0,-183,2858,11.6,3786.8
4853800796,0,16,0,0,29,29,83,0,0,0,2,39780,11.6,43506,109,0,57,184,10.9,3978.0,0,5,1,29,29,64,0,0,0,0,39723,11.6,43322,123,0,-57,-184,12.3,3972.3
4853767339,1,68,0,1,31,17,85,0,0,0,1,39741,11.4,42671,93,0,3620,6161,9.3,3974.1,0,0,0,17,31,49,0,0,0,0,36121,10.4,36510,104,0,-3620,-6161,10.4,3612.1
4853746808,1,0,0,1,48,33,143,0,0,0,2,44221,12.6,50242,121,0,2541,3026,12.1,4422.1,0,0,0,33,48,84,0,0,0,0,41680,12.0,47216,114,0,-2541,-3026,11.4,4168.0
4853165137,1,0,0,1,40,33,92,0,0,0,1,42828,12.2,47584,123,0,2120,2108,12.3,4282.8,0,0,0,33,40,78,0,0,0,0,40708,12.0,45476,103,0,-2120,-2108,10.3,4070.8
4839966752,0,13,0,0,7,10,7,0,0,0,0,15907,6.4,15950,164,56,-3352,-3259,22.0,1590.7,11,0,1,10,7,9,0,0,0,0,19259,7.2,19209,202,56,3352,3259,25.8,1925.9
4839693268,0,13,0,1,5,4,4,0,0,0,0,16820,7.0,18598,229,68,540,-149,29.7,1682.0,14,1,0,4,5,3,0,0,0,0,16280,7.0,18747,203,52,-540,149,25.5,1628.0
4818862045,0,4,0,1,10,3,4,0,0,0,0,15844,6.8,17965,128,44,684,292,17.2,1584.4,12,0,0,3,10,2,0,0,0,0,15160,6.6,17673,180,55,-684,-292,23.5,1516.0
4816297138,1,68,1,1,1,1,0,0,0,0,0,15502,7.4,19207,218,68,261,54,28.6,1550.2,11,0,0,1,1,1,0,0,0,0,15241,7.2,19153,231,60,-261,-54,29.1,1524.1
4816267304,0,12,1,0,1,8,0,0,0,0,0,14039,6.6,16520,168,68,-2594,-2078,23.6,1403.9,12,1,1,8,1,1,0,0,0,0,16633,7.0,18598,216,52,2594,2078,26.8,1663.3
4814755424,0,69,3,0,7,5,4,0,0,0,1,15789,5.6,13587,129,47,-1555,-4112,17.6,1578.9,74,3,1,5,7,1,1,1,0,0,17344,6.6,17699,222,64,1555,4112,28.6,1734.4
4812286114,0,8,0,0,4,9,3,0,0,0,0,14690,6.6,17443,145,51,-3312,-1719,19.6,1469.0,12,0,1,9,4,5,0,0,0,0,18002,7.4,19162,209,52,3312,1719,26.1,1800.2
4812256174,1,12,0,0,5,7,3,0,0,0,0,15811,6.8,18387,185,60,335,1615,24.5,1581.1,12,0,1,7,5,3,0,0,0,0,15476,6.8,16772,162,44,-335,-1615,20.6,1547.6
4812216403,0,10,1,0,2,14,0,0,0,0,0,13377,6.4,15780,144,44,-5682,-2979,18.8,1337.7,12,1,1,13,1,9,0,0,0,0,19059,7.0,18759,176,48,5682,2979,22.4,1905.9
4808004523,0,14,1,0,6,5,4,1,1,0,0,16550,6.8,17998,180,56,-347,-755,23.6,1655.0,12,2,1,5,6,3,0,0,0,0,16897,7.2,18753,189,60,347,755,24.9,1689.7
4804754148,0,16,1,0,5,8,0,0,0,0,0,15891,7.0,17757,199,52,-1498,-302,25.1,1589.1,10,0,1,8,5,6,0,0,0,0,17389,7.0,18059,193,52,1498,302,24.5,1738.9
4804712980,0,14,17,1,8,3,11,0,0,0,0,16879,6.8,16826,194,48,1839,-937,24.2,1687.9,38,2,0,3,8,2,1,1,0,0,15040,7.0,17763,169,60,-1839,937,22.9,1504.0
4804683026,1,13,1,0,1,5,3,1,1,0,0,13707,6.6,17091,180,64,-1317,-2188,24.4,1370.7,10,1,1,5,1,4,0,0,0,0,15024,7.2,19279,164,68,1317,2188,23.2,1502.4
4795994861,0,227,0,1,5,3,1,1,1,0,0,14376,6.6,17115,138,52,561,-415,19.0,1437.6,9,2,0,3,5,2,0,0,0,0,13815,6.6,17530,182,44,-561,415,22.6,1381.5
4783037842,1,10,0,1,6,8,6,0,0,0,0,16264,6.6,17217,169,48,-1009,-801,21.7,1626.4,9,1,0,8,6,1,1,1,0,0,17273,7.0,18018,217,48,1009,801,26.5,1727.3
4782129198,1,9,3,0,6,6,5,0,0,0,0,16399,6.6,17299,203,52,966,958,25.5,1639.9,14,1,1,6,6,3,1,1,0,0,15433,6.4,16341,171,56,-966,-958,22.7,1543.3
4781677348,0,13,1,0,2,8,3,0,0,0,0,14751,6.4,15227,172,46,-3806,-1931,21.8,1475.1,14,1,1,8,2,9,1,0,1,0,18557,6.6,17158,179,48,3806,1931,22.7,1855.7
4778715731,0,13,3,1,9,6,11,0,0,0,0,17995,7.0,18307,218,52,874,651,27.0,1799.5,12,1,0,6,9,6,1,1,0,0,17121,6.8,17656,222,48,-874,-651,27.0,1712.1
4774679378,1,37,1,0,7,15,4,0,0,0,0,16614,6.6,15859,162,48,-3656,-1883,21.0,1661.4,12,10,1,15,7,9,1,0,1,0,20270,6.8,17742,169,55,3656,1883,22.4,2027.0
4841367333,1,21,1,0,28,26,75,0,0,0,2,39703,11.8,43385,97,0,1876,3904,9.7,3970.3,14,0,1,26,28,72,0,0,0,0,37827,11.0,39481,86,0,-1876,-3904,8.6,3782.7
4841325711,1,0,0,0,22,27,49,0,0,0,0,38714,11.6,43433,102,0,1338,1338,10.2,3871.4,0,0,1,27,22,60,0,0,0,0,37376,11.4,42095,103,0,-1338,-1338,10.3,3737.6
4775468007,0,0,0,0,24,30,53,0,0,0,1,37427,11.4,42400,93,0,-2930,-1835,9.3,3742.7,0,0,1,30,24,76,0,0,0,0,40357,11.6,44235,112,0,2930,1835,11.2,4035.7
4775447601,0,69,0,1,30,31,67,0,0,0,1,38998,12.2,46593,101,0,-2150,2076,10.1,3899.8,2,0,0,31,30,73,0,0,0,0,41148,11.6,44517,114,0,2150,-2076,11.4,4114.8
4775432338,1,0,2,1,29,22,84,0,0,0,1,40084,11.6,43874,119,0,2888,3242,11.9,4008.4,17,0,0,22,29,45,0,0,0,0,37196,11.0,40632,88,0,-2888,-3242,8.8,3719.6
4774462499,0,0,0,0,18,31,41,0,0,0,2,35935,11.0,38353,92,0,-3913,-4785,9.2,3593.5,0,0,1,31,18,86,0,0,0,0,39848,11.4,43138,88,0,3913,4785,8.8,3984.8
4774453760,0,0,0,0,21,30,49,0,0,0,2,38936,11.4,42766,106,0,1318,1176,10.6,3893.6,0,0,1,30,21,85,0,0,0,0,37618,11.0,41590,96,0,-1318,-1176,9.6,3761.8
4774434887,1,20,1,1,18,21,50,0,0,0,1,37342,10.8,38122,119,0,465,-2164,11.9,3734.2,6,0,0,21,18,69,0,0,0,0,36877,11.0,40286,97,0,-465,2164,9.7,3687.7
4774303234,1,0,0,0,31,32,79,0,0,0,0,38760,12.0,45637,89,0,288,3082,8.9,3876.0,0,0,1,32,31,79,0,0,0,0,38472,11.4,42555,113,0,-288,-3082,11.3,3847.2
4771446242,0,0,0,1,28,36,60,0,0,0,0,37972,11.2,41900,73,0,-1408,-2654,7.3,3797.2,127,0,0,36,28,92,0,0,0,0,39380,11.6,44554,103,0,1408,2654,10.3,3938.0
4771417332,0,1,0,0,29,31,69,0,0,0,1,40074,11.4,42797,113,0,2307,488,11.3,4007.4,47,0,1,31,29,80,0,0,0,0,37767,11.4,42309,88,0,-2307,-488,8.8,3776.7
4771395261,1,0,0,0,24,25,70,0,0,0,2,36533,10.8,38582,87,0,-1037,-1229,8.7,3653.3,0,0,1,25,24,66,0,0,0,0,37570,10.8,39811,85,0,1037,1229,8.5,3757.0
4771133233,1,11,1,0,4,3,4,1,1,0,0,14362,6.4,16320,176,60,-1647,-1404,23.6,1436.2,8,1,1,3,4,2,0,0,0,0,16009,6.8,17724,198,46,1647,1404,24.4,1600.9
4770739954,1,0,0,1,26,18,74,0,0,0,1,38346,11.4,41961,122,0,2932,3343,12.2,3834.6,37,0,0,18,26,44,0,0,0,0,35414,10.8,38618,101,0,-2932,-3343,10.1,3541.4
4770709927,0,0,1,0,24,17,57,0,0,0,1,36835,11.2,41617,106,0,1575,3074,10.6,3683.5,17,0,1,17,24,36,0,0,0,0,35260,10.8,38543,103,0,-1575,-3074,10.3,3526.0
4770689874,0,0,0,0,25,32,57,0,0,0,1,37888,11.0,41246,98,0,-1093,-750,9.8,3788.8,0,0,1,32,25,89,0,0,0,0,38981,11.4,41996,88,0,1093,750,8.8,3898.1
4769995651,1,0,0,0,26,28,65,0,0,0,0,36106,11.2,40163,89,0,-3556,-3832,8.9,3610.6,35,0,1,28,26,82,0,0,0,0,39662,11.8,43995,105,0,3556,3832,10.5,3966.2
4769978508,1,0,0,0,17,17,41,0,0,0,1,34589,10.8,36928,103,0,670,962,10.3,3458.9,0,0,1,17,17,42,0,0,0,0,33919,10.6,35966,117,0,-670,-962,11.7,3391.9
4769128834,1,9,0,0,29,33,75,0,0,0,0,39692,11.6,45080,110,0,-88,-148,11.0,3969.2,0,0,1,33,29,84,0,0,0,0,39780,12.0,45228,108,0,88,148,10.8,3978.0
4768162286,1,13,1,1,9,2,4,1,1,0,0,17294,7.0,18562,190,58,3771,3181,24.8,1729.4,6,0,0,2,9,2,0,0,0,0,13523,6.4,15381,173,37,-3771,-3181,21.0,1352.3
4855870847,1,21,9,1,6,2,3,0,0,0,0,16058,7.0,18512,201,48,1888,1605,24.9,1605.8,27,0,0,2,6,2,1,0,1,0,14170,6.8,16907,168,47,-1888,-1605,21.5,1417.0
4855125159,0,51,0,0,1,5,1,0,0,0,0,13741,6.8,17006,196,48,-3227,-2766,24.4,1374.1,13,0,1,5,1,6,0,0,0,0,16968,7.2,19772,227,72,3227,2766,29.9,1696.8
4855077666,0,12,1,0,2,7,3,0,0,0,0,13616,6.8,17171,185,52,-3234,-1417,23.7,1361.6,26,0,1,7,2,5,1,0,1,0,16850,7.4,18588,229,50,3234,1417,27.9,1685.0
4854780376,1,0,0,0,19,21,17,0,0,0,0,47350,10.0,47500,0,0,18100,19000,0.0,4735.0,3,0,1,13,11,15,0,0,0,0,29250,6.0,28500,0,0,-18100,-19000,0.0,2925.0
4854768137,1,252,2,0,23,16,23,0,0,0,0,63890,12.0,55000,4,0,26980,22000,0.4,6389.0,32,0,1,7,14,12,0,0,0,0,36910,7.2,33000,1,0,-26980,-22000,0.1,3691.0
4854748360,1,0,0,0,23,14,21,0,0,0,0,63787,12.8,59000,0,0,25852,26000,0.0,6378.7,0,0,1,9,18,8,0,0,0,0,37935,7.2,33000,0,0,-25852,-26000,0.0,3793.5
4854734318,1,1,0,1,14,17,17,0,0,0,0,62350,12.2,56000,0,0,24100,23000,0.0,6235.0,42,0,0,14,11,11,0,0,0,0,38250,7.2,33000,0,0,-24100,-23000,0.0,3825.0
4854720120,1,91,0,1,18,15,15,0,0,0,0,45992,10.0,47500,0,0,19491,19000,0.0,4599.2,0,0,0,5,8,8,0,0,0,0,26501,6.0,28500,0,0,-19491,-19000,0.0,2650.1
4847601094,0,9,1,1,5,5,5,0,0,0,0,15100,6.6,16860,191,40,-1675,-2189,23.1,1510.0,12,1,0,5,5,5,1,1,0,0,16775,7.2,19049,249,59,1675,2189,30.8,1677.5
4835078687,0,11,2,1,6,7,7,0,0,0,0,17131,6.8,17079,187,51,345,-566,23.8,1713.1,11,1,0,7,6,5,1,1,0,0,16786,6.8,17645,180,54,-345,566,23.4,1678.6
4835034051,0,16,0,0,3,6,1,1,0,1,0,15832,6.8,17655,209,40,-865,-693,24.9,1583.2,12,4,1,6,3,4,0,0,0,0,16697,7.0,18348,208,55,865,693,26.3,1669.7
4834995932,1,15,2,0,7,5,4,1,0,1,0,18676,7.2,18454,201,44,3658,3542,24.5,1867.6,15,0,1,5,7,9,1,1,0,0,15018,6.4,14912,166,52,-3658,-3542,21.8,1501.8
4834947483,1,71,0,1,8,6,8,1,1,0,0,17833,6.6,17157,202,44,1642,529,24.6,1783.3,15,2,0,6,8,6,0,0,0,0,16191,6.2,16628,184,46,-1642,-529,23.0,1619.1
4834909674,1,15,1,0,4,4,4,1,1,0,0,14755,6.8,17180,206,48,-691,-804,25.4,1475.5,179,2,1,4,4,2,0,0,0,0,15446,7.0,17984,222,60,691,804,28.2,1544.6
4834884693,0,12,0,0,2,10,1,1,0,1,0,14409,6.6,16120,173,52,-6011,-5050,22.5,1440.9,11,0,1,10,2,8,1,1,0,0,20420,7.4,21170,219,74,6011,5050,29.3,2042.0
4834868940,1,10,0,1,8,0,4,1,1,0,0,16911,7.2,19293,197,60,3464,1816,25.7,1691.1,8,0,0,0,8,0,0,0,0,0,13447,6.8,17477,195,64,-3464,-1816,25.9,1344.7
4834680261,1,12,0,1,10,6,13,2,1,1,0,19418,7.0,18514,191,52,2798,1490,24.3,1941.8,11,2,0,6,10,7,0,0,0,0,16620,6.6,17024,195,60,-2798,-1490,25.5,1662.0
4833950139,1,43,1,1,6,2,4,1,1,0,0,17070,7.2,18779,189,64,1713,1483,25.3,1707.0,13,0,0,2,6,1,0,0,0,0,15357,6.8,17296,230,52,-1713,-1483,28.2,1535.7
4853047409,0,14,0,0,2,8,1,1,1,0,0,13797,6.4,16112,186,44,-3666,-1087,23.0,1379.7,11,0,1,8,2,7,1,0,1,0,17463,6.6,17199,173,48,3666,1087,22.1,1746.3
4853003685,0,12,2,1,3,6,0,0,0,0,0,14744,7.0,18008,209,52,-1453,1804,26.1,1474.4,13,1,0,6,3,5,1,1,0,0,16197,6.6,16204,166,60,1453,-1804,22.6,1619.7
4852954684,1,30,1,1,7,4,5,0,0,0,0,16976,6.8,17992,192,55,1480,163,24.7,1697.6,33,1,0,4,7,2,0,0,0,0,15496,7.0,17829,191,52,-1480,-163,24.3,1549.6
4852920381,1,14,1,1,3,2,0,1,0,1,0,15300,7.0,17929,205,64,1122,1456,26.9,1530.0,12,1,0,2,3,1,0,0,0,0,14178,6.6,16473,203,52,-1122,-1456,25.5,1417.8
4852316622,1,9,0,1,8,9,9,0,0,0,0,17718,6.6,17049,186,44,659,228,23.0,1771.8,9,2,0,9,8,6,1,0,1,0,17059,6.6,16821,183,52,-659,-228,23.5,1705.9
4852254665,0,38,0,0,1,3,0,0,0,0,0,14275,6.8,17885,183,56,-586,-75,23.9,1427.5,13,0,1,3,1,3,1,1,0,0,14861,6.8,17960,179,76,586,75,25.5,1486.1
4852239320,1,11,2,1,2,1,3,1,1,0,0,15712,6.8,18057,205,44,-263,-729,24.9,1571.2,68,1,0,1,2,0,1,0,1,0,15975,7.2,18786,226,56,263,729,28.2,1597.5
4852224434,0,117,1,0,5,9,5,1,1,0,0,16644,7.0,17479,207,59,-1987,-1146,26.6,1664.4,15,1,1,9,5,6,0,0,0,0,18631,7.2,18625,229,64,1987,1146,29.3,1863.1
4852209525,0,11,2,0,3,3,2,0,0,0,0,14412,7.0,17764,190,60,-877,-1008,25.0,1441.2,16,0,1,3,3,1,1,1,0,0,15289,7.2,18772,226,72,877,1008,29.8,1528.9
4852165620,1,15,1,1,7,0,6,1,1,0,0,16420,7.2,19281,191,68,2945,2574,25.9,1642.0,10,2,0,0,7,0,0,0,0,0,13475,6.6,16707,199,48,-2945,-2574,24.7,1347.5
4852146546,0,13,2,1,6,3,7,1,1,0,0,16845,6.8,16844,195,44,2100,334,23.9,1684.5,80,1,0,3,6,1,0,0,0,0,14745,6.6,16510,192,44,-2100,-334,23.6,1474.5
4852134295,1,16,0,0,3,5,1,1,0,1,0,16691,7.2,18618,198,68,2524,2386,26.6,1669.1,11,0,1,5,3,4,0,0,0,0,14167,6.2,16232,131,34,-2524,-2386,16.5,1416.7
4850400385,0,11,1,1,13,11,16,0,0,0,0,20526,7.0,18534,175,52,2396,1380,22.7,2052.6,10,3,0,11,13,6,0,0,0,0,18130,6.8,17154,192,52,-2396,-1380,24.4,1813.0
4850352198,1,9,2,0,7,8,8,0,0,0,0,16667,6.8,17485,194,55,-27,1863,24.9,1666.7,258,3,1,8,7,13,1,1,0,0,16694,6.4,15622,173,48,27,-1863,22.1,1669.4
4850338834,1,11,1,1,9,8,6,1,1,0,0,17966,6.8,17845,197,48,753,881,24.5,1796.6,11,1,0,8,9,11,0,0,0,0,17213,6.8,16964,206,52,-753,-881,25.8,1721.3
4850244028,0,11,2,0,8,5,4,1,1,0,0,17052,6.8,17485,197,64,53,261,26.1,1705.2,14,1,1,5,8,6,0,0,0,0,16999,6.8,17224,200,48,-53,-261,24.8,1699.9
4850226343,1,15,1,1,6,5,2,0,0,0,0,17222,7.2,18755,200,59,1340,1256,25.9,1722.2,13,0,0,5,6,2,0,0,0,0,15882,6.6,17499,200,52,-1340,-1256,25.2,1588.2
4850206458,1,15,3,1,5,2,2,0,0,0,0,15817,7.0,18222,192,56,685,90,24.8,1581.7,10,2,0,2,5,3,1,1,0,0,15132,7.0,18132,204,52,-685,-90,25.6,1513.2
4850181624,1,14,0,1,3,6,1,1,1,0,0,15590,7.0,17804,196,72,-681,-1060,26.8,1559.0,13,1,0,6,3,2,0,0,0,0,16271,7.0,18864,226,57,681,1060,28.3,1627.1
4765364953,0,9,1,0,3,6,4,0,0,0,0,15620,6.6,16726,199,60,-908,-198,25.9,1562.0,15,1,1,6,3,6,1,1,0,0,16528,6.6,16924,202,52,908,198,25.4,1652.8
4765347848,0,54,4,0,1,2,0,0,0,0,0,13220,7.0,17880,193,46,-1862,-570,23.9,1322.0,12,1,1,2,1,1,0,0,0,0,15082,7.0,18450,235,72,1862,570,30.7,1508.2
4765327258,1,49,1,1,8,1,9,1,1,0,0,17889,7.0,18613,213,64,3729,928,27.7,1788.9,64,2,0,1,8,1,0,0,0,0,14160,7.0,17685,208,52,-3729,-928,26.0,1416.0
4765319811,1,14,1,1,9,2,10,0,0,0,0,18488,7.2,18360,215,52,4958,1862,26.7,1848.8,12,1,0,2,9,3,1,1,0,0,13530,6.6,16498,165,60,-4958,-1862,22.5,1353.0
4764861298,1,14,1,1,4,5,6,0,0,0,0,15843,7.0,17837,217,52,164,220,26.9,1584.3,22,2,0,5,4,7,0,0,0,0,15679,7.0,17617,204,61,-164,-220,26.5,1567.9
4764818933,0,10,1,0,2,4,2,1,1,0,0,14780,7.0,17796,195,68,-839,335,26.3,1478.0,8,0,1,4,2,6,0,0,0,0,15619,7.0,17461,204,60,839,-335,26.4,1561.9
4764654045,1,9,1,1,9,3,6,0,0,0,0,17971,7.0,19041,199,60,875,1129,25.9,1797.1,13,1,0,3,9,5,0,0,0,0,17096,6.8,17912,197,56,-875,-1129,25.3,1709.6
4764619477,1,14,1,1,4,2,4,0,0,0,0,16693,7.0,18632,246,64,2424,283,31.0,1669.3,13,1,0,2,4,0,1,1,0,0,14269,6.8,18349,234,56,-2424,-283,29.0,1426.9
4763972149,0,9,4,0,5,7,4,0,0,0,0,16482,6.8,17557,213,52,-1433,-2008,26.5,1648.2,85,3,1,7,5,4,1,1,0,0,17915,7.2,19565,224,64,1433,2008,28.8,1791.5
4763924368,0,9,3,0,2,4,2,1,0,1,0,16014,6.8,17680,201,60,-1212,-1365,26.1,1601.4,26,1,1,4,2,3,1,1,0,0,17226,7.2,19045,222,68,1212,1365,29.0,1722.6
4763878659,1,104,10,0,4,2,4,1,1,0,0,16219,7.0,19079,222,72,1091,690,29.4,1621.9,29,0,1,2,4,2,0,0,0,0,15128,7.0,18389,215,56,-1091,-690,27.1,1512.8
4763861950,1,12,0,1,10,2,9,1,1,0,0,19960,7.0,19233,219,64,6204,3591,28.3,1996.0,5,1,0,2,10,2,0,0,0,0,13756,6.2,15642,184,55,-6204,-3591,23.9,1375.6
4763818440,1,34,0,0,11,10,7,1,1,0,0,18987,7.0,18435,202,56,1403,2508,25.8,1898.7,10,13,1,10,11,9,0,0,0,0,17584,6.4,15927,180,44,-1403,-2508,22.4,1758.4
4759834430,0,17,0,0,5,1,4,2,1,1,0,16064,7.0,18874,215,60,1402,365,27.5,1606.4,13,1,1,1,5,0,0,0,0,0,14662,6.8,18509,219,68,-1402,-365,28.7,1466.2
4759806822,1,13,7,1,8,5,4,1,1,0,0,17382,6.8,17973,183,52,963,1260,23.5,1738.2,33,0,0,5,8,2,0,0,0,0,16419,6.6,16713,188,44,-963,-1260,23.2,1641.9
4756745209,0,12,0,0,2,7,2,0,0,0,0,14915,6.8,17120,210,56,-2239,-1691,26.6,1491.5,8,1,1,7,2,4,1,1,0,0,17154,7.0,18811,233,64,2239,1691,29.7,1715.4
4755921586,1,0,5,1,17,10,22,0,0,0,0,47130,10.0,47500,6,0,20960,19000,0.6,4713.0,16,0,0,5,12,4,0,0,0,0,26170,6.0,28500,1,0,-20960,-19000,0.1,2617.0
4755900703,1,0,0,1,19,13,17,0,0,0,0,48427,10.0,47500,0,0,21624,19000,0.0,4842.7,77,0,0,6,12,6,0,0,0,0,26803,6.0,28500,0,0,-21624,-19000,0.0,2680.3
4755212540,1,18,2,1,9,9,12,1,1,0,0,17664,6.4,16841,183,44,-501,165,22.7,1766.4,12,4,0,8,8,10,1,0,1,0,18165,6.8,16676,192,46,501,-165,23.8,1816.5
4753417156,0,8,1,0,6,12,6,0,0,0,0,16414,7.0,17372,198,60,-3007,-173,25.8,1641.4,15,1,1,12,6,12,1,1,0,0,19421,6.8,17545,221,45,3007,173,26.6,1942.1
4753396838,0,119,1,0,7,6,11,0,0,0,0,17818,7.0,18027,197,56,1143,648,25.3,1781.8,15,0,1,6,7,9,1,1,0,0,16675,6.8,17379,215,44,-1143,-648,25.9,1667.5
4753088553,1,13,2,0,3,2,1,0,0,0,0,15696,6.8,18512,216,56,753,219,27.2,1569.6,12,0,1,2,3,2,0,0,0,0,14943,7.2,18293,206,72,-753,-219,27.8,1494.3
4753069826,0,8,1,1,4,7,1,0,0,0,0,15439,7.0,18568,235,56,-1993,-659,29.1,1543.9,11,2,0,7,4,7,1,1,0,0,17432,7.2,19227,213,48,1993,659,26.1,1743.2
4752917322,1,22,0,0,5,4,5,0,0,0,0,16716,7.0,18132,215,60,697,73,27.5,1671.6,11,1,1,4,5,2,0,0,0,0,16019,7.2,18059,215,60,-697,-73,27.5,1601.9
4752863822,0,20,2,1,6,5,6,1,0,1,0,17369,6.6,17663,200,64,1400,835,26.4,1736.9,15,3,0,5,6,6,0,0,0,0,15969,6.8,16828,206,48,-1400,-835,25.4,1596.9
4750268892,1,21,9,1,5,1,2,1,1,0,0,16603,7.4,19387,221,55,2196,1510,27.6,1660.3,32,0,0,1,5,3,0,0,0,0,14407,6.8,17877,204,64,-2196,-1510,26.8,1440.7
4750234077,1,67,1,0,4,9,2,1,1,0,0,17239,7.0,18304,222,59,547,1186,28.1,1723.9,10,2,1,9,4,7,0,0,0,0,16692,6.6,17118,208,44,-547,-1186,25.2,1669.2
4750168565,0,94,9,1,5,9,2,0,0,0,0,15625,6.6,16842,191,39,-2605,-999,23.0,1562.5,37,1,0,9,5,8,1,1,0,0,18230,7.0,17841,201,56,2605,999,25.7,1823.0
4750148169,1,19,0,1,7,1,5,0,0,0,0,19334,7.4,19337,196,59,6278,4452,25.5,1933.4,9,2,0,1,7,1,1,1,0,0,13056,6.2,14885,155,60,-6278,-4452,21.5,1305.6
4750116493,1,11,1,0,7,4,4,1,1,0,0,18120,7.2,19195,251,54,2779,2409,30.5,1812.0,9,2,1,4,7,5,0,0,0,0,15341,6.6,16786,220,36,-2779,-2409,25.6,1534.1
4750002849,0,15,1,0,3,6,6,0,0,0,0,14892,7.0,18114,220,48,-2188,-412,26.8,1489.2,28,1,1,6,3,7,1,1,0,0,17080,7.2,18526,237,56,2188,412,29.3,1708.0
4749913072,1,15,0,1,8,3,8,0,0,0,0,18218,7.2,18888,215,76,2414,688,29.1,1821.8,16,1,0,3,8,2,1,0,1,0,15804,7.0,18200,210,60,-2414,-688,27.0,1580.4
4749889558,0,12,2,1,3,10,1,0,0,0,0,15072,6.6,16823,214,52,-3719,-1320,26.6,1507.2,15,2,0,10,3,11,1,1,0,0,18791,7.0,18143,184,80,3719,1320,26.4,1879.1
4749860940,0,22,0,1,11,7,14,0,0,0,0,19166,6.8,16886,170,52,1989,-155,22.2,1916.6,13,1,0,7,11,6,2,1,1,0,17177,6.6,17041,173,68,-1989,155,24.1,1717.7
4749347023,0,21,0,0,3,8,1,0,0,0,0,14305,6.6,17117,188,50,-3053,-311,23.8,1430.5,13,2,1,8,3,12,0,0,0,0,17358,6.8,17428,206,58,3053,311,26.4,1735.8
4749310240,0,13,0,0,5,6,3,0,0,0,0,16149,7.2,18445,195,60,-1155,379,25.5,1614.9,8,2,1,6,5,5,1,0,1,0,17304,7.0,18066,207,56,1155,-379,26.3,1730.4
4749278231,0,12,1,0,2,6,0,0,0,0,0,14308,6.8,17003,202,62,-4373,-1880,26.4,1430.8,13,2,1,6,2,8,0,0,0,0,18681,7.2,18883,226,56,4373,1880,28.2,1868.1
4749244433,1,85,1,1,7,4,5,0,0,0,0,20066,7.4,19888,230,68,4536,2338,29.8,2006.6,192,1,0,4,7,4,1,1,0,0,15530,7.0,17550,178,52,-4536,-2338,23.0,1553.0
4852419617,0,12,0,1,4,9,3,0,0,0,0,13820,6.2,15115,197,0,-3821,-4711,19.7,1382.0,29,0,0,8,3,3,2,1,1,0,17641,7.4,19826,231,63,3821,4711,29.4,1764.1
4852397548,1,13,1,1,6,2,5,0,0,0,0,16820,7.2,18446,230,60,2145,-318,29.0,1682.0,8,1,0,2,6,2,0,0,0,0,14675,7.2,18764,197,68,-2145,318,26.5,1467.5
4852350856,1,15,1,0,6,7,6,0,0,0,0,17149,7.0,17643,202,42,664,765,24.4,1714.9,78,3,1,7,6,3,0,0,0,0,16485,6.6,16878,185,56,-664,-765,24.1,1648.5
4852329752,1,20,1,0,3,3,1,1,1,0,0,14727,7.0,17970,200,65,-774,-686,26.5,1472.7,13,2,1,3,3,0,0,0,0,0,15501,7.0,18656,217,60,774,686,27.7,1550.1
4852287192,1,12,3,1,1,3,1,0,0,0,0,14246,6.6,16302,175,43,-1740,-1884,21.8,1424.6,10,3,0,3,1,3,0,0,0,0,15986,7.0,18186,221,46,1740,1884,26.7,1598.6
4852268226,1,100,2,1,7,1,5,0,0,0,0,17458,6.8,18042,216,52,3819,667,26.8,1745.8,13,15,0,1,7,0,0,0,0,0,13639,6.8,17375,172,66,-3819,-667,23.8,1363.9
4849621637,1,13,1,1,4,0,7,1,1,0,0,15981,7.0,18235,202,48,1968,600,25.0,1598.1,16,0,0,0,4,0,1,0,1,0,14013,6.8,17635,191,56,-1968,-600,24.7,1401.3
4849596652,0,19,12,0,3,5,3,0,0,0,0,15108,7.0,17761,177,68,-1711,-1500,24.5,1510.8,87,3,1,5,3,3,1,1,0,0,16819,7.2,19261,242,68,1711,1500,31.0,1681.9
4849468784,0,66,1,0,1,6,1,0,0,0,0,14315,6.8,17167,166,68,-2014,-746,23.4,1431.5,14,1,1,6,1,3,1,1,0,0,16329,6.8,17913,205,52,2014,746,25.7,1632.9
4849450379,1,14,1,1,8,3,6,0,0,0,0,16873,7.0,17161,204,48,2230,-902,25.2,1687.3,24,0,0,3,8,1,0,0,0,0,14643,7.0,18063,169,68,-2230,902,23.7,1464.3
4848726325,1,23,0,1,4,2,5,1,0,1,0,15390,6.8,16679,191,57,1778,-706,24.8,1539.0,13,0,0,2,4,3,1,1,0,0,13612,7.0,17385,168,44,-1778,706,21.2,1361.2
4848694701,1,17,1,0,2,2,2,0,0,0,0,14873,6.6,16914,191,40,-408,-651,23.1,1487.3,97,1,1,2,2,3,0,0,0,0,15281,7.0,17565,207,48,408,651,25.5,1528.1
4845543881,1,125,1,1,5,2,6,1,1,0,0,15990,7.2,18322,160,68,1638,1632,22.8,1599.0,206,1,0,2,5,1,0,0,0,0,14352,6.4,16690,186,64,-1638,-1632,25.0,1435.2
4844899891,1,8,0,1,3,1,3,0,0,0,0,15819,6.8,18344,188,56,2150,1766,24.4,1581.9,12,1,0,1,3,1,0,0,0,0,13669,6.6,16578,198,48,-2150,-1766,24.6,1366.9
4844802941,0,8,1,0,2,6,0,0,0,0,0,14371,6.6,15783,173,64,-1904,-2019,23.7,1437.1,10,2,1,6,2,4,1,1,0,0,16275,6.8,17802,212,56,1904,2019,26.8,1627.5
4844780201,0,11,1,0,2,5,3,1,0,1,0,14538,6.8,18180,204,48,-1745,76,25.2,1453.8,15,1,1,5,2,5,0,0,0,0,16283,6.8,18104,244,48,1745,-76,29.2,1628.3
4844756864,1,14,0,1,5,7,6,0,0,0,0,17900,7.2,18379,242,52,1113,1481,29.4,1790.0,13,3,0,7,5,7,0,0,0,0,16787,6.6,16898,213,46,-1113,-1481,25.9,1678.7
4844633178,1,12,2,0,0,3,0,1,1,0,0,13997,6.8,17419,211,48,-962,-382,25.9,1399.7,13,2,1,3,0,1,0,0,0,0,14959,6.8,17801,222,56,962,382,27.8,1495.9
4844628815,0,12,0,0,3,9,0,0,0,0,0,14160,6.8,17140,177,60,-4756,-2916,23.7,1416.0,12,2,1,9,3,4,1,1,0,0,18916,7.4,20056,211,64,4756,2916,27.5,1891.6
4808212135,1,16,0,0,9,5,11,0,0,0,0,17255,6.6,16990,185,42,1879,666,22.7,1725.5,8,1,1,5,9,7,0,0,0,0,15376,6.6,16324,179,58,-1879,-666,23.7,1537.6
4808174762,1,16,1,0,3,1,3,0,0,0,0,16634,7.0,19209,240,48,2559,1676,28.8,1663.4,10,0,1,1,3,0,1,1,0,0,14075,6.8,17533,211,52,-2559,-1676,26.3,1407.5
4808127334,0,17,2,0,7,10,7,0,0,0,0,16805,6.6,16390,176,56,-2844,-2461,23.2,1680.5,10,1,1,10,7,8,0,0,0,0,19649,7.0,18851,249,52,2844,2461,30.1,1964.9
4796121635,0,213,0,0,17,28,43,0,0,0,0,36280,10.8,38598,127,0,-2008,-3206,12.7,3628.0,0,0,1,28,17,88,0,0,0,0,38288,11.4,41804,103,0,2008,3206,10.3,3828.8
4796075251,1,0,2,0,30,31,66,0,0,0,1,39042,11.6,44042,63,0,-1432,-715,6.3,3904.2,11,0,1,31,30,57,0,0,0,0,40474,11.6,44757,115,0,1432,715,11.5,4047.4
4771527445,1,13,1,1,8,13,12,0,0,0,0,17591,6.6,16582,182,43,-3427,-3060,22.5,1759.1,15,1,0,13,8,11,1,1,0,0,21018,7.4,19642,202,64,3427,3060,26.6,2101.8
4771490793,0,9,5,0,4,4,4,0,0,0,0,15770,7.0,18452,197,60,563,1926,25.7,1577.0,14,2,1,4,4,1,0,0,0,0,15207,6.6,16526,184,42,-563,-1926,22.6,1520.7
4765445546,1,42,3,1,5,2,2,1,1,0,0,16839,6.8,18078,234,44,1637,1061,27.8,1683.9,14,15,0,2,5,3,0,0,0,0,15202,6.8,17017,194,50,-1637,-1061,24.4,1520.2
4764960547,1,12,1,0,2,3,2,0,0,0,0,15958,7.4,18741,252,56,842,1597,30.8,1595.8,68,2,1,3,2,2,1,1,0,0,15116,6.8,17144,220,52,-842,-1597,27.2,1511.6
4764488472,0,8,0,0,2,7,2,0,0,0,0,13939,6.6,16357,184,64,-3412,-3310,24.8,1393.9,12,0,1,7,2,2,0,0,0,0,17351,7.2,19667,226,64,3412,3310,29.0,1735.1
4763805658,1,13,1,1,6,7,3,1,1,0,0,16952,6.8,17746,232,52,-18,570,28.4,1695.2,16,0,0,7,6,5,0,0,0,0,16970,6.8,17176,176,71,18,-570,24.7,1697.0
4763770429,0,15,0,0,10,13,8,0,0,0,0,18644,7.0,17897,206,56,-2810,-208,26.2,1864.4,10,1,1,13,10,13,0,0,0,0,21454,7.0,18105,236,47,2810,208,28.3,2145.4
4760622792,1,67,2,0,9,12,7,0,0,0,0,18502,6.8,16688,180,44,-361,-1030,22.4,1850.2,11,2,1,12,9,8,1,1,0,0,18863,6.8,17718,206,55,361,1030,26.1,1886.3
4752014197,0,48,0,0,21,30,56,0,0,0,1,36765,11.4,41911,77,0,-1531,-477,7.7,3676.5,58,2,1,30,21,88,0,0,0,0,38296,11.4,42388,91,0,1531,477,9.1,3829.6
4748344348,1,11,0,0,4,2,2,1,1,0,0,15872,7.0,17753,225,60,1225,152,28.5,1587.2,11,0,1,2,4,0,0,0,0,0,14647,6.6,17601,204,60,-1225,-152,26.4,1464.7
4747420871,1,10,2,0,5,4,5,0,0,0,0,15745,6.8,17429,213,52,290,-282,26.5,1574.5,13,0,1,4,5,6,0,0,0,0,15455,6.6,17711,199,48,-290,282,24.7,1545.5
4747373319,0,9,0,0,0,5,0,0,0,0,0,13676,6.6,16873,224,56,-3005,-2434,28.0,1367.6,9,1,1,5,0,8,1,1,0,0,16681,7.2,19307,219,80,3005,2434,29.9,1668.1
4746560062,0,7,2,1,7,6,4,1,1,0,0,16660,6.6,16952,186,52,816,-649,23.8,1666.0,8,1,0,6,7,2,0,0,0,0,15844,6.8,17601,209,42,-816,649,25.1,1584.4
4746513024,0,12,3,0,7,6,8,0,0,0,0,17572,6.8,17344,220,56,324,-453,27.6,1757.2,12,1,1,6,7,8,0,0,0,0,17248,6.8,17797,225,63,-324,453,28.8,1724.8
4746464756,0,13,0,1,9,6,11,0,0,0,0,17632,7.2,18570,199,52,1214,415,25.1,1763.2,7,0,0,6,9,5,0,0,0,0,16418,7.0,18155,212,72,-1214,-415,28.4,1641.8
4854687160,1,5,0,1,21,19,19,0,0,0,0,64100,12.0,55000,0,0,26900,22000,0.0,6410.0,0,0,0,9,11,13,0,0,0,0,37200,7.2,33000,0,0,-26900,-22000,0.0,3720.0
4854669463,1,0,0,1,19,12,21,0,0,0,0,62350,12.0,55000,0,0,27600,22000,0.0,6235.0,0,0,0,6,13,3,0,0,0,0,34750,7.2,33000,0,0,-27600,-22000,0.0,3475.0
4854651322,1,0,3,0,16,14,18,0,0,0,0,46665,10.2,48680,0,0,19465,20180,0.0,4666.5,23,0,1,9,11,8,0,0,0,0,27200,6.0,28500,2,0,-19465,-20180,0.2,2720.0
4854631050,1,5,0,1,14,14,14,0,0,0,0,45710,10.0,47500,2,0,16810,19000,0.2,4571.0,86,0,0,11,11,11,0,0,0,0,28900,6.0,28500,0,0,-16810,-19000,0.0,2890.0
4854613253,1,3,0,1,20,14,21,0,0,0,0,49100,10.0,47500,0,0,18100,19000,0.0,4910.0,0,0,0,8,14,10,0,0,0,0,31000,6.0,28500,0,0,-18100,-19000,0.0,3100.0
4854603961,1,1,0,1,18,19,15,0,0,0,0,52762,12.0,55000,0,0,21305,22000,0.0,5276.2,231,0,0,8,7,11,0,0,0,0,31457,7.2,33000,0,0,-21305,-22000,0.0,3145.7
4854058426,0,0,0,1,26,25,63,0,0,0,0,38040,11.4,42818,107,0,224,2126,10.7,3804.0,0,0,0,25,26,55,0,0,0,0,37816,11.2,40692,85,0,-224,-2126,8.5,3781.6
4854026470,0,16,0,1,35,29,96,0,0,0,2,41805,12.0,45644,115,0,3870,3199,11.5,4180.5,0,1,0,29,35,57,0,0,0,0,37935,11.4,42445,91,0,-3870,-3199,9.1,3793.5
4853991569,1,0,0,0,20,23,37,0,0,0,0,35055,10.8,38246,98,0,-1763,-3281,9.8,3505.5,0,0,1,23,20,56,0,0,0,0,36818,11.0,41527,112,0,1763,3281,11.2,3681.8
4853973807,0,4,0,0,23,31,52,0,0,0,1,37397,11.2,41670,93,0,-4198,-3091,9.3,3739.7,0,0,1,31,23,93,0,0,0,0,41595,11.8,44761,104,0,4198,3091,10.4,4159.5
4853914055,1,7,1,0,3,3,2,1,0,1,0,14823,6.8,17621,217,51,-703,-333,26.8,1482.3,18,3,1,3,3,4,1,1,0,0,15526,6.8,17954,236,52,703,333,28.8,1552.6
4853879454,0,15,2,0,2,4,0,0,0,0,0,13875,6.8,17162,174,52,-3103,-1344,22.6,1387.5,14,3,1,4,2,2,1,1,0,0,16978,7.0,18506,213,60,3103,1344,27.3,1697.8
4853805401,0,12,0,0,3,3,2,0,0,0,0,15316,6.8,17989,222,52,689,-480,27.4,1531.6,11,2,1,3,3,4,1,1,0,0,14627,7.0,18469,185,44,-689,480,22.9,1462.7
4853751846,1,14,2,1,5,7,3,0,0,0,0,15467,6.6,16421,162,56,-783,-680,21.8,1546.7,14,1,0,7,5,2,1,1,0,0,16250,6.8,17101,182,52,783,680,23.4,1625.0
4853729680,1,0,0,1,15,20,25,0,0,0,0,61300,12.6,59500,0,0,22700,22000,0.0,6130.0,6,0,0,15,10,12,0,0,0,0,38600,7.8,37500,0,0,-22700,-22000,0.0,3860.0
4853709640,1,42,0,1,23,17,20,0,0,0,0,64130,12.0,55000,0,0,26218,22000,0.0,6413.0,69,0,0,9,15,10,0,0,0,0,37912,7.2,33000,0,0,-26218,-22000,0.0,3791.2
4852758407,1,12,0,0,2,5,1,0,0,0,0,14511,6.4,16649,173,52,-255,189,22.5,1451.1,8,0,1,5,2,4,1,1,0,0,14766,6.6,16460,169,47,255,-189,21.6,1476.6
4852706595,0,7,2,0,7,6,6,0,0,0,0,16290,7.4,19190,182,51,531,899,23.3,1629.0,195,1,1,6,7,3,1,1,0,0,15759,6.8,18291,185,54,-531,-899,23.9,1575.9
4852652619,0,20,0,1,2,2,2,0,0,0,1,13535,6.6,16374,164,55,-2182,-1938,21.9,1353.5,12,1,0,2,2,0,1,0,1,0,15717,7.0,18312,219,60,2182,1938,27.9,1571.7
4852614472,1,5,0,1,19,18,16,0,0,0,0,46050,10.0,47500,2,0,17468,19000,0.2,4605.0,0,0,0,9,10,15,0,0,0,0,28582,6.0,28500,0,0,-17468,-19000,0.0,2858.2
4842939540,0,8,2,1,3,11,3,0,0,0,0,16036,6.8,17337,202,62,-3632,-2216,26.4,1603.6,13,0,0,11,3,8,1,1,0,0,19668,7.0,19553,218,54,3632,2216,27.2,1966.8
4842929794,0,21,0,1,3,7,1,1,1,0,0,15038,7.0,17546,211,56,-3744,-2063,26.7,1503.8,46,0,0,7,3,9,0,0,0,0,18782,7.2,19609,229,60,3744,2063,28.9,1878.2
4811081356,1,39,2,1,8,4,10,0,0,0,0,17660,6.8,17193,214,53,2411,200,26.7,1766.0,14,13,0,4,8,2,0,0,0,0,15249,6.8,16993,197,54,-2411,-200,25.1,1524.9
4811030592,1,13,1,1,6,3,2,0,0,0,0,15186,7.0,18368,199,64,-331,2,26.3,1518.6,10,1,0,3,6,1,0,0,0,0,15517,6.8,18366,229,56,331,-2,28.5,1551.7
4811007305,1,14,1,1,8,3,5,0,0,0,0,17190,7.0,18634,229,54,2425,1094,28.3,1719.0,16,2,0,3,8,2,0,0,0,0,14765,6.8,17540,197,73,-2425,-1094,27.0,1476.5
4797688674,0,12,0,0,6,8,2,0,0,0,0,16666,7.2,17451,203,60,-1091,-70,26.3,1666.6,9,2,1,8,6,11,0,0,0,0,17757,6.8,17521,193,44,1091,70,23.7,1775.7
4791270652,1,120,6,1,10,4,5,1,1,0,1,18654,7.4,19789,222,64,2552,3573,28.6,1865.4,34,1,0,4,10,3,0,0,0,0,16102,6.4,16216,187,52,-2552,-3573,23.9,1610.2
4617255605,0,17,0,0,1,5,0,0,0,0,0,14317,6.6,16539,209,48,-1059,-432,25.7,1431.7,10,2,1,5,1,6,1,1,0,0,15376,7.0,16971,202,58,1059,432,26.0,1537.6
4608734716,1,12,1,0,5,3,7,0,0,0,0,17022,6.8,16809,176,56,2152,49,23.2,1702.2,13,2,1,3,5,0,0,0,0,0,14870,6.8,16760,220,44,-2152,-49,26.4,1487.0
4499779058,1,14,0,1,5,3,4,1,0,1,0,18699,7.4,20386,203,60,3021,1307,26.3,1869.9,11,0,0,3,5,2,1,1,0,0,15678,7.2,19079,228,64,-3021,-1307,29.2,1567.8
4485940569,0,14,1,0,3,2,1,0,0,0,0,15984,7.2,19190,233,67,1193,925,30.0,1598.4,45,0,1,2,3,1,0,0,0,0,14791,7.2,18265,226,72,-1193,-925,29.8,1479.1
4485924352,1,10,0,1,8,6,8,0,0,0,0,18286,7.2,18598,193,56,2076,455,24.9,1828.6,9,1,0,6,8,1,0,0,0,0,16210,6.8,18143,179,52,-2076,-455,23.1,1621.0
4484520866,0,11,0,1,7,8,4,0,0,0,0,16664,6.8,17481,195,56,-396,-796,25.1,1666.4,14,0,0,8,7,4,1,1,0,0,17060,7.2,18277,200,46,396,796,24.6,1706.0
4484497070,0,12,3,1,3,3,1,0,0,0,0,14142,6.4,15971,191,26,-1613,-2043,21.7,1414.2,12,3,0,3,3,3,0,0,0,0,15755,6.8,18014,190,67,1613,2043,25.7,1575.5
4483937455,1,13,0,1,8,8,8,0,0,0,0,17765,6.6,17461,174,62,856,645,23.6,1776.5,327,1,0,8,8,9,0,0,0,0,16909,6.6,16816,160,36,-856,-645,19.6,1690.9
4483909580,0,14,0,0,6,14,5,0,0,0,0,16614,6.8,16932,192,56,-2980,-2390,24.8,1661.4,11,1,1,14,6,13,0,0,0,0,19594,7.0,19322,177,64,2980,2390,24.1,1959.4
4481650159,0,12,2,0,3,8,0,0,0,0,0,14763,6.8,16892,192,52,-4591,-2111,24.4,1476.3,12,4,1,8,3,4,1,1,0,0,19354,7.2,19003,220,40,4591,2111,26.0,1935.4
4481620224,1,21,1,1,5,8,7,0,0,0,0,17331,6.6,16307,179,55,-830,-2113,23.4,1733.1,14,4,0,8,5,5,0,0,0,0,18161,7.0,18420,215,40,830,2113,25.5,1816.1
4481593892,0,18,2,1,4,3,4,1,1,0,0,15980,7.0,18094,233,64,1553,515,29.7,1598.0,11,2,0,3,4,5,0,0,0,0,14427,6.8,17579,182,52,-1553,-515,23.4,1442.7
4857459286,1,0,0,1,16,16,21,0,0,0,0,45950,10.0,47500,0,0,18100,19000,0.0,4595.0,0,0,0,10,10,7,0,0,0,0,27850,6.0,28500,0,0,-18100,-19000,0.0,2785.0
4857432579,1,5,0,0,21,19,21,0,0,0,0,63750,12.0,55000,0,0,26200,22000,0.0,6375.0,21,0,1,8,10,11,0,0,0,0,37550,7.2,33000,0,0,-26200,-22000,0.0,3755.0
4857411423,1,34,1,1,27,15,27,0,0,0,0,65065,13.0,62500,11,0,29255,28000,1.1,6506.5,0,2,0,5,17,6,0,0,0,0,35810,7.4,34500,0,0,-29255,-28000,0.0,3581.0
4857393991,1,0,0,1,29,17,21,0,0,0,0,62700,13.0,62500,0,0,26200,28000,0.0,6270.0,0,0,0,5,17,11,0,0,0,0,36500,7.4,34500,0,0,-26200,-28000,0.0,3650.0
4857289715,1,363,0,1,19,15,22,0,0,0,0,52282,10.0,47500,0,0,25808,19000,0.0,5228.2,0,0,0,8,12,5,0,0,0,0,26474,6.0,28500,0,0,-25808,-19000,0.0,2647.4
4857267389,1,0,0,0,11,20,15,0,0,0,0,61400,12.0,55000,2,0,23410,22000,0.2,6140.0,0,0,1,14,5,11,0,0,0,0,37990,7.2,33000,2,0,-23410,-22000,0.2,3799.0
4856333754,1,81,0,1,13,18,16,0,0,0,0,45688,10.0,47500,0,0,18176,19000,0.0,4568.8,4,0,0,12,7,9,0,0,0,0,27512,6.0,28500,0,0,-18176,-19000,0.0,2751.2
4856288570,0,9,1,1,1,3,2,0,0,0,0,13788,7.0,17272,196,55,-2953,-1719,25.1,1378.8,67,2,0,3,1,8,1,1,0,0,16741,7.0,18991,210,76,2953,1719,28.6,1674.1
4856245783,0,8,0,1,5,5,2,0,0,0,0,16068,7.0,18217,235,56,-386,-619,29.1,1606.8,9,0,0,4,4,4,0,0,0,0,16454,7.2,18836,210,51,386,619,26.1,1645.4
4855492880,0,12,3,0,6,3,2,0,0,0,0,15857,6.6,16960,193,48,433,-522,24.1,1585.7,23,1,1,3,6,2,1,1,0,0,15424,6.8,17482,209,52,-433,522,26.1,1542.4
4855267154,1,11,0,0,8,8,10,0,0,0,0,17790,6.8,17865,190,36,546,-510,22.6,1779.0,10,1,1,8,8,5,1,1,0,0,17244,6.8,18375,200,58,-546,510,25.8,1724.4
4855073622,0,180,2,1,7,15,7,0,0,0,0,15735,6.8,16489,171,44,-4028,-1664,21.5,1573.5,10,1,0,14,6,15,0,0,0,0,19763,7.2,18153,206,56,4028,1664,26.2,1976.3
4854928603,1,15,6,0,7,4,5,1,1,0,0,16927,6.8,18051,223,48,465,482,27.1,1692.7,28,0,1,4,7,3,1,0,1,0,16462,7.0,17569,188,66,-465,-482,25.4,1646.2
4854899884,1,9,1,1,8,4,9,0,0,0,0,18040,7.0,18783,255,56,3195,2192,31.1,1804.0,9,0,0,4,8,5,0,0,0,0,14845,6.6,16591,189,55,-3195,-2192,24.4,1484.5
4854343026,0,17,1,1,8,7,5,1,1,0,0,16366,6.6,16642,208,68,-187,-107,27.6,1636.6,14,0,0,7,8,6,0,0,0,0,16553,6.8,16749,177,59,187,107,23.6,1655.3
4854296183,0,11,0,0,2,2,2,0,0,0,0,14429,7.0,17997,200,44,-2203,-1579,24.4,1442.9,15,1,1,2,2,2,1,1,0,0,16632,7.2,19576,246,72,2203,1579,31.8,1663.2
4854097929,1,0,0,1,19,22,15,0,0,0,0,62000,12.6,59500,0,0,23352,22000,0.0,6200.0,0,0,0,13,10,15,0,0,0,0,38648,7.8,37500,0,0,-23352,-22000,0.0,3864.8
4854061119,1,1,0,0,18,14,21,0,0,0,0,63050,12.2,56000,0,0,26900,23000,0.0,6305.0,0,0,1,5,9,8,0,0,0,0,36150,7.2,33000,0,0,-26900,-23000,0.0,3615.0
4854040829,1,0,0,1,15,22,20,0,0,0,0,63050,13.0,62500,0,0,22816,25000,0.0,6305.0,0,0,0,18,11,14,0,0,0,0,40234,7.8,37500,0,0,-22816,-25000,0.0,4023.4
4832244755,0,63,3,1,7,5,11,0,0,0,0,17057,6.6,16572,192,25,1431,-506,21.7,1705.7,13,1,0,5,7,3,0,0,0,0,15626,6.8,17078,200,51,-1431,506,25.1,1562.6
4832208805,1,189,7,0,7,6,6,2,1,1,0,17106,6.4,16249,192,52,189,-329,24.4,1710.6,35,2,1,6,7,9,0,0,0,0,16917,6.6,16578,194,60,-189,329,25.4,1691.7
4829736115,1,0,0,1,30,28,80,0,0,0,1,40630,11.8,45562,107,0,2082,1689,10.7,4063.0,6,0,0,28,30,65,0,0,0,0,38548,11.8,43873,88,0,-2082,-1689,8.8,3854.8
4829267190,1,17,3,1,6,9,4,0,0,0,0,17562,7.2,18604,251,46,427,1270,29.7,1756.2,16,1,0,9,6,9,0,0,0,0,17135,6.8,17334,169,56,-427,-1270,22.5,1713.5
4829216693,0,11,1,0,8,11,7,0,0,0,0,17850,7.2,18288,229,47,-2278,-1368,27.6,1785.0,10,1,1,11,8,12,1,1,0,0,20128,7.4,19656,227,72,2278,1368,29.9,2012.8
4829205509,0,16,2,0,1,9,1,0,0,0,0,14391,6.4,16134,203,52,-5206,-3856,25.5,1439.1,13,4,1,9,1,13,0,0,0,0,19597,7.2,19990,260,76,5206,3856,33.6,1959.7
4828961221,0,8,2,1,7,8,5,0,0,0,0,16622,6.8,18167,211,60,-337,459,27.1,1662.2,13,0,0,8,7,8,1,1,0,0,16959,7.0,17708,189,64,337,-459,25.3,1695.9
4822836058,0,0,2,0,21,28,56,0,0,0,0,35271,10.8,38913,83,0,-3538,-3599,8.3,3527.1,14,0,1,28,21,72,0,0,0,0,38809,11.4,42512,105,0,3538,3599,10.5,3880.9
4811432895,1,0,0,0,21,13,52,0,0,0,0,36082,10.8,37952,102,0,2794,2422,10.2,3608.2,0,0,1,13,21,39,0,0,0,0,33288,10.2,35530,105,0,-2794,-2422,10.5,3328.8
4811410244,1,0,1,1,22,17,54,0,0,0,0,37326,11.0,40378,119,0,3808,4301,11.9,3732.6,18,0,0,16,21,36,0,0,0,0,33518,10.4,36077,81,0,-3808,-4301,8.1,3351.8
4811386763,0,0,2,1,17,15,40,0,0,0,1,34600,10.8,38074,107,0,-399,2656,10.7,3460.0,15,0,0,15,17,35,0,0,0,0,34999,10.4,35418,106,0,399,-2656,10.6,3499.9
4774374649,0,0,0,0,23,23,51,0,0,0,2,35678,10.8,38152,103,0,-1902,-3681,10.3,3567.8,0,0,1,23,23,66,0,0,0,0,37580,11.4,41833,111,0,1902,3681,11.1,3758.0
4774347594,1,0,0,0,28,26,64,0,0,0,0,38341,11.8,43869,108,0,1076,304,10.8,3834.1,0,0,1,26,28,51,0,0,0,0,37265,11.6,43565,99,0,-1076,-304,9.9,3726.5
4774329870,0,90,0,0,10,25,12,0,0,0,0,34656,10.8,38015,82,0,-1288,-1375,8.2,3465.6,0,0,1,25,10,51,0,0,0,0,35944,10.8,39390,104,0,1288,1375,10.4,3594.4
4774297501,1,0,0,1,22,18,46,0,0,0,1,37142,10.8,39700,113,0,1665,304,11.3,3714.2,201,0,0,18,22,45,0,0,0,0,35477,10.8,39396,76,0,-1665,-304,7.6,3547.7
4774273438,1,0,0,0,27,18,60,0,0,0,0,38437,11.6,42753,94,0,2928,5567,9.4,3843.7,0,0,1,17,26,41,0,0,0,0,35509,10.4,37186,100,0,-2928,-5567,10.0,3550.9
4774255287,1,19,0,1,37,23,104,0,0,0,1,40351,11.8,45461,102,0,3795,4559,10.2,4035.1,0,1,0,23,37,58,0,0,0,0,36556,11.4,40902,87,0,-3795,-4559,8.7,3655.6
4794174092,0,14,3,0,4,6,5,1,0,1,0,16235,6.8,17389,227,52,-336,545,27.9,1623.5,13,2,1,6,4,9,1,1,0,0,16571,6.6,16844,201,66,336,-545,26.7,1657.1
4794143547,0,9,4,0,5,12,5,0,0,0,0,15184,6.6,16246,183,44,-3530,-2133,22.7,1518.4,28,3,1,12,5,10,1,1,0,0,18714,7.0,18379,196,59,3530,2133,25.5,1871.4
4785273067,1,15,1,1,5,7,8,0,0,0,0,15597,6.6,16525,180,55,-1468,-1522,23.5,1559.7,17,2,0,7,5,5,1,1,0,0,17065,6.8,18047,228,52,1468,1522,28.0,1706.5
4785230172,0,12,5,0,9,15,10,0,0,0,0,18494,6.8,17499,218,44,-1409,53,26.2,1849.4,18,4,1,15,9,25,1,1,0,0,19903,6.8,17446,203,52,1409,-53,25.5,1990.3
4785133870,1,19,1,0,5,9,7,0,0,0,0,16003,7.0,17564,208,64,-2230,-957,27.2,1600.3,16,4,1,9,5,9,0,0,0,0,18233,7.2,18521,225,48,2230,957,27.3,1823.3
4781642707,0,12,20,0,3,10,0,0,0,0,0,15345,7.0,18128,206,64,-2440,31,27.0,1534.5,34,2,1,9,2,12,0,0,0,0,17785,7.0,18097,200,36,2440,-31,23.6,1778.5
4781603436,0,10,0,0,1,2,1,0,0,0,0,14280,7.0,18648,205,52,-2046,-292,25.7,1428.0,11,1,1,2,1,6,1,1,0,0,16326,7.2,18940,241,76,2046,292,31.7,1632.6
4781532511,1,52,2,0,3,6,2,0,0,0,0,15856,6.8,18485,192,64,-790,2194,25.6,1585.6,15,0,1,6,3,4,0,0,0,0,16646,6.6,16291,215,48,790,-2194,26.3,1664.6
4781508122,0,19,0,1,6,7,4,1,1,0,0,16150,7.0,17719,176,60,-593,-326,23.6,1615.0,9,1,0,7,6,5,0,0,0,0,16743,7.2,18045,201,56,593,326,25.7,1674.3
4781454357,1,21,0,0,4,3,3,0,0,0,0,16536,6.8,18253,218,55,1835,1463,27.3,1653.6,12,0,1,3,4,2,0,0,0,0,14701,6.6,16790,201,48,-1835,-1463,24.9,1470.1
4781423200,1,38,5,1,8,4,6,1,1,0,0,18342,7.2,19313,228,60,3218,2554,28.8,1834.2,13,9,0,4,8,3,0,0,0,0,15124,6.4,16759,213,56,-3218,-2554,26.9,1512.4
4775317296,0,84,2,1,6,7,2,0,0,0,0,14674,6.6,15811,154,57,-2376,-1947,21.1,1467.4,15,2,0,6,5,8,0,0,0,0,17050,7.0,17758,218,52,2376,1947,27.0,1705.0
4775277303,1,9,0,1,15,3,19,1,1,0,0,20278,7.2,18428,208,60,5272,2619,26.8,2027.8,21,0,0,3,15,1,0,0,0,0,15006,6.4,15809,148,44,-5272,-2619,19.2,1500.6
4775240522,1,15,0,1,8,0,10,1,1,0,0,17386,6.0,15195,171,52,3506,-1820,22.3,1738.6,10,2,0,0,8,0,0,0,0,0,13880,6.4,17015,229,60,-3506,1820,28.9,1388.0
4775198021,1,13,0,1,10,8,11,1,1,0,0,18196,6.6,16551,180,58,33,-1888,23.8,1819.6,10,0,0,8,10,8,0,0,0,0,18163,7.2,18439,197,46,-33,1888,24.3,1816.3
4590161014,1,0,2,1,36,33,79,0,0,0,1,42955,11.8,46153,122,0,5436,3171,12.2,4295.5,14,0,0,33,36,87,0,0,0,0,37519,11.6,42982,93,0,-5436,-3171,9.3,3751.9
4569722143,0,189,1,1,7,7,5,0,0,0,0,16318,6.8,17234,161,42,448,-220,20.3,1631.8,9,1,0,7,7,6,1,1,0,0,15870,6.6,17454,203,44,-448,220,24.7,1587.0
4569696768,1,10,6,1,4,4,7,1,0,1,0,15315,6.8,17505,195,52,-1157,-609,24.7,1531.5,16,0,0,4,4,4,1,1,0,0,16472,6.8,18114,214,68,1157,609,28.2,1647.2
4856119602,1,126,0,1,24,27,72,0,0,0,2,39354,11.4,42005,114,0,1054,2097,11.4,3935.4,0,0,0,27,24,85,0,0,0,0,38300,11.0,39908,102,0,-1054,-2097,10.2,3830.0
4856085669,1,0,2,0,17,27,38,0,0,0,1,34666,10.8,37886,103,0,-2555,-2426,10.3,3466.6,8,0,1,27,17,61,0,0,0,0,37221,11.2,40312,112,0,2555,2426,11.2,3722.1
4855070203,0,0,0,0,25,36,63,0,0,0,1,37744,11.2,42803,92,0,-3374,-3101,9.2,3774.4,0,0,1,36,25,100,0,0,0,0,41118,12.0,45904,122,0,3374,3101,12.2,4111.8
4855037695,0,0,0,0,8,18,26,0,0,0,0,31637,10.0,32981,107,0,-5322,-5392,10.7,3163.7,0,0,1,18,8,55,0,0,0,0,36959,11.0,38373,110,0,5322,5392,11.0,3695.9
4855005685,0,0,0,1,25,31,79,0,0,0,0,37272,10.8,39254,106,0,-3003,-4805,10.6,3727.2,0,0,0,31,25,94,0,0,0,0,40275,11.8,44059,99,0,3003,4805,9.9,4027.5
4847824139,1,14,2,1,11,9,17,0,0,0,0,19760,6.8,17933,197,48,2384,1489,24.5,1976.0,19,1,0,9,11,7,0,0,0,0,17376,6.6,16444,197,44,-2384,-1489,24.1,1737.6
4847782155,0,13,2,1,11,5,6,1,1,0,0,16685,6.8,18097,155,56,547,1740,21.1,1668.5,14,0,0,5,11,5,0,0,0,0,16138,6.6,16357,212,40,-547,-1740,25.2,1613.8
4826664320,0,0,0,0,19,22,42,0,0,0,0,35499,10.6,38213,124,0,-345,-819,12.4,3549.9,0,0,1,22,19,68,0,0,0,0,35844,11.0,39032,115,0,345,819,11.5,3584.4
4826644809,1,0,0,1,28,23,71,0,0,0,0,40055,11.8,43624,124,0,3209,3766,12.4,4005.5,0,0,0,23,28,43,0,0,0,0,36846,11.0,39858,98,0,-3209,-3766,9.8,3684.6
4826607598,0,0,0,1,28,30,71,0,0,0,0,37368,11.0,40310,93,0,-2273,-3357,9.3,3736.8,0,0,0,30,28,75,0,0,0,0,39641,11.6,43667,112,0,2273,3357,11.2,3964.1
4821002882,0,20,1,1,1,1,2,1,1,0,0,16216,7.4,19183,237,56,1124,0,29.3,1621.6,12,0,0,1,1,1,0,0,0,0,15092,7.0,19183,258,64,-1124,0,32.2,1509.2
4820942414,0,14,5,0,1,3,1,0,0,0,0,15095,7.0,18251,234,72,-191,-347,30.6,1509.5,18,1,1,3,1,1,0,0,0,0,15286,7.2,18598,233,56,191,347,28.9,1528.6
4820879860,1,20,1,0,2,3,4,1,1,0,0,14549,6.8,18020,223,52,-1436,-1200,27.5,1454.9,9,1,1,3,2,2,0,0,0,0,15985,7.4,19220,234,56,1436,1200,29.0,1598.5
4820818558,0,11,3,0,3,9,2,0,0,0,0,14376,6.4,16371,206,52,-3902,-2244,25.8,1437.6,16,1,1,9,3,11,1,1,0,0,18278,7.0,18615,230,48,3902,2244,27.8,1827.8
4817126206,1,0,0,1,29,24,72,0,0,0,0,37569,11.2,41141,115,0,1704,1091,11.5,3756.9,0,0,0,24,29,54,0,0,0,0,35865,11.0,40050,119,0,-1704,-1091,11.9,3586.5
4817100464,1,17,0,0,27,28,65,0,0,0,0,39670,11.8,44441,102,0,1111,3914,10.2,3967.0,0,4,1,28,27,70,0,0,0,0,38559,11.2,40527,105,0,-1111,-3914,10.5,3855.9
4815289322,0,0,0,1,34,35,93,0,0,0,0,39295,12.0,45534,92,0,-1840,-2969,9.2,3929.5,0,0,0,35,34,57,0,0,0,0,41135,12.0,48503,99,0,1840,2969,9.9,4113.5
4815260929,1,46,0,1,32,14,55,0,0,0,1,41107,12.0,45512,64,70,4812,6426,13.4,4110.7,21,0,0,14,32,36,0,0,0,0,36295,11.0,39086,62,43,-4812,-6426,10.5,3629.5
4815217212,0,19,0,1,19,11,31,0,0,0,0,34300,11.0,39381,78,59,-60,-72,13.7,3430.0,11,0,0,11,19,13,0,0,0,0,34360,11.0,39453,70,59,60,72,12.9,3436.0
4815186097,0,50,0,1,17,14,28,0,0,0,0,33413,10.8,37189,72,55,-869,-729,12.7,3341.3,14,19,0,14,17,24,0,0,0,0,34282,11.0,37918,84,59,869,729,14.3,3428.2
4857526192,1,4,0,0,18,15,17,0,0,0,0,63050,12.0,55000,0,0,25479,20000,0.0,6305.0,0,0,1,11,14,11,0,0,0,0,37571,7.6,35000,0,0,-25479,-20000,0.0,3757.1
4857508215,1,0,0,0,14,19,18,0,0,0,0,61300,12.0,55000,0,0,23400,22000,0.0,6130.0,0,0,1,13,8,8,0,0,0,0,37900,7.2,33000,0,0,-23400,-22000,0.0,3790.0
4857483388,1,0,0,1,14,17,19,0,0,0,0,51200,12.4,57000,0,0,26000,24000,0.0,5120.0,0,0,0,12,9,7,0,0,0,0,25200,7.2,33000,0,0,-26000,-24000,0.0,2520.0
4856387410,1,25,5,0,10,21,10,0,0,0,0,59314,12.8,59000,3,0,20699,22000,0.3,5931.4,6,2,1,16,5,15,0,0,0,0,38615,8.0,37000,0,0,-20699,-22000,0.0,3861.5
4856360692,1,29,1,0,20,17,17,0,0,0,0,46760,10.0,47500,17,0,18871,19000,1.7,4676.0,0,2,1,7,10,9,0,0,0,0,27889,6.0,28500,0,0,-18871,-19000,0.0,2788.9
4854973231,1,0,0,0,13,17,15,0,0,0,0,46050,12.0,55000,0,0,16600,22000,0.0,4605.0,0,0,1,10,6,8,0,0,0,0,29450,7.2,33000,0,0,-16600,-22000,0.0,2945.0
4853116000,1,0,0,1,18,21,19,0,0,0,0,63842,12.2,56000,1,0,24882,23000,0.1,6384.2,252,0,0,12,9,14,0,0,0,0,38960,7.2,33000,0,0,-24882,-23000,0.0,3896.0
4853104768,1,0,0,0,23,19,30,0,0,0,0,64800,12.0,55000,0,0,28300,22000,0.0,6480.0,0,0,1,11,15,7,0,0,0,0,36500,7.2,33000,0,0,-28300,-22000,0.0,3650.0
4853083131,1,9,0,0,23,14,22,0,0,0,0,48750,10.4,49860,0,0,20168,21360,0.0,4875.0,0,0,1,6,15,6,0,0,0,0,28582,6.0,28500,0,0,-20168,-21360,0.0,2858.2
4853067247,1,392,2,0,17,19,17,0,0,0,0,61535,12.0,55050,9,0,23605,22050,0.9,6153.5,1,6,1,12,10,11,0,0,0,0,37930,7.2,33000,0,0,-23605,-22050,0.0,3793.0
4852648656,1,29,4,0,17,18,18,0,0,0,0,45855,10.0,47500,10,0,16910,19000,1.0,4585.5,0,3,1,11,10,10,0,0,0,0,28945,6.0,28500,1,0,-16910,-19000,0.1,2894.5
4852609321,1,87,0,0,17,14,18,0,0,0,0,47820,10.0,47500,1,0,19534,19000,0.1,4782.0,0,0,1,7,10,8,0,0,0,0,28286,6.0,28500,0,0,-19534,-19000,0.0,2828.6
4852595971,1,0,0,1,13,23,21,0,0,0,0,60250,12.6,59500,0,0,20563,22000,0.0,6025.0,0,0,0,17,7,11,0,0,0,0,39687,7.8,37500,0,0,-20563,-22000,0.0,3968.7
4852566625,1,0,0,0,23,20,22,0,0,0,0,63750,12.0,55000,0,0,25500,22000,0.0,6375.0,0,0,1,10,13,13,0,0,0,0,38250,7.2,33000,0,0,-25500,-22000,0.0,3825.0
4852540667,1,0,0,0,18,17,20,0,0,0,0,62730,12.0,55000,0,0,25530,22000,0.0,6273.0,0,0,1,11,12,11,0,0,0,0,37200,7.2,33000,0,0,-25530,-22000,0.0,3720.0
4852530830,1,21,3,1,19,18,11,0,0,0,0,46145,10.0,47500,15,0,16755,19000,1.5,4614.5,0,0,0,7,8,14,0,0,0,0,29390,6.0,28500,3,0,-16755,-19000,0.3,2939.0
4852511742,1,0,0,1,14,18,18,0,0,0,0,46603,10.0,47500,0,0,17003,19000,0.0,4660.3,0,0,0,16,12,11,0,0,0,0,29600,6.0,28500,0,0,-17003,-19000,0.0,2960.0
4852489437,1,4,0,0,14,19,17,0,0,0,0,61650,12.0,55000,0,0,23400,22000,0.0,6165.0,0,0,1,14,9,8,0,0,0,0,38250,7.2,33000,0,0,-23400,-22000,0.0,3825.0
4852475459,1,30,0,1,12,19,17,0,0,0,0,61350,12.0,55000,1,0,23400,22000,0.1,6135.0,0,0,0,15,8,9,0,0,0,0,37950,7.2,33000,1,0,-23400,-22000,0.1,3795.0
4852461216,1,0,0,1,16,17,11,0,0,0,0,47700,10.2,48680,0,0,19500,20180,0.0,4770.0,17,0,0,9,8,13,0,0,0,0,28200,6.0,28500,0,0,-19500,-20180,0.0,2820.0
4856119625,1,0,0,0,20,15,52,0,0,0,1,34264,10.6,38148,102,0,-588,818,10.2,3426.4,1,0,1,15,20,37,0,0,0,0,34852,10.6,37330,100,0,588,-818,10.0,3485.2
4856094031,0,18,0,0,28,29,84,0,0,0,0,38101,11.0,40684,112,0,-424,-2594,11.2,3810.1,0,1,1,29,28,86,0,0,0,0,38525,11.4,43278,87,0,424,2594,8.7,3852.5
4856055287,0,0,0,0,11,23,32,0,0,0,1,32656,10.4,36017,88,0,-4228,-3935,8.8,3265.6,0,0,1,23,11,65,0,0,0,0,36884,11.0,39952,82,0,4228,3935,8.2,3688.4
4855006882,0,0,0,1,31,28,73,0,0,0,0,38139,11.2,42044,112,0,1051,1157,11.2,3813.9,0,0,0,28,31,75,0,0,0,0,37088,11.2,40887,110,0,-1051,-1157,11.0,3708.8
4854974822,1,0,0,1,15,9,46,0,0,0,0,34385,10.2,35389,99,0,2800,1960,9.9,3438.5,0,0,0,9,15,31,0,0,0,0,31585,10.0,33429,112,0,-2800,-1960,11.2,3158.5
4854922267,1,0,0,1,24,21,67,0,0,0,2,38172,11.2,41402,111,0,2226,4228,11.1,3817.2,0,0,0,21,24,56,0,0,0,0,35946,10.6,37174,112,0,-2226,-4228,11.2,3594.6
4854811803,1,89,0,1,19,18,47,0,0,0,0,34913,10.8,38926,96,0,831,1945,9.6,3491.3,2,0,0,18,19,25,0,0,0,0,34082,10.8,36981,109,0,-831,-1945,10.9,3408.2
4848936606,1,15,1,0,11,8,9,0,0,0,0,20076,6.6,17206,194,48,2925,1169,24.2,2007.6,12,2,1,8,11,12,0,0,0,0,17151,6.4,16037,166,52,-2925,-1169,21.8,1715.1
4847908619,0,9,0,0,8,6,5,0,0,0,0,18429,7.2,19364,218,59,1562,1618,27.7,1842.9,11,1,1,6,8,4,0,0,0,0,16867,6.8,17746,206,56,-1562,-1618,26.2,1686.7
4847872365,1,7,0,0,6,6,8,0,0,0,0,16570,7.2,18581,195,60,-593,-750,25.5,1657.0,7,1,1,6,6,4,1,1,0,0,17163,7.2,19331,198,64,593,750,26.2,1716.3
4847744765,0,12,0,1,4,5,5,0,0,0,0,16066,7.0,17786,212,56,-1282,-229,26.8,1606.6,11,1,0,5,4,6,0,0,0,0,17348,6.8,18015,216,56,1282,229,27.2,1734.8
4836880520,1,9,1,1,7,6,5,0,0,0,0,17213,6.6,17275,174,36,528,220,21.0,1721.3,10,3,0,6,7,4,0,0,0,0,16685,6.6,17055,218,52,-528,-220,27.0,1668.5
4826743941,1,11,1,0,10,7,9,0,0,0,0,16415,6.6,16549,183,36,480,-1376,21.9,1641.5,11,1,1,7,10,5,1,1,0,0,15935,6.8,17925,181,52,-480,1376,23.3,1593.5
4822873395,1,10,1,1,10,4,9,0,0,0,0,18476,7.0,18775,226,64,2569,1021,29.0,1847.6,13,0,0,4,10,0,0,0,0,0,15907,6.8,17754,208,56,-2569,-1021,26.4,1590.7
4821953045,1,13,0,0,2,5,2,0,0,0,0,14359,6.6,17466,211,60,-3169,-293,27.1,1435.9,13,1,1,5,2,3,0,0,0,0,17528,6.8,17759,212,60,3169,293,27.2,1752.8
4821881061,1,11,1,0,4,3,4,1,1,0,0,16516,7.0,19342,208,56,1343,2030,26.4,1651.6,14,1,1,3,4,4,0,0,0,0,15173,6.6,17312,203,60,-1343,-2030,26.3,1517.3
4821815451,1,9,3,1,3,0,3,1,1,0,0,15568,6.8,18598,254,60,1606,-201,31.4,1556.8,12,3,0,0,3,0,0,0,0,0,13962,7.0,18799,224,72,-1606,201,29.6,1396.2
4820705099,0,13,1,0,5,5,4,0,0,0,0,15899,7.0,17930,216,80,558,713,29.6,1589.9,15,0,1,4,4,2,1,1,0,0,15341,6.8,17217,204,44,-558,-713,24.8,1534.1
4820404919,0,7,0,1,3,6,4,0,0,0,0,14873,6.6,17417,220,60,-1655,-1505,28.0,1487.3,102,2,0,6,3,7,0,0,0,0,16528,7.0,18922,240,60,1655,1505,30.0,1652.8
4819952472,0,13,2,0,0,7,0,0,0,0,0,13297,6.4,16063,200,56,-4139,-2555,25.6,1329.7,13,1,1,7,0,9,0,0,0,0,17436,6.8,18618,233,52,4139,2555,28.5,1743.6
4857277454,0,9,3,0,6,9,11,2,1,1,0,16785,6.8,17243,165,72,-1876,-476,23.7,1678.5,14,4,1,9,6,13,0,0,0,0,18661,7.0,17719,226,48,1876,476,27.4,1866.1
4857238016,0,13,1,0,4,8,2,0,0,0,0,15324,6.6,16633,191,43,-848,-48,23.4,1532.4,11,2,1,8,4,7,0,0,0,0,16172,6.6,16681,187,60,848,48,24.7,1617.2
4854183476,0,15,1,0,0,3,0,0,0,0,0,13787,6.8,18043,240,44,-1238,629,28.4,1378.7,80,1,1,3,0,3,0,0,0,0,15025,6.6,17414,208,56,1238,-629,26.4,1502.5
4854143218,1,13,1,1,5,2,4,1,1,0,0,16981,7.0,18889,240,54,2861,1942,29.4,1698.1,13,1,0,2,5,1,0,0,0,0,14120,6.6,16947,168,44,-2861,-1942,21.2,1412.0
4854097386,1,17,2,1,12,6,16,0,0,0,0,19587,7.0,17740,197,40,4325,1045,23.7,1958.7,14,1,0,6,12,3,1,1,0,0,15262,6.6,16695,188,52,-4325,-1045,24.0,1526.2
4752505054,1,118,0,0,2,5,4,0,0,0,0,15532,7.0,17890,220,57,-982,-706,27.7,1553.2,136,0,1,5,2,2,0,0,0,0,16514,7.0,18596,207,55,982,706,26.2,1651.4
4752481630,1,143,3,1,8,3,9,0,0,0,0,18014,7.0,19101,251,56,2348,1179,30.7,1801.4,13,1,0,3,8,1,0,0,0,0,15666,6.8,17922,227,56,-2348,-1179,28.3,1566.6
4752400385,0,11,1,0,10,11,11,0,0,0,0,19271,6.6,17824,237,44,374,1189,28.1,1927.1,11,2,1,11,10,15,0,0,0,0,18897,6.6,16635,193,56,-374,-1189,24.9,1889.7
4750667025,1,21,1,1,5,7,5,0,0,0,0,15962,6.6,16273,189,60,99,-808,24.9,1596.2,13,3,0,7,5,5,1,1,0,0,15863,6.6,17081,170,48,-99,808,21.8,1586.3
4750648391,0,11,1,0,3,7,1,0,0,0,0,14237,6.6,16140,206,52,-4204,-1339,25.8,1423.7,21,1,1,7,3,12,0,0,0,0,18441,6.8,17479,224,51,4204,1339,27.5,1844.1
4750531933,1,16,1,1,10,4,9,1,1,0,0,18741,6.8,17741,195,56,1915,638,25.1,1874.1,28,1,0,4,10,2,0,0,0,0,16826,6.6,17103,164,52,-1915,-638,21.6,1682.6
4750514083,1,12,0,0,4,9,6,0,0,0,0,16093,7.0,17815,199,54,-1515,-316,25.3,1609.3,8,0,1,9,4,6,0,0,0,0,17608,7.0,18131,184,46,1515,316,23.0,1760.8
4749580533,1,41,2,0,8,2,4,0,0,0,0,19042,7.2,18052,220,56,5449,2848,27.6,1904.2,12,12,1,2,8,2,0,0,0,0,13593,6.2,15204,170,44,-5449,-2848,21.4,1359.3
4749547451,0,10,0,0,3,3,0,1,0,1,0,15071,7.0,18045,177,68,-154,1015,24.5,1507.1,10,0,1,3,3,2,0,0,0,0,15225,6.6,17030,173,48,154,-1015,22.1,1522.5
4749540548,0,30,1,0,0,10,0,0,0,0,0,12011,6.6,16514,154,48,-7327,-3740,20.2,1201.1,11,13,1,10,0,8,1,1,0,0,19338,7.8,20254,207,58,7327,3740,26.5,1933.8
4746792517,1,11,0,0,3,9,2,0,0,0,0,14472,6.6,16578,173,48,-3972,-2310,22.1,1447.2,11,0,1,9,3,6,0,0,0,0,18444,7.4,18888,212,60,3972,2310,27.2,1844.4
4746779552,1,10,0,0,8,5,3,1,0,1,0,16725,7.2,19023,197,68,2300,3142,26.5,1672.5,10,1,1,5,8,2,0,0,0,0,14425,6.6,15881,169,52,-2300,-3142,22.1,1442.5
4745923662,1,22,2,1,11,5,16,1,1,0,0,18813,6.6,17023,186,56,3241,437,24.2,1881.3,151,0,0,5,11,4,0,0,0,0,15572,6.8,16586,201,44,-3241,-437,24.5,1557.2
4745917991,0,9,4,1,3,11,2,0,0,0,0,13985,6.4,16663,166,44,-6000,-2991,21.0,1398.5,13,2,0,11,3,9,1,1,0,0,19985,7.4,19654,211,60,6000,2991,27.1,1998.5
4743929304,1,29,3,1,5,2,4,0,0,0,0,15555,6.8,17221,174,56,1245,336,23.0,1555.5,12,1,0,2,5,2,0,0,0,0,14310,6.8,16885,194,48,-1245,-336,24.2,1431.0
4855483998,0,9,5,0,4,5,2,0,0,0,0,15860,7.2,18853,202,59,69,1076,26.1,1586.0,15,1,1,5,4,4,0,0,0,0,15791,6.8,17777,195,45,-69,-1076,24.0,1579.1
4854789550,1,14,0,1,16,17,17,0,0,0,0,47000,10.0,47500,0,0,18800,19000,0.0,4700.0,0,0,0,10,9,7,0,0,0,0,28200,6.0,28500,0,0,-18800,-19000,0.0,2820.0
4854778354,1,2,1,1,22,19,28,0,0,0,0,64490,12.0,55000,1,0,25525,22000,0.1,6449.0,19,0,0,14,17,8,0,0,0,0,38965,7.2,33000,0,0,-25525,-22000,0.0,3896.5
4854761350,1,0,0,1,19,25,21,0,0,0,0,63750,12.0,55000,0,0,35500,22000,0.0,6375.0,0,0,0,15,9,12,0,0,0,0,28250,7.2,33000,0,0,-35500,-22000,0.0,2825.0
4854746376,1,5,0,0,20,23,17,0,0,0,0,62700,12.0,55000,0,0,23400,22000,0.0,6270.0,0,0,1,12,9,17,0,0,0,0,39300,7.2,33000,0,0,-23400,-22000,0.0,3930.0
4847702015,0,16,4,1,8,5,11,0,0,0,0,16774,6.8,16775,201,55,-407,-2072,25.6,1677.4,16,0,0,5,8,4,1,1,0,0,17181,7.0,18847,196,60,407,2072,25.6,1718.1
4841539948,1,10,1,0,7,5,7,0,0,0,0,19819,7.2,18982,227,62,5392,3011,28.9,1981.9,13,0,1,5,7,2,0,0,0,0,14427,6.4,15971,138,37,-5392,-3011,17.5,1442.7
4841512048,1,16,1,1,13,0,8,0,0,0,0,19070,6.8,17675,182,44,7773,4761,22.6,1907.0,9,1,0,0,13,0,0,0,0,0,11297,5.6,12914,138,43,-7773,-4761,18.1,1129.7
4837632041,1,12,0,0,7,3,8,1,1,0,0,16804,7.0,18320,209,49,2368,2003,25.8,1680.4,15,1,1,3,7,3,0,0,0,0,14436,6.6,16317,180,58,-2368,-2003,23.8,1443.6
4836041030,1,10,1,1,10,3,8,0,0,0,0,17141,6.6,17132,155,44,1721,113,19.9,1714.1,12,1,0,3,10,1,0,0,0,0,15420,6.6,17019,190,56,-1721,-113,24.6,1542.0
4835696361,0,9,1,1,5,4,3,1,1,0,0,14564,6.4,16070,162,54,-2061,-2615,21.6,1456.4,14,1,0,4,5,3,0,0,0,0,16625,7.0,18685,191,48,2061,2615,23.9,1662.5
4835670517,1,13,2,1,5,4,4,0,0,0,0,15504,6.8,17864,191,48,416,588,23.9,1550.4,22,1,0,4,5,3,0,0,0,0,15088,6.6,17276,185,52,-416,-588,23.7,1508.8
4833786189,0,8,1,0,4,9,1,0,0,0,0,14653,6.6,17411,197,52,-2603,-526,24.9,1465.3,12,0,1,9,4,6,1,1,0,0,17256,6.8,17937,179,52,2603,526,23.1,1725.6
4833751622,1,13,2,1,8,5,7,0,0,0,0,18915,7.2,18726,180,60,3658,1942,24.0,1891.5,17,1,0,5,8,4,0,0,0,0,15257,6.6,16784,174,48,-3658,-1942,22.2,1525.7
4833725676,0,23,0,1,5,10,4,0,0,0,0,14911,6.6,16018,180,48,-3067,-1021,22.8,1491.1,12,1,0,10,5,7,1,1,0,0,17978,6.6,17039,209,52,3067,1021,26.1,1797.8
4833704073,0,10,0,1,3,4,1,1,1,0,0,15414,7.0,17798,213,52,31,858,26.5,1541.4,11,2,0,4,3,5,0,0,0,0,15383,7.0,16940,197,55,-31,-858,25.2,1538.3
4833685219,0,14,1,0,1,5,1,0,0,0,0,13186,6.6,16788,193,52,-3891,-1443,24.5,1318.6,35,1,1,5,1,6,1,1,0,0,17077,6.8,18231,210,56,3891,1443,26.6,1707.7
4827806883,1,10,3,0,7,7,2,1,0,1,0,16890,6.8,17054,179,40,-181,927,21.9,1689.0,14,0,1,7,7,7,0,0,0,0,17071,6.6,16127,179,48,181,-927,22.7,1707.1
4827759176,1,11,2,1,9,4,11,1,1,0,0,19075,7.2,18438,203,48,2493,1282,25.1,1907.5,14,1,0,4,9,3,1,0,1,0,16582,6.6,17156,204,48,-2493,-1282,25.2,1658.2
4827710103,1,10,5,0,3,3,0,0,0,0,0,15642,7.2,18854,208,64,371,607,27.2,1564.2,13,0,1,3,3,0,1,1,0,0,15271,7.2,18247,196,60,-371,-607,25.6,1527.1
4842230419,1,23,0,1,16,19,40,0,0,0,0,37207,10.8,37027,69,36,2335,-627,10.5,3720.7,12,1,0,19,16,33,0,0,0,0,34872,10.8,37654,93,55,-2335,627,14.8,3487.2
4842204751,0,13,0,0,19,15,35,0,0,0,1,35704,11.0,38337,95,47,2721,4609,14.2,3570.4,7,0,1,15,19,25,0,0,0,0,32983,10.0,33728,60,48,-2721,-4609,10.8,3298.3
4839898870,1,8,6,0,12,8,22,0,0,0,0,32346,10.8,38237,73,64,5142,7181,13.7,3234.6,47,0,1,8,12,12,0,0,0,0,27204,9.8,31056,57,47,-5142,-7181,10.4,2720.4
4835950344,1,108,0,1,16,7,40,0,0,0,2,36607,11.2,40566,85,71,5237,4074,15.6,3660.7,9,2,0,7,16,8,0,0,0,0,31370,10.6,36492,88,71,-5237,-4074,15.9,3137.0
4835918694,1,45,1,0,22,13,37,0,0,0,1,35060,11.2,41213,84,55,2696,3930,13.9,3506.0,15,12,1,13,22,19,0,0,0,0,32364,10.6,37283,82,51,-2696,-3930,13.3,3236.4
4835895153,1,8,2,1,15,16,30,0,0,0,0,37477,11.2,41201,98,64,2628,2100,16.2,3747.7,13,0,0,16,15,37,0,0,0,0,34849,11.2,39101,57,63,-2628,-2100,12.0,3484.9
4835864562,1,35,0,1,18,12,28,0,0,0,1,36701,12.0,45332,110,87,2989,6824,19.7,3670.1,12,2,0,12,18,20,0,0,0,0,33712,11.0,38508,84,59,-2989,-6824,14.3,3371.2
4832977642,0,11,0,0,11,13,19,0,0,0,0,31519,10.2,35092,109,50,-8931,-6788,15.9,3151.9,20,0,1,13,11,26,0,0,0,0,40450,11.2,41880,103,76,8931,6788,17.9,4045.0
4832960782,1,17,0,1,12,16,19,0,0,0,0,29732,10.8,37153,68,67,-1125,-1004,13.5,2973.2,14,0,0,16,12,24,0,0,0,0,30857,11.0,38157,81,47,1125,1004,12.8,3085.7
4832083175,0,26,0,1,23,15,36,0,0,0,0,33383,10.6,36245,64,52,983,763,11.6,3338.3,11,0,0,15,23,22,0,0,0,0,32400,10.6,35482,60,44,-983,-763,10.4,3240.0
4832062809,0,11,1,0,15,9,26,0,0,0,1,39223,11.6,42703,126,59,7772,6431,18.5,3922.3,10,0,1,9,15,16,0,0,0,0,31451,10.6,36272,112,47,-7772,-6431,15.9,3145.1
4829483513,1,9,0,0,9,13,19,0,0,0,0,33692,11.0,40062,72,47,-1089,-1859,11.9,3369.2,12,0,1,13,9,19,0,0,0,0,34781,11.4,41921,102,71,1089,1859,17.3,3478.1
4829453612,1,13,0,0,25,14,52,0,0,0,2,43774,12.4,48967,125,79,10171,10920,20.4,4377.4,15,0,1,14,25,24,0,0,0,0,33603,10.8,38047,94,43,-10171,-10920,13.7,3360.3
4829437290,0,139,1,1,15,15,21,0,0,0,1,34207,11.4,42151,111,57,-7598,-3116,16.8,3420.7,12,0,0,14,14,28,0,0,0,0,41805,12.0,45267,103,79,7598,3116,18.2,4180.5
4829406425,0,49,0,1,9,17,9,0,0,0,0,32111,10.6,39128,111,63,-4330,-3270,17.4,3211.1,25,18,0,17,9,25,0,0,0,0,36441,11.4,42398,102,63,4330,3270,16.5,3644.1
4818004126,0,11,2,0,19,27,40,0,0,0,0,33393,10.8,39172,77,47,-9593,-8344,12.4,3339.3,27,0,1,27,19,44,0,0,0,0,42986,12.2,47516,90,79,9593,8344,16.9,4298.6
4817969336,0,14,0,1,14,17,27,0,0,0,0,34471,11.4,41683,95,54,-1163,46,14.9,3447.1,10,0,0,17,14,28,0,0,0,0,35634,11.4,41637,97,67,1163,-46,16.4,3563.4
4817938718,1,18,1,0,15,11,37,0,0,0,0,33176,11.4,41597,115,59,320,-178,17.4,3317.6,14,2,1,9,13,17,0,0,0,0,32856,11.4,41775,114,75,-320,178,18.9,3285.6
4817915446,0,42,1,0,9,18,19,0,0,0,1,31371,10.8,38459,139,51,-6886,-4646,19.0,3137.1,11,13,1,18,9,31,0,0,0,0,38257,11.6,43105,109,83,6886,4646,19.2,3825.7
4856578607,0,12,2,1,8,5,5,0,0,0,0,18822,6.8,17612,200,47,3989,851,24.7,1882.2,21,0,0,4,7,5,0,0,0,0,14833,6.8,16761,204,42,-3989,-851,24.6,1483.3
4856556593,0,20,2,0,3,8,3,1,1,0,0,15243,6.6,16884,173,39,-3394,-1807,21.2,1524.3,13,4,1,8,3,7,0,0,0,0,18637,7.0,18691,215,64,3394,1807,27.9,1863.7
4856531050,1,12,5,1,9,5,7,1,1,0,0,19324,7.0,18555,205,48,3670,1631,25.3,1932.4,13,3,0,5,9,3,0,0,0,0,15654,6.6,16924,180,72,-3670,-1631,25.2,1565.4
4856493255,0,14,1,0,4,6,3,0,0,0,0,15984,6.6,17692,204,52,-794,340,25.6,1598.4,13,1,1,6,4,6,1,1,0,0,16778,7.0,17352,162,64,794,-340,22.6,1677.8
4856453161,0,85,1,1,4,6,3,0,0,0,0,16368,7.0,18582,225,60,621,1041,28.5,1636.8,76,2,0,6,4,9,1,1,0,0,15747,7.0,17541,167,60,-621,-1041,22.7,1574.7
4847299415,1,35,0,0,5,5,8,0,0,0,0,15987,6.8,17288,215,48,-105,-334,26.3,1598.7,32,2,1,5,5,3,1,1,0,0,16092,6.8,17622,200,60,105,334,26.0,1609.2
4847289054,0,12,1,1,6,5,5,0,0,0,0,17100,7.0,17741,211,52,647,-341,26.3,1710.0,12,1,0,5,6,4,0,0,0,0,16453,7.0,18082,169,52,-647,341,22.1,1645.3
4847274916,1,15,1,1,11,6,11,0,0,0,0,19414,6.8,18084,188,44,3131,1327,23.2,1941.4,15,2,0,6,11,5,0,0,0,0,16283,6.4,16757,173,52,-3131,-1327,22.5,1628.3
4845726084,1,11,1,0,4,6,1,0,0,0,0,15487,6.8,17955,206,60,117,588,26.6,1548.7,13,3,1,6,4,2,1,1,0,0,15370,6.8,17367,218,40,-117,-588,25.8,1537.0
4844573062,1,13,3,1,12,9,8,1,1,0,0,18227,7.2,19026,176,59,2104,1564,23.5,1822.7,8,2,0,9,12,4,1,0,1,0,16123,6.6,17462,177,49,-2104,-1564,22.6,1612.3
4844563297,0,16,6,0,2,7,1,0,0,0,0,14964,6.6,17334,188,56,-2275,-1848,24.4,1496.4,28,2,1,7,2,5,1,1,0,0,17239,7.0,19182,210,60,2275,1848,27.0,1723.9
4844548221,1,15,1,1,7,8,5,0,0,0,0,16599,6.8,17576,167,48,-1271,-1702,21.5,1659.9,11,1,0,8,7,5,0,0,0,0,17870,7.2,19278,204,64,1271,1702,26.8,1787.0
4844535045,1,9,3,1,6,5,2,1,1,0,0,15980,7.2,18553,226,56,-72,222,28.2,1598.0,13,0,0,5,6,3,0,0,0,0,16052,6.8,18331,215,44,72,-222,25.9,1605.2
4842509569,1,13,3,1,4,6,5,0,0,0,0,14949,6.6,16807,196,46,-2119,-1562,24.2,1494.9,13,2,0,6,4,8,0,0,0,0,17068,7.2,18369,238,55,2119,1562,29.3,1706.8
4842451373,0,15,0,0,2,5,1,1,1,0,0,14744,6.6,17131,200,64,-1871,-220,26.4,1474.4,10,1,1,5,2,3,0,0,0,0,16615,6.8,17351,231,56,1871,220,28.7,1661.5
4842396388,1,13,2,0,3,8,1,0,0,0,0,14872,6.8,17145,192,72,-1898,-578,26.4,1487.2,13,2,1,8,3,7,0,0,0,0,16770,7.2,17723,196,56,1898,578,25.2,1677.0
4841578853,1,21,0,0,4,5,2,1,1,0,0,16143,7.0,18313,194,52,345,1232,24.6,1614.3,14,1,1,5,4,3,0,0,0,0,15798,6.6,17081,195,60,-345,-1232,25.5,1579.8
4840533068,1,15,2,1,13,4,8,0,0,0,0,19473,7.2,19285,225,48,4957,3111,27.3,1947.3,56,2,0,4,13,5,0,0,0,0,14516,6.4,16174,176,36,-4957,-3111,21.2,1451.6
