gameId,blueWins,blueWardsPlaced,blueWardsDestroyed,blueFirstBlood,blueKills,blueDeaths,blueAssists,blueEliteMonsters,blueDragons,blueHeralds,blueTowersDestroyed,blueTotalGold,blueAvgLevel,blueTotalExperience,blueTotalMinionsKilled,blueTotalJungleMinionsKilled,blueGoldDiff,blueExperienceDiff,blueCSPerMin,blueGoldPerMin,redWardsPlaced,redWardsDestroyed,redFirstBlood,redKills,redDeaths,redAssists,redEliteMonsters,redDragons,redHeralds,redTowersDestroyed,redTotalGold,redAvgLevel,redTotalExperience,redTotalMinionsKilled,redTotalJungleMinionsKilled,redGoldDiff,redExperienceDiff,redCSPerMin,redGoldPerMin
4854122582,0,19,0,0,1,3,1,0,0,0,0,13591,6.8,17542,206,44,-2341,-725,25.0,1359.1,9,1,1,3,1,2,0,0,0,0,15932,7.0,18267,244,49,2341,725,29.3,1593.2
4854072450,1,12,1,1,3,0,2,0,0,0,0,15707,6.8,18132,220,39,2466,554,25.9,1570.7,11,0,0,0,3,0,0,0,0,0,13241,6.6,17578,193,64,-2466,-554,25.7,1324.1
4854017958,1,27,1,0,2,3,3,0,0,0,0,14827,7.0,17984,215,67,-188,95,28.2,1482.7,12,16,1,3,2,3,0,0,0,0,15015,6.8,17889,218,44,188,-95,26.2,1501.5
4852814588,1,138,0,0,5,3,5,1,1,0,0,15447,7.2,18532,181,52,1007,611,23.3,1544.7,11,1,1,3,5,1,0,0,0,0,14440,7.0,17921,181,48,-1007,-611,22.9,1444.0
4852781001,0,12,3,0,3,5,4,0,0,0,0,14843,6.6,16858,187,48,-1796,-1704,23.5,1484.3,15,0,1,5,3,3,1,1,0,0,16639,7.2,18562,192,60,1796,1704,25.2,1663.9
4852728995,1,10,0,0,3,2,0,0,0,0,0,13844,6.6,17469,167,40,-1190,-280,20.7,1384.4,11,0,1,2,3,1,0,0,0,0,15034,6.8,17749,195,52,1190,280,24.7,1503.4
4852451041,0,13,3,0,4,15,6,1,0,1,1,15649,6.4,15044,137,52,-6122,-5064,18.9,1564.9,22,4,1,15,4,11,1,1,0,0,21771,7.2,20108,221,65,6122,5064,28.6,2177.1
4852043409,1,36,1,1,5,2,4,0,0,0,0,17371,7.0,18101,210,53,3473,982,26.3,1737.1,35,2,0,2,5,3,0,0,0,0,13898,6.8,17119,171,46,-3473,-982,21.7,1389.8
4852011885,0,10,0,1,4,7,5,0,0,0,0,14023,6.2,15588,155,38,-1974,-2900,19.3,1402.3,11,2,0,7,4,3,1,1,0,0,15997,7.2,18488,215,48,1974,2900,26.3,1599.7
4851966170,0,23,3,1,14,3,10,0,0,0,0,19449,7.0,18436,180,56,5391,2969,23.6,1944.9,14,1,0,3,14,3,1,1,0,0,14058,6.4,15467,166,52,-5391,-2969,21.8,1405.8
4851891281,1,182,14,1,4,2,6,0,0,0,0,15192,6.8,17790,184,56,839,543,24.0,1519.2,35,4,0,2,4,3,0,0,0,0,14353,6.6,17247,212,48,-839,-543,26.0,1435.3
4851834101,0,13,0,1,8,4,8,0,0,0,0,16779,6.8,18203,204,64,1354,1801,26.8,1677.9,12,0,0,4,8,4,0,0,0,0,15425,6.6,16402,163,44,-1354,-1801,20.7,1542.5
4850570502,0,55,2,1,4,2,2,0,0,0,0,15558,7.0,19214,211,68,636,2043,27.9,1555.8,17,3,0,2,4,2,0,0,0,0,14922,6.8,17171,212,52,-636,-2043,26.4,1492.2
4850555227,0,255,1,0,1,9,1,1,1,0,0,14701,7.0,18627,237,48,-2811,-620,28.5,1470.1,15,1,1,9,1,8,0,0,0,0,17512,7.2,19247,183,68,2811,620,25.1,1751.2
4841449717,0,156,0,0,23,35,68,0,0,0,0,37128,10.8,40161,84,0,-3925,-4090,8.4,3712.8,0,0,1,35,23,98,0,0,0,0,41053,11.6,44251,108,0,3925,4090,10.8,4105.3
4841431377,1,0,0,0,22,21,46,0,0,0,0,38534,11.4,40427,112,0,1298,-119,11.2,3853.4,0,0,1,21,22,44,0,0,0,0,37236,10.8,40546,112,0,-1298,119,11.2,3723.6
4841398945,0,0,0,0,16,23,50,0,0,0,0,36391,10.8,37410,94,0,830,-2732,9.4,3639.1,0,0,1,23,16,75,0,0,0,0,35561,11.0,40142,66,0,-830,2732,6.6,3556.1
4841359935,1,50,0,0,18,25,31,0,0,0,1,35315,11.0,39320,111,0,-2377,-3389,11.1,3531.5,34,3,1,25,18,59,0,0,0,0,37692,11.4,42709,107,0,2377,3389,10.7,3769.2
4841322479,0,0,0,1,28,30,72,0,0,0,1,38362,11.0,40023,86,0,-1215,-3620,8.6,3836.2,0,0,0,30,28,82,0,0,0,0,39577,11.4,43643,101,0,1215,3620,10.1,3957.7
4841305954,0,18,0,0,18,33,35,0,0,0,1,34427,10.4,36822,98,0,-6088,-8378,9.8,3442.7,63,4,1,33,18,83,0,0,0,0,40515,12.0,45200,110,0,6088,8378,11.0,4051.5
4847183912,1,13,2,1,4,4,1,0,0,0,0,16527,7.4,19268,245,68,626,469,31.3,1652.7,19,0,0,4,4,5,0,0,0,0,15901,6.8,18799,203,72,-626,-469,27.5,1590.1
4844151852,0,14,3,0,2,6,1,0,0,0,0,15510,7.0,18162,177,58,-2439,-766,23.5,1551.0,9,3,1,6,2,5,1,1,0,0,17949,7.0,18928,213,49,2439,766,26.2,1794.9
4844111032,1,13,1,0,6,7,6,1,1,0,0,16545,6.6,16904,208,50,268,1261,25.8,1654.5,10,1,1,7,6,10,0,0,0,0,16277,6.2,15643,173,45,-268,-1261,21.8,1627.7
4844054385,0,12,0,1,11,5,15,0,0,0,0,18029,7.0,17713,213,44,1452,-292,25.7,1802.9,13,1,0,5,11,3,0,0,0,0,16577,7.0,18005,203,60,-1452,292,26.3,1657.7
4843982317,1,13,1,1,6,5,6,0,0,0,0,17165,6.8,17867,220,47,1050,-68,26.7,1716.5,18,1,0,5,6,4,1,1,0,0,16115,6.8,17935,201,44,-1050,68,24.5,1611.5
4817966461,0,11,3,1,10,7,10,0,0,0,0,19597,7.0,18346,227,56,2428,1393,28.3,1959.7,13,1,0,7,10,8,1,1,0,0,17169,6.6,16953,189,56,-2428,-1393,24.5,1716.9
4806890757,0,11,1,0,5,7,3,0,0,0,0,15900,6.6,17253,239,40,-1682,-793,27.9,1590.0,11,1,1,7,5,9,1,1,0,0,17582,6.8,18046,221,60,1682,793,28.1,1758.2
4806869235,0,11,0,0,1,4,1,0,0,0,0,13724,6.6,16696,190,48,-2415,-1381,23.8,1372.4,7,1,1,4,1,4,0,0,0,0,16139,6.8,18077,205,50,2415,1381,25.5,1613.9
4775277922,0,16,0,0,3,3,1,0,0,0,0,16036,7.0,18550,209,72,-31,292,28.1,1603.6,14,2,1,3,3,2,1,1,0,0,16067,7.0,18258,210,56,31,-292,26.6,1606.7
4775221210,1,10,0,1,5,4,6,0,0,0,0,18108,7.2,19054,203,64,2941,828,26.7,1810.8,14,0,0,4,5,2,0,0,0,0,15167,6.8,18226,210,52,-2941,-828,26.2,1516.7
4775156104,0,22,2,0,2,3,3,0,0,0,0,16454,7.2,18447,205,56,610,537,26.1,1645.4,9,0,1,3,2,2,0,0,0,0,15844,7.0,17910,218,52,-610,-537,27.0,1584.4
4752045881,0,0,0,1,33,22,95,0,0,0,0,38547,11.6,43888,119,0,1019,3016,11.9,3854.7,0,0,0,22,33,59,0,0,0,0,37528,11.2,40872,108,0,-1019,-3016,10.8,3752.8
4752017478,1,0,4,0,22,22,51,0,0,0,0,37535,11.2,41560,102,0,929,2281,10.2,3753.5,17,0,1,22,22,63,0,0,0,0,36606,11.0,39279,116,0,-929,-2281,11.6,3660.6
4751987397,1,0,0,0,17,19,43,0,0,0,0,34917,10.8,36882,114,0,869,-181,11.4,3491.7,0,0,1,19,17,47,0,0,0,0,34048,10.4,37063,99,0,-869,181,9.9,3404.8
4719168531,1,13,0,1,4,2,5,1,1,0,0,17218,6.8,17934,253,53,2327,221,30.6,1721.8,11,0,0,2,4,2,0,0,0,0,14891,7.0,17713,208,40,-2327,-221,24.8,1489.1
4719117188,1,74,0,1,8,5,9,0,0,0,0,18605,7.0,18753,213,68,2756,1444,28.1,1860.5,119,0,0,4,7,4,1,1,0,0,15849,6.8,17309,230,44,-2756,-1444,27.4,1584.9
4719067608,0,13,1,0,2,10,2,0,0,0,0,15012,6.6,17474,209,47,-5058,-1249,25.6,1501.2,19,2,1,10,2,14,1,0,1,0,20070,7.0,18723,245,53,5058,1249,29.8,2007.0
4719011516,1,13,1,1,6,6,3,0,0,0,0,17150,7.0,18159,232,36,356,316,26.8,1715.0,19,2,0,6,6,4,0,0,0,0,16794,7.0,17843,213,52,-356,-316,26.5,1679.4
4701767485,1,14,1,1,5,3,5,0,0,0,0,18077,7.2,19413,241,64,3487,798,30.5,1807.7,12,0,0,3,5,3,0,0,0,0,14590,7.0,18615,189,63,-3487,-798,25.2,1459.0
4678578866,0,11,2,0,3,9,3,0,0,0,0,14860,6.6,16704,205,35,-3998,-2830,24.0,1486.0,22,1,1,9,3,9,1,1,0,0,18858,7.2,19534,219,51,3998,2830,27.0,1885.8
4857145697,1,11,1,1,3,1,2,0,0,0,0,16998,7.4,19732,248,68,2045,1056,31.6,1699.8,15,2,0,1,3,0,1,1,0,0,14953,7.0,18676,238,76,-2045,-1056,31.4,1495.3
4856122994,1,14,3,1,4,4,5,1,1,0,0,17310,7.2,18680,211,56,1632,1048,26.7,1731.0,14,3,0,4,4,3,1,0,1,0,15678,6.8,17632,208,48,-1632,-1048,25.6,1567.8
4856014356,0,14,3,1,3,6,2,0,0,0,0,16272,6.8,17426,214,54,-103,-1013,26.8,1627.2,13,2,0,6,3,1,1,1,0,0,16375,7.0,18439,215,73,103,1013,28.8,1637.5
4855440347,1,17,6,1,7,7,7,1,1,0,0,16909,6.4,16629,184,64,-862,-419,24.8,1690.9,18,1,0,7,7,8,0,0,0,0,17771,6.6,17048,211,48,862,419,25.9,1777.1
4855410986,1,16,2,1,5,4,1,0,0,0,0,15639,7.0,18593,213,56,-144,351,26.9,1563.9,13,3,0,4,5,6,0,0,0,0,15783,7.0,18242,207,68,144,-351,27.5,1578.3
4855373808,0,20,2,1,2,4,0,0,0,0,0,14025,6.8,17333,216,52,-2057,33,26.8,1402.5,19,1,0,4,2,5,0,0,0,0,16082,6.8,17300,207,52,2057,-33,25.9,1608.2
4853705579,1,0,0,0,13,22,16,0,0,0,0,62299,12.0,55000,0,0,23699,22000,0.0,6229.9,0,0,1,17,8,13,0,0,0,0,38600,7.2,33000,2,0,-23699,-22000,0.2,3860.0
4853691008,1,7,0,0,13,17,14,0,0,0,0,46300,10.0,47500,0,0,17400,19000,0.0,4630.0,10,0,1,13,9,8,0,0,0,0,28900,6.0,28500,0,0,-17400,-19000,0.0,2890.0
4848575716,1,12,0,1,8,7,8,0,0,0,0,16327,6.6,16686,177,44,656,375,22.1,1632.7,11,1,0,7,8,8,0,0,0,0,15671,6.4,16311,159,44,-656,-375,20.3,1567.1
4848549845,1,12,1,0,4,4,4,0,0,0,0,15952,6.8,17390,197,42,10,-1147,23.9,1595.2,14,1,1,4,4,3,0,0,0,0,15942,7.0,18537,187,66,-10,1147,25.3,1594.2
4847471679,1,0,0,1,29,17,79,0,0,0,0,37297,11.6,43419,108,0,1817,4129,10.8,3729.7,20,0,0,17,29,49,0,0,0,0,35480,10.8,39290,107,0,-1817,-4129,10.7,3548.0
4846682830,0,1,0,0,21,29,62,0,0,0,1,36581,11.2,40957,96,0,-689,-491,9.6,3658.1,27,0,1,29,21,64,0,0,0,0,37270,11.2,41448,86,0,689,491,8.6,3727.0
4846658441,1,3,0,0,22,24,48,0,0,0,0,37653,11.2,41209,117,0,2042,3060,11.7,3765.3,0,0,1,24,22,70,0,0,0,0,35611,10.8,38149,96,0,-2042,-3060,9.6,3561.1
4846629002,0,25,2,1,8,9,7,0,0,0,0,17371,7.0,18263,203,52,-1175,-622,25.5,1737.1,10,2,0,9,8,6,2,1,1,0,18546,7.0,18885,230,52,1175,622,28.2,1854.6
4846587695,1,37,5,0,6,3,8,1,1,0,0,16847,7.0,17530,202,50,1785,-221,25.2,1684.7,38,4,1,3,6,3,0,0,0,0,15062,7.0,17751,197,52,-1785,221,24.9,1506.2
4845891220,1,19,1,1,5,2,6,0,0,0,0,15693,6.6,16850,210,52,326,-1224,26.2,1569.3,13,1,0,2,5,2,0,0,0,0,15367,7.0,18074,186,64,-326,1224,25.0,1536.7
4845850954,1,17,2,1,4,4,5,0,0,0,0,15445,6.8,17014,195,47,839,-335,24.2,1544.5,15,3,0,4,4,0,1,0,1,0,14606,6.8,17349,210,56,-839,335,26.6,1460.6
4845665093,0,13,0,1,32,33,86,0,0,0,2,41263,12.0,46444,102,0,-56,478,10.2,4126.3,7,0,0,33,32,74,0,0,0,0,41319,11.8,45966,110,0,56,-478,11.0,4131.9
4845290315,1,0,1,0,31,16,77,0,0,0,1,40130,11.6,43678,121,0,5053,6125,12.1,4013.0,21,0,1,16,31,26,0,0,0,0,35077,10.8,37553,101,0,-5053,-6125,10.1,3507.7
4845264482,1,23,0,0,18,18,51,0,0,0,1,37845,11.2,40002,116,0,2468,1416,11.6,3784.5,0,5,1,18,18,50,0,0,0,0,35377,10.6,38586,106,0,-2468,-1416,10.6,3537.7
4856556006,0,0,0,1,24,20,52,0,0,0,0,36068,10.8,38495,105,0,1238,430,10.5,3606.8,0,0,0,20,24,64,0,0,0,0,34830,10.8,38065,89,0,-1238,-430,8.9,3483.0
4856539814,0,0,0,0,21,26,55,0,0,0,2,36575,10.8,37958,109,0,-1954,-4978,10.9,3657.5,0,0,1,26,21,67,0,0,0,0,38529,11.6,42936,111,0,1954,4978,11.1,3852.9
4856521122,0,0,0,1,24,29,58,0,0,0,1,37586,11.2,41360,106,0,-811,-220,10.6,3758.6,0,0,0,29,24,82,0,0,0,0,38397,11.0,41580,107,0,811,220,10.7,3839.7
4856492490,1,0,0,1,12,21,36,0,0,0,0,34146,10.0,34382,102,0,-735,-2198,10.2,3414.6,0,0,0,21,12,57,0,0,0,0,34881,10.4,36580,98,0,735,2198,9.8,3488.1
4856476070,1,91,0,0,16,15,33,0,0,0,0,33910,10.4,36063,111,0,16,-864,11.1,3391.0,11,0,1,15,16,37,0,0,0,0,33894,10.8,36927,106,0,-16,864,10.6,3389.4
4856452307,1,21,1,0,14,19,13,0,0,0,0,60960,12.0,55000,1,0,22000,22000,0.1,6096.0,4,1,1,14,9,12,0,0,0,0,38960,7.2,33000,1,0,-22000,-22000,0.1,3896.0
4856432209,1,20,0,0,15,16,12,0,0,0,0,45770,10.0,47500,2,0,17540,19000,0.2,4577.0,18,0,1,10,9,13,0,0,0,0,28230,6.0,28500,0,0,-17540,-19000,0.0,2823.0
4856407630,1,93,0,1,19,14,17,0,0,0,0,33229,9.0,40000,2,0,13560,16000,0.2,3322.9,0,0,0,8,13,8,0,0,0,0,19669,5.4,24000,1,0,-13560,-16000,0.1,1966.9
4856007743,0,0,0,1,14,22,29,0,0,0,1,34023,10.4,37031,106,0,-1607,-1959,10.6,3402.3,0,0,0,22,14,44,0,0,0,0,35630,10.8,38990,103,0,1607,1959,10.3,3563.0
4855964446,0,0,0,1,13,22,37,0,0,0,0,34740,10.6,35736,101,0,-897,-3348,10.1,3474.0,0,0,0,22,13,64,0,0,0,0,35637,10.8,39084,114,0,897,3348,11.4,3563.7
4855349321,0,4,0,0,21,30,46,0,0,0,2,36764,10.8,38304,101,0,-2714,-6396,10.1,3676.4,0,0,1,30,21,73,0,0,0,0,39478,11.8,44700,109,0,2714,6396,10.9,3947.8
4855328985,1,0,2,0,22,34,47,0,0,0,1,39256,11.8,43967,127,0,-2470,-1045,12.7,3925.6,31,0,1,34,22,83,0,0,0,0,41726,11.6,45012,92,0,2470,1045,9.2,4172.6
4855301162,1,9,0,1,26,27,44,0,0,0,1,38818,11.4,42424,124,0,2087,1620,12.4,3881.8,0,2,0,27,26,74,0,0,0,0,36731,11.0,40804,118,0,-2087,-1620,11.8,3673.1
4855232613,1,11,0,0,3,4,1,0,0,0,0,14587,6.8,18162,194,56,-2599,-1044,25.0,1458.7,11,0,1,4,3,1,0,0,0,0,17186,7.2,19206,221,68,2599,1044,28.9,1718.6
4855174854,1,12,1,0,2,5,2,1,1,0,0,14794,6.4,16794,215,56,-1001,-1169,27.1,1479.4,9,1,1,5,2,4,0,0,0,0,15795,7.0,17963,194,52,1001,1169,24.6,1579.5
4855143186,1,6,0,0,16,19,20,0,0,0,0,62700,12.0,55000,0,0,25500,22000,0.0,6270.0,0,0,1,11,8,8,0,0,0,0,37200,7.2,33000,0,0,-25500,-22000,0.0,3720.0
4855098610,1,19,0,1,17,18,49,0,0,0,0,36699,10.6,38052,115,0,1560,-318,11.5,3669.9,0,0,0,18,17,48,0,0,0,0,35139,10.6,38370,114,0,-1560,318,11.4,3513.9
4855053468,1,22,0,0,22,21,63,0,0,0,0,36122,11.0,38875,135,0,1013,957,13.5,3612.2,0,24,1,21,22,37,0,0,0,0,35109,10.6,37918,93,0,-1013,-957,9.3,3510.9
4855018670,1,99,0,0,18,26,48,0,0,0,0,36329,11.2,40324,121,0,-768,1366,12.1,3632.9,0,23,1,26,18,66,0,0,0,0,37097,11.0,38958,102,0,768,-1366,10.2,3709.7
4854992978,1,0,0,1,19,16,17,0,0,0,0,45950,10.0,47500,0,0,17400,19000,0.0,4595.0,0,0,0,7,10,14,0,0,0,0,28550,6.0,28500,0,0,-17400,-19000,0.0,2855.0
4855806506,0,12,0,0,0,2,0,1,1,0,0,15019,6.8,17540,221,62,-568,-1543,28.3,1501.9,13,0,1,2,0,2,0,0,0,0,15587,7.0,19083,223,68,568,1543,29.1,1558.7
4855498262,0,12,1,0,4,10,2,0,0,0,0,17538,6.8,16985,201,52,68,546,25.3,1753.8,8,0,1,10,4,13,1,1,0,0,17470,6.6,16439,191,48,-68,-546,23.9,1747.0
4855472557,0,15,2,0,2,6,2,0,0,0,0,15049,6.8,16963,204,44,-1454,-987,24.8,1504.9,20,1,1,6,2,7,1,1,0,0,16503,7.0,17950,194,63,1454,987,25.7,1650.3
4855454066,0,11,2,1,9,6,6,0,0,0,0,18206,7.2,18802,218,60,1830,306,27.8,1820.6,13,0,0,6,9,3,1,1,0,0,16376,7.0,18496,199,52,-1830,-306,25.1,1637.6
4855419024,0,14,1,0,2,2,3,1,1,0,0,14821,7.0,18432,206,60,-1065,-937,26.6,1482.1,13,1,1,2,2,1,1,0,1,0,15886,7.0,19369,226,68,1065,937,29.4,1588.6
4855373702,0,15,2,1,9,7,7,0,0,0,0,17811,7.0,18074,216,42,181,-516,25.8,1781.1,10,1,0,7,9,5,0,0,0,0,17630,6.8,18590,225,44,-181,516,26.9,1763.0
4855346032,1,9,4,1,14,6,8,0,0,0,0,21277,7.2,18925,221,44,5570,3324,26.5,2127.7,15,0,0,6,14,6,0,0,0,0,15707,6.4,15601,184,44,-5570,-3324,22.8,1570.7
4855288293,0,19,11,1,9,5,9,0,0,0,0,20511,7.2,20180,218,69,5080,3047,28.7,2051.1,35,2,0,5,9,4,0,0,0,0,15431,6.8,17133,193,34,-5080,-3047,22.7,1543.1
4855236837,1,38,2,0,8,7,7,1,1,0,0,16947,7.4,19468,220,64,-1102,273,28.4,1694.7,18,19,1,7,8,7,0,0,0,0,18049,7.0,19195,211,52,1102,-273,26.3,1804.9
4855175666,0,19,1,0,7,5,6,0,0,0,0,16464,6.6,17649,191,58,583,802,24.9,1646.4,15,3,1,5,7,3,1,1,0,0,15881,6.6,16847,204,44,-583,-802,24.8,1588.1
4855151108,1,0,0,1,31,16,73,0,0,0,2,38661,11.2,41593,114,0,4785,3655,11.4,3866.1,0,0,0,14,29,25,0,0,0,0,33876,10.8,37938,77,0,-4785,-3655,7.7,3387.6
4855117874,0,4,0,0,20,28,47,0,0,0,2,33982,10.4,36288,89,0,-7393,-9470,8.9,3398.2,0,0,1,26,18,77,0,0,0,0,41375,12.0,45758,109,0,7393,9470,10.9,4137.5
4855085023,0,0,0,0,26,29,55,0,0,0,2,38245,11.2,40183,97,0,-2029,-4061,9.7,3824.5,0,0,1,29,26,77,0,0,0,0,40274,11.4,44244,96,0,2029,4061,9.6,4027.4
4854978502,1,0,0,0,16,21,9,0,0,0,0,45600,10.0,47500,0,0,17400,17820,0.0,4560.0,0,0,1,10,5,15,0,0,0,0,28200,6.2,29680,0,0,-17400,-17820,0.0,2820.0
4854951386,1,17,3,0,14,16,19,0,0,0,0,59495,12.0,55000,4,0,24425,22000,0.4,5949.5,33,0,1,14,12,6,0,0,0,0,35070,7.2,33000,0,0,-24425,-22000,0.0,3507.0
4854923485,1,0,0,1,17,18,22,0,0,0,0,48050,12.8,59000,0,0,19500,26000,0.0,4805.0,0,0,0,13,12,8,0,0,0,0,28550,7.2,33000,0,0,-19500,-26000,0.0,2855.0
4854906646,1,115,0,1,14,14,14,0,0,0,0,60710,12.0,55000,0,0,23489,22000,0.0,6071.0,31,0,0,10,10,9,0,0,0,0,37221,7.2,33000,0,0,-23489,-22000,0.0,3722.1
4854885627,1,0,0,1,14,15,19,0,0,0,0,45250,10.0,47500,0,0,14600,19000,0.0,4525.0,0,0,0,11,10,8,0,0,0,0,30650,6.0,28500,0,0,-14600,-19000,0.0,3065.0
4854878766,1,0,0,1,15,14,18,0,0,0,0,61467,12.0,55000,0,0,24247,22000,0.0,6146.7,0,0,0,11,12,9,0,0,0,0,37220,7.2,33000,0,0,-24247,-22000,0.0,3722.0
4857127767,0,13,1,1,5,5,2,0,0,0,0,16250,7.0,18019,191,48,1362,1521,23.9,1625.0,15,0,0,5,5,1,0,0,0,0,14888,6.4,16498,192,58,-1362,-1521,25.0,1488.8
4856131760,1,4,0,1,23,22,25,0,0,0,0,63550,12.0,55000,2,0,25595,22000,0.2,6355.0,0,0,0,11,12,9,0,0,0,0,37955,7.2,33000,1,0,-25595,-22000,0.1,3795.5
4856104707,1,0,0,0,19,15,17,0,0,0,0,48050,10.0,47500,0,0,20900,19000,0.0,4805.0,0,0,1,8,12,7,0,0,0,0,27150,6.0,28500,0,0,-20900,-19000,0.0,2715.0
4855971200,0,10,1,0,0,2,0,0,0,0,0,13941,6.6,17840,232,56,-1389,-117,28.8,1394.1,13,0,1,2,0,2,0,0,0,0,15330,7.0,17957,213,56,1389,117,26.9,1533.0
4854631952,0,12,1,0,1,3,0,0,0,0,0,13674,6.8,17131,184,60,-2340,-1312,24.4,1367.4,12,2,1,3,1,1,1,1,0,0,16014,7.0,18443,235,68,2340,1312,30.3,1601.4
4854597414,1,12,1,0,6,10,8,0,0,0,0,17721,6.8,17738,171,56,-1409,-436,22.7,1772.1,13,0,1,10,6,12,1,1,0,0,19130,7.2,18174,221,56,1409,436,27.7,1913.0
4854570142,0,17,2,1,9,6,9,1,1,0,0,17825,6.6,17548,227,48,1418,674,27.5,1782.5,13,2,0,6,9,4,0,0,0,0,16407,6.6,16874,186,48,-1418,-674,23.4,1640.7
4854540636,0,9,0,1,5,4,5,1,1,0,0,15900,7.0,17723,205,64,-356,-725,26.9,1590.0,9,0,0,4,5,4,0,0,0,0,16256,7.0,18448,222,59,356,725,28.1,1625.6
4854518222,0,13,1,0,1,5,1,0,0,0,0,13987,6.8,17735,199,56,-1318,-407,25.5,1398.7,9,1,1,5,1,4,0,0,0,0,15305,6.8,18142,182,55,1318,407,23.7,1530.5
4854495566,0,11,0,0,2,7,3,0,0,0,0,14667,6.8,17103,189,64,-3280,-2762,25.3,1466.7,8,0,1,7,2,7,1,0,1,0,17947,7.4,19865,237,60,3280,2762,29.7,1794.7
4854477232,1,13,0,0,4,8,4,0,0,0,0,16197,6.8,17878,244,48,-711,1564,29.2,1619.7,13,0,1,8,4,12,0,0,0,0,16908,6.6,16314,174,56,711,-1564,23.0,1690.8
4854456524,1,13,1,1,6,3,5,1,1,0,0,16496,7.0,18231,212,56,1547,1291,26.8,1649.6,11,0,0,3,6,3,0,0,0,0,14949,6.6,16940,198,56,-1547,-1291,25.4,1494.9
4853907245,1,11,0,0,3,2,5,0,0,0,0,14965,7.0,17586,220,52,-82,27,27.2,1496.5,9,1,1,2,3,3,0,0,0,0,15047,6.8,17559,196,64,82,-27,26.0,1504.7
4853859132,0,12,0,0,3,5,4,0,0,0,0,15256,7.0,17530,169,63,-514,11,23.2,1525.6,12,0,1,5,3,7,1,1,0,0,15770,6.6,17519,212,48,514,-11,26.0,1577.0
4853810245,1,10,2,0,2,8,2,0,0,0,0,13997,6.6,15990,195,43,-5106,-3404,23.8,1399.7,10,2,1,8,2,2,1,1,0,0,19103,7.4,19394,233,64,5106,3404,29.7,1910.3
4852510779,1,88,0,0,9,9,8,0,0,0,0,18325,7.0,17599,213,51,470,-1395,26.4,1832.5,9,1,1,8,8,3,1,1,0,0,17855,7.4,18994,216,64,-470,1395,28.0,1785.5
4852488756,1,0,0,0,8,16,12,0,0,0,0,29200,9.0,40000,0,0,10000,16000,0.0,2920.0,6,0,1,11,3,9,0,0,0,0,19200,5.4,24000,0,0,-10000,-16000,0.0,1920.0
4851713568,0,10,1,1,7,11,8,0,0,0,0,17707,6.8,16526,204,40,-281,-1315,24.4,1770.7,13,0,0,11,7,8,0,0,0,0,17988,7.0,17841,167,64,281,1315,23.1,1798.8
4851693293,0,16,2,0,9,12,6,0,0,0,0,15821,6.2,15107,138,42,-4883,-2651,18.0,1582.1,15,2,1,12,9,10,1,1,0,0,20704,6.8,17758,208,52,4883,2651,26.0,2070.4
4856362702,0,11,2,0,6,5,5,0,0,0,0,15780,6.8,18316,182,56,-493,1494,23.8,1578.0,13,0,1,5,6,3,0,0,0,0,16273,6.8,16822,209,50,493,-1494,25.9,1627.3
4856303130,1,8,4,0,3,4,2,0,0,0,0,15706,7.0,17976,232,56,-237,548,28.8,1570.6,13,1,1,4,3,4,0,0,0,0,15943,6.8,17428,209,48,237,-548,25.7,1594.3
4856266479,0,19,0,0,2,4,0,0,0,0,0,14119,7.0,17331,209,48,-2780,-1715,25.7,1411.9,10,1,1,4,2,5,0,0,0,0,16899,7.2,19046,241,52,2780,1715,29.3,1689.9
4856223703,0,10,2,0,3,8,3,0,0,0,0,14590,6.6,17008,194,50,-3815,-2423,24.4,1459.0,13,2,1,8,3,9,0,0,0,0,18405,7.2,19431,242,64,3815,2423,30.6,1840.5
4856188536,0,9,1,0,6,12,5,0,0,0,0,17174,6.6,17100,212,53,-2325,-1542,26.5,1717.4,9,0,1,12,6,7,1,1,0,0,19499,6.8,18642,214,56,2325,1542,27.0,1949.9
4855296209,0,12,1,1,6,5,6,0,0,0,0,16436,6.8,17368,198,48,1247,210,24.6,1643.6,134,0,0,5,6,2,1,1,0,0,15189,6.8,17158,184,52,-1247,-210,23.6,1518.9
4855261430,1,10,4,1,4,2,1,0,0,0,0,15826,7.0,18041,224,60,1738,665,28.4,1582.6,11,1,0,2,4,4,1,1,0,0,14088,7.0,17376,185,60,-1738,-665,24.5,1408.8
4855197265,0,13,3,0,5,5,4,0,0,0,0,15516,6.6,16960,185,48,-394,-942,23.3,1551.6,14,1,1,5,5,6,1,1,0,0,15910,7.0,17902,194,64,394,942,25.8,1591.0
4854147601,1,5,1,0,5,4,3,0,0,0,0,17202,6.8,18082,196,52,1463,1487,24.8,1720.2,12,0,1,4,5,3,0,0,0,0,15739,6.6,16595,209,52,-1463,-1487,26.1,1573.9
4854121461,1,15,2,1,12,3,14,0,0,0,0,18667,7.2,19062,185,68,3855,2356,25.3,1866.7,10,2,0,3,12,2,0,0,0,0,14812,6.6,16706,193,56,-3855,-2356,24.9,1481.2
4853138776,0,12,1,1,7,6,7,0,0,0,0,17009,7.2,17772,214,56,-892,-908,27.0,1700.9,11,0,0,5,6,3,0,0,0,0,17901,7.0,18680,220,44,892,908,26.4,1790.1
4853093733,0,9,2,0,7,7,8,0,0,0,0,16187,6.6,16580,200,44,11,-287,24.4,1618.7,22,0,1,7,7,4,0,0,0,0,16176,7.0,16867,198,48,-11,287,24.6,1617.6
4853033604,0,10,4,1,5,3,5,0,0,0,0,15777,7.0,18697,204,56,634,499,26.0,1577.7,16,0,0,3,5,2,0,0,0,0,15143,6.8,18198,224,48,-634,-499,27.2,1514.3
4851588214,1,12,1,1,3,3,2,0,0,0,0,14304,6.8,17570,164,44,-601,228,20.8,1430.4,21,0,0,3,3,3,1,1,0,0,14905,6.6,17342,204,61,601,-228,26.5,1490.5
4851548326,1,10,0,1,9,1,5,0,0,0,0,17126,7.2,19637,227,56,2811,3250,28.3,1712.6,8,0,0,1,9,1,0,0,0,0,14315,6.4,16387,193,48,-2811,-3250,24.1,1431.5
4851436349,1,14,0,1,7,6,6,0,0,0,0,16696,7.0,18031,198,48,-625,845,24.6,1669.6,15,1,0,6,7,6,1,1,0,0,17321,6.8,17186,190,57,625,-845,24.7,1732.1
4851000319,1,85,3,1,8,8,14,1,1,0,0,18312,7.0,17921,192,63,1505,545,25.5,1831.2,83,2,0,8,8,7,0,0,0,0,16807,6.6,17376,186,52,-1505,-545,23.8,1680.7
4849984133,0,17,1,1,5,2,1,0,0,0,0,16195,7.0,18452,216,55,1509,1152,27.1,1619.5,11,1,0,2,5,0,0,0,0,0,14686,6.6,17300,199,60,-1509,-1152,25.9,1468.6
4849941294,1,12,4,1,12,7,8,0,0,0,0,21047,7.0,19318,206,56,4549,3712,26.2,2104.7,11,1,0,7,12,8,0,0,0,0,16498,6.4,15606,185,32,-4549,-3712,21.7,1649.8
4849579827,0,10,0,0,3,8,1,1,1,0,0,15397,6.6,16864,204,55,-1414,-1320,25.9,1539.7,10,1,1,8,3,2,0,0,0,0,16811,7.0,18184,186,48,1414,1320,23.4,1681.1
4856378734,1,9,0,1,21,15,22,0,0,0,0,65150,12.0,55000,0,0,27600,22000,0.0,6515.0,0,0,0,9,15,10,0,0,0,0,37550,7.2,33000,0,0,-27600,-22000,0.0,3755.0
4856345465,1,0,0,0,17,11,19,0,0,0,0,47000,10.0,47500,0,0,20200,19000,0.0,4700.0,0,0,1,6,12,3,0,0,0,0,26800,6.0,28500,0,0,-20200,-19000,0.0,2680.0
4856318788,1,41,0,1,16,23,10,0,0,0,0,44900,10.0,47500,0,0,16000,16000,0.0,4490.0,0,0,0,12,5,15,0,0,0,0,28900,6.6,31500,0,0,-16000,-16000,0.0,2890.0
4856263052,0,1,0,0,21,22,62,0,0,0,0,35436,11.0,39716,97,0,-1010,-264,9.7,3543.6,36,0,1,22,21,56,0,0,0,0,36446,11.2,39980,97,0,1010,264,9.7,3644.6
4856225567,1,0,0,1,27,14,78,0,0,0,1,37673,11.0,39714,108,0,2580,3906,10.8,3767.3,0,0,0,14,27,25,0,0,0,0,35093,10.4,35808,107,0,-2580,-3906,10.7,3509.3
4856182951,1,0,0,1,19,12,54,0,0,0,0,35174,10.8,37781,114,0,1626,2156,11.4,3517.4,0,0,0,12,19,28,0,0,0,0,33548,10.2,35625,94,0,-1626,-2156,9.4,3354.8
4856141852,1,0,0,1,27,17,25,0,0,0,0,50500,10.0,47500,0,0,21600,19000,0.0,5050.0,0,0,0,4,14,10,0,0,0,0,28900,6.0,28500,0,0,-21600,-19000,0.0,2890.0
4855860139,0,8,0,1,31,31,67,0,0,0,0,39413,11.8,45291,100,0,-99,1854,10.0,3941.3,0,2,0,31,31,70,0,0,0,0,39512,11.8,43437,114,0,99,-1854,11.4,3951.2
4855830718,0,1,6,1,26,26,47,0,0,0,1,38644,11.4,41824,125,0,1458,1255,12.5,3864.4,13,0,0,25,25,54,0,0,0,0,37186,11.0,40569,94,0,-1458,-1255,9.4,3718.6
4855556215,1,0,0,1,13,17,23,0,0,0,0,48750,10.0,47500,5,0,20200,19000,0.5,4875.0,0,0,0,13,9,5,0,0,0,0,28550,6.0,28500,3,0,-20200,-19000,0.3,2855.0
4855551041,1,353,0,1,10,20,11,0,0,0,0,45657,10.0,47799,0,0,16757,19299,0.0,4565.7,0,0,0,16,6,15,0,0,0,0,28900,6.0,28500,0,0,-16757,-19299,0.0,2890.0
4855544999,1,8,0,1,15,17,15,0,0,0,0,46395,10.0,47500,1,0,18216,19000,0.1,4639.5,0,0,0,10,8,8,0,0,0,0,28179,6.0,28500,1,0,-18216,-19000,0.1,2817.9
4855534690,1,4,0,0,22,19,24,0,0,0,0,49100,10.0,47500,0,0,20900,19000,0.0,4910.0,0,0,1,9,12,9,0,0,0,0,28200,6.0,28500,0,0,-20900,-19000,0.0,2820.0
4855533932,1,0,0,1,16,17,19,0,0,0,0,47437,10.0,47500,3,0,20287,19000,0.3,4743.7,8,0,0,11,10,8,0,0,0,0,27150,6.0,28500,0,0,-20287,-19000,0.0,2715.0
4855523418,1,0,0,0,20,21,20,0,0,0,0,64525,12.0,55000,0,0,27630,22000,0.0,6452.5,0,0,1,12,11,9,0,0,0,0,36895,7.2,33000,0,0,-27630,-22000,0.0,3689.5
4855517328,1,0,0,1,9,22,12,0,0,0,0,45784,10.0,47500,0,0,16149,19000,0.0,4578.4,0,0,0,17,4,12,0,0,0,0,29635,6.0,28500,0,0,-16149,-19000,0.0,2963.5
4855510134,1,0,0,0,10,18,13,0,0,0,0,44550,10.0,47500,0,0,15300,19000,0.0,4455.0,0,0,1,14,6,10,0,0,0,0,29250,6.0,28500,0,0,-15300,-19000,0.0,2925.0
4855500141,1,0,0,0,20,15,18,0,0,0,0,62700,12.0,55000,0,0,25500,22000,0.0,6270.0,12,0,1,8,13,12,0,0,0,0,37200,7.2,33000,0,0,-25500,-22000,0.0,3720.0
4855483324,1,0,0,1,24,16,22,0,0,0,0,49175,10.0,47500,1,0,20625,19000,0.1,4917.5,4,0,0,10,18,9,0,0,0,0,28550,6.0,28500,0,0,-20625,-19000,0.0,2855.0
4855195813,0,9,1,1,8,7,6,0,0,0,0,18237,6.8,18645,245,56,861,885,30.1,1823.7,76,0,0,7,8,6,0,0,0,0,17376,6.8,17760,184,63,-861,-885,24.7,1737.6
4855552942,1,176,0,1,16,11,10,0,0,0,0,32000,9.0,40000,0,0,14200,15625,0.0,3200.0,176,0,0,4,9,8,0,0,0,0,17800,5.4,24375,0,0,-14200,-15625,0.0,1780.0
4855547920,1,352,0,0,17,20,16,0,0,0,0,47362,10.6,50550,0,0,18812,22050,0.0,4736.2,0,0,1,13,10,7,0,0,0,0,28550,6.0,28500,0,0,-18812,-22050,0.0,2855.0
4855541975,1,3,2,1,17,16,19,0,0,0,0,47021,10.0,47500,0,0,19421,19000,0.0,4702.1,26,0,0,10,11,6,0,0,0,0,27600,6.0,28500,4,0,-19421,-19000,0.4,2760.0
4855536826,1,75,0,0,24,14,20,0,0,0,0,64100,12.0,55000,0,0,26200,22000,0.0,6410.0,0,0,1,8,18,8,0,0,0,0,37900,7.2,33000,0,0,-26200,-22000,0.0,3790.0
4855234036,1,12,1,0,7,10,4,0,0,0,0,17173,7.0,17698,187,65,-1954,-441,25.2,1717.3,17,0,1,10,7,14,1,1,0,0,19127,6.8,18139,170,48,1954,441,21.8,1912.7
4855176599,0,15,1,1,9,6,7,0,0,0,0,17067,6.8,17526,155,56,1205,81,21.1,1706.7,16,2,0,6,9,2,1,1,0,0,15862,6.6,17445,191,44,-1205,-81,23.5,1586.2
4855128859,0,11,0,0,1,9,1,0,0,0,0,13980,6.6,16382,153,58,-5259,-3457,21.1,1398.0,12,0,1,9,1,5,0,0,0,0,19239,7.2,19839,224,56,5259,3457,28.0,1923.9
4855087887,0,1,0,0,17,34,29,0,0,0,1,34814,10.6,38188,86,0,-5635,-6002,8.6,3481.4,0,0,1,34,17,98,0,0,0,0,40449,11.8,44190,109,0,5635,6002,10.9,4044.9
4855053553,1,0,0,1,20,20,50,0,0,0,1,36756,10.8,37617,108,0,829,-1493,10.8,3675.6,0,0,0,20,20,65,0,0,0,0,35927,11.0,39110,95,0,-829,1493,9.5,3592.7
4855024333,0,0,0,0,31,35,61,0,0,0,0,38605,11.8,44624,97,0,-2263,453,9.7,3860.5,6,0,1,35,31,79,0,0,0,0,40868,11.8,44171,121,0,2263,-453,12.1,4086.8
4854341282,0,10,1,1,2,0,2,1,0,1,0,13961,6.8,17466,181,44,503,-629,22.5,1396.1,13,2,0,0,2,0,0,0,0,0,13458,6.8,18095,209,60,-503,629,26.9,1345.8
4854311421,0,11,1,0,1,2,0,0,0,0,0,14288,6.8,17990,224,64,-331,-287,28.8,1428.8,12,0,1,2,1,1,1,1,0,0,14619,6.8,18277,207,52,331,287,25.9,1461.9
4854289426,0,12,0,0,5,9,2,0,0,0,0,14668,6.8,16402,179,52,-3433,-2749,23.1,1466.8,12,0,1,9,5,8,0,0,0,0,18101,7.0,19151,207,46,3433,2749,25.3,1810.1
4854252149,0,15,0,0,9,7,3,0,0,0,0,16810,6.8,17031,180,44,494,-291,22.4,1681.0,9,0,1,7,9,3,0,0,0,0,16316,6.8,17322,185,44,-494,291,22.9,1631.6
4853906370,1,12,0,0,2,1,2,1,1,0,0,14391,7.0,18717,223,56,-288,397,27.9,1439.1,15,0,1,1,2,0,0,0,0,0,14679,6.8,18320,213,60,288,-397,27.3,1467.9
4853875212,1,6,1,1,16,14,18,0,0,0,0,61305,12.0,55000,0,0,24545,22000,0.0,6130.5,38,2,0,9,11,8,0,0,0,0,36760,7.2,33000,10,0,-24545,-22000,1.0,3676.0
4853238837,1,2,0,1,18,18,21,0,0,0,0,61765,12.0,55000,0,0,24160,22000,0.0,6176.5,0,0,0,13,13,10,0,0,0,0,37605,7.2,33000,0,0,-24160,-22000,0.0,3760.5
4853228452,1,2,0,1,20,17,20,0,0,0,0,62002,12.0,55000,0,0,23401,22000,0.0,6200.2,4,0,0,14,17,14,0,0,0,0,38601,7.2,33000,0,0,-23401,-22000,0.0,3860.1
4853221076,1,16,0,0,16,17,14,0,0,0,0,46375,10.0,47500,0,0,17466,19000,0.0,4637.5,0,0,1,10,9,14,0,0,0,0,28909,6.0,28500,0,0,-17466,-19000,0.0,2890.9
4849100080,0,0,0,1,23,27,37,0,0,0,0,36346,11.2,39236,115,0,-2153,-4725,11.5,3634.6,3,0,0,27,23,70,0,0,0,0,38499,11.8,43961,104,0,2153,4725,10.4,3849.9
4857103539,1,2,0,1,25,20,21,0,0,0,0,47700,10.0,47500,0,0,18986,19000,0.0,4770.0,0,0,0,10,15,7,0,0,0,0,28714,6.0,28500,0,0,-18986,-19000,0.0,2871.4
4857062988,1,3,0,1,17,15,15,0,0,0,0,47415,12.2,56000,1,0,20065,23000,0.1,4741.5,0,0,0,8,10,10,0,0,0,0,27350,7.2,33000,2,0,-20065,-23000,0.2,2735.0
4856759450,0,11,1,0,5,8,4,0,0,0,0,16282,7.0,17585,189,54,-919,-293,24.3,1628.2,16,1,1,8,5,6,0,0,0,0,17201,7.0,17878,195,50,919,293,24.5,1720.1
4856746084,1,38,1,1,8,4,8,0,0,0,0,17939,6.8,17155,182,48,2564,-768,23.0,1793.9,33,0,0,4,8,6,0,0,0,0,15375,7.0,17923,190,56,-2564,768,24.6,1537.5
4855832765,1,0,0,1,22,26,22,0,0,0,0,63400,12.6,59500,0,0,24100,22000,0.0,6340.0,8,0,0,16,12,17,0,0,0,0,39300,7.8,37500,0,0,-24100,-22000,0.0,3930.0
4853616810,1,19,0,0,17,11,15,0,0,0,0,46300,10.0,47500,0,0,19500,19000,0.0,4630.0,0,0,1,5,11,6,0,0,0,0,26800,6.0,28500,0,0,-19500,-19000,0.0,2680.0
4853578399,1,2,0,0,14,25,17,0,0,0,0,48207,10.0,47500,0,0,19307,19000,0.0,4820.7,0,0,1,18,7,12,0,0,0,0,28900,6.0,28500,0,0,-19307,-19000,0.0,2890.0
4853561947,1,0,0,0,15,13,14,0,0,0,0,48057,10.0,47500,2,0,20785,19000,0.2,4805.7,270,0,1,8,10,8,0,0,0,0,27272,6.0,28500,2,0,-20785,-19000,0.2,2727.2
4853496450,1,75,3,0,4,5,3,0,0,0,0,16524,7.2,18287,184,56,638,1179,24.0,1652.4,12,3,1,5,4,3,0,0,0,0,15886,6.8,17108,188,52,-638,-1179,24.0,1588.6
4853476867,0,13,2,1,1,2,2,0,0,0,0,14171,6.6,17231,210,48,-1905,-2108,25.8,1417.1,10,3,0,2,1,2,0,0,0,0,16076,7.4,19339,235,68,1905,2108,30.3,1607.6
4853389426,0,144,3,0,0,2,0,0,0,0,0,14696,7.2,18315,186,76,-1394,-466,26.2,1469.6,13,0,1,2,0,3,1,1,0,0,16090,7.0,18781,250,59,1394,466,30.9,1609.0
4853369497,0,11,2,0,2,7,2,1,0,1,0,13807,6.8,17040,166,50,-4564,-2339,21.6,1380.7,9,1,1,7,2,5,1,1,0,0,18371,7.4,19379,223,64,4564,2339,28.7,1837.1
4853341332,0,16,1,1,7,2,8,0,0,0,0,16530,6.4,16476,191,56,402,-1018,24.7,1653.0,10,1,0,2,7,2,1,1,0,0,16128,6.8,17494,201,52,-402,1018,25.3,1612.8
4853318234,1,0,3,1,17,21,15,0,0,0,0,62015,12.8,59000,0,0,23965,26000,0.0,6201.5,25,0,0,11,7,13,0,0,0,0,38050,7.2,33000,6,0,-23965,-26000,0.6,3805.0
4852573645,1,0,0,1,21,20,15,0,0,0,0,49100,12.0,55000,0,0,17100,22000,0.0,4910.0,0,0,0,12,13,14,0,0,0,0,32000,7.2,33000,0,0,-17100,-22000,0.0,3200.0
4852563177,1,25,0,0,21,19,16,0,0,0,0,64482,12.0,55000,0,0,26932,22000,0.0,6448.2,12,0,1,11,13,10,0,0,0,0,37550,7.2,33000,0,0,-26932,-22000,0.0,3755.0
4852538184,1,0,0,1,14,19,13,0,0,0,0,44900,10.0,47500,0,0,16000,19000,0.0,4490.0,32,0,0,12,7,10,0,0,0,0,28900,6.0,28500,0,0,-16000,-19000,0.0,2890.0
4852529899,1,23,0,0,21,20,22,0,0,0,0,63050,13.0,62500,0,0,25500,28000,0.0,6305.0,4,0,1,13,14,11,0,0,0,0,37550,7.4,34500,0,0,-25500,-28000,0.0,3755.0
4852512977,1,0,0,1,15,18,14,0,0,0,0,46620,10.0,47500,0,0,18746,19000,0.0,4662.0,0,0,0,12,9,12,0,0,0,0,27874,6.0,28500,0,0,-18746,-19000,0.0,2787.4
4851355517,1,256,2,1,3,2,2,0,0,0,0,16355,6.8,18258,200,52,1972,2048,25.2,1635.5,105,0,0,2,3,3,1,1,0,0,14383,6.6,16210,181,44,-1972,-2048,22.5,1438.3
4829578295,1,17,1,1,2,4,0,0,0,0,0,15021,6.6,17557,243,60,-259,-662,30.3,1502.1,8,2,0,4,2,3,0,0,0,0,15280,6.8,18219,208,52,259,662,26.0,1528.0
4826670456,0,35,4,1,6,3,7,0,0,0,0,17220,7.0,18557,234,64,264,541,29.8,1722.0,15,8,0,3,6,4,0,0,0,0,16956,7.2,18016,242,60,-264,-541,30.2,1695.6
4826293032,0,54,0,0,2,4,3,0,0,0,0,15110,7.0,18626,233,60,-1181,-229,29.3,1511.0,81,2,1,4,2,2,1,0,1,0,16291,7.0,18855,260,56,1181,229,31.6,1629.1
4825408337,0,31,1,0,3,8,3,0,0,0,0,15222,6.6,17343,212,52,-3893,-1872,26.4,1522.2,11,1,1,8,3,16,1,1,0,0,19115,7.0,19215,242,52,3893,1872,29.4,1911.5
4825372674,1,13,1,1,7,8,6,0,0,0,0,17751,7.4,19186,236,68,-439,690,30.4,1775.1,14,1,0,8,7,7,0,0,0,0,18190,7.0,18496,177,52,439,-690,22.9,1819.0
4825314874,1,17,3,0,4,9,5,0,0,0,0,15366,7.0,17040,206,48,-2679,-916,25.4,1536.6,13,2,1,9,4,11,0,0,0,0,18045,7.0,17956,223,48,2679,916,27.1,1804.5
4822883078,1,0,0,1,31,18,79,0,0,0,1,38897,11.6,43965,107,0,3557,5377,10.7,3889.7,0,0,0,16,29,32,0,0,0,0,35340,10.8,38588,102,0,-3557,-5377,10.2,3534.0
4822720035,1,13,0,0,2,8,0,1,1,0,0,15030,6.8,18061,207,56,-2819,-1811,26.3,1503.0,7,0,1,8,2,4,0,0,0,0,17849,7.4,19872,221,64,2819,1811,28.5,1784.9
4822695597,1,20,1,1,7,1,9,1,1,0,0,16098,6.8,17028,201,40,1962,-949,24.1,1609.8,15,2,0,1,7,0,0,0,0,0,14136,7.0,17977,225,62,-1962,949,28.7,1413.6
4820755764,1,30,1,1,5,7,5,0,0,0,0,16215,6.8,17439,211,48,-2,-219,25.9,1621.5,15,11,0,7,5,6,0,0,0,0,16217,7.0,17658,181,52,2,219,23.3,1621.7
4818888213,1,53,2,1,8,5,7,0,0,0,0,18276,7.0,18172,198,56,1247,72,25.4,1827.6,7,0,0,5,8,5,0,0,0,0,17029,7.2,18100,221,52,-1247,-72,27.3,1702.9
4818802985,1,64,1,1,3,2,2,0,0,0,0,15303,7.0,18929,209,44,-842,891,25.3,1530.3,16,3,0,2,3,2,0,0,0,0,16145,6.8,18038,217,52,842,-891,26.9,1614.5
4817943481,0,13,0,1,13,22,27,0,0,0,1,34011,10.8,38689,98,43,-3183,-2600,14.1,3401.1,5,1,0,22,13,39,0,0,0,0,37194,11.2,41289,87,79,3183,2600,16.6,3719.4
4817917235,0,13,0,0,7,2,4,0,0,0,0,16038,6.8,17226,193,40,566,-1142,23.3,1603.8,13,0,1,2,7,1,0,0,0,0,15472,7.0,18368,238,68,-566,1142,30.6,1547.2
4817880428,0,33,0,1,4,5,3,0,0,0,0,15318,7.0,17541,214,46,-1264,-820,26.0,1531.8,12,1,0,5,4,4,1,1,0,0,16582,7.0,18361,194,60,1264,820,25.4,1658.2
4817688529,0,12,2,1,7,12,5,0,0,0,0,16985,6.4,15865,173,56,-3549,-2627,22.9,1698.5,11,1,0,12,7,8,0,0,0,0,20534,7.0,18492,228,63,3549,2627,29.1,2053.4
4817637487,1,11,2,1,7,1,9,1,1,0,0,16492,6.8,17929,186,52,2561,732,23.8,1649.2,30,0,0,1,7,0,0,0,0,0,13931,6.8,17197,218,56,-2561,-732,27.4,1393.1
4817622981,1,13,3,0,4,4,3,2,1,1,0,16295,7.0,18236,216,68,-838,617,28.4,1629.5,11,0,1,4,4,7,0,0,0,0,17133,6.8,17619,221,56,838,-617,27.7,1713.3
4816352810,0,90,0,0,22,23,46,0,0,0,0,34319,10.8,39546,73,0,-3928,-2034,7.3,3431.9,10,0,1,23,22,69,0,0,0,0,38247,11.4,41580,118,0,3928,2034,11.8,3824.7
4816319198,1,17,2,1,3,6,2,0,0,0,0,15293,7.0,18010,201,59,17,762,26.0,1529.3,10,0,0,6,3,5,0,0,0,0,15276,6.8,17248,204,32,-17,-762,23.6,1527.6
4849258967,0,12,1,1,5,7,5,0,0,0,0,16579,6.6,16106,217,43,-1047,-1654,26.0,1657.9,11,2,0,7,5,5,0,0,0,0,17626,7.0,17760,195,60,1047,1654,25.5,1762.6
4849225612,1,11,0,0,6,8,6,0,0,0,0,16828,7.0,18320,180,68,-723,138,24.8,1682.8,12,0,1,8,6,3,1,1,0,0,17551,7.0,18182,208,44,723,-138,25.2,1755.1
4849208092,1,29,0,0,1,6,0,0,0,0,0,14752,6.8,16592,184,52,-1525,-1864,23.6,1475.2,27,1,1,6,1,3,0,0,0,0,16277,6.8,18456,213,48,1525,1864,26.1,1627.7
4848219146,0,26,0,0,1,3,1,0,0,0,0,13571,6.8,17226,186,44,-1878,-2410,23.0,1357.1,32,0,1,3,1,1,0,0,0,0,15449,7.2,19636,225,67,1878,2410,29.2,1544.9
4848185244,0,176,1,0,5,3,6,0,0,0,0,15119,6.4,16344,177,49,-669,-1148,22.6,1511.9,64,1,1,3,5,2,0,0,0,0,15788,6.6,17492,213,53,669,1148,26.6,1578.8
4845366253,1,0,0,1,31,17,72,0,0,0,0,39930,11.8,43963,114,0,4996,7787,11.4,3993.0,0,0,0,17,31,47,0,0,0,0,34934,10.4,36176,91,0,-4996,-7787,9.1,3493.4
4845339468,1,15,2,0,4,5,7,0,0,0,0,16021,6.8,17060,184,60,-541,248,24.4,1602.1,14,1,1,5,4,8,1,1,0,0,16562,6.4,16812,221,32,541,-248,25.3,1656.2
4845321907,1,47,0,1,4,5,1,0,0,0,0,15159,7.2,18818,188,68,-178,1029,25.6,1515.9,9,0,0,5,4,2,0,0,0,0,15337,6.8,17789,215,68,178,-1029,28.3,1533.7
4845295617,0,0,0,1,22,30,54,0,0,0,0,37066,11.4,41423,92,0,-293,263,9.2,3706.6,0,0,0,30,22,82,0,0,0,0,37359,11.0,41160,107,0,293,-263,10.7,3735.9
4845256389,1,11,2,1,5,10,2,0,0,0,0,15757,6.8,16318,203,40,-2838,-2902,24.3,1575.7,12,1,0,10,5,8,0,0,0,0,18595,7.0,19220,223,48,2838,2902,27.1,1859.5
4844437143,0,3,0,0,29,30,74,0,0,0,1,39304,11.6,43089,118,0,-354,-1632,11.8,3930.4,24,0,1,30,29,75,0,0,0,0,39658,11.8,44721,111,0,354,1632,11.1,3965.8
4844397749,1,8,1,0,7,11,4,0,0,0,0,16931,6.8,18179,208,48,-1526,634,25.6,1693.1,83,0,1,11,7,11,1,0,1,0,18457,6.8,17545,170,60,1526,-634,23.0,1845.7
4844306421,1,12,4,1,7,1,3,1,1,0,0,16294,6.8,17663,213,44,1915,345,25.7,1629.4,14,0,0,1,7,1,1,0,1,0,14379,6.8,17318,210,56,-1915,-345,26.6,1437.9
4841578558,1,61,0,1,4,3,6,1,1,0,0,15955,6.8,18102,194,48,1302,251,24.2,1595.5,12,0,0,3,4,2,0,0,0,0,14653,6.8,17851,184,48,-1302,-251,23.2,1465.3
4841548397,0,18,1,1,2,4,4,0,0,0,0,14960,6.8,17239,200,52,-1109,-885,25.2,1496.0,82,1,0,4,2,4,1,1,0,0,16069,7.0,18124,216,56,1109,885,27.2,1606.9
4840521061,1,15,1,1,7,5,12,0,0,0,0,17399,6.6,17164,226,56,1513,-964,28.2,1739.9,13,0,0,5,7,6,1,1,0,0,15886,7.0,18128,237,56,-1513,964,29.3,1588.6
4840490574,0,19,0,1,2,5,1,0,0,0,0,14785,7.0,17203,227,48,-279,218,27.5,1478.5,11,1,0,5,2,7,1,1,0,0,15064,6.4,16985,178,56,279,-218,23.4,1506.4
4840143784,1,98,1,0,8,4,12,1,1,0,0,16955,7.0,17696,219,60,3088,1133,27.9,1695.5,9,0,1,4,8,2,0,0,0,0,13867,6.8,16563,153,43,-3088,-1133,19.6,1386.7
4840030449,0,8,0,1,9,6,10,0,0,0,0,18367,7.2,19598,235,40,1875,1310,27.5,1836.7,13,0,0,6,9,2,0,0,0,0,16492,7.2,18288,217,60,-1875,-1310,27.7,1649.2
4839376812,1,82,0,0,7,6,4,0,0,0,0,16848,7.4,19480,195,68,848,249,26.3,1684.8,10,0,1,6,7,3,1,1,0,0,16000,7.2,19231,210,55,-848,-249,26.5,1600.0
4856591076,1,3,0,1,34,17,92,0,0,0,2,42234,11.4,42862,93,0,6325,4242,9.3,4223.4,0,0,0,17,34,45,0,0,0,0,35909,10.8,38620,80,0,-6325,-4242,8.0,3590.9
4856581930,1,0,0,1,22,10,55,0,0,0,0,36984,11.0,40002,99,0,2965,4380,9.9,3698.4,0,0,0,10,22,21,0,0,0,0,34019,10.2,35622,93,0,-2965,-4380,9.3,3401.9
4856549716,0,13,0,0,2,1,1,0,0,0,0,14095,6.8,17504,191,56,-2566,-1023,24.7,1409.5,12,2,1,1,2,1,0,0,0,0,16661,7.0,18527,237,48,2566,1023,28.5,1666.1
4856515881,0,30,2,0,1,3,0,0,0,0,0,13926,6.6,17074,198,56,-1424,-1710,25.4,1392.6,10,13,1,3,1,2,0,0,0,0,15350,7.0,18784,206,61,1424,1710,26.7,1535.0
4856467704,0,11,2,0,4,3,6,0,0,0,0,16005,6.8,17760,181,55,235,380,23.6,1600.5,13,4,1,3,4,4,0,0,0,0,15770,6.4,17380,258,42,-235,-380,30.0,1577.0
4856441010,1,35,0,1,21,9,19,0,0,0,0,49100,10.0,47500,0,0,23000,19000,0.0,4910.0,0,0,0,3,15,5,0,0,0,0,26100,6.0,28500,0,0,-23000,-19000,0.0,2610.0
4856421761,0,0,0,0,21,21,52,0,0,0,1,36636,11.0,40324,108,0,-839,1164,10.8,3663.6,3,0,1,21,21,51,0,0,0,0,37475,10.8,39160,118,0,839,-1164,11.8,3747.5
4856397945,1,0,0,1,28,18,71,0,0,0,1,39255,11.8,42663,103,0,1942,3142,10.3,3925.5,23,0,0,18,28,40,0,0,0,0,37313,11.0,39521,104,0,-1942,-3142,10.4,3731.3
4855460920,0,9,0,1,5,4,8,0,0,0,0,15883,7.0,17957,221,60,214,-179,28.1,1588.3,8,0,0,4,5,3,1,1,0,0,15669,6.8,18136,238,36,-214,179,27.4,1566.9
4855431081,0,9,2,0,2,8,0,0,0,0,0,14048,6.8,17309,191,52,-4153,-1489,24.3,1404.8,10,1,1,8,2,7,1,1,0,0,18201,7.2,18798,228,56,4153,1489,28.4,1820.1
4855399265,0,156,1,0,3,5,4,1,1,0,0,14241,6.8,16238,203,48,-3405,-2552,25.1,1424.1,12,3,1,5,3,2,0,0,0,0,17646,7.0,18790,238,61,3405,2552,29.9,1764.6
4855351003,0,12,1,1,7,4,8,0,0,0,0,17073,7.2,18843,219,54,2612,1758,27.3,1707.3,8,1,0,4,7,6,0,0,0,0,14461,6.8,17085,204,40,-2612,-1758,24.4,1446.1
4855303736,1,13,1,1,7,9,6,1,1,0,0,17958,6.8,18372,197,48,-44,-225,24.5,1795.8,11,2,0,9,7,5,0,0,0,0,18002,7.0,18597,173,64,44,225,23.7,1800.2
4855251685,1,0,0,1,19,13,16,0,0,0,0,47155,10.0,47500,0,0,20005,19000,0.0,4715.5,0,0,0,5,11,9,0,0,0,0,27150,6.0,28500,0,0,-20005,-19000,0.0,2715.0
4855227552,1,39,3,1,21,16,20,0,0,0,0,62890,12.0,55000,5,0,27004,22000,0.5,6289.0,0,1,0,6,11,9,0,0,0,0,35886,7.2,33000,1,0,-27004,-22000,0.1,3588.6
4855204387,1,7,0,0,19,22,18,0,0,0,0,63478,12.0,55000,0,0,24866,22000,0.0,6347.8,0,0,1,13,10,12,0,0,0,0,38612,7.2,33000,1,0,-24866,-22000,0.1,3861.2
4855173556,1,0,0,1,12,23,18,0,0,0,0,61300,12.0,55000,0,0,22000,22000,0.0,6130.0,14,0,0,16,5,14,0,0,0,0,39300,7.2,33000,0,1,-22000,-22000,0.1,3930.0
4855157062,1,0,0,1,23,19,26,0,0,0,0,70723,15.0,70000,3,0,32673,31000,0.3,7072.3,3,0,0,10,14,10,0,0,0,0,38050,8.2,39000,0,0,-32673,-31000,0.0,3805.0
4855126534,1,7,0,0,17,12,16,0,0,0,0,61300,12.0,55000,0,0,25500,22000,0.0,6130.0,0,0,1,7,12,6,0,0,0,0,35800,7.2,33000,0,0,-25500,-22000,0.0,3580.0
4837961853,0,12,18,1,6,7,5,0,0,0,0,17336,7.2,18169,212,62,119,-656,27.4,1733.6,40,1,0,7,6,5,1,1,0,0,17217,7.0,18825,220,50,-119,656,27.0,1721.7
4833803880,0,15,4,1,4,5,6,1,1,0,0,16061,6.8,16936,194,44,-1391,-1986,23.8,1606.1,14,2,0,5,4,6,0,0,0,0,17452,7.2,18922,209,72,1391,1986,28.1,1745.2
4833176215,0,13,0,0,2,6,1,0,0,0,0,14106,6.8,17452,216,52,-2441,-1836,26.8,1410.6,11,1,1,6,2,2,1,1,0,0,16547,7.2,19288,271,57,2441,1836,32.8,1654.7
4829393950,1,12,4,1,8,2,11,0,0,0,0,16695,6.6,16740,191,49,1378,-864,24.0,1669.5,90,1,0,2,8,1,1,1,0,0,15317,7.0,17604,216,42,-1378,864,25.8,1531.7
4829358612,0,90,3,1,4,8,4,0,0,0,0,16797,6.8,17134,199,44,425,-772,24.3,1679.7,12,4,0,8,4,3,1,1,0,0,16372,6.8,17906,211,56,-425,772,26.7,1637.2
4829320658,0,13,0,0,5,9,4,0,0,0,0,15987,6.8,17884,200,58,-1705,512,25.8,1598.7,10,0,1,9,5,6,0,0,0,0,17692,6.8,17372,191,52,1705,-512,24.3,1769.2
4829306258,0,47,4,0,2,11,3,0,0,0,0,14218,6.4,15936,183,56,-6103,-3556,23.9,1421.8,13,2,1,11,2,8,1,0,1,0,20321,7.2,19492,223,56,6103,3556,27.9,2032.1
4828321692,0,14,0,0,4,7,4,0,0,0,0,16136,7.0,18498,219,64,-753,-393,28.3,1613.6,180,1,1,7,4,7,1,1,0,0,16889,7.2,18891,223,58,753,393,28.1,1688.9
4822873548,0,7,11,0,3,5,4,0,0,0,0,15883,7.0,17497,244,40,-1473,-1367,28.4,1588.3,34,0,1,5,3,5,1,1,0,0,17356,7.4,18864,198,64,1473,1367,26.2,1735.6
4822756517,1,14,3,1,6,2,5,1,1,0,0,16548,7.0,18474,234,46,1640,743,28.0,1654.8,14,3,0,2,6,2,0,0,0,0,14908,6.8,17731,247,48,-1640,-743,29.5,1490.8
4822675674,0,7,0,0,1,5,0,0,0,0,0,12877,6.6,16077,180,52,-4245,-3628,23.2,1287.7,75,0,1,5,1,4,1,1,0,0,17122,7.2,19705,236,68,4245,3628,30.4,1712.2
4822650289,0,37,2,0,8,9,8,0,0,0,0,17480,7.0,18308,165,59,-1207,-727,22.4,1748.0,10,7,1,9,8,6,1,1,0,0,18687,7.2,19035,227,80,1207,727,30.7,1868.7
4820018817,0,14,2,0,3,4,3,0,0,0,0,16215,7.2,18521,246,51,525,899,29.7,1621.5,14,1,1,4,3,5,1,1,0,0,15690,6.8,17622,214,56,-525,-899,27.0,1569.0
4818704214,1,14,2,1,6,0,6,1,1,0,0,18071,7.0,18372,215,52,4240,1534,26.7,1807.1,10,1,0,0,6,0,1,0,1,0,13831,6.6,16838,206,52,-4240,-1534,25.8,1383.1
4816893825,0,12,4,1,3,0,5,0,0,0,0,15325,7.0,17952,200,57,1056,465,25.7,1532.5,20,1,0,0,3,0,0,0,0,0,14269,7.0,17487,203,64,-1056,-465,26.7,1426.9
4816140162,0,12,2,0,4,6,3,0,0,0,0,15615,6.6,17083,211,40,-1524,-1871,25.1,1561.5,12,0,1,6,4,7,1,1,0,0,17139,7.2,18954,198,58,1524,1871,25.6,1713.9
4816102239,1,12,2,1,3,2,6,0,0,0,0,15584,6.6,17735,211,52,-76,-333,26.3,1558.4,11,1,0,2,3,2,0,0,0,0,15660,7.0,18068,225,52,76,333,27.7,1566.0
4816061774,1,9,1,0,5,9,6,2,1,1,0,16259,7.0,17713,191,52,-2162,331,24.3,1625.9,13,0,1,9,5,7,0,0,0,0,18421,6.6,17382,202,56,2162,-331,25.8,1842.1
4813922339,0,35,2,0,3,3,4,1,1,0,0,15673,7.0,19117,232,60,32,-398,29.2,1567.3,15,10,1,3,3,2,1,0,1,0,15641,7.2,19515,240,69,-32,398,30.9,1564.1
4813895136,1,18,3,1,5,3,5,0,0,0,0,17462,7.0,18576,251,48,2307,777,29.9,1746.2,13,2,0,3,5,3,1,1,0,0,15155,6.8,17799,215,52,-2307,-777,26.7,1515.5
4850451135,0,11,3,0,10,9,10,0,0,0,0,18106,6.6,17806,210,48,62,99,25.8,1810.6,73,2,1,8,9,6,0,0,0,0,18044,6.8,17707,225,51,-62,-99,27.6,1804.4
4850427533,1,9,0,0,1,7,1,0,0,0,0,13912,6.4,16116,194,56,-3060,-2413,25.0,1391.2,64,0,1,7,1,5,0,0,0,0,16972,7.0,18529,222,60,3060,2413,28.2,1697.2
4846425959,0,17,4,1,6,2,3,1,1,0,0,15775,6.8,17008,177,56,1169,-1092,23.3,1577.5,20,3,0,2,6,4,0,0,0,0,14606,7.0,18100,188,59,-1169,1092,24.7,1460.6
4846415866,0,11,1,1,6,11,7,0,0,0,0,15928,6.6,16212,170,40,-3553,-2944,21.0,1592.8,10,3,0,11,6,8,0,0,0,0,19481,7.0,19156,217,62,3553,2944,27.9,1948.1
4825326085,0,9,18,1,12,10,24,0,0,0,0,31459,10.8,38287,96,49,5,-221,14.5,3145.9,46,0,0,10,12,17,0,0,0,0,31454,10.8,38508,84,70,-5,221,15.4,3145.4
4825304657,0,33,0,1,10,14,12,0,0,0,0,32272,10.4,34856,109,51,-673,-3012,16.0,3227.2,11,21,0,14,10,29,0,0,0,0,32945,10.6,37868,60,71,673,3012,13.1,3294.5
4823903429,0,13,1,1,1,3,0,0,0,0,0,12898,6.8,17643,135,60,-3106,-466,19.5,1289.8,10,0,0,3,1,3,0,0,0,0,16004,6.8,18109,205,56,3106,466,26.1,1600.4
4823856858,0,189,0,1,3,3,6,0,0,0,0,13922,6.6,16218,188,48,-1343,-1385,23.6,1392.2,16,1,0,3,3,2,1,0,1,0,15265,6.8,17603,211,40,1343,1385,25.1,1526.5
4823815274,1,10,0,0,4,2,2,1,1,0,0,14856,6.8,18497,167,48,1714,2151,21.5,1485.6,6,1,1,2,4,1,0,0,0,0,13142,6.6,16346,162,48,-1714,-2151,21.0,1314.2
4814089803,0,15,1,0,9,18,15,0,0,0,0,36347,11.2,41472,118,63,453,-933,18.1,3634.7,12,0,1,18,9,30,0,0,0,0,35894,11.4,42405,131,56,-453,933,18.7,3589.4
4814067973,0,44,0,0,8,18,21,0,0,0,1,31982,10.8,38801,72,58,-4634,-3840,13.0,3198.2,46,1,1,18,8,34,0,0,0,0,36616,11.6,42641,105,63,4634,3840,16.8,3661.6
4814020516,1,25,0,0,17,11,22,0,0,0,1,35238,11.0,39091,103,71,-297,-1535,17.4,3523.8,14,0,1,11,17,12,0,0,0,0,35535,11.2,40626,117,55,297,1535,17.2,3553.5
4814001718,1,7,1,0,27,19,69,0,0,0,2,40906,12.4,47137,90,71,2991,6282,16.1,4090.6,12,0,1,18,26,26,0,0,0,0,37915,11.2,40855,89,63,-2991,-6282,15.2,3791.5
4813886175,0,25,1,0,5,20,9,0,0,0,2,29175,10.0,31540,66,39,-9015,-10450,10.5,2917.5,18,0,1,20,5,32,0,0,0,0,38190,11.4,41990,99,75,9015,10450,17.4,3819.0
4813872333,1,12,0,1,17,9,36,0,0,0,0,35172,11.0,39384,96,63,2079,-611,15.9,3517.2,10,1,0,9,17,18,0,0,0,0,33093,11.0,39995,84,67,-2079,611,15.1,3309.3
4813855358,0,11,1,0,6,15,7,0,0,0,0,34938,10.6,36541,123,43,-1131,-4182,16.6,3493.8,9,0,1,15,6,24,0,0,0,0,36069,11.4,40723,101,61,1131,4182,16.2,3606.9
4812073173,0,68,0,0,16,14,48,0,0,0,0,37161,11.4,40788,107,64,4354,1873,17.1,3716.1,29,16,1,14,16,31,0,0,0,0,32807,10.8,38915,100,59,-4354,-1873,15.9,3280.7
4800737089,0,9,2,0,0,2,0,1,1,0,0,13807,6.8,17609,224,44,-1065,-1454,26.8,1380.7,13,1,1,2,0,1,0,0,0,0,14872,7.2,19063,217,68,1065,1454,28.5,1487.2
4800667583,1,9,4,1,7,1,8,1,1,0,0,16465,7.0,18176,217,56,2037,1654,27.3,1646.5,16,1,0,1,7,1,1,0,1,0,14428,6.6,16522,189,48,-2037,-1654,23.7,1442.8
4851695988,1,19,1,0,7,7,7,0,0,0,0,17017,6.8,16966,195,50,-538,-737,24.5,1701.7,10,1,1,7,7,7,0,0,0,0,17555,6.8,17703,198,47,538,737,24.5,1755.5
4851667149,0,23,3,0,1,8,3,0,0,0,0,14234,6.4,16298,191,58,-3967,-2202,24.9,1423.4,16,1,1,8,1,11,0,0,0,0,18201,6.8,18500,226,57,3967,2202,28.3,1820.1
4851628881,1,12,1,1,10,5,10,0,0,0,0,18858,7.4,19595,210,59,3338,3280,26.9,1885.8,22,3,0,5,10,5,0,0,0,0,15520,6.6,16315,210,40,-3338,-3280,25.0,1552.0
4847861084,1,11,2,0,7,8,3,0,0,0,0,17108,6.8,18067,210,60,230,942,27.0,1710.8,15,1,1,8,7,7,1,0,1,0,16878,6.6,17125,209,40,-230,-942,24.9,1687.8
4767057883,1,15,2,1,3,2,2,1,1,0,0,15592,7.4,20154,210,84,1626,2548,29.4,1559.2,10,3,0,2,3,2,0,0,0,0,13966,6.8,17606,193,39,-1626,-2548,23.2,1396.6
4677614819,1,13,0,0,4,8,4,0,0,0,0,15014,6.4,15992,179,45,-1646,-1566,22.4,1501.4,10,0,1,8,4,7,0,0,0,0,16660,6.8,17558,234,42,1646,1566,27.6,1666.0
4677585756,0,12,1,0,2,6,2,0,0,0,0,14437,6.8,17903,203,51,-1664,641,25.4,1443.7,12,1,1,6,2,6,1,1,0,0,16101,6.8,17262,210,56,1664,-641,26.6,1610.1
4676148066,1,25,3,0,8,2,6,0,0,0,0,17356,7.0,17683,211,55,3414,2058,26.6,1735.6,29,3,1,2,8,2,0,0,0,0,13942,6.2,15625,179,50,-3414,-2058,22.9,1394.2
4584892266,0,0,0,0,14,25,36,0,0,0,2,35697,10.6,37059,86,0,-1254,-2383,8.6,3569.7,0,0,1,25,14,78,0,0,0,0,36951,11.0,39442,96,0,1254,2383,9.6,3695.1
4584860727,1,0,0,1,39,24,90,0,0,0,1,42220,11.8,46619,95,0,3560,5964,9.5,4222.0,0,0,0,24,39,46,0,0,0,0,38660,11.0,40655,100,0,-3560,-5964,10.0,3866.0
4583902471,0,0,3,1,7,3,7,0,0,0,0,16643,6.8,17464,178,52,2190,-764,23.0,1664.3,0,0,0,3,7,2,1,1,0,0,14453,7.2,18228,202,48,-2190,764,25.0,1445.3
4583872454,1,0,2,1,2,2,3,1,1,0,0,14538,7.0,18119,195,44,812,896,23.9,1453.8,0,4,0,2,2,0,0,0,0,0,13726,6.8,17223,198,44,-812,-896,24.2,1372.6
4583136039,0,0,0,0,13,31,12,0,0,0,2,33233,10.0,33895,212,20,-11831,-2694,23.2,3323.3,0,0,1,31,13,32,1,1,0,0,45064,10.6,36589,232,60,11831,2694,29.2,4506.4
4583113353,0,0,2,1,18,17,21,0,0,0,0,35599,10.2,33685,244,3,-450,80,24.7,3559.9,0,0,0,17,18,11,0,0,0,0,36049,10.0,33605,221,4,450,-80,22.5,3604.9
4583092263,1,0,2,1,17,15,19,1,1,0,1,36513,9.8,31654,210,12,2567,-372,22.2,3651.3,0,7,0,14,16,10,0,0,0,0,33946,9.6,32026,217,16,-2567,372,23.3,3394.6
4583072811,0,0,1,1,25,22,23,1,1,0,4,42144,10.4,36641,218,24,2157,577,24.2,4214.4,0,3,0,22,25,20,0,0,0,0,39987,10.2,36064,233,27,-2157,-577,26.0,3998.7
4583035617,1,0,2,0,16,5,29,0,0,0,0,34773,9.2,29408,170,14,7142,3226,18.4,3477.3,0,1,1,5,16,6,1,1,0,0,27631,8.8,26182,148,40,-7142,-3226,18.8,2763.1
4583022817,1,0,0,1,22,21,56,0,0,0,0,37212,11.0,40648,104,0,698,1271,10.4,3721.2,0,0,0,21,22,48,0,0,0,0,36514,11.0,39377,118,0,-698,-1271,11.8,3651.4
4582995292,1,0,0,0,19,23,55,0,0,0,1,35070,10.8,37647,93,0,-3564,-3105,9.3,3507.0,0,0,1,23,19,60,0,0,0,0,38634,11.2,40752,113,0,3564,3105,11.3,3863.4
4582979319,0,0,0,0,13,26,25,0,0,0,1,34171,10.8,37897,96,0,-3673,-3971,9.6,3417.1,0,0,1,26,13,80,0,0,0,0,37844,11.2,41868,119,0,3673,3971,11.9,3784.4
4838668634,0,13,3,1,5,3,2,1,0,1,0,16521,7.2,18183,220,66,-478,623,28.6,1652.1,16,1,0,3,5,4,1,1,0,0,16999,6.8,17560,229,66,478,-623,29.5,1699.9
4838646463,0,12,1,0,4,7,3,0,0,0,0,15885,6.8,16953,206,50,-512,257,25.6,1588.5,54,0,1,7,4,9,1,1,0,0,16397,6.8,16696,174,49,512,-257,22.3,1639.7
4837759138,1,13,1,0,2,5,2,1,1,0,0,14851,6.8,16928,219,56,-2432,-1867,27.5,1485.1,16,0,1,5,2,3,0,0,0,0,17283,7.2,18795,228,49,2432,1867,27.7,1728.3
4837730903,1,15,5,1,13,5,13,0,0,0,0,20385,7.4,19107,218,47,4414,1990,26.5,2038.5,12,1,0,5,13,5,1,1,0,0,15971,6.6,17117,192,64,-4414,-1990,25.6,1597.1
4837697234,0,48,0,0,6,8,8,1,0,1,0,16941,7.0,18277,217,60,-1001,278,27.7,1694.1,11,0,1,8,6,19,0,0,0,0,17942,6.8,17999,224,59,1001,-278,28.3,1794.2
4837666662,0,12,3,1,2,4,2,1,1,0,0,15958,7.0,18415,232,66,1297,881,29.8,1595.8,25,3,0,4,2,4,0,0,0,0,14661,6.8,17534,181,50,-1297,-881,23.1,1466.1
4837640273,1,10,0,0,4,9,2,0,0,0,0,15365,7.2,18364,202,68,-2540,557,27.0,1536.5,10,1,1,9,4,8,1,1,0,0,17905,7.0,17807,226,47,2540,-557,27.3,1790.5
4824572754,1,15,3,0,9,4,7,0,0,0,0,19737,7.0,18046,225,40,4379,1855,26.5,1973.7,16,1,1,4,9,6,0,0,0,0,15358,6.4,16191,190,60,-4379,-1855,25.0,1535.8
4809377773,1,11,0,1,12,9,20,1,1,0,0,19657,6.8,17449,188,55,1543,-2427,24.3,1965.7,4,1,0,9,12,13,0,0,0,0,18114,7.4,19876,252,52,-1543,2427,30.4,1811.4
4804054806,1,12,1,1,12,9,10,0,0,0,0,19638,6.8,17902,198,52,2228,251,25.0,1963.8,15,2,0,9,12,5,1,0,1,0,17410,6.8,17651,195,44,-2228,-251,23.9,1741.0
4765714975,0,13,0,0,3,6,5,0,0,0,0,14467,6.8,17167,169,52,-2377,-677,22.1,1446.7,12,2,1,6,3,7,1,1,0,0,16844,7.0,17844,202,60,2377,677,26.2,1684.4
4754824822,1,10,1,1,5,5,3,0,0,0,0,15808,6.8,17636,192,48,348,51,24.0,1580.8,10,0,0,5,5,4,0,0,0,0,15460,6.8,17585,186,68,-348,-51,25.4,1546.0
4753001764,0,15,0,1,7,10,7,1,1,0,0,17275,6.6,15847,178,40,-1620,-2726,21.8,1727.5,13,1,0,10,7,8,1,0,1,0,18895,7.0,18573,183,64,1620,2726,24.7,1889.5
4752959176,1,16,3,1,6,4,7,0,0,0,0,18048,6.8,17398,205,52,1671,1369,25.7,1804.8,59,3,0,4,6,7,0,0,0,0,16377,6.6,16029,184,50,-1671,-1369,23.4,1637.7
4746044098,1,0,0,1,22,13,22,0,0,0,0,64700,13.0,62500,0,0,28900,28000,0.0,6470.0,0,0,0,6,15,5,0,0,0,0,35800,7.4,34500,0,0,-28900,-28000,0.0,3580.0
4745866298,1,16,0,1,20,22,25,0,0,0,0,67350,12.0,55000,2,0,27000,22000,0.2,6735.0,0,0,0,12,10,10,0,0,0,0,40350,7.2,33000,0,0,-27000,-22000,0.0,4035.0
4742810194,1,18,2,1,10,9,12,0,0,0,0,19366,6.8,16907,204,44,1663,354,24.8,1936.6,13,5,0,9,10,15,1,1,0,0,17703,6.6,16553,177,63,-1663,-354,24.0,1770.3
4717930456,0,48,0,1,10,6,4,1,1,0,0,16873,6.8,17202,171,55,39,-412,22.6,1687.3,14,0,0,6,10,5,0,0,0,0,16834,6.8,17614,226,48,-39,412,27.4,1683.4
4707589946,1,12,2,0,8,4,8,1,1,0,0,18788,6.6,18044,227,51,2620,974,27.8,1878.8,10,1,1,4,8,6,0,0,0,0,16168,6.6,17070,187,48,-2620,-974,23.5,1616.8
4857166261,1,0,0,1,24,12,23,0,0,0,0,63400,12.0,55000,0,0,28300,22000,0.0,6340.0,2,0,0,3,15,6,0,0,0,0,35100,7.2,33000,0,0,-28300,-22000,0.0,3510.0
4857141149,1,0,0,0,14,16,17,0,0,0,0,60600,12.0,55000,0,0,22700,22000,0.0,6060.0,0,0,1,11,9,9,0,0,0,0,37900,7.2,33000,0,0,-22700,-22000,0.0,3790.0
4857117636,1,0,2,1,14,16,18,0,0,0,0,47389,10.0,47500,0,0,20179,19000,0.0,4738.9,27,2,0,11,9,9,0,0,0,0,27210,6.0,28500,2,0,-20179,-19000,0.2,2721.0
4857102910,1,3,0,1,22,13,14,0,0,0,0,63400,12.0,55000,0,0,28300,22000,0.0,6340.0,95,0,0,2,11,8,0,0,0,0,35100,7.2,33000,0,0,-28300,-22000,0.0,3510.0
4857082740,1,0,0,1,15,13,14,0,0,0,0,45600,10.0,47500,0,0,17375,19000,0.0,4560.0,0,0,0,7,9,9,0,0,0,0,28225,6.0,28500,1,0,-17375,-19000,0.1,2822.5
4857059362,1,1,0,1,12,20,9,0,0,0,0,59550,12.0,55000,0,0,21300,21000,0.0,5955.0,0,0,0,14,6,16,0,0,0,0,38250,7.4,34000,0,0,-21300,-21000,0.0,3825.0
4857043747,1,0,0,0,20,19,15,0,0,0,0,66115,12.0,55000,0,0,28565,22000,0.0,6611.5,0,0,1,10,11,12,0,0,0,0,37550,7.2,33000,0,0,-28565,-22000,0.0,3755.0
4841138684,1,12,0,1,8,5,8,0,0,0,0,18406,7.4,19960,255,56,2094,2334,31.1,1840.6,12,0,0,5,8,5,0,0,0,0,16312,6.8,17626,210,44,-2094,-2334,25.4,1631.2
4841109984,0,11,0,0,7,6,4,1,1,0,0,15578,6.6,17257,192,52,-1418,-1365,24.4,1557.8,12,2,1,6,7,9,1,0,1,0,16996,7.4,18622,230,55,1418,1365,28.5,1699.6
4841078672,0,69,1,0,0,5,0,0,0,0,0,13263,6.8,16579,203,52,-3832,-1822,25.5,1326.3,22,0,1,5,0,7,2,1,1,0,17095,7.2,18401,196,60,3832,1822,25.6,1709.5
4841052084,0,9,0,1,6,6,5,1,1,0,0,16676,7.0,17982,184,64,-1575,-1190,24.8,1667.6,7,2,0,6,6,5,0,0,0,0,18251,7.0,19172,207,60,1575,1190,26.7,1825.1
4841003392,1,13,2,1,3,0,4,1,1,0,0,14404,6.8,17190,183,52,104,-720,23.5,1440.4,109,2,0,0,3,0,1,0,1,0,14300,7.0,17910,229,68,-104,720,29.7,1430.0
4840969810,1,13,1,0,8,10,11,0,0,0,0,17917,6.6,17293,188,55,210,524,24.3,1791.7,11,1,1,10,8,8,0,0,0,0,17707,6.6,16769,226,43,-210,-524,26.9,1770.7
4840938873,0,11,1,0,3,7,3,0,0,0,0,14526,6.6,15976,186,40,-3169,-2642,22.6,1452.6,69,1,1,7,3,6,1,1,0,0,17695,7.0,18618,202,56,3169,2642,25.8,1769.5
4840901168,0,95,0,1,4,3,4,0,0,0,0,17059,7.0,17984,247,44,-325,-962,29.1,1705.9,9,2,0,3,4,3,0,0,0,0,17384,7.0,18946,216,56,325,962,27.2,1738.4
4840870086,0,12,4,0,6,9,7,1,1,0,0,15638,6.8,16652,195,56,-1742,-831,25.1,1563.8,12,0,1,9,6,7,0,0,0,0,17380,6.8,17483,229,48,1742,831,27.7,1738.0
4840099332,0,10,0,0,1,3,1,1,1,0,0,15509,7.2,19215,229,60,-489,680,28.9,1550.9,13,0,1,3,1,3,0,0,0,0,15998,7.0,18535,228,64,489,-680,29.2,1599.8
4840046849,1,51,3,1,4,2,4,0,0,0,0,16743,6.8,19068,214,62,2692,2607,27.6,1674.3,11,0,0,2,4,3,0,0,0,0,14051,6.6,16461,209,46,-2692,-2607,25.5,1405.1
4840013912,0,12,0,1,2,3,1,0,0,0,0,13622,6.6,16726,181,48,-1522,-944,22.9,1362.2,104,0,0,3,2,1,0,0,0,0,15144,6.8,17670,180,56,1522,944,23.6,1514.4
4839972608,1,13,3,1,3,3,3,0,0,0,0,15689,6.6,17820,213,63,94,374,27.6,1568.9,16,2,0,3,3,5,1,1,0,0,15595,6.6,17446,226,52,-94,-374,27.8,1559.5
4850937459,0,8,1,0,8,10,9,1,1,0,0,17301,6.8,17828,202,52,-1669,-1011,25.4,1730.1,11,0,1,10,8,4,0,0,0,0,18970,7.2,18839,207,52,1669,1011,25.9,1897.0
4850888401,0,30,1,1,5,3,3,0,0,0,0,15898,7.2,18294,189,64,1258,750,25.3,1589.8,14,1,0,3,5,1,1,1,0,0,14640,6.8,17544,194,60,-1258,-750,25.4,1464.0
4850826588,0,10,2,0,3,2,3,1,1,0,0,13681,6.4,15641,184,55,-1864,-2555,23.9,1368.1,14,1,1,2,3,3,0,0,0,0,15545,7.0,18196,221,56,1864,2555,27.7,1554.5
4850786224,0,28,0,0,7,4,7,0,0,0,0,16564,6.8,17403,213,46,641,-393,25.9,1656.4,11,1,1,4,7,3,0,0,0,0,15923,6.8,17796,234,48,-641,393,28.2,1592.3
4849950662,0,8,1,1,7,3,6,1,0,1,0,17637,7.0,17864,205,60,2207,20,26.5,1763.7,12,0,0,3,7,0,0,0,0,0,15430,7.0,17844,196,56,-2207,-20,25.2,1543.0
4849915224,0,52,0,0,1,2,2,0,0,0,0,15424,6.8,18165,221,56,1157,-143,27.7,1542.4,19,1,1,2,1,2,1,1,0,0,14267,7.0,18308,181,76,-1157,143,25.7,1426.7
4849879414,0,11,0,1,6,5,7,0,0,0,0,16516,6.6,16712,176,56,630,-1437,23.2,1651.6,12,1,0,5,6,3,0,0,0,0,15886,6.8,18149,215,44,-630,1437,25.9,1588.6
4848931413,0,13,1,0,6,7,7,0,0,0,0,16543,6.8,18173,202,48,-1129,-291,25.0,1654.3,14,1,1,7,6,1,1,1,0,0,17672,6.8,18464,220,56,1129,291,27.6,1767.2
4848872695,0,31,2,0,2,6,6,0,0,0,0,14228,6.4,16127,183,56,-2823,-2670,23.9,1422.8,9,10,1,6,2,4,0,0,0,0,17051,7.2,18797,205,66,2823,2670,27.1,1705.1
4836648196,0,13,0,1,9,10,6,0,0,0,0,17717,6.8,17298,160,52,635,67,21.2,1771.7,8,0,0,10,9,3,0,0,0,0,17082,6.8,17231,162,44,-635,-67,20.6,1708.2
4836623818,0,10,0,1,6,1,5,1,1,0,0,17205,6.8,18687,208,60,2624,1945,26.8,1720.5,27,0,0,1,6,0,0,0,0,0,14581,6.6,16742,188,60,-2624,-1945,24.8,1458.1
4836603306,1,11,1,0,3,4,2,1,1,0,0,14202,6.8,17804,161,56,-172,1064,21.7,1420.2,8,1,1,3,2,1,0,0,0,0,14374,6.8,16740,207,24,172,-1064,23.1,1437.4
4836568219,0,51,13,0,3,8,5,0,0,0,0,15385,6.8,17294,196,52,-2436,-1639,24.8,1538.5,32,0,1,8,3,4,1,0,1,0,17821,7.0,18933,206,64,2436,1639,27.0,1782.1
4831417921,1,14,0,1,2,3,2,0,0,0,0,16264,7.2,19405,227,60,1530,1944,28.7,1626.4,9,1,0,3,2,2,0,0,0,0,14734,7.0,17461,199,60,-1530,-1944,25.9,1473.4
4801188553,0,50,0,0,19,23,56,0,0,0,1,35611,10.8,38781,92,0,-2726,-3125,9.2,3561.1,49,3,1,23,19,68,0,0,0,0,38337,11.4,41906,110,0,2726,3125,11.0,3833.7
4787613780,0,0,0,0,26,28,48,0,0,0,0,37040,11.8,44273,82,0,-565,3480,8.2,3704.0,0,0,1,28,26,63,0,0,0,0,37605,11.2,40793,98,0,565,-3480,9.8,3760.5
4766449399,0,15,0,0,3,5,1,0,0,0,0,14675,6.8,17241,208,51,-1704,-1027,25.9,1467.5,6,0,1,5,3,9,1,1,0,0,16379,6.8,18268,215,60,1704,1027,27.5,1637.9
4766406687,1,9,1,1,8,5,7,2,1,1,0,18022,7.0,17225,239,52,2485,-222,29.1,1802.2,13,0,0,5,8,2,0,0,0,0,15537,6.8,17447,203,56,-2485,222,25.9,1553.7
4766383205,1,10,0,1,8,4,2,1,0,1,0,17012,6.8,18496,229,54,1390,2693,28.3,1701.2,8,0,0,4,8,9,0,0,0,0,15622,6.4,15803,185,42,-1390,-2693,22.7,1562.2
4855902492,0,12,0,0,11,8,13,0,0,0,0,18763,7.0,18198,206,52,2580,2650,25.8,1876.3,19,1,1,8,11,9,0,0,0,0,16183,6.4,15548,162,47,-2580,-2650,20.9,1618.3
4855869217,0,12,2,0,6,5,5,1,1,0,0,16767,7.0,18436,215,64,-383,-156,27.9,1676.7,15,0,1,5,6,4,0,0,0,0,17150,6.8,18592,218,64,383,156,28.2,1715.0
4851498343,1,12,1,1,7,6,13,0,0,0,0,16193,6.4,14763,171,35,-611,-2531,20.6,1619.3,12,1,0,6,7,8,1,1,0,0,16804,7.2,17294,214,67,611,2531,28.1,1680.4
4850506952,0,10,1,1,10,7,9,0,0,0,0,19834,7.2,18960,202,56,2265,474,25.8,1983.4,8,0,0,7,10,5,0,0,0,0,17569,6.8,18486,178,52,-2265,-474,23.0,1756.9
4850481142,0,12,0,1,6,6,5,0,0,0,0,17366,7.0,18458,214,56,390,-22,27.0,1736.6,12,0,0,6,6,8,1,1,0,0,16976,7.0,18480,214,72,-390,22,28.6,1697.6
4849595457,1,13,1,0,5,8,3,0,0,0,0,16369,6.8,18225,181,72,-2173,17,25.3,1636.9,8,0,1,8,5,10,0,0,0,0,18542,7.0,18208,232,48,2173,-17,28.0,1854.2
4849578755,0,13,0,0,4,7,5,0,0,0,0,15792,7.0,18372,211,56,-1404,-1249,26.7,1579.2,73,0,1,7,4,4,0,0,0,0,17196,7.2,19621,231,68,1404,1249,29.9,1719.6
4849551833,1,31,16,0,5,5,5,0,0,0,0,17139,6.6,17200,202,39,-164,-250,24.1,1713.9,30,1,1,5,5,5,0,0,0,0,17303,6.8,17450,220,56,164,250,27.6,1730.3
4848742455,0,12,0,0,4,9,3,0,0,0,0,17235,7.2,18168,208,60,-361,197,26.8,1723.5,17,0,1,9,4,7,1,1,0,0,17596,6.8,17971,218,52,361,-197,27.0,1759.6
4848678097,1,16,1,1,8,7,8,1,1,0,0,17217,6.8,17037,176,52,267,-625,22.8,1721.7,11,1,0,6,7,5,0,0,0,0,16950,6.8,17662,196,68,-267,625,26.4,1695.0
4848643769,1,139,0,1,8,2,7,1,1,0,0,17183,7.2,18478,202,64,2574,560,26.6,1718.3,10,0,0,2,8,2,0,0,0,0,14609,7.0,17918,193,72,-2574,-560,26.5,1460.9
4848600494,1,228,0,0,6,9,5,0,0,0,0,16654,6.8,17593,205,44,-934,-155,24.9,1665.4,18,1,1,9,6,8,1,0,1,0,17588,6.8,17748,214,52,934,155,26.6,1758.8
4846632193,1,15,1,1,6,5,2,0,0,0,0,16137,7.0,18044,197,60,1517,1454,25.7,1613.7,68,1,0,5,6,4,0,0,0,0,14620,6.8,16590,176,48,-1517,-1454,22.4,1462.0
4846602979,0,98,2,1,3,2,0,0,0,0,0,15162,6.8,17722,240,44,328,-234,28.4,1516.2,16,15,0,2,3,2,0,0,0,0,14834,7.2,17956,198,64,-328,234,26.2,1483.4
4846576717,1,14,1,0,7,4,5,1,1,0,0,17136,7.2,18563,226,60,1646,1036,28.6,1713.6,14,1,1,4,7,4,0,0,0,0,15490,6.8,17527,227,44,-1646,-1036,27.1,1549.0
4846543673,0,18,6,0,6,6,7,0,0,0,0,17960,7.4,20236,225,68,2252,3088,29.3,1796.0,20,2,1,6,6,5,0,0,0,0,15708,6.8,17148,178,60,-2252,-3088,23.8,1570.8
4846529175,0,15,2,0,4,4,3,1,1,0,0,15369,7.0,17761,156,64,-1264,240,22.0,1536.9,15,2,1,4,4,2,0,0,0,0,16633,6.8,17521,197,48,1264,-240,24.5,1663.3
4846216982,0,10,0,1,4,5,0,0,0,0,0,14910,6.8,17141,210,55,-848,-1554,26.5,1491.0,12,2,0,5,4,1,1,1,0,0,15758,7.0,18695,202,76,848,1554,27.8,1575.8
4846172906,0,12,2,1,8,8,4,0,0,0,0,17358,7.0,18480,225,44,-426,108,26.9,1735.8,10,1,0,8,8,6,0,0,0,0,17784,7.0,18372,209,51,426,-108,26.0,1778.4
4846129345,0,13,1,1,7,5,7,0,0,0,0,16346,6.8,18211,205,60,525,454,26.5,1634.6,12,0,0,5,7,6,1,1,0,0,15821,6.8,17757,202,52,-525,-454,25.4,1582.1
4856115342,0,18,0,0,7,7,3,1,1,0,0,16557,7.0,18361,178,68,220,1107,24.6,1655.7,13,3,1,7,7,5,0,0,0,0,16337,6.8,17254,207,48,-220,-1107,25.5,1633.7
4856066848,0,13,1,0,6,6,8,0,0,0,0,16089,6.6,17000,188,40,-777,124,22.8,1608.9,10,2,1,6,6,7,1,1,0,0,16866,6.6,16876,217,48,777,-124,26.5,1686.6
4855085878,1,0,0,1,11,15,12,0,0,0,0,44900,10.0,47500,0,0,17400,19000,0.0,4490.0,0,0,0,10,6,11,0,0,0,0,27500,6.0,28500,0,0,-17400,-19000,0.0,2750.0
4855052186,1,4,0,1,18,12,18,0,0,0,0,45250,10.0,47500,0,0,16900,19000,0.0,4525.0,0,0,0,9,15,7,0,0,0,0,28350,6.0,28500,0,0,-16900,-19000,0.0,2835.0
4854995486,0,8,0,1,6,8,6,0,0,0,0,16757,7.2,19099,220,64,-1807,-655,28.4,1675.7,16,1,0,8,6,7,2,1,1,0,18564,7.4,19754,241,64,1807,655,30.5,1856.4
4854941721,1,146,0,1,8,7,5,0,0,0,0,17114,6.8,18697,193,52,448,1436,24.5,1711.4,9,1,0,7,8,5,0,0,0,0,16666,6.8,17261,184,52,-448,-1436,23.6,1666.6
4854593922,1,9,0,0,2,9,2,0,0,0,0,16094,6.8,17151,190,72,-2336,-1759,26.2,1609.4,13,0,1,9,2,12,1,1,0,0,18430,7.0,18910,202,55,2336,1759,25.7,1843.0
4853852000,1,12,1,1,10,3,16,0,0,0,1,19801,7.2,18181,223,59,3644,385,28.2,1980.1,10,1,0,3,10,2,1,1,0,0,16157,6.8,17796,206,68,-3644,-385,27.4,1615.7
4853816369,1,11,0,1,10,1,7,2,1,1,0,19324,7.4,19436,214,64,2289,1353,27.8,1932.4,9,0,0,1,10,1,0,0,0,0,17035,7.0,18083,182,50,-2289,-1353,23.2,1703.5
4848789375,0,15,2,0,3,5,0,0,0,0,0,15009,6.8,17568,166,64,-984,572,23.0,1500.9,27,0,1,5,3,5,0,0,0,0,15993,6.6,16996,198,40,984,-572,23.8,1599.3
4848753296,1,9,1,0,6,2,4,1,1,0,0,16130,7.2,19052,225,48,336,1158,27.3,1613.0,14,0,1,2,6,1,0,0,0,0,15794,6.8,17894,204,58,-336,-1158,26.2,1579.4
4846834913,0,28,1,0,4,3,4,0,0,0,0,15923,6.6,16865,201,44,-709,1,24.5,1592.3,16,6,1,3,4,5,0,0,0,0,16632,6.6,16864,178,41,709,-1,21.9,1663.2
4846783714,0,11,2,0,7,5,7,0,0,0,0,17201,7.0,17867,180,56,-64,-775,23.6,1720.1,14,1,1,5,7,3,1,0,1,0,17265,7.0,18642,219,52,64,775,27.1,1726.5
4842208783,1,33,1,1,5,4,0,0,0,0,0,17529,7.0,18392,219,48,2296,914,26.7,1752.9,11,20,0,4,5,4,0,0,0,0,15233,6.8,17478,183,52,-2296,-914,23.5,1523.3
4842174736,0,7,0,1,5,3,1,0,0,0,0,15114,7.0,18072,198,46,-65,177,24.4,1511.4,11,0,0,3,5,1,1,1,0,0,15179,7.0,17895,199,65,65,-177,26.4,1517.9
4841155565,1,11,2,1,10,4,8,0,0,0,0,18199,6.8,17344,199,48,2231,549,24.7,1819.9,13,1,0,4,10,4,1,1,0,0,15968,6.6,16795,185,48,-2231,-549,23.3,1596.8
4841120058,1,11,1,0,7,4,2,1,1,0,0,16490,6.8,18447,199,56,125,1016,25.5,1649.0,14,1,1,4,7,3,0,0,0,0,16365,7.0,17431,186,56,-125,-1016,24.2,1636.5
4840122689,0,9,1,0,4,3,5,0,0,0,0,17164,7.6,20129,251,66,2055,2362,31.7,1716.4,19,0,1,3,4,3,0,0,0,0,15109,6.8,17767,217,61,-2055,-2362,27.8,1510.9
4840068933,1,13,0,0,5,9,3,0,0,0,0,15955,6.6,16130,133,52,-3303,-3582,18.5,1595.5,12,1,1,9,5,10,1,1,0,0,19258,7.2,19712,224,64,3303,3582,28.8,1925.8
4840016407,1,12,1,0,4,11,4,0,0,0,0,15557,6.2,14921,159,48,-3872,-4032,20.7,1555.7,17,3,1,11,4,8,0,0,0,0,19429,7.2,18953,202,60,3872,4032,26.2,1942.9
4856147841,1,0,0,1,27,30,71,0,0,0,1,38944,11.2,42497,88,0,-2054,-584,8.8,3894.4,0,0,0,30,27,84,0,0,0,0,40998,11.8,43081,95,0,2054,584,9.5,4099.8
4856114110,1,0,0,0,18,20,47,0,0,0,0,34505,10.6,38259,115,0,-2865,-177,11.5,3450.5,0,0,1,20,18,49,0,0,0,0,37370,10.8,38436,120,0,2865,177,12.0,3737.0
4856079663,0,0,0,0,21,26,67,0,0,0,0,36195,10.8,38441,95,0,-2903,-3677,9.5,3619.5,0,0,1,26,21,70,0,0,0,0,39098,11.6,42118,123,0,2903,3677,12.3,3909.8
4856042613,1,5,0,0,18,12,18,0,0,0,0,60950,12.4,57000,0,0,25500,24000,0.0,6095.0,0,0,1,5,11,7,0,0,0,0,35450,7.2,33000,0,0,-25500,-24000,0.0,3545.0
4856019980,1,22,0,1,20,12,20,0,0,0,0,47710,10.0,47500,1,0,20310,19000,0.1,4771.0,0,0,0,6,14,7,0,0,0,0,27400,6.0,28500,0,0,-20310,-19000,0.0,2740.0
4856003743,1,15,1,0,15,15,16,0,0,0,0,60960,12.8,59000,1,0,24110,26000,0.1,6096.0,0,0,1,10,10,7,0,0,0,0,36850,7.2,33000,0,0,-24110,-26000,0.0,3685.0
4855416504,1,0,0,1,14,12,11,0,0,0,0,45600,10.0,47500,0,0,18800,19000,0.0,4560.0,7,0,0,8,10,7,0,0,0,0,26800,6.0,28500,0,0,-18800,-19000,0.0,2680.0
4855400193,1,17,0,0,15,14,15,0,0,0,0,45637,10.0,47500,0,0,18081,19000,0.0,4563.7,0,0,1,10,11,10,0,0,0,0,27556,6.0,28500,0,0,-18081,-19000,0.0,2755.6
4855383838,1,0,0,1,16,19,15,0,0,0,0,46300,10.0,47500,0,0,17400,19000,0.0,4630.0,6,0,0,11,8,13,0,0,0,0,28900,6.0,28500,0,0,-17400,-19000,0.0,2890.0
4855363094,1,0,0,1,21,18,13,0,0,0,0,63750,12.0,55000,0,0,26200,22000,0.0,6375.0,0,0,0,8,11,12,0,0,0,0,37550,7.2,33000,0,0,-26200,-22000,0.0,3755.0
4855341349,1,0,0,1,21,17,25,0,0,0,0,63820,12.0,55000,0,0,26226,22000,0.0,6382.0,0,0,0,11,15,8,0,0,0,0,37594,7.2,33000,0,0,-26226,-22000,0.0,3759.4
4855177896,1,0,0,1,31,20,86,0,0,0,1,39859,11.6,42844,123,0,2648,2945,12.3,3985.9,0,0,0,20,31,44,0,0,0,0,37211,11.2,39899,98,0,-2648,-2945,9.8,3721.1
4855136892,0,2,0,0,26,26,68,0,0,0,0,38554,11.6,43121,97,0,443,2251,9.7,3855.4,0,0,1,26,26,68,0,0,0,0,38111,11.2,40870,96,0,-443,-2251,9.6,3811.1
4855097104,1,0,0,0,23,20,63,0,0,0,0,37201,11.2,40998,104,0,-20,1455,10.4,3720.1,2,0,1,20,23,44,0,0,0,0,37221,11.2,39543,102,0,20,-1455,10.2,3722.1
4854352392,1,30,0,1,20,10,20,0,0,0,0,46040,10.2,48680,0,0,20260,20180,0.0,4604.0,0,0,0,3,13,6,0,0,0,0,25780,6.0,28500,0,0,-20260,-20180,0.0,2578.0
4854346149,1,4,0,0,18,16,19,0,0,0,0,63425,12.0,55000,1,0,26200,22000,0.1,6342.5,3,0,1,11,13,11,0,0,0,0,37225,7.2,33000,1,0,-26200,-22000,0.1,3722.5
4854338032,1,0,0,1,12,21,15,0,0,0,0,61300,12.8,60500,0,0,22000,22000,0.0,6130.0,0,0,0,17,8,12,0,0,0,0,39300,8.0,38500,0,0,-22000,-22000,0.0,3930.0
4854167909,1,48,0,1,20,18,23,0,0,0,0,64228,12.0,55000,0,0,26258,22000,0.0,6422.8,0,7,0,12,14,11,0,0,0,0,37970,7.2,33000,7,0,-26258,-22000,0.7,3797.0
4854083009,1,7,2,0,4,5,3,0,0,0,0,15011,6.8,17409,211,44,-1577,86,25.5,1501.1,11,0,1,5,4,8,0,0,0,0,16588,6.8,17323,192,44,1577,-86,23.6,1658.8
4852965644,1,4,0,1,18,17,22,0,0,0,0,62580,12.0,55000,2,0,25030,22000,0.2,6258.0,0,0,0,11,12,9,0,0,0,0,37550,7.2,33000,0,0,-25030,-22000,0.0,3755.0
4763533589,1,0,0,0,25,32,65,0,0,0,1,38937,11.6,42844,100,0,-858,-1196,10.0,3893.7,0,0,1,32,25,78,0,0,0,0,39795,11.6,44040,107,0,858,1196,10.7,3979.5
4763497524,1,13,0,1,3,2,3,0,0,0,0,16360,7.0,18810,231,68,1397,1096,29.9,1636.0,12,0,0,2,3,2,0,0,0,0,14963,7.0,17714,214,68,-1397,-1096,28.2,1496.3
4762882443,1,43,2,1,5,3,8,0,0,0,0,15102,6.8,17022,164,55,-1251,-1347,21.9,1510.2,16,0,0,3,5,2,1,1,0,0,16353,7.2,18369,208,64,1251,1347,27.2,1635.3
4762854890,1,12,2,1,6,3,5,0,0,0,0,17301,6.8,18025,205,48,1173,-944,25.3,1730.1,12,0,0,3,6,1,0,0,0,0,16128,7.4,18969,218,80,-1173,944,29.8,1612.8
4762704768,1,18,0,1,7,5,6,0,0,0,0,18266,6.6,17488,210,56,2785,1788,26.6,1826.6,7,0,0,5,7,2,0,0,0,0,15481,6.6,15700,148,56,-2785,-1788,20.4,1548.1
4762671556,0,8,0,1,3,8,2,0,0,0,0,14887,6.8,17139,195,52,-1433,-645,24.7,1488.7,10,0,0,8,3,7,1,1,0,0,16320,6.8,17784,173,50,1433,645,22.3,1632.0
4761874443,1,8,2,1,6,5,3,0,0,0,0,16251,7.0,18166,218,56,471,459,27.4,1625.1,11,0,0,5,6,6,0,0,0,0,15780,7.0,17707,223,44,-471,-459,26.7,1578.0
4761853845,1,11,0,1,9,3,8,0,0,0,0,17369,6.8,17592,177,72,3536,1713,24.9,1736.9,14,0,0,3,9,4,0,0,0,0,13833,6.4,15879,177,44,-3536,-1713,22.1,1383.3
4761833829,0,10,0,1,12,4,8,0,0,0,0,18417,7.2,19044,196,56,2800,471,25.2,1841.7,346,1,0,4,12,0,1,1,0,0,15617,7.2,18573,221,68,-2800,-471,28.9,1561.7
4761813510,1,0,2,1,35,27,88,0,0,0,1,43469,12.0,46804,122,0,4169,4063,12.2,4346.9,2,0,0,27,35,65,0,0,0,0,39300,11.2,42741,101,0,-4169,-4063,10.1,3930.0
4761297459,0,13,0,0,2,3,1,0,0,0,0,14449,6.8,18395,215,40,-1183,-665,25.5,1444.9,11,0,1,3,2,1,0,0,0,0,15632,7.0,19060,230,75,1183,665,30.5,1563.2
4761249554,1,10,1,1,8,3,4,0,0,0,0,16955,6.8,17743,223,48,3090,2096,27.1,1695.5,88,3,0,3,8,2,1,1,0,0,13865,6.4,15647,147,52,-3090,-2096,19.9,1386.5
4760995606,1,17,0,0,2,3,1,1,0,1,0,14565,6.8,17690,188,64,-522,458,25.2,1456.5,15,2,1,3,2,2,0,0,0,0,15087,6.6,17232,234,56,522,-458,29.0,1508.7
4760975708,0,14,2,0,0,7,0,0,0,0,0,13687,6.8,16957,200,64,-3857,-2181,26.4,1368.7,14,5,1,7,0,6,1,1,0,0,17544,7.4,19138,219,71,3857,2181,29.0,1754.4
4760960581,0,12,2,1,5,5,3,0,0,0,0,15828,6.8,17091,208,52,-3001,-1688,26.0,1582.8,10,1,0,5,5,5,1,0,1,0,18829,6.8,18779,252,56,3001,1688,30.8,1882.9
4760943682,0,9,1,0,3,12,4,1,1,0,0,16163,6.4,16148,178,64,-5154,-3403,24.2,1616.3,16,0,1,12,3,9,0,0,0,0,21317,7.2,19551,212,39,5154,3403,25.1,2131.7
4760514720,0,13,2,1,2,4,4,0,0,0,0,15220,6.8,17218,181,52,-1762,-2606,23.3,1522.0,13,2,0,4,2,4,0,0,0,0,16982,7.6,19824,270,68,1762,2606,33.8,1698.2
4760467749,1,13,0,0,8,7,5,0,0,0,0,17550,7.0,17432,193,55,1023,-43,24.8,1755.0,7,1,1,7,8,5,0,0,0,0,16527,7.0,17475,201,48,-1023,43,24.9,1652.7
4760419114,0,18,1,1,5,1,3,1,1,0,0,15907,7.0,18138,197,52,1511,960,24.9,1590.7,6,1,0,1,5,1,0,0,0,0,14396,6.6,17178,221,64,-1511,-960,28.5,1439.6
4760391088,1,76,1,1,7,3,6,1,1,0,0,18199,6.8,17878,219,63,2989,647,28.2,1819.9,12,0,0,3,7,3,0,0,0,0,15210,6.6,17231,195,56,-2989,-647,25.1,1521.0
4813978078,0,13,2,1,5,6,6,1,1,0,0,16600,7.0,18735,237,59,-1953,-636,29.6,1660.0,87,0,0,5,4,4,0,0,0,0,18553,7.2,19371,228,72,1953,636,30.0,1855.3
4813190165,0,8,0,1,11,2,10,1,1,0,0,18310,7.2,19250,218,64,4032,2816,28.2,1831.0,13,0,0,2,11,1,0,0,0,0,14278,6.4,16434,188,55,-4032,-2816,24.3,1427.8
4813160739,0,15,1,1,2,6,1,0,0,0,0,14029,6.6,16203,175,50,-3622,-2520,22.5,1402.9,31,1,0,6,2,4,1,1,0,0,17651,7.2,18723,249,49,3622,2520,29.8,1765.1
4813109538,0,33,1,1,6,5,9,2,1,1,0,19287,7.0,18615,215,52,3250,1022,26.7,1928.7,16,1,0,5,6,1,0,0,0,0,16037,7.0,17593,216,60,-3250,-1022,27.6,1603.7
4813078012,1,12,0,1,9,2,10,0,0,0,0,18557,6.6,17278,192,35,4624,793,22.7,1855.7,14,0,0,2,9,1,0,0,0,0,13933,6.4,16485,169,53,-4624,-793,22.2,1393.3
4495628582,1,10,2,1,7,8,4,0,0,0,0,19074,6.8,17821,210,52,1105,-40,26.2,1907.4,13,0,0,8,7,6,0,0,0,0,17969,6.8,17861,211,52,-1105,40,26.3,1796.9
4492517755,1,11,4,1,7,3,9,0,0,0,0,17672,7.2,18972,202,48,2609,1453,25.0,1767.2,14,0,0,3,7,3,0,0,0,0,15063,6.8,17519,235,52,-2609,-1453,28.7,1506.3
4492145557,0,13,0,1,3,4,3,0,0,0,0,16233,6.8,18334,249,48,-335,-826,29.7,1623.3,74,0,0,4,3,7,0,0,0,0,16568,7.2,19160,179,76,335,826,25.5,1656.8
4492112254,0,14,3,0,3,5,3,0,0,0,0,15897,6.8,18206,218,52,-876,-383,27.0,1589.7,14,1,1,5,3,3,1,1,0,0,16773,7.0,18589,219,64,876,383,28.3,1677.3
4491286379,1,0,0,0,22,17,56,0,0,0,2,38744,11.4,41141,115,0,2660,4303,11.5,3874.4,0,0,1,17,22,40,0,0,0,0,36084,10.8,36838,105,0,-2660,-4303,10.5,3608.4
4491254625,0,13,0,0,9,10,7,0,0,0,0,16740,6.8,16242,182,50,-1386,-1436,23.2,1674.0,10,6,1,10,9,14,0,0,0,0,18126,7.0,17678,198,44,1386,1436,24.2,1812.6
4491228980,1,13,0,1,14,6,10,0,0,0,0,20991,7.4,19698,243,58,4507,1732,30.1,2099.1,6,0,0,6,14,3,0,0,0,0,16484,6.6,17966,178,64,-4507,-1732,24.2,1648.4
4491175605,1,8,1,1,5,3,4,2,1,1,0,16830,7.0,19323,195,60,1663,1313,25.5,1683.0,10,0,0,3,5,4,0,0,0,0,15167,6.8,18010,223,55,-1663,-1313,27.8,1516.7
4491137603,0,11,1,0,3,8,3,0,0,0,0,15587,7.0,17372,195,63,-2766,-2185,25.8,1558.7,13,1,1,8,3,6,0,0,0,0,18353,7.2,19557,224,52,2766,2185,27.6,1835.3
4490889598,1,59,1,0,10,8,8,0,0,0,0,19115,7.0,17557,215,47,1966,-281,26.2,1911.5,31,9,1,8,10,4,1,1,0,0,17149,7.0,17838,195,45,-1966,281,24.0,1714.9
4490832540,0,17,2,1,7,6,6,1,1,0,0,16874,7.2,18493,218,48,413,-504,26.6,1687.4,14,3,0,6,7,5,0,0,0,0,16461,7.2,18997,225,60,-413,504,28.5,1646.1
4490811276,0,13,1,0,4,6,3,0,0,0,0,16158,6.8,18223,201,52,-2692,-1893,25.3,1615.8,10,4,1,6,4,7,1,1,0,0,18850,7.4,20116,220,78,2692,1893,29.8,1885.0
4490328067,0,15,2,0,10,11,6,0,0,0,0,18490,7.0,18371,217,48,-1275,-205,26.5,1849.0,11,2,1,11,10,11,1,1,0,0,19765,6.8,18576,196,60,1275,205,25.6,1976.5
4490280540,1,16,4,0,3,5,2,0,0,0,0,15587,6.6,17808,210,81,13,899,29.1,1558.7,32,6,1,5,3,10,1,1,0,0,15574,6.6,16909,203,53,-13,-899,25.6,1557.4
4857544255,0,0,0,0,8,15,20,0,0,0,1,31720,10.0,33268,95,0,-2574,-3350,9.5,3172.0,0,0,1,15,8,46,0,0,0,0,34294,10.6,36618,113,0,2574,3350,11.3,3429.4
4857487730,1,74,1,1,5,7,2,1,1,0,0,16168,7.0,19115,209,64,-762,344,27.3,1616.8,8,1,0,7,5,5,1,0,1,0,16930,7.2,18771,184,51,762,-344,23.5,1693.0
4857463647,1,8,0,1,19,4,57,0,0,0,1,34710,10.6,37631,103,0,6332,6457,10.3,3471.0,0,2,0,4,19,7,0,0,0,0,28378,9.4,31174,84,0,-6332,-6457,8.4,2837.8
4857446094,1,0,0,1,19,13,18,0,0,0,0,47000,10.0,47500,0,0,20200,19000,0.0,4700.0,0,0,0,6,12,6,0,0,0,0,26800,6.0,28500,0,0,-20200,-19000,0.0,2680.0
4857416432,1,0,0,1,10,18,13,0,0,0,0,45250,10.0,47500,0,0,16000,19000,0.0,4525.0,0,0,0,14,6,9,0,0,0,0,29250,6.0,28500,0,0,-16000,-19000,0.0,2925.0
4857384374,1,18,0,1,17,20,38,0,0,0,0,35502,10.6,37251,107,0,-291,-3358,10.7,3550.2,0,2,0,20,17,54,0,0,0,0,35793,11.0,40609,96,0,291,3358,9.6,3579.3
4857335256,1,0,0,0,22,22,55,0,0,0,1,37625,11.0,40046,117,0,1733,2622,11.7,3762.5,0,0,1,22,22,46,0,0,0,0,35892,10.8,37424,85,0,-1733,-2622,8.5,3589.2
4857300648,1,0,5,1,17,15,46,0,0,0,1,34814,10.2,36571,121,0,1224,83,12.1,3481.4,6,0,0,15,17,31,0,0,0,0,33590,10.4,36488,105,0,-1224,-83,10.5,3359.0
4857279199,0,0,0,0,35,22,96,0,0,0,1,39667,11.4,43233,84,0,-569,454,8.4,3966.7,6,0,1,22,35,46,0,0,0,0,40236,11.6,42779,114,0,569,-454,11.4,4023.6
4856540924,1,12,0,1,20,24,42,0,0,0,0,35743,10.8,40179,102,0,-276,394,10.2,3574.3,0,2,0,24,20,48,0,0,0,0,36019,11.0,39785,93,0,276,-394,9.3,3601.9
4856528767,0,0,0,0,16,28,35,0,0,0,1,34556,10.6,37948,96,0,-3431,-2941,9.6,3455.6,0,0,1,28,16,87,0,0,0,0,37987,11.0,40889,119,0,3431,2941,11.9,3798.7
4856503928,1,0,0,1,17,21,39,0,0,0,0,35581,11.0,39732,97,0,929,1672,9.7,3558.1,0,0,0,21,17,51,0,0,0,0,34652,10.8,38060,106,0,-929,-1672,10.6,3465.2
4856477464,1,0,0,0,19,11,44,0,0,0,0,34522,10.8,37750,104,0,1574,4559,10.4,3452.2,25,0,1,11,19,23,0,0,0,0,32948,10.0,33191,98,0,-1574,-4559,9.8,3294.8
4856457620,1,0,0,1,33,27,65,0,0,0,0,40789,12.0,46015,109,0,2941,4791,10.9,4078.9,0,0,0,27,33,57,0,0,0,0,37848,11.2,41224,100,0,-2941,-4791,10.0,3784.8
4856434487,1,22,0,1,16,15,31,0,0,0,0,35018,10.8,37573,74,0,2257,2189,7.4,3501.8,0,7,0,15,16,36,0,0,0,0,32761,10.2,35384,89,0,-2257,-2189,8.9,3276.1
4856402784,1,3,0,1,20,22,44,0,0,0,1,36060,10.6,37661,118,0,-2096,-4265,11.8,3606.0,0,0,0,22,20,49,0,0,0,0,38156,11.4,41926,106,0,2096,4265,10.6,3815.6
4854279100,0,0,1,0,23,21,51,0,0,0,0,35852,11.0,38776,112,0,-1781,-2551,11.2,3585.2,5,0,1,21,23,53,0,0,0,0,37633,11.2,41327,122,0,1781,2551,12.2,3763.3
4854248103,1,11,1,1,5,3,1,1,1,0,0,15871,7.2,18345,184,60,-388,-1150,24.4,1587.1,13,1,0,3,5,1,1,0,1,0,16259,7.2,19495,219,55,388,1150,27.4,1625.9
4854190563,0,13,0,0,4,6,4,0,0,0,0,15820,6.6,17208,205,50,-470,-1449,25.5,1582.0,9,0,1,6,4,2,0,0,0,0,16290,7.0,18657,220,46,470,1449,26.6,1629.0
4856698209,1,15,0,0,14,14,20,0,0,0,0,62756,12.4,57000,0,0,24812,24000,0.0,6275.6,0,0,1,14,14,4,0,0,0,0,37944,7.2,33000,0,0,-24812,-24000,0.0,3794.4
4856689707,1,0,0,1,18,18,21,0,0,0,0,53250,12.0,55000,0,0,22700,22000,0.0,5325.0,0,0,0,10,10,9,0,0,0,0,30550,7.2,33000,0,0,-22700,-22000,0.0,3055.0
4856690953,1,1,0,0,13,23,16,0,0,0,0,53800,12.2,56000,0,0,15500,23000,0.0,5380.0,41,0,1,15,5,13,0,0,0,0,38300,7.2,33000,0,0,-15500,-23000,0.0,3830.0
4856681527,1,0,0,1,21,13,22,0,0,0,0,63415,13.0,62500,0,0,26215,28000,0.0,6341.5,0,0,0,9,17,8,0,0,0,0,37200,7.4,34500,0,0,-26215,-28000,0.0,3720.0
4856678351,1,0,0,0,21,19,15,0,0,0,0,48050,10.0,47500,0,0,20900,19000,0.0,4805.0,0,0,1,8,10,7,0,0,0,0,27150,6.0,28500,0,0,-20900,-19000,0.0,2715.0
4856670570,1,18,0,0,18,19,12,0,0,0,0,61360,12.0,55000,0,0,22730,22000,0.0,6136.0,0,1,1,13,12,13,0,0,0,0,38630,7.2,33000,1,0,-22730,-22000,0.1,3863.0
4856668302,1,4,0,0,16,18,16,0,0,0,0,46300,10.0,47500,0,0,15300,19000,0.0,4630.0,33,0,1,9,7,7,0,0,0,0,31000,6.0,28500,0,0,-15300,-19000,0.0,3100.0
4855569555,1,23,2,1,18,18,15,0,0,0,0,63095,12.0,55000,3,0,24845,22000,0.3,6309.5,59,0,0,11,11,13,0,0,0,0,38250,7.2,33000,0,0,-24845,-22000,0.0,3825.0
4855571824,1,0,0,1,24,17,19,0,0,0,0,47700,10.0,47500,0,0,20200,19000,0.0,4770.0,0,0,0,6,13,11,0,0,0,0,27500,6.0,28500,0,0,-20200,-19000,0.0,2750.0
4855564329,1,0,0,1,15,14,15,0,0,0,0,45600,10.0,47500,0,0,16000,19000,0.0,4560.0,0,0,0,8,9,8,0,0,0,0,29600,6.0,28500,0,0,-16000,-19000,0.0,2960.0
4855562118,1,0,0,1,20,20,18,0,0,0,0,48385,10.0,47500,6,0,19735,19000,0.6,4838.5,0,0,0,11,11,12,0,0,0,0,28650,6.0,28500,1,0,-19735,-19000,0.1,2865.0
4855559756,1,0,0,0,17,16,15,0,0,0,0,46383,10.0,47500,1,0,18129,19000,0.1,4638.3,23,0,1,9,10,10,0,0,0,0,28254,6.0,28500,0,0,-18129,-19000,0.0,2825.4
4854249257,1,0,0,1,18,13,21,0,0,0,0,64100,12.0,55000,0,0,28300,22000,0.0,6410.0,5,0,0,6,11,5,0,0,0,0,35800,7.2,33000,0,0,-28300,-22000,0.0,3580.0
4853223731,1,5,0,1,19,12,20,0,0,0,0,63400,12.0,55000,0,0,26900,22000,0.0,6340.0,0,0,0,7,14,5,0,0,0,0,36500,7.2,33000,0,0,-26900,-22000,0.0,3650.0
4853220340,1,14,0,1,26,15,29,0,0,0,0,64450,12.8,59000,0,0,27600,26000,0.0,6445.0,0,0,0,8,19,7,0,0,0,0,36850,7.2,33000,0,0,-27600,-26000,0.0,3685.0
4853216972,1,9,0,1,18,18,20,0,0,0,0,62950,13.8,66500,0,0,24994,29000,0.0,6295.0,0,0,0,15,15,12,0,0,0,0,37956,7.8,37500,0,0,-24994,-29000,0.0,3795.6
4853203536,1,0,0,1,17,18,19,0,0,0,0,47000,10.0,47500,0,0,18800,19000,0.0,4700.0,0,0,0,11,10,12,0,0,0,0,28200,6.0,28500,0,0,-18800,-19000,0.0,2820.0
4853193688,1,0,0,0,15,19,17,0,0,0,0,63592,12.0,55000,8,0,26692,22000,0.8,6359.2,61,0,1,14,10,9,0,0,0,0,36900,7.2,33000,6,0,-26692,-22000,0.6,3690.0
4853186434,1,0,0,1,21,11,20,0,0,0,0,48492,10.0,47500,0,0,21342,19000,0.0,4849.2,0,0,0,5,15,4,0,0,0,0,27150,6.0,28500,0,0,-21342,-19000,0.0,2715.0
4853174416,1,0,0,1,17,24,22,0,0,0,0,63050,12.8,60500,0,0,24068,23000,0.0,6305.0,0,0,0,17,10,15,0,0,0,0,38982,7.8,37500,0,0,-24068,-23000,0.0,3898.2
4830301836,0,12,1,0,3,4,4,0,0,0,0,14992,6.8,17668,202,52,-1393,-957,25.4,1499.2,21,0,1,4,3,3,0,0,0,0,16385,7.0,18625,210,63,1393,957,27.3,1638.5
4830272504,0,13,0,0,3,8,4,0,0,0,0,15539,6.6,16879,202,64,-3360,-1001,26.6,1553.9,11,0,1,8,3,11,0,0,0,0,18899,6.8,17880,218,58,3360,1001,27.6,1889.9
4829310595,1,17,1,0,6,9,5,0,0,0,0,16461,6.8,17280,217,52,-1514,-502,26.9,1646.1,13,2,1,9,6,10,1,1,0,0,17975,6.8,17782,228,48,1514,502,27.6,1797.5
4829286019,0,14,0,1,3,4,5,1,1,0,0,15566,6.8,17451,178,64,-1438,-2130,24.2,1556.6,14,3,0,4,3,1,1,0,1,0,17004,7.4,19581,229,68,1438,2130,29.7,1700.4
4827667987,1,14,2,0,6,4,6,1,1,0,0,16797,6.8,17333,222,56,12,-1975,27.8,1679.7,14,0,1,4,6,4,0,0,0,0,16785,7.4,19308,203,68,-12,1975,27.1,1678.5
4775085392,1,22,1,1,12,4,11,1,1,0,0,17635,6.8,17593,219,48,2141,-205,26.7,1763.5,14,2,0,3,11,3,0,0,0,0,15494,7.0,17798,194,68,-2141,205,26.2,1549.4
4775031686,1,13,2,0,4,4,4,0,0,0,0,15520,6.8,17402,200,52,532,177,25.2,1552.0,14,1,1,4,4,4,1,1,0,0,14988,6.8,17225,217,48,-532,-177,26.5,1498.8
4774997680,1,36,0,0,17,33,43,0,0,0,0,34889,10.8,37870,90,0,-3507,-6532,9.0,3488.9,35,0,1,33,17,96,0,0,0,0,38396,12.0,44402,102,0,3507,6532,10.2,3839.6
4772754740,1,14,0,1,9,8,9,0,0,0,0,19024,7.0,18282,230,60,2363,75,29.0,1902.4,17,0,0,7,8,9,0,0,0,0,16661,7.4,18207,206,56,-2363,-75,26.2,1666.1
4772724375,1,15,2,0,12,6,12,0,0,0,0,20303,6.8,17057,224,41,3886,3781,26.5,2030.3,16,0,1,6,12,9,0,0,0,0,16417,5.8,13276,126,62,-3886,-3781,18.8,1641.7
4772706648,0,14,0,1,8,4,10,0,0,0,0,17774,7.0,17510,211,60,1073,-322,27.1,1777.4,12,1,0,4,8,4,0,0,0,0,16701,6.8,17832,223,40,-1073,322,26.3,1670.1
4772698834,1,53,2,1,8,5,7,1,1,0,0,16866,6.6,17585,176,52,2084,1059,22.8,1686.6,18,3,0,5,8,3,0,0,0,0,14782,6.8,16526,190,35,-2084,-1059,22.5,1478.2
4767180842,0,0,1,1,28,21,58,0,0,0,1,39437,11.2,41756,114,0,4174,2806,11.4,3943.7,11,0,0,20,27,49,0,0,0,0,35263,11.2,38950,89,0,-4174,-2806,8.9,3526.3
4767038370,1,12,3,0,6,3,1,1,1,0,0,16125,6.6,17415,210,48,796,647,25.8,1612.5,17,0,1,2,5,3,0,0,0,0,15329,6.4,16768,194,40,-796,-647,23.4,1532.9
4767011591,0,9,2,0,6,9,6,0,0,0,0,17017,6.6,17369,200,54,-1068,-1309,25.4,1701.7,129,1,1,9,6,13,0,0,0,0,18085,7.2,18678,225,56,1068,1309,28.1,1808.5
4766987428,1,17,3,1,7,7,9,0,0,0,0,16703,6.8,16694,171,48,193,-1550,21.9,1670.3,13,2,0,7,7,3,0,0,0,0,16510,7.0,18244,201,64,-193,1550,26.5,1651.0
4766975339,0,55,1,0,2,10,2,0,0,0,0,13849,6.6,16168,185,48,-6683,-2680,23.3,1384.9,11,0,1,10,2,11,2,1,1,0,20532,7.2,18848,235,64,6683,2680,29.9,2053.2
4766464219,1,0,0,1,37,22,91,0,0,0,1,42890,12.0,46656,108,0,6275,7582,10.8,4289.0,0,0,0,22,37,52,0,0,0,0,36615,11.0,39074,88,0,-6275,-7582,8.8,3661.5
4766435581,0,11,0,1,24,19,66,0,0,0,1,38487,11.4,42210,107,0,3000,3808,10.7,3848.7,194,3,0,19,24,32,0,0,0,0,35487,10.8,38402,112,0,-3000,-3808,11.2,3548.7
4765356566,1,13,0,1,5,3,8,0,0,0,0,17075,7.0,18498,234,52,1460,-26,28.6,1707.5,25,1,0,3,5,3,0,0,0,0,15615,7.0,18524,187,71,-1460,26,25.8,1561.5
4857546764,1,0,0,1,38,21,92,0,0,0,1,41186,12.0,45778,116,0,6383,6379,11.6,4118.6,198,0,0,20,37,49,0,0,0,0,34803,10.8,39399,80,0,-6383,-6379,8.0,3480.3
4857526795,1,0,0,1,12,17,14,0,0,0,0,59950,12.0,55000,1,0,22050,22000,0.1,5995.0,0,0,0,12,7,12,0,0,0,0,37900,7.2,33000,0,0,-22050,-22000,0.0,3790.0
4857363793,1,75,0,1,7,3,6,0,0,0,0,16266,6.8,17911,169,52,29,-521,22.1,1626.6,70,17,0,3,7,4,0,0,0,0,16237,6.8,18432,214,48,-29,521,26.2,1623.7
4857305331,1,12,1,1,5,4,3,0,0,0,0,15488,7.0,17867,202,56,196,798,25.8,1548.8,23,0,0,4,5,5,0,0,0,0,15292,6.6,17069,155,56,-196,-798,21.1,1529.2
4857253821,1,15,0,0,1,6,0,0,0,0,0,13486,6.6,17188,183,60,-2520,-1006,24.3,1348.6,7,0,1,6,1,5,0,0,0,0,16006,6.8,18194,179,40,2520,1006,21.9,1600.6
4857046430,1,11,1,1,6,8,3,1,1,0,0,16051,6.2,15021,158,40,-120,399,19.8,1605.1,15,0,0,8,6,12,0,0,0,0,16171,6.2,14622,132,47,120,-399,17.9,1617.1
4856984083,1,12,1,0,4,5,2,0,0,0,0,16258,7.0,18103,199,56,120,-274,25.5,1625.8,17,0,1,5,4,3,0,0,0,0,16138,6.8,18377,209,52,-120,274,26.1,1613.8
4856959285,1,10,0,0,4,4,1,0,0,0,0,14970,7.0,18099,180,55,-1423,-275,23.5,1497.0,10,0,1,4,4,2,0,0,0,0,16393,7.0,18374,207,48,1423,275,25.5,1639.3
4856942215,1,10,1,1,9,5,7,0,0,0,0,16463,6.6,17277,184,48,89,-832,23.2,1646.3,13,3,0,5,9,6,0,0,0,0,16374,6.8,18109,205,72,-89,832,27.7,1637.4
4856875841,1,1,0,0,23,22,43,0,0,0,2,37411,10.8,39999,118,0,55,173,11.8,3741.1,30,0,1,22,23,61,0,0,0,0,37356,10.8,39826,88,0,-55,-173,8.8,3735.6
4856846917,1,20,3,0,2,2,4,1,1,0,0,13618,6.4,16473,166,52,-968,-683,21.8,1361.8,18,0,1,2,2,1,0,0,0,0,14586,6.6,17156,182,52,968,683,23.4,1458.6
4856617963,0,13,1,1,2,4,1,1,0,1,0,13993,6.6,17076,202,52,-1005,-935,25.4,1399.3,13,3,0,4,2,3,1,1,0,0,14998,7.0,18011,203,52,1005,935,25.5,1499.8
4856541390,0,13,1,0,4,3,2,1,1,0,0,15281,7.2,18810,183,66,850,-632,24.9,1528.1,84,2,1,3,4,0,0,0,0,0,14431,7.4,19442,205,38,-850,632,24.3,1443.1
4856503743,1,12,2,1,1,0,1,0,0,0,0,14821,7.0,17888,203,64,94,-278,26.7,1482.1,13,0,0,0,1,0,0,0,0,0,14727,6.8,18166,204,48,-94,278,25.2,1472.7
4856242425,1,18,0,1,34,32,65,0,0,0,0,39335,11.8,45010,101,0,1066,112,10.1,3933.5,15,0,0,32,34,85,0,0,0,0,38269,11.8,44898,106,0,-1066,-112,10.6,3826.9
4856208256,0,0,5,0,16,32,49,0,0,0,1,34264,10.6,36722,95,0,-4175,-6392,9.5,3426.4,25,0,1,32,16,92,0,0,0,0,38439,11.6,43114,91,0,4175,6392,9.1,3843.9
4856163446,1,0,0,1,22,24,56,0,0,0,1,35308,11.2,40383,92,0,-3314,-1290,9.2,3530.8,0,0,0,24,22,58,0,0,0,0,38622,11.4,41673,110,0,3314,1290,11.0,3862.2
4856057771,1,15,0,0,13,11,40,0,0,0,0,32245,10.4,34937,101,0,-882,-257,10.1,3224.5,0,0,1,11,13,36,0,0,0,0,33127,10.0,35194,103,0,882,257,10.3,3312.7
4813380913,1,25,0,0,9,18,14,0,0,0,0,30271,10.2,33311,88,50,-6391,-7519,13.8,3027.1,16,1,1,18,9,24,0,0,0,0,36662,11.0,40830,118,63,6391,7519,18.1,3666.2
4807533573,0,20,0,0,18,19,46,0,0,0,0,35272,10.8,39031,94,0,331,1422,9.4,3527.2,0,4,1,19,18,48,0,0,0,0,34941,10.8,37609,88,0,-331,-1422,8.8,3494.1
4779233152,0,0,0,0,24,26,57,0,0,0,0,37585,10.8,39645,99,0,-97,-2757,9.9,3758.5,0,0,1,26,24,74,0,0,0,0,37682,11.6,42402,95,0,97,2757,9.5,3768.2
4779199155,0,0,0,0,28,37,78,0,0,0,2,38315,11.4,41852,103,0,-4949,-2438,10.3,3831.5,91,0,1,37,28,93,0,0,0,0,43264,11.8,44290,128,0,4949,2438,12.8,4326.4
4774027684,0,48,1,0,3,3,5,0,0,0,0,15825,7.0,18256,209,56,71,212,26.5,1582.5,13,0,1,3,3,0,2,1,1,0,15754,7.0,18044,219,64,-71,-212,28.3,1575.4
4772855746,1,0,3,1,21,27,59,0,0,0,1,36880,11.0,39098,110,0,-2352,-4011,11.0,3688.0,86,0,0,27,21,74,0,0,0,0,39232,11.6,43109,119,0,2352,4011,11.9,3923.2
4769848653,0,0,0,1,33,28,79,0,0,0,1,39610,11.6,43044,116,0,1663,1896,11.6,3961.0,0,0,0,28,33,74,0,0,0,0,37947,11.0,41148,104,0,-1663,-1896,10.4,3794.7
4769768301,1,0,0,0,24,19,76,0,0,0,1,38945,11.6,44036,120,0,2238,4968,12.0,3894.5,0,0,1,19,24,59,0,0,0,0,36707,10.8,39068,108,0,-2238,-4968,10.8,3670.7
4767723378,1,126,1,1,16,22,36,0,0,0,0,35993,11.0,40011,105,0,43,248,10.5,3599.3,42,0,0,22,16,44,0,0,0,0,35950,11.0,39763,78,0,-43,-248,7.8,3595.0
4764655174,0,9,0,0,10,5,9,1,1,0,0,18701,6.8,17527,182,49,2435,361,23.1,1870.1,10,0,1,5,10,2,0,0,0,0,16266,6.8,17166,176,55,-2435,-361,23.1,1626.6
4763801505,1,0,0,0,19,26,55,0,0,0,1,35591,11.0,38154,109,0,-2720,-2923,10.9,3559.1,0,0,1,26,19,75,0,0,0,0,38311,11.0,41077,116,0,2720,2923,11.6,3831.1
4759799766,1,6,2,0,26,21,63,0,0,0,0,37965,11.0,40348,127,0,727,899,12.7,3796.5,25,0,1,21,26,40,0,0,0,0,37238,11.0,39449,106,0,-727,-899,10.6,3723.8
4758613953,1,10,0,1,4,2,3,0,0,0,0,17056,7.0,18621,244,48,2526,1198,29.2,1705.6,82,0,0,2,4,2,1,1,0,0,14530,6.6,17423,198,56,-2526,-1198,25.4,1453.0
4758585697,0,12,2,1,7,12,14,0,0,0,0,15896,6.6,16781,187,52,-4408,-1430,23.9,1589.6,13,1,0,12,7,12,0,0,0,0,20304,7.0,18211,214,64,4408,1430,27.8,2030.4
4758564024,1,17,0,0,3,5,1,0,0,0,0,14451,6.6,17042,203,52,-2078,-909,25.5,1445.1,54,4,1,5,3,6,1,1,0,0,16529,6.8,17951,199,56,2078,909,25.5,1652.9
4758130110,1,14,1,0,4,5,6,0,0,0,0,15857,6.2,15428,169,44,-211,-1528,21.3,1585.7,20,1,1,5,4,3,0,0,0,0,16068,6.4,16956,174,48,211,1528,22.2,1606.8
4757571057,0,32,0,0,6,2,4,0,0,0,0,16515,7.2,18790,226,49,1969,2195,27.5,1651.5,75,5,1,2,6,1,1,1,0,0,14546,6.4,16595,192,43,-1969,-2195,23.5,1454.6
4757544246,0,13,0,0,3,3,2,1,1,0,0,15130,7.2,17918,203,62,-101,-21,26.5,1513.0,11,0,1,3,3,4,0,0,0,0,15231,6.8,17939,209,53,101,21,26.2,1523.1
4756752970,0,52,3,1,3,5,2,0,0,0,0,16498,7.0,18060,236,40,-923,-566,27.6,1649.8,14,3,0,5,3,6,0,0,0,0,17421,7.0,18626,223,48,923,566,27.1,1742.1
4756543871,0,13,2,1,5,7,9,1,1,0,0,15768,6.4,16548,191,48,-1897,-1424,23.9,1576.8,15,2,0,7,5,12,0,0,0,0,17665,6.8,17972,221,64,1897,1424,28.5,1766.5
4856535422,0,12,1,0,4,7,7,0,0,0,1,15224,6.0,13721,123,54,-2909,-3263,17.7,1522.4,15,0,1,7,4,5,0,0,0,0,18133,6.6,16984,234,46,2909,3263,28.0,1813.3
4856495791,0,14,7,0,6,7,5,1,1,0,0,15662,6.4,15625,189,36,-953,-1672,22.5,1566.2,37,3,1,7,6,7,0,0,0,0,16615,6.6,17297,204,51,953,1672,25.5,1661.5
4856441195,0,13,0,1,3,0,1,0,0,0,0,16486,7.0,18481,231,56,2483,695,28.7,1648.6,11,0,0,0,3,0,1,1,0,0,14003,7.0,17786,182,55,-2483,-695,23.7,1400.3
4856393047,1,225,0,0,8,4,4,1,1,0,0,17581,7.0,19012,229,56,2359,2523,28.5,1758.1,19,2,1,4,8,6,0,0,0,0,15222,6.4,16489,171,54,-2359,-2523,22.5,1522.2
4856336163,1,11,0,1,4,2,2,0,0,0,0,15895,6.8,18381,223,49,2349,950,27.2,1589.5,12,0,0,2,4,0,1,1,0,0,13546,6.6,17431,174,57,-2349,-950,23.1,1354.6
4855377602,0,10,0,0,4,4,3,0,0,0,0,15615,6.8,17097,212,55,458,485,26.7,1561.5,14,1,1,4,4,5,1,1,0,0,15157,6.8,16612,160,48,-458,-485,20.8,1515.7
4855326671,0,170,3,1,7,10,9,0,0,0,0,16416,6.8,16943,190,47,-1017,-1288,23.7,1641.6,13,1,0,10,7,14,0,0,0,0,17433,6.8,18231,207,64,1017,1288,27.1,1743.3
4855286145,0,42,1,0,0,4,0,1,1,0,0,13523,6.2,15545,160,44,-3530,-2903,20.4,1352.3,14,9,1,4,0,4,0,0,0,0,17053,7.0,18448,217,48,3530,2903,26.5,1705.3
4855230748,1,13,1,1,6,6,5,0,0,0,0,17665,7.0,18550,219,56,1984,2387,27.5,1766.5,12,0,0,6,6,10,1,1,0,0,15681,6.2,16163,196,60,-1984,-2387,25.6,1568.1
4855132893,1,12,1,1,16,10,14,0,0,0,0,20205,6.8,17398,173,40,2420,-298,21.3,2020.5,9,0,0,10,16,6,0,0,0,0,17785,7.0,17696,191,44,-2420,298,23.5,1778.5
4855098308,1,34,1,1,5,3,9,1,1,0,0,16355,6.6,16378,173,48,865,-1144,22.1,1635.5,12,0,0,3,5,1,0,0,0,0,15490,7.0,17522,206,64,-865,1144,27.0,1549.0
4855056726,0,10,1,0,4,11,5,1,0,1,0,15113,6.6,16924,189,64,-4092,-2968,25.3,1511.3,8,2,1,11,4,8,0,0,0,0,19205,7.4,19892,233,72,4092,2968,30.5,1920.5
4855032877,1,10,0,1,12,2,6,0,0,0,0,19162,7.0,18898,228,47,5047,4884,27.5,1916.2,14,0,0,2,12,2,0,0,0,0,14115,6.0,14014,159,48,-5047,-4884,20.7,1411.5
4854980410,0,11,8,0,7,8,7,1,0,1,0,16715,6.8,17444,181,52,-1313,44,23.3,1671.5,30,1,1,8,7,11,0,0,0,0,18028,6.8,17400,200,44,1313,-44,24.4,1802.8
4854927734,0,16,1,0,3,9,1,0,0,0,0,16249,7.0,17797,236,56,-1881,-1198,29.2,1624.9,10,1,1,9,3,8,0,0,0,0,18130,7.0,18995,207,68,1881,1198,27.5,1813.0
4854643957,0,35,1,0,5,7,4,0,0,0,0,16356,6.8,18408,217,76,-242,-95,29.3,1635.6,30,0,1,7,5,5,1,1,0,0,16598,7.0,18503,213,52,242,95,26.5,1659.8
4854582546,0,14,3,0,6,6,7,0,0,0,0,15547,6.6,16061,199,36,-2539,-1384,23.5,1554.7,13,3,1,6,6,5,0,0,0,0,18086,6.8,17445,209,58,2539,1384,26.7,1808.6
4854322153,0,12,0,0,7,11,6,0,0,0,1,15203,6.4,15712,143,44,-6700,-2620,18.7,1520.3,11,2,1,11,7,11,0,0,0,0,21903,7.2,18332,223,56,6700,2620,27.9,2190.3
4854291201,1,18,1,0,5,6,4,0,0,0,0,15683,6.8,17744,194,56,-642,481,25.0,1568.3,285,1,1,6,5,8,1,1,0,0,16325,7.0,17263,196,47,642,-481,24.3,1632.5
4854150635,0,23,2,1,7,4,12,1,0,1,0,17454,6.8,17701,205,52,711,-82,25.7,1745.4,9,0,0,4,7,2,0,0,0,0,16743,7.0,17783,206,36,-711,82,24.2,1674.3
4852779485,0,10,0,0,5,17,4,0,0,0,0,16307,6.4,16725,204,47,-5662,-3788,25.1,1630.7,12,2,1,17,5,16,1,1,0,0,21969,7.8,20513,261,58,5662,3788,31.9,2196.9
4852743357,1,34,3,1,5,7,5,1,1,0,0,16543,6.6,17015,218,48,-884,-1316,26.6,1654.3,31,3,0,7,5,10,0,0,0,0,17427,6.8,18331,192,52,884,1316,24.4,1742.7
4852026100,0,36,3,0,4,4,3,0,0,0,0,16344,7.0,17494,206,48,846,-406,25.4,1634.4,70,2,1,4,4,3,0,0,0,0,15498,7.2,17900,189,44,-846,406,23.3,1549.8
4851130431,1,39,0,1,32,39,65,0,0,0,0,39041,11.8,46034,103,0,-1109,-297,10.3,3904.1,0,2,0,39,32,76,0,0,0,0,40150,12.0,46331,106,0,1109,297,10.6,4015.0
4851118762,0,19,0,0,20,30,42,0,0,0,0,34681,10.6,37705,102,0,-3204,-6062,10.2,3468.1,0,10,1,30,20,86,0,0,0,0,37885,11.6,43767,97,0,3204,6062,9.7,3788.5
4851067939,0,15,1,0,8,5,7,0,0,0,0,18331,7.0,18691,239,52,1496,1667,29.1,1833.1,9,2,1,5,8,5,0,0,0,0,16835,6.6,17024,214,52,-1496,-1667,26.6,1683.5
4850687200,0,11,3,0,3,8,1,0,0,0,0,15375,7.0,18524,213,72,-3309,-295,28.5,1537.5,14,0,1,8,3,9,1,1,0,0,18684,7.0,18819,242,48,3309,295,29.0,1868.4
4850524311,1,73,2,1,8,4,7,1,1,0,0,19669,7.0,18638,238,44,4810,1353,28.2,1966.9,14,0,0,4,8,3,0,0,0,0,14859,6.8,17285,200,53,-4810,-1353,25.3,1485.9
4850129915,0,15,0,0,5,9,1,0,0,0,0,15813,6.8,17870,219,48,-2307,59,26.7,1581.3,10,1,1,8,4,13,1,1,0,0,18120,7.0,17811,208,68,2307,-59,27.6,1812.0
4848684721,1,16,19,1,6,12,7,0,0,0,0,16813,7.0,17457,209,56,-2364,-839,26.5,1681.3,50,1,0,12,6,14,0,0,0,0,19177,6.8,18296,232,52,2364,839,28.4,1917.7
4848654153,0,10,0,0,4,5,4,0,0,0,0,16523,7.0,18078,202,61,-1036,-577,26.3,1652.3,15,2,1,5,4,4,1,1,0,0,17559,7.2,18655,215,54,1036,577,26.9,1755.9
4848245612,0,15,2,0,8,6,5,0,0,0,0,17467,7.0,18981,228,56,244,721,28.4,1746.7,17,2,1,6,8,7,0,0,0,0,17223,7.0,18260,241,58,-244,-721,29.9,1722.3
4848227043,0,12,1,0,2,6,2,0,0,0,0,15971,7.0,17807,243,54,-525,-887,29.7,1597.1,23,2,1,6,2,2,1,1,0,0,16496,7.4,18694,215,68,525,887,28.3,1649.6
4848196542,0,17,0,0,10,9,10,0,0,0,0,18470,6.8,17702,202,60,303,169,26.2,1847.0,13,3,1,9,10,17,1,1,0,0,18167,6.8,17533,201,44,-303,-169,24.5,1816.7
4848170245,0,14,1,0,6,5,6,0,0,0,0,16207,6.8,17650,217,48,885,-738,26.5,1620.7,13,0,1,5,6,1,0,0,0,0,15322,7.0,18388,190,68,-885,738,25.8,1532.2
4848130664,1,23,2,0,5,6,3,0,0,0,0,17149,7.0,18469,202,50,-132,167,25.2,1714.9,12,0,1,6,5,2,0,0,0,0,17281,7.0,18302,200,56,132,-167,25.6,1728.1
4847544762,0,11,1,0,5,9,6,0,0,0,0,17339,6.8,17187,205,48,-2063,-1780,25.3,1733.9,13,0,1,9,5,11,1,1,0,0,19402,7.2,18967,213,44,2063,1780,25.7,1940.2
4847502828,0,33,0,1,5,5,4,0,0,0,0,17270,6.4,17198,168,60,927,760,22.8,1727.0,34,1,0,5,5,6,0,0,0,0,16343,6.8,16438,190,40,-927,-760,23.0,1634.3
4847475747,0,11,1,0,7,7,5,0,0,0,0,16657,6.8,17519,190,50,0,487,24.0,1665.7,15,1,1,7,7,8,0,0,0,0,16657,6.8,17032,177,50,0,-487,22.7,1665.7
4854931414,1,50,2,0,12,7,16,1,1,0,0,19170,6.8,17807,180,56,2768,538,23.6,1917.0,12,0,1,7,12,5,0,0,0,0,16402,6.6,17269,193,48,-2768,-538,24.1,1640.2
4851496118,1,13,4,1,4,5,5,0,0,0,0,15971,6.8,17915,241,48,906,731,28.9,1597.1,13,2,0,5,4,6,1,0,1,0,15065,6.8,17184,181,48,-906,-731,22.9,1506.5
4851471304,0,13,1,0,0,3,0,1,0,1,0,13637,6.8,18192,226,56,-1895,-321,28.2,1363.7,11,0,1,3,0,4,1,1,0,0,15532,7.0,18513,223,60,1895,321,28.3,1553.2
4851182460,0,10,0,0,2,12,0,0,0,0,0,14283,6.6,14918,179,44,-5420,-3680,22.3,1428.3,6,0,1,12,2,6,0,0,0,0,19703,7.0,18598,232,43,5420,3680,27.5,1970.3
4851168680,1,12,1,1,7,4,10,1,1,0,0,17995,6.8,17212,207,48,2728,-460,25.5,1799.5,12,2,0,4,7,2,0,0,0,0,15267,6.6,17672,194,59,-2728,460,25.3,1526.7
4850705918,1,11,3,1,10,7,12,1,1,0,0,18804,7.2,18939,240,67,1676,2920,30.7,1880.4,17,2,0,7,10,8,0,0,0,0,17128,6.4,16019,167,44,-1676,-2920,21.1,1712.8
4850680713,1,51,1,1,9,6,4,0,0,0,0,17615,7.2,19129,188,76,2082,1766,26.4,1761.5,12,0,0,6,9,2,0,0,0,0,15533,7.0,17363,196,47,-2082,-1766,24.3,1553.3
4849685546,0,48,2,0,4,7,3,0,0,0,0,16068,6.6,16536,194,47,-1013,-107,24.1,1606.8,40,15,1,7,4,10,0,0,0,0,17081,6.8,16643,214,36,1013,107,25.0,1708.1
4848869625,1,12,1,0,4,1,2,1,1,0,0,15472,6.8,17782,215,52,359,861,26.7,1547.2,13,0,1,1,4,1,0,0,0,0,15113,6.8,16921,202,52,-359,-861,25.4,1511.3
4848809525,0,12,1,1,8,10,11,0,0,0,0,17531,6.6,16551,182,52,-1714,-1932,23.4,1753.1,13,1,0,10,8,10,1,1,0,0,19245,6.8,18483,204,48,1714,1932,25.2,1924.5
4848712883,1,16,2,0,3,5,7,1,0,1,0,17451,7.4,19027,227,60,310,1444,28.7,1745.1,13,2,1,5,3,5,1,1,0,0,17141,6.8,17583,209,60,-310,-1444,26.9,1714.1
4848664437,1,41,2,1,4,3,4,0,0,0,0,16811,7.2,18911,207,55,774,863,26.2,1681.1,8,17,0,3,4,3,0,0,0,0,16037,6.8,18048,225,60,-774,-863,28.5,1603.7
4848638018,1,11,1,1,4,0,3,0,0,0,0,16370,7.2,18801,242,56,2638,1057,29.8,1637.0,20,0,0,0,4,0,0,0,0,0,13732,7.0,17744,194,60,-2638,-1057,25.4,1373.2
4847609265,1,11,2,1,3,2,4,1,1,0,0,15978,6.8,17615,246,60,1719,1026,30.6,1597.8,11,1,0,2,3,3,0,0,0,0,14259,6.6,16589,203,50,-1719,-1026,25.3,1425.9
4847589492,1,9,3,1,4,3,7,0,0,0,0,15851,6.6,17450,212,52,240,-811,26.4,1585.1,15,4,0,3,4,2,0,0,0,0,15611,7.0,18261,250,60,-240,811,31.0,1561.1
4847575894,0,20,0,0,2,10,0,0,0,0,0,14183,6.6,16517,214,59,-5575,-2297,27.3,1418.3,13,2,1,10,2,14,1,1,0,0,19758,7.0,18814,220,44,5575,2297,26.4,1975.8
4845169550,0,18,1,1,7,4,6,0,0,0,0,17109,6.6,17523,208,36,497,152,24.4,1710.9,11,1,0,4,7,5,0,0,0,0,16612,6.8,17371,182,71,-497,-152,25.3,1661.2
4845142602,1,28,0,0,7,4,10,0,0,0,0,17427,7.0,17965,214,61,2877,1790,27.5,1742.7,29,0,1,4,7,3,0,0,0,0,14550,6.6,16175,180,49,-2877,-1790,22.9,1455.0
4845116091,1,13,0,0,6,2,2,1,1,0,0,15887,7.0,18172,197,60,699,1219,25.7,1588.7,10,2,1,2,6,3,0,0,0,0,15188,6.6,16953,229,56,-699,-1219,28.5,1518.8
4857556092,1,10,1,1,8,2,7,1,1,0,0,17042,6.6,16825,184,66,2129,-282,25.0,1704.2,11,0,0,2,8,0,0,0,0,0,14913,6.8,17107,235,46,-2129,282,28.1,1491.3
4857525771,1,14,1,0,8,10,7,0,0,0,0,17875,6.8,17930,203,44,-567,-202,24.7,1787.5,30,4,1,10,8,8,0,0,0,0,18442,7.0,18132,194,56,567,202,25.0,1844.2
4857482714,0,16,4,0,2,5,0,0,0,0,0,14682,6.8,17847,203,56,-2149,-1692,25.9,1468.2,20,1,1,5,2,3,0,0,0,0,16831,7.2,19539,218,68,2149,1692,28.6,1683.1
4857047376,0,9,0,1,4,4,2,0,0,0,0,15678,6.8,17662,209,44,-258,-520,25.3,1567.8,9,1,0,4,4,5,0,0,0,0,15936,7.0,18182,192,59,258,520,25.1,1593.6
4857016656,1,14,3,1,11,7,5,1,0,1,0,20380,7.2,20097,221,68,4243,3074,28.9,2038.0,21,0,0,7,11,5,1,1,0,0,16137,6.8,17023,176,48,-4243,-3074,22.4,1613.7
4856983541,0,15,1,0,3,3,3,0,0,0,0,16118,7.0,18583,253,52,823,1729,30.5,1611.8,51,1,1,3,3,5,1,1,0,0,15295,6.6,16854,216,56,-823,-1729,27.2,1529.5
4855468170,1,15,2,0,0,2,0,0,0,0,0,13971,6.8,17408,213,63,-1107,-819,27.6,1397.1,13,3,1,2,0,0,0,0,0,0,15078,6.8,18227,218,67,1107,819,28.5,1507.8
4855454840,0,7,1,1,3,8,3,0,0,0,0,15656,6.8,17559,232,48,-1648,-849,28.0,1565.6,14,2,0,8,3,5,0,0,0,0,17304,7.0,18408,225,51,1648,849,27.6,1730.4
4853576460,1,13,0,0,4,5,3,0,0,0,0,14321,6.6,16153,198,41,-1771,-1448,23.9,1432.1,14,0,1,5,4,3,0,0,0,0,16092,6.6,17601,210,54,1771,1448,26.4,1609.2
4853005963,0,76,1,0,2,2,2,0,0,0,0,15147,7.0,18024,221,56,157,-250,27.7,1514.7,11,1,1,2,2,1,1,1,0,0,14990,6.8,18274,244,60,-157,250,30.4,1499.0
4852944502,0,13,3,0,4,7,3,0,0,0,0,15274,6.8,17182,218,56,-2654,-698,27.4,1527.4,13,3,1,7,4,6,1,1,0,0,17928,7.2,17880,196,56,2654,698,25.2,1792.8
4852673161,1,14,3,1,6,3,2,1,1,0,0,17494,7.4,19403,246,68,2556,1839,31.4,1749.4,24,1,0,3,6,2,0,0,0,0,14938,7.0,17564,180,54,-2556,-1839,23.4,1493.8
4852638728,1,15,0,1,19,15,19,0,0,0,0,50150,10.0,47500,0,0,23000,19000,0.0,5015.0,0,0,0,8,12,4,0,0,0,0,27150,6.0,28500,0,0,-23000,-19000,0.0,2715.0
4851083549,0,15,2,0,6,7,8,0,0,0,0,17284,6.8,17612,196,64,60,-703,26.0,1728.4,15,2,1,7,6,3,1,1,0,0,17224,7.0,18315,218,44,-60,703,26.2,1722.4
4851060788,1,10,3,1,12,7,18,1,1,0,0,21019,7.4,20065,252,56,5118,3468,30.8,2101.9,15,1,0,7,12,5,0,0,0,0,15901,6.4,16597,177,51,-5118,-3468,22.8,1590.1
4850262693,1,10,1,1,9,0,5,1,1,0,0,18584,7.4,20266,225,80,4972,4073,30.5,1858.4,10,0,0,0,9,0,0,0,0,0,13612,6.6,16193,210,44,-4972,-4073,25.4,1361.2
4850259292,0,10,1,0,3,4,1,0,0,0,0,14880,6.8,17678,225,52,-244,183,27.7,1488.0,17,1,1,4,3,2,0,0,0,0,15124,6.8,17495,180,50,244,-183,23.0,1512.4
4850244534,1,13,0,1,9,5,9,0,0,0,0,18101,7.0,18409,233,56,1872,-549,28.9,1810.1,9,0,0,5,9,2,1,1,0,0,16229,7.2,18958,195,68,-1872,549,26.3,1622.9
4850233216,1,12,3,1,9,6,5,0,0,0,0,18455,7.2,18993,211,72,2634,1864,28.3,1845.5,14,2,0,6,9,4,0,0,0,0,15821,6.8,17129,166,48,-2634,-1864,21.4,1582.1
4854009478,1,37,0,1,16,22,22,0,0,0,0,60842,12.0,55000,4,0,22906,22000,0.4,6084.2,19,1,0,15,9,13,0,0,0,0,37936,7.2,33000,0,0,-22906,-22000,0.0,3793.6
4825402494,1,22,5,0,18,7,25,0,0,0,0,37500,11.8,44326,103,78,7656,8521,18.1,3750.0,195,0,1,7,18,12,0,0,0,0,29844,10.4,35805,76,59,-7656,-8521,13.5,2984.4
4825387635,1,13,0,1,20,7,38,0,0,0,1,37431,11.6,43637,109,63,8426,9078,17.2,3743.1,8,3,0,7,20,17,0,0,0,0,29005,10.4,34559,88,47,-8426,-9078,13.5,2900.5
4816168212,0,19,0,1,15,17,24,0,0,0,0,34218,11.0,38304,95,67,-372,-1388,16.2,3421.8,14,0,0,17,15,28,0,0,0,0,34590,11.0,39692,105,59,372,1388,16.4,3459.0
4816140729,1,12,0,0,15,12,37,0,0,0,0,40670,11.6,43345,110,87,8993,7261,19.7,4067.0,17,2,1,12,15,30,0,0,0,0,31677,10.6,36084,97,56,-8993,-7261,15.3,3167.7
4816119636,1,11,1,1,14,17,25,0,0,0,0,34431,11.4,41850,93,51,-1487,-656,14.4,3443.1,21,0,0,17,14,32,0,0,0,0,35918,11.6,42506,97,67,1487,656,16.4,3591.8
4814829051,1,16,0,1,16,5,26,0,0,0,1,36838,11.6,43342,76,71,8026,8834,14.7,3683.8,17,0,0,5,16,6,0,0,0,0,28812,10.2,34508,96,59,-8026,-8834,15.5,2881.2
4814801668,1,13,0,1,17,13,23,0,0,0,1,38213,11.8,44105,150,71,2849,2886,22.1,3821.3,20,0,0,13,17,22,0,0,0,0,35364,11.4,41219,116,55,-2849,-2886,17.1,3536.4
4814283031,1,9,0,1,18,20,27,0,0,0,0,33653,11.2,39445,82,57,-5672,-6620,13.9,3365.3,11,0,0,20,18,33,0,0,0,0,39325,11.8,46065,132,63,5672,6620,19.5,3932.5
4814257802,1,11,0,1,18,15,39,0,0,0,0,34984,11.0,39779,88,63,1665,3561,15.1,3498.4,12,0,0,15,18,35,0,0,0,0,33319,10.6,36218,58,55,-1665,-3561,11.3,3331.9
4814218888,1,110,0,1,19,9,18,0,0,0,1,34875,11.4,42794,105,63,5745,9294,16.8,3487.5,9,21,0,9,19,12,0,0,0,0,29130,10.0,33500,78,57,-5745,-9294,13.5,2913.0
4814196950,0,12,0,0,15,26,26,0,0,0,0,34859,11.0,39830,101,59,-4428,-5283,16.0,3485.9,13,0,1,26,15,42,0,0,0,0,39287,12.0,45113,101,61,4428,5283,16.2,3928.7
4813767899,0,15,0,0,14,23,18,0,0,0,1,32956,11.0,37994,101,60,-9474,-7115,16.1,3295.6,13,0,1,23,14,39,0,0,0,0,42430,11.8,45109,115,72,9474,7115,18.7,4243.0
4813139018,1,20,0,0,21,14,25,0,0,0,1,35063,11.2,40911,78,59,2408,3140,13.7,3506.3,15,0,1,13,20,16,0,0,0,0,32655,10.6,37771,69,51,-2408,-3140,12.0,3265.5
4813116895,1,15,0,0,24,12,51,0,0,0,2,38636,11.6,43689,100,63,1146,1807,16.3,3863.6,10,2,1,12,24,20,0,0,0,0,37490,11.6,41882,83,71,-1146,-1807,15.4,3749.0
4813100889,0,13,0,0,16,16,30,0,0,0,0,31000,10.8,37484,91,42,-3050,-2280,13.3,3100.0,14,0,1,16,16,24,0,0,0,0,34050,11.2,39764,59,71,3050,2280,13.0,3405.0
4813075250,0,41,0,0,26,22,55,0,0,0,0,36839,10.6,36337,61,48,-4100,-4088,10.9,3683.9,35,0,1,22,26,44,0,0,0,0,40939,11.4,40425,78,64,4100,4088,14.2,4093.9
4842197989,1,13,6,1,10,6,7,0,0,0,0,18397,6.8,17699,199,48,1785,-150,24.7,1839.7,14,1,0,6,10,3,0,0,0,0,16612,6.8,17849,197,64,-1785,150,26.1,1661.2
4842158479,1,17,0,0,9,5,10,1,1,0,0,17857,6.2,16512,184,52,556,-471,23.6,1785.7,14,2,1,5,9,4,0,0,0,0,17301,6.6,16983,207,43,-556,471,25.0,1730.1
4842109998,1,86,2,1,3,4,2,0,0,0,0,17158,6.8,18155,218,52,601,802,27.0,1715.8,8,0,0,4,3,4,0,0,0,0,16557,6.8,17353,173,68,-601,-802,24.1,1655.7
4842043684,0,12,0,0,1,7,1,0,0,0,0,14545,7.0,17981,189,57,-2304,-1342,24.6,1454.5,12,0,1,7,1,4,1,1,0,0,16849,7.0,19323,196,72,2304,1342,26.8,1684.9
4841991038,1,15,1,0,4,2,4,0,0,0,0,15539,6.8,17638,211,48,461,-563,25.9,1553.9,70,3,1,2,4,1,0,0,0,0,15078,6.8,18201,225,60,-461,563,28.5,1507.8
4841257822,0,9,0,0,1,5,0,1,0,1,0,15581,7.0,18223,196,62,366,-69,25.8,1558.1,10,0,1,5,1,2,0,0,0,0,15215,6.8,18292,214,54,-366,69,26.8,1521.5
4834900286,1,11,2,1,4,6,3,0,0,0,0,16191,6.8,17554,216,64,-103,-505,28.0,1619.1,12,1,0,6,4,6,1,1,0,0,16294,6.8,18059,199,60,103,505,25.9,1629.4
4834852389,0,11,0,0,7,4,6,1,0,1,0,16603,6.8,18362,201,64,604,-175,26.5,1660.3,10,1,1,4,7,1,0,0,0,0,15999,7.0,18537,234,48,-604,175,28.2,1599.9
4758451853,1,14,2,1,9,1,9,2,1,1,0,17956,7.0,17514,195,60,4054,575,25.5,1795.6,10,1,0,1,9,1,0,0,0,0,13902,6.6,16939,211,44,-4054,-575,25.5,1390.2
4758422595,0,11,1,1,6,6,6,0,0,0,0,16909,7.0,17943,212,60,1105,33,27.2,1690.9,17,1,0,6,6,6,1,1,0,0,15804,7.0,17910,172,64,-1105,-33,23.6,1580.4
4756876187,1,10,2,1,5,3,3,0,0,0,0,15992,7.0,18211,203,60,1127,632,26.3,1599.2,11,1,0,3,5,2,1,1,0,0,14865,6.8,17579,174,60,-1127,-632,23.4,1486.5
4756842789,1,8,0,0,11,5,7,1,1,0,0,18535,6.8,17276,192,48,2536,765,24.0,1853.5,11,0,1,5,11,7,0,0,0,0,15999,6.6,16511,190,52,-2536,-765,24.2,1599.9
4756814461,0,10,21,0,8,8,5,0,0,0,0,15883,6.8,16778,179,42,-1800,-2313,22.1,1588.3,36,1,1,7,7,5,1,1,0,0,17683,7.0,19091,256,44,1800,2313,30.0,1768.3
4756781274,0,8,0,0,0,2,0,0,0,0,0,14011,6.8,18067,217,52,-2041,-799,26.9,1401.1,77,1,1,2,0,1,1,1,0,0,16052,7.0,18866,238,56,2041,799,29.4,1605.2
4756754413,0,14,0,0,6,12,5,0,0,0,0,16724,6.6,15858,161,40,-2143,-575,20.1,1672.4,13,1,1,12,6,9,1,1,0,0,18867,6.6,16433,208,52,2143,575,26.0,1886.7
4756722094,1,15,2,0,8,12,7,1,0,1,0,17606,7.0,18649,227,54,-1493,-720,28.1,1760.6,14,1,1,11,7,9,1,1,0,0,19099,7.4,19369,196,73,1493,720,26.9,1909.9
4752123360,1,12,2,0,3,3,1,0,0,0,0,16605,7.4,19573,191,56,1411,1518,24.7,1660.5,9,2,1,3,3,2,1,1,0,0,15194,7.0,18055,229,60,-1411,-1518,28.9,1519.4
4752076044,1,15,3,1,7,5,8,1,1,0,0,17004,6.8,17653,192,48,-485,-2052,24.0,1700.4,13,0,0,5,7,6,0,0,0,0,17489,7.0,19705,198,75,485,2052,27.3,1748.9
4752018233,0,13,1,1,7,1,6,0,0,0,0,16642,7.2,19415,190,76,2300,1530,26.6,1664.2,12,0,0,1,7,0,1,1,0,0,14342,7.0,17885,213,60,-2300,-1530,27.3,1434.2
4845229656,0,8,0,0,6,11,6,0,0,0,0,16200,6.8,17129,188,44,-1304,422,23.2,1620.0,10,0,1,11,6,12,0,0,0,0,17504,6.8,16707,189,40,1304,-422,22.9,1750.4
4843467346,1,20,2,1,10,3,9,1,1,0,0,17990,6.8,17891,216,44,3911,1041,26.0,1799.0,12,1,0,3,10,4,0,0,0,0,14079,6.6,16850,175,36,-3911,-1041,21.1,1407.9
4842230598,1,13,1,0,3,4,3,0,0,0,0,14916,7.0,17650,189,52,-564,-546,24.1,1491.6,11,1,1,4,3,0,0,0,0,0,15480,6.8,18196,229,52,564,546,28.1,1548.0
4839227949,1,14,0,1,6,1,6,0,0,0,0,16711,6.8,17966,195,59,2599,-177,25.4,1671.1,14,0,0,1,6,0,0,0,0,0,14112,7.0,18143,211,52,-2599,177,26.3,1411.2
4839105425,1,38,0,1,4,2,1,0,0,0,0,16132,7.0,18001,231,56,-279,-828,28.7,1613.2,8,16,0,2,4,2,0,0,0,0,16411,7.2,18829,219,64,279,828,28.3,1641.1
4838847457,1,20,2,1,5,3,5,1,1,0,0,17159,6.8,17998,216,52,2845,608,26.8,1715.9,12,0,0,3,5,3,0,0,0,0,14314,6.8,17390,175,59,-2845,-608,23.4,1431.4
4838816653,0,9,1,0,7,12,7,0,0,0,0,16558,7.0,17323,184,48,-2560,-2965,23.2,1655.8,10,1,1,11,6,8,0,0,0,0,19118,7.4,20288,194,68,2560,2965,26.2,1911.8
4838756335,1,85,0,0,1,3,1,0,0,0,0,13597,6.8,17210,189,60,-2018,-1061,24.9,1359.7,33,0,1,3,1,3,1,1,0,0,15615,6.8,18271,214,76,2018,1061,29.0,1561.5
4838733316,1,16,2,1,10,5,12,0,0,0,0,17557,6.8,17322,183,48,1930,468,23.1,1755.7,19,1,0,5,10,4,0,0,0,0,15627,6.8,16854,208,46,-1930,-468,25.4,1562.7
4838721892,0,15,1,0,2,9,1,0,0,0,0,13506,6.2,14698,161,48,-5143,-2613,20.9,1350.6,14,1,1,9,2,13,1,0,1,0,18649,6.8,17311,193,55,5143,2613,24.8,1864.9
4836044379,0,14,1,1,5,7,6,0,0,0,0,15125,6.8,16366,180,48,-1349,-1590,22.8,1512.5,14,3,0,7,5,6,1,1,0,0,16474,6.8,17956,199,64,1349,1590,26.3,1647.4
4834153184,1,11,1,0,4,6,8,1,1,0,0,14827,6.6,17101,215,48,-1885,-1220,26.3,1482.7,11,1,1,5,3,9,0,0,0,0,16712,7.0,18321,226,63,1885,1220,28.9,1671.2
4831063075,1,17,1,0,1,11,1,0,0,0,0,15187,6.8,16951,198,36,-3582,-2225,23.4,1518.7,14,2,1,11,1,9,1,1,0,0,18769,7.4,19176,206,60,3582,2225,26.6,1876.9
4827601156,0,16,1,1,5,4,5,0,0,0,0,16722,7.0,18507,239,52,776,274,29.1,1672.2,9,2,0,4,5,4,1,1,0,0,15946,7.2,18233,190,56,-776,-274,24.6,1594.6
4825792913,0,8,0,1,3,4,0,0,0,0,0,16586,7.2,18896,239,60,-1056,356,29.9,1658.6,7,0,0,4,3,2,0,0,0,0,17642,7.2,18540,201,68,1056,-356,26.9,1764.2
4823996389,1,163,1,1,5,2,8,0,0,0,0,16655,6.8,17158,197,48,1484,-910,24.5,1665.5,9,1,0,2,5,2,1,1,0,0,15171,7.0,18068,217,57,-1484,910,27.4,1517.1
4823044524,0,13,17,0,4,6,2,0,0,0,0,15668,7.0,18618,220,56,-616,-513,27.6,1566.8,35,2,1,6,4,3,1,1,0,0,16284,7.0,19131,207,64,616,513,27.1,1628.4
4820994556,0,51,1,0,2,4,0,0,0,0,0,13772,6.8,17776,205,52,-2136,-796,25.7,1377.2,13,2,1,4,2,4,2,1,1,0,15908,7.0,18572,251,50,2136,796,30.1,1590.8
4819985580,1,12,2,0,6,3,4,0,0,0,0,16237,7.0,17608,191,52,1088,1510,24.3,1623.7,12,2,1,3,6,2,0,0,0,0,15149,6.2,16098,215,32,-1088,-1510,24.7,1514.9
4857410495,1,0,0,0,19,20,44,0,0,0,1,36201,11.0,38884,112,0,1149,-868,11.2,3620.1,0,0,1,20,19,39,0,0,0,0,35052,11.0,39752,104,0,-1149,868,10.4,3505.2
4857381538,0,25,0,0,33,29,84,0,0,0,0,40726,12.0,44439,102,0,443,34,10.2,4072.6,1,4,1,29,33,70,0,0,0,0,40283,11.8,44405,101,0,-443,-34,10.1,4028.3
4856287600,1,10,1,0,4,3,5,0,0,0,0,15712,6.8,17840,224,60,332,16,28.4,1571.2,15,1,1,3,4,2,0,0,0,0,15380,6.8,17824,206,52,-332,-16,25.8,1538.0
4853997651,0,15,0,0,1,5,1,0,0,0,0,13323,6.4,16065,186,40,-3574,-2555,22.6,1332.3,14,4,1,5,1,3,2,1,1,0,16897,7.0,18620,220,68,3574,2555,28.8,1689.7
4853050433,0,148,0,0,5,12,9,1,1,0,0,16037,6.8,16766,184,56,-3729,-1786,24.0,1603.7,11,1,1,12,5,17,0,0,0,0,19766,7.0,18552,240,52,3729,1786,29.2,1976.6
4853004623,1,14,0,0,5,4,4,0,0,0,0,16329,7.0,18734,198,52,912,-181,25.0,1632.9,11,0,1,4,5,1,0,0,0,0,15417,7.2,18915,212,56,-912,181,26.8,1541.7
4852952413,1,0,0,0,25,19,62,0,0,0,0,36253,11.0,40650,93,0,-239,1813,9.3,3625.3,0,0,1,19,25,61,0,0,0,0,36492,10.8,38837,95,0,239,-1813,9.5,3649.2
4851058452,1,52,0,1,6,4,10,1,1,0,0,17998,7.0,18186,213,59,1749,-41,27.2,1799.8,9,0,0,4,6,4,0,0,0,0,16249,7.0,18227,204,60,-1749,41,26.4,1624.9
4851019636,0,12,1,0,6,7,3,0,0,0,0,16248,6.8,17216,199,44,-611,-1233,24.3,1624.8,15,1,1,7,6,5,2,1,1,0,16859,6.8,18449,203,72,611,1233,27.5,1685.9
4850913581,0,17,0,1,2,1,0,0,0,0,0,14934,6.8,18614,237,60,198,954,29.7,1493.4,103,0,0,1,2,1,0,0,0,0,14736,7.0,17660,229,44,-198,-954,27.3,1473.6
4850872575,0,13,1,1,6,6,5,1,1,0,0,17130,6.8,17215,211,52,-183,-710,26.3,1713.0,8,1,0,6,6,6,1,0,1,0,17313,6.8,17925,190,64,183,710,25.4,1731.3
4850839803,0,8,1,0,2,4,2,0,0,0,0,15941,7.2,18596,213,64,118,977,27.7,1594.1,8,1,1,4,2,3,0,0,0,0,15823,6.8,17619,240,40,-118,-977,28.0,1582.3
4850061988,0,83,0,0,9,11,8,0,0,0,0,18439,6.6,17537,194,32,-1750,-1988,22.6,1843.9,11,2,1,11,9,9,1,1,0,0,20189,7.2,19525,199,76,1750,1988,27.5,2018.9
4850011695,0,8,1,1,3,4,2,0,0,0,0,15217,6.8,17428,218,44,-287,-544,26.2,1521.7,10,0,0,4,3,3,0,0,0,0,15504,6.8,17972,203,48,287,544,25.1,1550.4
4846107380,1,161,0,1,4,1,2,1,1,0,0,16559,7.0,19289,237,56,2685,1949,29.3,1655.9,12,1,0,1,4,0,0,0,0,0,13874,6.8,17340,200,52,-2685,-1949,25.2,1387.4
4846062415,0,14,0,0,1,4,0,0,0,0,0,14274,6.8,17648,214,60,-1571,-1296,27.4,1427.4,11,1,1,4,1,2,1,1,0,0,15845,7.0,18944,223,60,1571,1296,28.3,1584.5
4846013450,1,75,0,0,8,3,8,0,0,0,0,17062,7.2,18509,191,40,1905,1416,23.1,1706.2,9,0,1,3,8,3,0,0,0,0,15157,6.8,17093,216,44,-1905,-1416,26.0,1515.7
4845805061,1,21,2,0,6,8,6,0,0,0,0,15568,6.6,16719,189,40,-2400,-553,22.9,1556.8,16,2,1,8,6,10,1,1,0,0,17968,6.8,17272,208,52,2400,553,26.0,1796.8
4844299859,1,12,1,0,4,2,4,0,0,0,0,14979,7.0,17471,181,56,-631,-1283,23.7,1497.9,13,0,1,2,4,0,0,0,0,0,15610,7.0,18754,210,60,631,1283,27.0,1561.0
4857505347,0,19,0,1,9,6,6,1,1,0,0,17698,6.6,17208,220,48,1847,-1309,26.8,1769.8,19,0,0,6,9,2,0,0,0,0,15851,7.2,18517,220,56,-1847,1309,27.6,1585.1
4857373882,0,14,1,0,4,10,4,1,1,0,0,17420,7.0,17890,232,44,-957,-274,27.6,1742.0,12,1,1,10,4,11,0,0,0,0,18377,6.8,18164,210,52,957,274,26.2,1837.7
4856409133,1,15,1,1,3,1,3,1,1,0,0,16400,6.8,18430,230,56,2547,1905,28.6,1640.0,11,1,0,1,3,1,0,0,0,0,13853,6.6,16525,207,48,-2547,-1905,25.5,1385.3
4856355957,0,16,2,0,3,2,3,0,0,0,0,15848,7.0,18593,245,55,212,62,30.0,1584.8,88,3,1,2,3,2,1,1,0,0,15636,7.2,18531,225,52,-212,-62,27.7,1563.6
4856203711,0,9,1,0,3,5,7,0,0,0,0,15017,6.8,16663,214,45,-1708,-730,25.9,1501.7,11,0,1,5,3,7,0,0,0,0,16725,6.8,17393,226,58,1708,730,28.4,1672.5
4856132921,0,4,1,1,4,8,2,0,0,0,0,16199,6.6,16897,210,48,-1391,-1430,25.8,1619.9,10,0,0,8,4,6,1,1,0,0,17590,7.0,18327,222,44,1391,1430,26.6,1759.0
4856074386,0,13,0,1,4,2,5,1,0,1,0,16398,6.8,18667,222,56,479,487,27.8,1639.8,10,0,0,2,4,2,1,1,0,0,15919,6.8,18180,229,48,-479,-487,27.7,1591.9
4856026076,0,10,0,0,3,10,2,0,0,0,0,14539,6.8,17428,186,44,-3622,-1086,23.0,1453.9,11,0,1,10,3,7,0,0,0,0,18161,7.2,18514,240,51,3622,1086,29.1,1816.1
4855960342,0,23,0,0,4,4,2,1,0,1,0,15706,7.2,18767,215,56,393,465,27.1,1570.6,80,1,1,4,4,2,1,1,0,0,15313,7.0,18302,195,68,-393,-465,26.3,1531.3
4855915531,1,11,1,0,5,2,4,0,0,0,0,16808,7.0,18484,221,56,3059,2490,27.7,1680.8,14,1,1,2,5,1,1,1,0,0,13749,6.6,15994,176,52,-3059,-2490,22.8,1374.9
4855874561,0,24,0,1,8,4,10,1,1,0,0,17638,6.6,17393,209,44,1319,-888,25.3,1763.8,13,0,0,4,8,2,1,0,1,0,16319,7.0,18281,213,52,-1319,888,26.5,1631.9
4855500302,0,12,1,1,6,4,4,0,0,0,0,16312,6.8,17806,201,48,616,625,24.9,1631.2,11,2,0,4,6,4,0,0,0,0,15696,6.8,17181,213,56,-616,-625,26.9,1569.6
4855471493,1,23,2,1,3,5,3,1,1,0,0,14828,7.0,17754,189,60,-1886,-1350,24.9,1482.8,18,3,0,5,3,3,0,0,0,0,16714,7.2,19104,231,48,1886,1350,27.9,1671.4
4855183515,0,117,2,0,2,5,1,0,0,0,0,15004,7.2,18794,232,76,-1577,741,30.8,1500.4,12,2,1,5,2,4,0,0,0,0,16581,6.8,18053,234,48,1577,-741,28.2,1658.1
4848284053,0,11,1,1,5,7,1,0,0,0,0,15418,6.2,16104,170,47,-1645,-832,21.7,1541.8,80,1,0,7,5,9,1,1,0,0,17063,6.8,16936,176,64,1645,832,24.0,1706.3
4841393099,1,12,0,0,11,7,21,0,0,0,0,19491,6.8,16988,197,40,2533,-628,23.7,1949.1,7,2,1,7,11,10,1,0,1,0,16958,6.8,17616,190,60,-2533,628,25.0,1695.8
4841304305,0,13,2,0,2,7,2,0,0,0,0,14787,6.8,17412,230,52,-2705,-1686,28.2,1478.7,10,2,1,7,2,10,1,1,0,0,17492,7.2,19098,247,64,2705,1686,31.1,1749.2
4839231092,0,9,1,1,9,4,6,1,1,0,0,16808,6.8,17021,179,60,966,-1117,23.9,1680.8,10,0,0,4,9,2,0,0,0,0,15842,7.0,18138,196,64,-966,1117,26.0,1584.2
4838413018,1,18,2,1,8,11,9,0,0,0,0,17326,6.8,16986,208,40,-2412,-930,24.8,1732.6,16,3,0,11,8,13,0,0,0,0,19738,6.8,17916,196,52,2412,930,24.8,1973.8
4856427683,1,0,0,0,21,15,19,0,0,0,0,63056,12.8,60500,0,0,26203,23000,0.0,6305.6,0,0,1,7,13,11,0,0,0,0,36853,7.8,37500,0,0,-26203,-23000,0.0,3685.3
4856413873,1,30,1,1,18,17,20,0,0,0,0,48110,10.0,47500,2,0,19515,19000,0.2,4811.0,0,4,0,13,14,8,0,0,0,0,28595,6.0,28500,1,0,-19515,-19000,0.1,2859.5
4856380725,1,234,1,1,19,17,17,0,0,0,0,47067,10.0,47500,1,0,18691,19000,0.1,4706.7,28,0,0,8,10,13,0,0,0,0,28376,6.0,28500,6,0,-18691,-19000,0.6,2837.6
4856361236,1,176,0,1,17,12,11,0,0,0,0,46130,10.2,48680,3,0,19635,20055,0.3,4613.0,176,0,0,5,10,10,0,0,0,0,26495,6.0,28625,1,0,-19635,-20055,0.1,2649.5
4856325948,1,0,0,1,15,11,45,0,0,0,1,35407,10.6,36385,111,0,2851,1823,11.1,3540.7,0,0,0,11,15,23,0,0,0,0,32556,10.4,34562,87,0,-2851,-1823,8.7,3255.6
4856292862,1,0,5,1,16,12,35,0,0,0,1,34348,10.2,35882,115,0,1292,2007,11.5,3434.8,23,0,0,12,16,25,0,0,0,0,33056,10.0,33875,94,0,-1292,-2007,9.4,3305.6
4856254149,0,0,0,1,23,21,51,0,0,0,0,37918,11.4,40841,118,0,81,-624,11.8,3791.8,3,0,0,21,23,54,0,0,0,0,37837,11.2,41465,93,0,-81,624,9.3,3783.7
4855927780,1,0,0,0,20,17,22,0,0,0,0,49854,10.2,48680,0,0,18809,20180,0.0,4985.4,13,0,1,11,14,13,0,0,0,0,31045,6.0,28500,0,0,-18809,-20180,0.0,3104.5
4855903693,1,8,0,0,10,21,18,0,0,0,0,46400,10.0,47500,2,0,18200,19000,0.2,4640.0,0,0,1,16,5,9,0,0,0,0,28200,6.0,28500,0,0,-18200,-19000,0.0,2820.0
4855896062,1,5,1,1,23,15,24,0,0,0,0,66360,12.0,55000,1,0,29510,22000,0.1,6636.0,17,0,0,8,16,9,0,0,0,0,36850,7.2,33000,0,0,-29510,-22000,0.0,3685.0
4855878614,1,9,4,0,16,23,22,0,0,0,0,63795,12.0,55000,1,0,25415,22000,0.1,6379.5,27,1,1,16,9,8,0,0,0,0,38380,7.2,33000,5,0,-25415,-22000,0.5,3838.0
4855269491,1,0,0,1,13,15,12,0,0,0,0,45400,10.0,47500,1,0,16718,19000,0.1,4540.0,6,0,0,10,8,10,0,0,0,0,28682,6.0,28500,2,0,-16718,-19000,0.2,2868.2
4855252271,1,0,0,1,26,15,26,0,0,0,0,63800,12.2,56000,1,0,26928,22962,0.1,6380.0,87,0,0,7,18,10,0,0,0,0,36872,7.2,33038,2,1,-26928,-22962,0.3,3687.2
4855223599,1,326,0,0,20,19,21,0,0,0,0,52034,12.8,59000,0,0,13962,25000,0.0,5203.4,0,0,1,11,12,13,0,0,0,0,38072,7.4,34000,3,0,-13962,-25000,0.3,3807.2
4855201286,1,0,0,0,13,20,13,0,0,0,0,61820,12.0,55000,2,0,22795,22000,0.2,6182.0,0,0,1,14,7,13,0,0,0,0,39025,7.2,33000,1,0,-22795,-22000,0.1,3902.5
4855184856,1,0,0,1,21,11,17,0,0,0,0,62700,12.0,55000,2,0,26900,22000,0.2,6270.0,4,0,0,3,13,7,0,0,0,0,35800,7.2,33000,0,0,-26900,-22000,0.0,3580.0
4854960468,1,43,0,0,11,18,8,0,0,0,0,44900,10.0,47500,0,0,16700,19000,0.0,4490.0,5,0,1,11,4,13,0,0,0,0,28200,6.0,28500,0,0,-16700,-19000,0.0,2820.0
4854936682,1,56,3,0,21,18,21,0,0,0,0,64140,12.0,55000,1,0,26240,22000,0.1,6414.0,0,0,1,12,15,11,0,0,0,0,37900,7.2,33000,0,0,-26240,-22000,0.0,3790.0
4854920874,1,0,0,1,28,18,28,0,0,0,0,65935,12.0,55000,1,0,29060,22000,0.1,6593.5,0,0,0,6,16,8,0,0,0,0,36875,7.2,33000,1,0,-29060,-22000,0.1,3687.5
4854891314,1,254,0,1,26,17,29,0,0,0,0,64508,12.0,55000,1,0,28227,22000,0.1,6450.8,28,0,0,7,16,7,0,0,0,0,36281,7.2,33000,5,0,-28227,-22000,0.5,3628.1
4856378734,1,9,0,1,21,15,22,0,0,0,0,65150,12.0,55000,0,0,27600,22000,0.0,6515.0,0,0,0,9,15,10,0,0,0,0,37550,7.2,33000,0,0,-27600,-22000,0.0,3755.0
4856345465,1,0,0,0,17,11,19,0,0,0,0,47000,10.0,47500,0,0,20200,19000,0.0,4700.0,0,0,1,6,12,3,0,0,0,0,26800,6.0,28500,0,0,-20200,-19000,0.0,2680.0
4856318788,1,41,0,1,16,23,10,0,0,0,0,44900,10.0,47500,0,0,16000,16000,0.0,4490.0,0,0,0,12,5,15,0,0,0,0,28900,6.6,31500,0,0,-16000,-16000,0.0,2890.0
4856263052,0,1,0,0,21,22,62,0,0,0,0,35436,11.0,39716,97,0,-1010,-264,9.7,3543.6,36,0,1,22,21,56,0,0,0,0,36446,11.2,39980,97,0,1010,264,9.7,3644.6
4856225567,1,0,0,1,27,14,78,0,0,0,1,37673,11.0,39714,108,0,2580,3906,10.8,3767.3,0,0,0,14,27,25,0,0,0,0,35093,10.4,35808,107,0,-2580,-3906,10.7,3509.3
4856182951,1,0,0,1,19,12,54,0,0,0,0,35174,10.8,37781,114,0,1626,2156,11.4,3517.4,0,0,0,12,19,28,0,0,0,0,33548,10.2,35625,94,0,-1626,-2156,9.4,3354.8
4856141852,1,0,0,1,27,17,25,0,0,0,0,50500,10.0,47500,0,0,21600,19000,0.0,5050.0,0,0,0,4,14,10,0,0,0,0,28900,6.0,28500,0,0,-21600,-19000,0.0,2890.0
4855860139,0,8,0,1,31,31,67,0,0,0,0,39413,11.8,45291,100,0,-99,1854,10.0,3941.3,0,2,0,31,31,70,0,0,0,0,39512,11.8,43437,114,0,99,-1854,11.4,3951.2
4855830718,0,1,6,1,26,26,47,0,0,0,1,38644,11.4,41824,125,0,1458,1255,12.5,3864.4,13,0,0,25,25,54,0,0,0,0,37186,11.0,40569,94,0,-1458,-1255,9.4,3718.6
4855556215,1,0,0,1,13,17,23,0,0,0,0,48750,10.0,47500,5,0,20200,19000,0.5,4875.0,0,0,0,13,9,5,0,0,0,0,28550,6.0,28500,3,0,-20200,-19000,0.3,2855.0
4855551041,1,353,0,1,10,20,11,0,0,0,0,45657,10.0,47799,0,0,16757,19299,0.0,4565.7,0,0,0,16,6,15,0,0,0,0,28900,6.0,28500,0,0,-16757,-19299,0.0,2890.0
4855544999,1,8,0,1,15,17,15,0,0,0,0,46395,10.0,47500,1,0,18216,19000,0.1,4639.5,0,0,0,10,8,8,0,0,0,0,28179,6.0,28500,1,0,-18216,-19000,0.1,2817.9
4855534690,1,4,0,0,22,19,24,0,0,0,0,49100,10.0,47500,0,0,20900,19000,0.0,4910.0,0,0,1,9,12,9,0,0,0,0,28200,6.0,28500,0,0,-20900,-19000,0.0,2820.0
4855533932,1,0,0,1,16,17,19,0,0,0,0,47437,10.0,47500,3,0,20287,19000,0.3,4743.7,8,0,0,11,10,8,0,0,0,0,27150,6.0,28500,0,0,-20287,-19000,0.0,2715.0
4855523418,1,0,0,0,20,21,20,0,0,0,0,64525,12.0,55000,0,0,27630,22000,0.0,6452.5,0,0,1,12,11,9,0,0,0,0,36895,7.2,33000,0,0,-27630,-22000,0.0,3689.5
4855517328,1,0,0,1,9,22,12,0,0,0,0,45784,10.0,47500,0,0,16149,19000,0.0,4578.4,0,0,0,17,4,12,0,0,0,0,29635,6.0,28500,0,0,-16149,-19000,0.0,2963.5
4855510134,1,0,0,0,10,18,13,0,0,0,0,44550,10.0,47500,0,0,15300,19000,0.0,4455.0,0,0,1,14,6,10,0,0,0,0,29250,6.0,28500,0,0,-15300,-19000,0.0,2925.0
4855500141,1,0,0,0,20,15,18,0,0,0,0,62700,12.0,55000,0,0,25500,22000,0.0,6270.0,12,0,1,8,13,12,0,0,0,0,37200,7.2,33000,0,0,-25500,-22000,0.0,3720.0
4855483324,1,0,0,1,24,16,22,0,0,0,0,49175,10.0,47500,1,0,20625,19000,0.1,4917.5,4,0,0,10,18,9,0,0,0,0,28550,6.0,28500,0,0,-20625,-19000,0.0,2855.0
4855195813,0,9,1,1,8,7,6,0,0,0,0,18237,6.8,18645,245,56,861,885,30.1,1823.7,76,0,0,7,8,6,0,0,0,0,17376,6.8,17760,184,63,-861,-885,24.7,1737.6
4857362539,0,15,1,1,10,9,15,1,1,0,0,18894,6.8,17589,237,43,1529,341,28.0,1889.4,14,1,0,9,10,13,0,0,0,0,17365,6.8,17248,207,52,-1529,-341,25.9,1736.5
4856060129,0,17,1,1,9,6,7,0,0,0,0,18216,7.2,18129,223,55,2033,-325,27.8,1821.6,12,1,0,5,8,0,1,1,0,0,16183,6.8,18454,223,64,-2033,325,28.7,1618.3
4853902772,0,53,1,0,2,8,2,0,0,0,0,15484,6.8,17009,200,52,-3235,-1962,25.2,1548.4,13,0,1,8,2,9,1,0,1,0,18719,7.2,18971,217,60,3235,1962,27.7,1871.9
4851813483,1,72,1,0,8,8,5,1,0,1,0,18022,7.2,18524,211,58,1360,1465,26.9,1802.2,10,0,1,8,8,5,1,1,0,0,16662,6.8,17059,184,44,-1360,-1465,22.8,1666.2
4850702535,0,14,1,0,8,4,9,0,0,0,0,16523,7.0,17903,172,52,200,-25,22.4,1652.3,14,1,1,4,8,6,0,0,0,0,16323,6.8,17928,228,72,-200,25,30.0,1632.3
4848532508,0,11,1,1,5,4,7,0,0,0,0,16564,6.8,17511,191,52,196,254,24.3,1656.4,12,0,0,4,5,3,1,1,0,0,16368,6.8,17257,189,44,-196,-254,23.3,1636.8
4841075986,1,20,0,1,6,6,6,0,0,0,0,17025,6.8,17182,210,60,438,-1433,27.0,1702.5,12,1,0,6,6,3,1,1,0,0,16587,7.0,18615,225,40,-438,1433,26.5,1658.7
4835935636,1,13,0,1,7,4,7,1,1,0,0,16575,7.2,18722,205,76,1258,-151,28.1,1657.5,14,0,0,3,6,2,0,0,0,0,15317,7.4,18873,182,59,-1258,151,24.1,1531.7
4835853304,0,16,1,0,4,3,5,1,1,0,0,15624,6.8,16508,197,54,-955,-2461,25.1,1562.4,9,0,1,3,4,1,0,0,0,0,16579,7.0,18969,214,62,955,2461,27.6,1657.9
4835251050,1,15,4,1,6,1,8,0,0,0,0,17910,7.2,18582,251,62,4443,1496,31.3,1791.0,10,1,0,1,6,0,1,1,0,0,13467,6.8,17086,203,48,-4443,-1496,25.1,1346.7
4835215889,1,14,1,1,7,6,14,0,0,0,0,18166,7.0,17400,206,57,885,47,26.3,1816.6,9,2,0,6,7,5,1,1,0,0,17281,6.8,17353,221,48,-885,-47,26.9,1728.1
4835104757,1,13,2,1,7,3,5,0,0,0,0,18030,6.8,19131,256,55,3920,2571,31.1,1803.0,13,1,0,3,7,1,0,0,0,0,14110,6.6,16560,174,56,-3920,-2571,23.0,1411.0
4833933919,0,17,0,0,5,10,9,1,1,0,0,15741,6.2,15344,153,51,-4458,-4149,20.4,1574.1,242,3,1,10,5,10,0,0,0,0,20199,7.2,19493,212,48,4458,4149,26.0,2019.9
4832064102,0,15,2,0,1,6,0,0,0,0,0,15030,7.0,18027,217,67,-1775,-766,28.4,1503.0,15,2,1,6,1,3,1,1,0,0,16805,7.0,18793,208,52,1775,766,26.0,1680.5
4831989830,1,11,1,0,10,8,12,0,0,0,0,18910,6.6,17196,193,48,1364,-542,24.1,1891.0,19,2,1,8,10,3,0,0,0,0,17546,7.0,17738,182,51,-1364,542,23.3,1754.6
4830343857,1,12,2,1,5,2,4,0,0,0,0,15547,6.6,16891,202,50,739,-826,25.2,1554.7,13,3,0,2,5,1,1,1,0,0,14808,7.0,17717,211,64,-739,826,27.5,1480.8
4830181408,0,10,0,1,5,2,5,1,1,0,0,16187,7.0,19070,234,68,1297,319,30.2,1618.7,12,0,0,2,5,3,0,0,0,0,14890,7.2,18751,223,67,-1297,-319,29.0,1489.0
4827802171,0,11,0,1,3,2,1,0,0,0,0,14706,6.8,17415,207,36,-368,-844,24.3,1470.6,15,1,0,2,3,1,0,0,0,0,15074,6.8,18259,219,51,368,844,27.0,1507.4
4827645284,0,14,0,1,8,8,9,1,1,0,0,17000,6.8,17563,189,56,281,-230,24.5,1700.0,13,0,0,7,7,3,0,0,0,0,16719,6.6,17793,222,48,-281,230,27.0,1671.9
4827478684,0,189,1,0,3,8,2,0,0,0,0,15284,6.6,17511,212,50,-2813,-947,26.2,1528.4,15,3,1,8,3,6,1,1,0,0,18097,7.0,18458,199,64,2813,947,26.3,1809.7
4857010237,1,0,0,1,30,31,71,0,0,0,1,39319,11.4,42203,113,0,349,-2081,11.3,3931.9,0,0,0,31,30,70,0,0,0,0,38970,12.0,44284,105,0,-349,2081,10.5,3897.0
4856579758,1,0,0,1,37,27,81,0,0,0,1,42752,12.0,47596,121,0,5441,5698,12.1,4275.2,0,0,0,27,37,42,0,0,0,0,37311,11.6,41898,82,0,-5441,-5698,8.2,3731.1
4856019401,1,12,0,1,16,15,32,0,0,0,0,35245,10.8,37082,102,0,-125,-375,10.2,3524.5,0,0,0,15,16,36,0,0,0,0,35370,10.6,37457,122,0,125,375,12.2,3537.0
4855905553,1,10,0,1,28,33,68,0,0,0,1,39523,11.6,43677,118,0,-602,-1713,11.8,3952.3,0,0,0,33,28,100,0,0,0,0,40125,11.6,45390,105,0,602,1713,10.5,4012.5
4855022032,0,3,0,1,27,32,69,0,0,0,1,38676,12.0,44583,95,0,-548,-298,9.5,3867.6,3,0,0,32,27,84,0,0,0,0,39224,11.8,44881,104,0,548,298,10.4,3922.4
4854998996,0,128,0,0,17,29,29,0,0,0,0,34682,10.4,37186,94,0,-3557,-5939,9.4,3468.2,0,0,1,29,17,90,0,0,0,0,38239,11.6,43125,114,0,3557,5939,11.4,3823.9
4854971827,0,15,0,0,21,23,57,0,0,0,1,35639,10.8,38391,110,0,-4032,-2593,11.0,3563.9,0,0,1,23,21,53,0,0,0,0,39671,11.2,40984,114,0,4032,2593,11.4,3967.1
4854944445,1,22,0,1,22,18,63,0,0,0,0,36260,10.8,38863,107,0,683,360,10.7,3626.0,0,3,0,18,22,35,0,0,0,0,35577,11.0,38503,117,0,-683,-360,11.7,3557.7
4853872271,1,0,0,1,27,18,69,0,0,0,1,39536,11.2,42487,111,0,3796,3714,11.1,3953.6,0,0,0,18,27,46,0,0,0,0,35740,11.0,38773,81,0,-3796,-3714,8.1,3574.0
4852986071,1,2,0,1,26,21,59,0,0,0,1,38559,11.2,40348,123,0,2685,1680,12.3,3855.9,38,0,0,21,26,54,0,0,0,0,35874,11.0,38668,105,0,-2685,-1680,10.5,3587.4
4852650058,0,13,0,0,21,31,47,0,0,0,2,37014,10.8,39219,105,0,-4582,-6142,10.5,3701.4,0,0,1,31,21,81,0,0,0,0,41596,11.8,45361,118,0,4582,6142,11.8,4159.6
4852617543,0,0,0,0,30,32,74,0,0,0,1,38646,11.4,42971,125,0,-71,-2223,12.5,3864.6,0,0,1,32,30,77,0,0,0,0,38717,11.8,45194,125,0,71,2223,12.5,3871.7
4852004759,1,68,0,0,11,14,32,0,0,0,0,33621,10.2,35633,120,0,197,1192,12.0,3362.1,0,0,1,14,11,42,0,0,0,0,33424,10.0,34441,107,0,-197,-1192,10.7,3342.4
4851979951,1,1,0,1,27,26,67,0,0,0,1,40823,11.6,43561,112,0,3558,1065,11.2,4082.3,0,0,0,26,27,73,0,0,0,0,37265,11.4,42496,87,0,-3558,-1065,8.7,3726.5
4850691709,1,0,29,1,24,18,67,0,0,0,0,38010,11.4,42020,115,0,2288,3493,11.5,3801.0,26,0,0,18,24,47,0,0,0,0,35722,10.8,38527,107,0,-2288,-3493,10.7,3572.2
4850673284,1,0,0,0,20,25,42,0,0,0,0,37790,11.2,41591,114,0,-13,1014,11.4,3779.0,0,0,1,25,20,49,0,0,0,0,37803,11.2,40577,84,0,13,-1014,8.4,3780.3
4850013482,0,13,0,1,31,27,73,0,0,0,0,41474,11.2,43021,118,0,2242,-1291,11.8,4147.4,0,0,0,27,31,69,0,0,0,0,39232,11.8,44312,96,0,-2242,1291,9.6,3923.2
4849988429,0,0,0,1,17,21,46,0,0,0,1,34412,10.2,35548,91,0,-1957,-2917,9.1,3441.2,0,0,0,21,17,54,0,0,0,0,36369,11.2,38465,107,0,1957,2917,10.7,3636.9
4847817697,1,15,13,1,4,2,3,0,0,0,0,15463,6.8,17721,227,48,1319,109,27.5,1546.3,40,1,0,2,4,0,0,0,0,0,14144,6.8,17612,220,52,-1319,-109,27.2,1414.4
4855488762,1,0,0,1,20,17,23,0,0,0,0,62700,12.0,55000,0,0,25318,22000,0.0,6270.0,0,0,0,10,13,8,0,0,0,0,37382,7.2,33000,0,0,-25318,-22000,0.0,3738.2
4853125435,0,14,0,0,6,2,4,0,0,0,0,16164,7.0,17717,187,52,-323,-330,23.9,1616.4,16,0,1,2,6,1,0,0,0,0,16487,7.0,18047,219,68,323,330,28.7,1648.7
4851579097,1,11,2,0,6,3,5,0,0,0,0,16298,7.0,18200,196,52,1059,549,24.8,1629.8,10,1,1,3,6,1,0,0,0,0,15239,7.0,17651,223,56,-1059,-549,27.9,1523.9
4851534603,0,17,0,1,6,5,5,1,1,0,1,16453,6.6,16896,198,60,-914,-1129,25.8,1645.3,149,0,0,5,6,5,0,0,0,0,17367,7.2,18025,208,60,914,1129,26.8,1736.7
4851501801,0,14,1,0,2,3,5,1,1,0,0,14718,7.0,17465,198,64,-259,-1510,26.2,1471.8,12,1,1,3,2,2,0,0,0,0,14977,7.2,18975,213,48,259,1510,26.1,1497.7
4849239371,1,0,0,0,18,19,45,0,0,0,0,35826,10.8,39224,113,0,270,884,11.3,3582.6,0,0,1,19,18,27,0,0,0,0,35556,10.6,38340,102,0,-270,-884,10.2,3555.6
4849226779,1,0,0,1,18,18,40,0,0,0,0,35900,11.0,38566,118,0,1542,1705,11.8,3590.0,9,0,0,18,18,40,0,0,0,0,34358,10.6,36861,103,0,-1542,-1705,10.3,3435.8
4849203366,0,0,0,0,23,40,45,0,0,0,1,37433,11.0,40389,101,0,-3116,-4668,10.1,3743.3,0,0,1,40,23,85,0,0,0,0,40549,11.8,45057,95,0,3116,4668,9.5,4054.9
4846236639,0,32,0,0,12,10,11,2,1,1,0,18801,6.6,16844,172,68,1425,-139,24.0,1880.1,33,1,1,10,12,7,0,0,0,0,17376,7.0,16983,154,48,-1425,139,20.2,1737.6
4846135267,0,8,0,0,6,10,3,0,0,0,0,14731,6.4,15793,143,56,-3299,-1801,19.9,1473.1,12,3,1,10,6,11,1,1,0,0,18030,6.8,17594,187,40,3299,1801,22.7,1803.0
4846095134,0,12,0,1,4,7,2,1,1,0,0,15025,6.6,17052,193,56,-1336,-795,24.9,1502.5,8,0,0,7,4,6,0,0,0,0,16361,7.0,17847,166,59,1336,795,22.5,1636.1
4844948420,1,11,0,1,9,4,13,1,1,0,0,18114,6.6,16174,167,44,1795,38,21.1,1811.4,10,1,0,4,9,2,0,0,0,0,16319,6.6,16136,164,60,-1795,-38,22.4,1631.9
4844892290,0,12,0,1,5,4,4,1,1,0,0,16343,7.0,18535,188,60,1519,1122,24.8,1634.3,18,0,0,4,5,4,0,0,0,0,14824,6.8,17413,176,52,-1519,-1122,22.8,1482.4
4844855169,0,9,1,0,2,5,0,0,0,0,0,13340,6.6,16625,173,40,-3089,-276,21.3,1334.0,12,1,1,5,2,5,0,0,0,0,16429,6.6,16901,211,48,3089,276,25.9,1642.9
4844821472,1,35,3,0,0,2,0,0,0,0,0,14900,6.8,17532,224,52,-10,-783,27.6,1490.0,37,3,1,2,0,2,0,0,0,0,14910,7.0,18315,171,60,10,783,23.1,1491.0
4844806354,1,10,0,1,6,2,2,1,1,0,0,17284,7.2,19451,224,60,3419,2824,28.4,1728.4,11,0,0,2,6,4,0,0,0,0,13865,6.4,16627,190,48,-3419,-2824,23.8,1386.5
4839341916,1,11,1,1,6,2,7,1,1,0,0,17686,7.4,19877,218,75,3180,1473,29.3,1768.6,13,1,0,2,6,1,1,0,1,0,14506,7.0,18404,205,51,-3180,-1473,25.6,1450.6
4839287939,1,13,1,1,4,4,4,0,0,0,0,15223,6.8,17029,162,52,-69,1024,21.4,1522.3,10,1,0,4,4,5,0,0,0,0,15292,6.4,16005,188,48,69,-1024,23.6,1529.2
4838219631,0,11,1,0,10,10,8,1,1,0,0,18276,7.2,18515,173,41,159,311,21.4,1827.6,12,0,1,10,10,6,1,0,1,0,18117,7.0,18204,185,48,-159,-311,23.3,1811.7
4856711558,1,22,0,0,7,7,7,0,0,0,0,17402,6.8,18203,207,51,375,29,25.8,1740.2,11,0,1,7,7,11,0,0,0,0,17027,6.8,18174,201,48,-375,-29,24.9,1702.7
4856707029,1,10,3,1,7,2,4,0,0,0,0,17751,7.2,18303,223,56,3341,2080,27.9,1775.1,12,3,0,2,7,2,1,1,0,0,14410,6.6,16223,208,60,-3341,-2080,26.8,1441.0
4856600868,0,0,0,1,36,27,88,0,0,0,1,43176,11.8,45170,100,0,1760,248,10.0,4317.6,0,0,0,27,36,71,0,0,0,0,41416,11.8,44922,100,0,-1760,-248,10.0,4141.6
4856460099,0,0,0,1,22,28,55,0,0,0,1,36142,10.8,39428,100,0,-1831,-2955,10.0,3614.2,0,0,0,28,22,92,0,0,0,0,37973,11.2,42383,94,0,1831,2955,9.4,3797.3
4855176676,1,0,0,0,19,16,50,0,0,0,0,34766,10.8,37575,88,0,-545,136,8.8,3476.6,0,0,1,16,19,34,0,0,0,0,35311,10.6,37439,102,0,545,-136,10.2,3531.1
4855030214,0,15,0,0,18,18,47,0,0,0,0,34434,10.8,36703,105,0,-1284,-838,10.5,3443.4,0,3,1,18,18,52,0,0,0,0,35718,10.8,37541,118,0,1284,838,11.8,3571.8
4853422769,1,8,1,1,3,4,3,1,0,1,0,15165,6.6,17095,218,48,-3012,-1442,26.6,1516.5,13,1,0,4,3,5,0,0,0,0,18177,7.0,18537,212,64,3012,1442,27.6,1817.7
4853403775,1,19,2,1,5,11,6,0,0,0,0,16835,6.6,16426,209,28,-1939,-1560,23.7,1683.5,13,0,0,11,5,15,0,0,0,0,18774,6.8,17986,202,66,1939,1560,26.8,1877.4
4853213894,1,20,0,1,30,20,61,0,0,0,1,38596,11.2,40827,114,0,4020,3429,11.4,3859.6,0,7,0,20,30,34,0,0,0,0,34576,10.6,37398,101,0,-4020,-3429,10.1,3457.6
4853197541,1,0,0,0,28,20,81,0,0,0,0,38497,11.2,42025,110,0,2651,899,11.0,3849.7,0,0,1,20,28,34,0,0,0,0,35846,11.4,41126,110,0,-2651,-899,11.0,3584.6
4853183279,0,57,0,1,31,20,98,0,0,0,1,39795,11.8,43459,107,0,4681,4799,10.7,3979.5,34,6,0,19,30,55,0,0,0,0,35114,11.0,38660,91,0,-4681,-4799,9.1,3511.4
4853170122,1,21,0,1,25,25,50,0,0,0,0,37695,11.6,43071,88,0,-195,760,8.8,3769.5,14,4,0,25,25,55,0,0,0,0,37890,11.6,42311,107,0,195,-760,10.7,3789.0
4847425243,0,14,0,0,5,5,7,0,0,0,0,14813,6.6,17342,161,60,-1308,-1149,22.1,1481.3,12,1,1,5,5,2,1,1,0,0,16121,7.0,18491,232,44,1308,1149,27.6,1612.1
4847177959,0,10,3,1,4,2,2,0,0,0,0,14971,6.8,18267,176,52,-205,275,22.8,1497.1,12,1,0,2,4,1,0,0,0,0,15176,7.0,17992,203,56,205,-275,25.9,1517.6
4847133375,1,9,1,0,0,5,0,0,0,0,0,13895,6.8,17401,196,48,-1641,-976,24.4,1389.5,11,1,1,5,0,4,0,0,0,0,15536,7.0,18377,179,52,1641,976,23.1,1553.6
4847096160,1,13,2,1,7,2,4,0,0,0,0,16666,7.2,19622,196,60,2988,2129,25.6,1666.6,9,0,0,2,7,2,0,0,0,0,13678,6.8,17493,171,56,-2988,-2129,22.7,1367.8
4847054898,0,16,1,1,6,10,6,0,0,0,0,16876,6.8,17489,204,44,-228,113,24.8,1687.6,12,2,0,10,6,9,1,1,0,0,17104,6.8,17376,167,48,228,-113,21.5,1710.4
4847016025,1,14,1,1,6,5,5,1,1,0,0,15960,6.4,16427,156,55,1405,905,21.1,1596.0,9,1,0,5,6,6,0,0,0,0,14555,6.4,15522,143,44,-1405,-905,18.7,1455.5
4846969928,1,9,1,1,7,0,5,1,0,1,0,15581,7.0,17598,164,52,1899,-253,21.6,1558.1,118,0,0,0,7,0,0,0,0,0,13682,7.0,17851,226,44,-1899,253,27.0,1368.2
4846828655,1,0,0,0,32,23,105,0,0,0,1,40149,11.6,44780,106,0,5425,6260,10.6,4014.9,0,0,1,23,32,63,0,0,0,0,34724,11.0,38520,77,0,-5425,-6260,7.7,3472.4
4856330337,0,53,0,0,3,5,1,0,0,0,0,15657,6.8,18225,214,52,221,-242,26.6,1565.7,11,3,1,5,3,2,0,0,0,0,15436,7.2,18467,176,52,-221,242,22.8,1543.6
4850912260,0,16,0,1,31,17,77,0,0,0,1,40380,11.6,43610,114,0,5231,5395,11.4,4038.0,10,0,0,16,30,29,0,0,0,0,35149,10.8,38215,97,0,-5231,-5395,9.7,3514.9
4850888754,0,0,0,1,26,21,69,0,0,0,1,37805,11.4,40349,111,0,1369,888,11.1,3780.5,3,0,0,21,26,46,0,0,0,0,36436,10.8,39461,99,0,-1369,-888,9.9,3643.6
4850855334,0,0,0,1,35,28,95,0,0,0,2,40490,11.8,44246,106,0,-322,1400,10.6,4049.0,0,0,0,28,35,53,0,0,0,0,40812,11.4,42846,115,0,322,-1400,11.5,4081.2
4850819472,0,18,0,1,24,19,66,0,0,0,0,36465,11.0,39437,112,0,1930,2344,11.2,3646.5,0,0,0,19,24,45,0,0,0,0,34535,10.8,37093,100,0,-1930,-2344,10.0,3453.5
4850780245,0,14,0,0,20,24,46,0,0,0,0,36216,11.0,39520,107,0,250,239,10.7,3621.6,0,1,1,24,20,62,0,0,0,0,35966,11.2,39281,114,0,-250,-239,11.4,3596.6
4845288849,1,11,1,0,3,11,2,0,0,0,0,13494,6.0,13609,123,48,-5059,-3907,17.1,1349.4,14,2,1,11,3,5,0,0,0,0,18553,6.8,17516,184,52,5059,3907,23.6,1855.3
4845223718,1,14,14,1,11,5,17,0,0,0,0,19386,6.6,17584,200,38,2489,701,23.8,1938.6,35,3,0,5,11,3,0,0,0,0,16897,6.6,16883,218,33,-2489,-701,25.1,1689.7
4840402414,1,16,0,0,5,8,4,2,1,1,0,15357,6.6,16455,169,48,-3961,-1491,21.7,1535.7,13,0,1,8,5,6,0,0,0,0,19318,6.8,17946,214,52,3961,1491,26.6,1931.8
4840365522,0,13,2,0,7,8,4,0,0,0,0,16636,7.0,18058,208,44,-682,-454,25.2,1663.6,14,1,1,8,7,5,0,0,0,0,17318,7.0,18512,231,52,682,454,28.3,1731.8
4835172134,0,14,1,1,4,4,3,0,0,0,0,15635,6.8,17293,229,56,-742,-1188,28.5,1563.5,16,4,0,4,4,5,0,0,0,0,16377,7.0,18481,231,66,742,1188,29.7,1637.7
4835139830,0,16,3,1,6,11,5,1,1,0,0,15263,6.4,15718,187,40,-4143,-1741,22.7,1526.3,23,1,0,11,6,14,1,0,1,0,19406,7.0,17459,219,54,4143,1741,27.3,1940.6
4835098335,1,20,2,1,8,3,14,0,0,0,0,17953,6.6,16760,232,49,4002,-73,28.1,1795.3,13,0,0,3,8,1,1,1,0,0,13951,6.4,16833,171,55,-4002,73,22.6,1395.1
4835062762,0,11,0,0,9,5,6,0,0,0,0,17350,6.6,17285,184,55,2276,-8,23.9,1735.0,9,2,1,5,9,1,1,1,0,0,15074,6.8,17293,197,56,-2276,8,25.3,1507.4
4828851632,0,11,1,0,2,8,2,0,0,0,0,14759,6.8,17699,203,56,-2887,-529,25.9,1475.9,13,1,1,8,2,6,1,1,0,0,17646,6.8,18228,223,68,2887,529,29.1,1764.6
4828832903,1,15,0,1,6,3,5,0,0,0,0,17454,7.4,19267,231,52,2102,1606,28.3,1745.4,16,1,0,3,6,1,0,0,0,0,15352,7.0,17661,205,52,-2102,-1606,25.7,1535.2
4828713090,1,24,0,0,15,20,30,0,0,0,0,35672,10.6,36791,122,0,1184,33,12.2,3567.2,0,0,1,20,15,41,0,0,0,0,34488,10.4,36758,107,0,-1184,-33,10.7,3448.8
4828689827,0,24,0,0,22,23,43,0,0,0,0,36583,10.8,39095,96,0,-624,-1250,9.6,3658.3,0,19,1,23,22,62,0,0,0,0,37207,11.0,40345,102,0,624,1250,10.2,3720.7
4828278001,0,68,0,1,26,20,76,0,0,0,0,37902,11.2,42608,93,0,1271,1474,9.3,3790.2,0,0,0,20,26,47,0,0,0,0,36631,11.2,41134,93,0,-1271,-1474,9.3,3663.1
4857563756,0,10,1,0,4,10,1,0,0,0,0,14971,6.8,17458,183,71,-3761,-885,25.4,1497.1,79,0,1,10,4,10,0,0,0,0,18732,7.0,18343,220,52,3761,885,27.2,1873.2
4857508883,0,21,4,1,7,7,13,2,1,1,0,17775,7.0,18600,246,68,-823,383,31.4,1777.5,79,3,0,7,7,9,0,0,0,0,18598,7.0,18217,202,64,823,-383,26.6,1859.8
4857477923,1,14,2,1,7,5,6,0,0,0,0,16142,6.8,17780,192,51,63,464,24.3,1614.2,86,0,0,5,7,3,1,1,0,0,16079,7.0,17316,219,44,-63,-464,26.3,1607.9
4854021459,1,11,3,1,5,1,5,0,0,0,0,17214,7.0,18264,200,43,3304,1137,24.3,1721.4,77,2,0,1,5,1,0,0,0,0,13910,6.8,17127,191,56,-3304,-1137,24.7,1391.0
4853946720,1,79,1,1,6,4,5,1,1,0,0,17483,7.0,18241,197,43,1790,731,24.0,1748.3,9,2,0,3,5,2,0,0,0,0,15693,6.6,17510,217,48,-1790,-731,26.5,1569.3
4853876690,0,77,2,0,2,3,2,0,0,0,0,15198,7.0,18454,227,65,577,1132,29.2,1519.8,15,1,1,3,2,2,1,1,0,0,14621,7.0,17322,199,50,-577,-1132,24.9,1462.1
4853640940,1,16,5,1,10,3,5,1,1,0,0,18425,7.0,19272,230,56,4090,4401,28.6,1842.5,72,2,0,3,10,4,0,0,0,0,14335,6.2,14871,167,48,-4090,-4401,21.5,1433.5
4853611918,0,10,4,1,5,5,5,0,0,0,0,16724,7.2,18802,224,64,307,197,28.8,1672.4,71,0,0,5,5,2,1,1,0,0,16417,7.0,18605,213,48,-307,-197,26.1,1641.7
4853564358,1,15,4,1,6,4,6,0,0,0,0,17752,6.8,17855,194,44,461,-490,23.8,1775.2,272,2,0,4,6,4,1,1,0,0,17291,7.0,18345,218,52,-461,490,27.0,1729.1
4853518952,0,9,0,1,7,4,3,0,0,0,0,17458,7.0,18828,207,60,1216,434,26.7,1745.8,84,0,0,4,7,4,1,1,0,0,16242,7.0,18394,213,64,-1216,-434,27.7,1624.2
4853460471,1,103,0,1,6,2,7,0,0,0,0,16720,6.6,17836,219,56,1734,438,27.5,1672.0,11,15,0,2,6,2,0,0,0,0,14986,6.6,17398,205,40,-1734,-438,24.5,1498.6
4851900817,1,76,16,0,5,4,5,0,0,0,0,15900,6.8,18080,202,64,-447,-585,26.6,1590.0,34,1,1,4,5,3,0,0,0,0,16347,7.2,18665,253,56,447,585,30.9,1634.7
4850456794,1,73,1,1,5,6,2,0,0,0,0,16204,6.6,17284,205,56,-411,-757,26.1,1620.4,13,0,0,6,5,4,0,0,0,0,16615,6.8,18041,212,60,411,757,27.2,1661.5
4849672478,0,14,0,0,1,4,1,1,1,0,0,14629,6.8,17542,187,56,-397,-65,24.3,1462.9,89,1,1,4,1,3,0,0,0,0,15026,6.8,17607,186,56,397,65,24.2,1502.6
4848806862,0,11,1,0,3,4,3,0,0,0,0,12829,6.8,16819,127,48,-2213,-703,17.5,1282.9,529,0,1,4,3,2,0,0,0,0,15042,6.8,17522,178,48,2213,703,22.6,1504.2
4848762520,0,244,1,0,2,4,1,1,1,0,0,13713,6.6,17354,174,39,-774,257,21.3,1371.3,13,1,1,4,2,2,0,0,0,0,14487,6.6,17097,180,56,774,-257,23.6,1448.7
4848581172,1,13,2,0,3,2,2,0,0,0,0,15642,6.8,17295,211,56,1819,1310,26.7,1564.2,93,3,1,2,3,4,1,1,0,0,13823,6.6,15985,187,44,-1819,-1310,23.1,1382.3
4848556768,0,91,4,0,3,8,0,0,0,0,0,15060,6.8,17713,206,44,-3138,-622,25.0,1506.0,14,10,1,8,3,10,0,0,0,0,18198,7.2,18335,228,60,3138,622,28.8,1819.8
4848471612,1,15,5,0,4,2,4,0,0,0,0,16126,7.0,18603,227,52,683,730,27.9,1612.6,79,1,1,2,4,1,0,0,0,0,15443,6.8,17873,230,60,-683,-730,29.0,1544.3
4850937459,0,8,1,0,8,10,9,1,1,0,0,17301,6.8,17828,202,52,-1669,-1011,25.4,1730.1,11,0,1,10,8,4,0,0,0,0,18970,7.2,18839,207,52,1669,1011,25.9,1897.0
4850888401,0,30,1,1,5,3,3,0,0,0,0,15898,7.2,18294,189,64,1258,750,25.3,1589.8,14,1,0,3,5,1,1,1,0,0,14640,6.8,17544,194,60,-1258,-750,25.4,1464.0
4850826588,0,10,2,0,3,2,3,1,1,0,0,13681,6.4,15641,184,55,-1864,-2555,23.9,1368.1,14,1,1,2,3,3,0,0,0,0,15545,7.0,18196,221,56,1864,2555,27.7,1554.5
4850786224,0,28,0,0,7,4,7,0,0,0,0,16564,6.8,17403,213,46,641,-393,25.9,1656.4,11,1,1,4,7,3,0,0,0,0,15923,6.8,17796,234,48,-641,393,28.2,1592.3
4849950662,0,8,1,1,7,3,6,1,0,1,0,17637,7.0,17864,205,60,2207,20,26.5,1763.7,12,0,0,3,7,0,0,0,0,0,15430,7.0,17844,196,56,-2207,-20,25.2,1543.0
4849915224,0,52,0,0,1,2,2,0,0,0,0,15424,6.8,18165,221,56,1157,-143,27.7,1542.4,19,1,1,2,1,2,1,1,0,0,14267,7.0,18308,181,76,-1157,143,25.7,1426.7
4849879414,0,11,0,1,6,5,7,0,0,0,0,16516,6.6,16712,176,56,630,-1437,23.2,1651.6,12,1,0,5,6,3,0,0,0,0,15886,6.8,18149,215,44,-630,1437,25.9,1588.6
4848931413,0,13,1,0,6,7,7,0,0,0,0,16543,6.8,18173,202,48,-1129,-291,25.0,1654.3,14,1,1,7,6,1,1,1,0,0,17672,6.8,18464,220,56,1129,291,27.6,1767.2
4848872695,0,31,2,0,2,6,6,0,0,0,0,14228,6.4,16127,183,56,-2823,-2670,23.9,1422.8,9,10,1,6,2,4,0,0,0,0,17051,7.2,18797,205,66,2823,2670,27.1,1705.1
4836648196,0,13,0,1,9,10,6,0,0,0,0,17717,6.8,17298,160,52,635,67,21.2,1771.7,8,0,0,10,9,3,0,0,0,0,17082,6.8,17231,162,44,-635,-67,20.6,1708.2
4836623818,0,10,0,1,6,1,5,1,1,0,0,17205,6.8,18687,208,60,2624,1945,26.8,1720.5,27,0,0,1,6,0,0,0,0,0,14581,6.6,16742,188,60,-2624,-1945,24.8,1458.1
4836603306,1,11,1,0,3,4,2,1,1,0,0,14202,6.8,17804,161,56,-172,1064,21.7,1420.2,8,1,1,3,2,1,0,0,0,0,14374,6.8,16740,207,24,172,-1064,23.1,1437.4
4836568219,0,51,13,0,3,8,5,0,0,0,0,15385,6.8,17294,196,52,-2436,-1639,24.8,1538.5,32,0,1,8,3,4,1,0,1,0,17821,7.0,18933,206,64,2436,1639,27.0,1782.1
4831417921,1,14,0,1,2,3,2,0,0,0,0,16264,7.2,19405,227,60,1530,1944,28.7,1626.4,9,1,0,3,2,2,0,0,0,0,14734,7.0,17461,199,60,-1530,-1944,25.9,1473.4
4801188553,0,50,0,0,19,23,56,0,0,0,1,35611,10.8,38781,92,0,-2726,-3125,9.2,3561.1,49,3,1,23,19,68,0,0,0,0,38337,11.4,41906,110,0,2726,3125,11.0,3833.7
4787613780,0,0,0,0,26,28,48,0,0,0,0,37040,11.8,44273,82,0,-565,3480,8.2,3704.0,0,0,1,28,26,63,0,0,0,0,37605,11.2,40793,98,0,565,-3480,9.8,3760.5
4766449399,0,15,0,0,3,5,1,0,0,0,0,14675,6.8,17241,208,51,-1704,-1027,25.9,1467.5,6,0,1,5,3,9,1,1,0,0,16379,6.8,18268,215,60,1704,1027,27.5,1637.9
4766406687,1,9,1,1,8,5,7,2,1,1,0,18022,7.0,17225,239,52,2485,-222,29.1,1802.2,13,0,0,5,8,2,0,0,0,0,15537,6.8,17447,203,56,-2485,222,25.9,1553.7
4766383205,1,10,0,1,8,4,2,1,0,1,0,17012,6.8,18496,229,54,1390,2693,28.3,1701.2,8,0,0,4,8,9,0,0,0,0,15622,6.4,15803,185,42,-1390,-2693,22.7,1562.2
4857529244,0,12,1,0,5,8,6,0,0,0,0,15647,6.4,16669,199,56,-2141,-721,25.5,1564.7,14,2,1,8,5,9,1,1,0,0,17788,6.8,17390,190,51,2141,721,24.1,1778.8
4857487838,0,14,2,0,4,5,2,0,0,0,0,14795,6.8,17462,200,48,-1279,-172,24.8,1479.5,16,1,1,5,4,1,0,0,0,0,16074,6.8,17634,210,48,1279,172,25.8,1607.4
4857437330,1,13,1,0,3,2,0,0,0,0,0,14637,7.0,18142,208,52,-688,196,26.0,1463.7,75,1,1,2,3,1,0,0,0,0,15325,7.0,17946,222,64,688,-196,28.6,1532.5
4857383946,0,15,0,1,3,1,1,1,1,0,0,15436,6.8,17760,242,60,28,-1152,30.2,1543.6,7,1,0,1,3,1,0,0,0,0,15408,7.0,18912,247,60,-28,1152,30.7,1540.8
4857176856,1,14,1,1,5,2,5,1,1,0,0,17390,7.4,19963,205,60,1118,208,26.5,1739.0,13,0,0,2,5,0,0,0,0,0,16272,7.2,19755,227,68,-1118,-208,29.5,1627.2
4857130044,0,12,1,0,3,5,1,0,0,0,0,14727,6.8,17262,220,48,-821,718,26.8,1472.7,12,0,1,5,3,6,0,0,0,0,15548,6.6,16544,167,52,821,-718,21.9,1554.8
4857076253,1,16,1,1,2,5,2,0,0,0,0,14962,6.8,17418,194,56,-1693,-1072,25.0,1496.2,20,1,0,5,2,8,0,0,0,0,16655,6.8,18490,249,54,1693,1072,30.3,1665.5
4857040995,1,16,0,0,3,6,3,1,1,0,0,15494,7.0,17920,226,48,-1496,22,27.4,1549.4,13,0,1,6,3,6,1,0,1,0,16990,7.0,17898,218,56,1496,-22,27.4,1699.0
4857006316,0,13,0,1,5,7,3,0,0,0,0,13886,6.4,15039,151,40,-2493,-2601,19.1,1388.6,26,1,0,7,5,7,0,0,0,0,16379,6.8,17640,181,55,2493,2601,23.6,1637.9
4856987164,1,9,3,1,5,4,8,0,0,0,0,16858,7.0,18821,226,56,2331,1729,28.2,1685.8,15,1,0,4,5,1,1,1,0,0,14527,6.8,17092,195,44,-2331,-1729,23.9,1452.7
4856390371,1,14,0,0,4,6,3,0,0,0,0,16470,7.2,18500,210,62,-1134,-112,27.2,1647.0,98,1,1,6,4,5,0,0,0,0,17604,7.0,18612,229,44,1134,112,27.3,1760.4
4856342419,0,13,1,0,3,5,3,1,1,0,0,15923,6.8,18283,209,56,292,964,26.5,1592.3,15,2,1,5,3,4,0,0,0,0,15631,6.6,17319,206,60,-292,-964,26.6,1563.1
4856175213,0,12,4,1,5,6,8,0,0,0,0,16312,6.8,17515,168,64,-622,1097,23.2,1631.2,25,3,0,6,5,7,0,0,0,0,16934,6.4,16418,241,40,622,-1097,28.1,1693.4
4856123688,0,287,0,0,2,11,1,0,0,0,0,14838,6.6,16665,220,48,-5180,-3229,26.8,1483.8,10,2,1,11,2,13,1,1,0,0,20018,7.4,19894,219,68,5180,3229,28.7,2001.8
4855208119,1,75,4,1,7,3,6,1,1,0,0,17088,7.2,18686,186,59,1305,712,24.5,1708.8,12,1,0,3,7,2,0,0,0,0,15783,7.0,17974,221,52,-1305,-712,27.3,1578.3
4855160367,1,14,3,1,2,5,1,0,0,0,0,14225,6.6,16465,223,52,-1755,-473,27.5,1422.5,17,2,0,5,2,5,0,0,0,0,15980,6.8,16938,201,52,1755,473,25.3,1598.0
4854943226,0,17,2,0,5,4,3,0,0,0,0,15248,6.8,17399,211,43,-2027,-203,25.4,1524.8,12,2,1,4,5,4,0,0,0,0,17275,6.8,17602,194,57,2027,203,25.1,1727.5
4854182930,0,11,1,0,8,14,4,0,0,0,0,15819,6.4,15819,182,48,-6099,-3050,23.0,1581.9,12,2,1,14,8,14,1,1,0,0,21918,7.2,18869,213,42,6099,3050,25.5,2191.8
4854126011,1,12,1,0,3,7,2,1,0,1,0,15921,6.8,17844,228,56,-1452,-1373,28.4,1592.1,11,2,1,7,3,4,1,1,0,0,17373,7.4,19217,266,51,1452,1373,31.7,1737.3
4832493479,1,51,0,1,14,2,19,0,0,0,0,20349,7.0,17755,201,48,4283,1980,24.9,2034.9,7,0,0,2,14,4,0,0,0,0,16066,6.4,15775,162,56,-4283,-1980,21.8,1606.6
4832483582,0,10,1,0,5,4,1,1,1,0,0,16099,7.2,18933,199,76,1571,2726,27.5,1609.9,6,0,1,4,5,4,0,0,0,0,14528,6.8,16207,175,36,-1571,-2726,21.1,1452.8
4832473647,0,11,4,1,11,7,11,1,1,0,0,19104,6.8,18431,197,52,2639,243,24.9,1910.4,23,1,0,7,11,7,0,0,0,0,16465,7.2,18188,203,48,-2639,-243,25.1,1646.5
4832463349,1,13,0,1,6,9,8,0,0,0,0,16681,6.8,17838,169,56,-1673,-656,22.5,1668.1,12,2,0,9,6,11,0,0,0,0,18354,7.2,18494,211,54,1673,656,26.5,1835.4
4832448471,0,23,1,0,4,10,3,0,0,0,0,15359,6.6,16410,164,59,-3671,-1008,22.3,1535.9,7,3,1,10,4,8,0,0,0,0,19030,7.0,17418,178,51,3671,1008,22.9,1903.0
4832436090,1,11,1,0,11,3,11,1,0,1,0,19349,7.0,17927,169,52,4276,1170,22.1,1934.9,17,2,1,3,11,3,0,0,0,0,15073,6.6,16757,193,60,-4276,-1170,25.3,1507.3
4832409189,0,18,3,1,16,8,11,1,1,0,0,18668,6.4,16170,164,52,-1517,-778,21.6,1866.8,10,1,0,8,16,7,0,0,0,0,20185,6.8,16948,178,48,1517,778,22.6,2018.5
4832399028,1,8,0,1,22,6,28,1,0,1,2,26296,7.4,20010,212,56,10071,4420,26.8,2629.6,8,0,0,6,22,9,0,0,0,0,16225,6.2,15590,154,32,-10071,-4420,18.6,1622.5
4832373643,0,14,1,1,7,6,7,0,0,0,0,18218,7.0,18647,221,53,1675,1825,27.4,1821.8,8,3,0,6,7,8,0,0,0,0,16543,6.8,16822,165,55,-1675,-1825,22.0,1654.3
4804808801,1,11,1,0,9,4,6,1,0,1,0,18408,7.2,19947,226,67,1679,1744,29.3,1840.8,13,2,1,4,9,3,1,1,0,0,16729,6.8,18203,235,52,-1679,-1744,28.7,1672.9
4804787869,1,5,2,1,8,5,9,0,0,0,0,18982,7.2,19361,219,48,3102,862,26.7,1898.2,12,0,0,5,8,6,0,0,0,0,15880,7.2,18499,198,56,-3102,-862,25.4,1588.0
4804761726,0,11,0,1,10,7,18,0,0,0,0,18518,6.6,16534,207,44,285,-525,25.1,1851.8,9,2,0,7,10,8,1,1,0,0,18233,6.8,17059,182,56,-285,525,23.8,1823.3
4804749416,0,13,0,0,6,15,4,0,0,0,0,16203,6.8,16576,174,52,-3558,-1167,22.6,1620.3,139,1,1,15,6,19,0,0,0,0,19761,6.8,17743,178,64,3558,1167,24.2,1976.1
4804725193,1,11,0,1,2,1,2,0,0,0,0,15132,7.2,18855,204,67,988,1993,27.1,1513.2,81,1,0,1,2,2,0,0,0,0,14144,6.6,16862,210,56,-988,-1993,26.6,1414.4
4804700975,1,10,0,0,8,10,6,1,1,0,0,16858,6.8,16940,188,43,-1785,-1297,23.1,1685.8,10,0,1,10,8,9,0,0,0,0,18643,7.0,18237,194,60,1785,1297,25.4,1864.3
4804662403,0,10,1,0,3,1,2,1,0,1,0,15879,7.2,19413,198,63,1382,2106,26.1,1587.9,18,0,1,1,3,3,1,1,0,0,14497,7.0,17307,205,50,-1382,-2106,25.5,1449.7
4804623849,0,11,0,0,3,11,3,0,0,0,0,15701,6.6,16887,210,59,-4614,-2167,26.9,1570.1,21,1,1,11,3,11,0,0,0,0,20315,7.2,19054,217,52,4614,2167,26.9,2031.5
4784450461,1,11,3,1,8,4,9,0,0,0,0,18244,7.4,19282,244,44,2460,2254,28.8,1824.4,14,1,0,4,8,6,0,0,0,0,15784,6.8,17028,224,60,-2460,-2254,28.4,1578.4
4784420533,1,11,0,1,9,6,8,0,0,0,0,21023,7.4,19672,231,63,3660,2162,29.4,2102.3,5,0,0,5,8,7,0,0,0,0,17363,6.8,17510,207,60,-3660,-2162,26.7,1736.3
4761417317,0,12,1,0,9,5,9,1,1,0,0,19177,7.0,18638,217,43,2207,1022,26.0,1917.7,6,1,1,5,9,1,0,0,0,0,16970,6.8,17616,207,56,-2207,-1022,26.3,1697.0
4838394532,1,13,3,1,4,3,5,0,0,0,0,16789,6.8,18345,223,72,1971,766,29.5,1678.9,19,1,0,3,4,5,1,1,0,0,14818,6.8,17579,214,56,-1971,-766,27.0,1481.8
4838360397,1,82,3,1,2,3,2,1,1,0,0,15821,7.0,18336,231,64,895,104,29.5,1582.1,14,1,0,3,2,2,1,0,1,0,14926,7.0,18232,206,64,-895,-104,27.0,1492.6
4836995092,0,11,1,1,3,5,3,0,0,0,0,17273,7.2,18915,231,54,-395,305,28.5,1727.3,12,0,0,5,3,8,0,0,0,0,17668,7.0,18610,226,46,395,-305,27.2,1766.8
4836950111,0,14,1,0,6,7,3,0,0,0,0,16303,6.6,16964,219,44,-419,-363,26.3,1630.3,14,2,1,7,6,8,0,0,0,0,16722,6.8,17327,221,54,419,363,27.5,1672.2
4836898809,1,16,1,0,2,4,1,0,0,0,0,15208,7.2,18116,199,64,246,746,26.3,1520.8,136,1,1,4,2,6,1,1,0,0,14962,7.0,17370,219,48,-246,-746,26.7,1496.2
4836840226,1,16,3,1,4,3,4,0,0,0,0,16758,6.8,17737,216,52,674,-535,26.8,1675.8,15,3,0,3,4,2,0,0,0,0,16084,7.0,18272,205,68,-674,535,27.3,1608.4
4824903111,0,11,1,1,7,6,7,0,0,0,0,16968,6.8,17195,187,36,468,-789,22.3,1696.8,11,3,0,6,7,2,1,1,0,0,16500,6.8,17984,190,56,-468,789,24.6,1650.0
4820578199,0,11,1,0,4,5,3,0,0,0,0,16009,6.8,17054,216,52,-594,-783,26.8,1600.9,13,1,1,5,4,4,0,0,0,0,16603,6.8,17837,239,51,594,783,29.0,1660.3
4820547023,1,7,1,0,3,10,3,0,0,0,0,15834,7.0,18455,226,51,-3913,-1020,27.7,1583.4,13,1,1,10,3,11,1,0,1,0,19747,7.2,19475,217,72,3913,1020,28.9,1974.7
4820532071,1,34,0,0,29,24,78,0,0,0,1,40848,12.2,46764,114,0,3260,5913,11.4,4084.8,34,0,1,24,29,61,0,0,0,0,37588,11.2,40851,96,0,-3260,-5913,9.6,3758.8
4820521768,1,20,0,0,26,30,63,0,0,0,2,40506,11.8,44044,114,0,156,-389,11.4,4050.6,0,4,1,30,26,75,0,0,0,0,40350,11.6,44433,111,0,-156,389,11.1,4035.0
4820186427,0,8,0,1,9,7,11,0,0,0,0,18127,7.0,17589,208,52,1461,268,26.0,1812.7,10,0,0,7,9,6,0,0,0,0,16666,6.6,17321,206,50,-1461,-268,25.6,1666.6
4820163131,0,11,1,1,2,7,2,0,0,0,0,15212,7.0,18235,212,56,-1329,-639,26.8,1521.2,18,2,0,7,2,6,0,0,0,0,16541,7.0,18874,201,65,1329,639,26.6,1654.1
4820136269,1,8,1,0,6,9,5,0,0,0,0,17607,6.6,16908,192,59,172,411,25.1,1760.7,31,2,1,9,6,8,0,0,0,0,17435,6.6,16497,186,40,-172,-411,22.6,1743.5
4820121079,1,19,2,1,5,2,4,0,0,0,0,16982,6.8,18688,226,60,3037,1743,28.6,1698.2,13,0,0,2,5,0,0,0,0,0,13945,6.6,16945,196,39,-3037,-1743,23.5,1394.5
4820073522,1,14,2,0,7,5,9,0,0,0,0,16919,7.0,18902,243,64,1297,1623,30.7,1691.9,12,0,1,5,7,3,0,0,0,0,15622,7.0,17279,201,52,-1297,-1623,25.3,1562.2
4820046110,1,17,0,1,7,5,12,0,0,0,0,17748,7.0,18284,230,52,2211,509,28.2,1774.8,11,0,0,5,7,6,0,0,0,0,15537,6.8,17775,180,56,-2211,-509,23.6,1553.7
4819080759,1,14,0,1,3,0,3,1,1,0,0,15382,6.8,17843,198,52,1970,536,25.0,1538.2,15,1,0,0,3,0,0,0,0,0,13412,6.8,17307,204,63,-1970,-536,26.7,1341.2
4818871061,1,40,3,1,3,3,2,0,0,0,0,14806,7.0,17309,210,48,58,-746,25.8,1480.6,38,1,0,3,3,3,1,0,1,0,14748,6.8,18055,203,64,-58,746,26.7,1474.8
4818827115,0,11,1,1,7,8,7,0,0,0,0,17720,7.0,17635,220,65,545,546,28.5,1772.0,11,0,0,8,7,8,0,0,0,0,17175,6.6,17089,143,50,-545,-546,19.3,1717.5
4814654207,0,0,0,0,30,34,74,0,0,0,1,39855,11.8,44896,76,0,-2097,-2069,7.6,3985.5,0,0,1,34,30,98,0,0,0,0,41952,12.0,46965,112,0,2097,2069,11.2,4195.2
4814652861,1,0,0,1,32,25,85,0,0,0,0,38800,11.4,42761,100,0,1011,-613,10.0,3880.0,0,0,0,25,32,51,0,0,0,0,37789,11.6,43374,102,0,-1011,613,10.2,3778.9
4814642559,1,20,0,0,9,14,15,0,0,0,0,33121,10.6,35680,119,0,-2025,-2407,11.9,3312.1,0,5,1,14,9,31,0,0,0,0,35146,11.0,38087,96,0,2025,2407,9.6,3514.6
4813708566,1,41,2,0,5,8,5,0,0,0,0,16144,6.6,16407,168,56,-3227,-1979,22.4,1614.4,65,2,1,8,5,8,0,0,0,0,19371,7.0,18386,202,60,3227,1979,26.2,1937.1
4811731174,0,7,1,1,9,5,1,0,0,0,0,17638,7.0,18719,200,51,2201,2543,25.1,1763.8,14,0,0,5,9,4,0,0,0,0,15437,6.2,16176,185,49,-2201,-2543,23.4,1543.7
4811718052,1,11,1,1,2,6,4,0,0,0,0,14919,6.4,16182,196,44,-2557,-2091,24.0,1491.9,11,3,0,6,2,7,0,0,0,0,17476,7.0,18273,224,47,2557,2091,27.1,1747.6
4809708501,0,10,1,1,6,3,4,0,0,0,0,16040,6.8,16422,179,51,452,-769,23.0,1604.0,14,2,0,3,6,3,1,1,0,0,15588,6.6,17191,207,50,-452,769,25.7,1558.8
4808776086,0,1,0,0,29,29,66,0,0,0,0,36774,11.4,42706,105,0,-1419,-1809,10.5,3677.4,0,0,1,29,29,66,0,0,0,0,38193,11.6,44515,101,0,1419,1809,10.1,3819.3
4807370513,1,14,0,0,31,31,87,0,0,0,1,39336,11.6,42570,95,0,-85,-522,9.5,3933.6,0,0,1,31,31,87,0,0,0,0,39421,11.6,43092,95,0,85,522,9.5,3942.1
4807347339,1,0,0,0,24,24,75,0,0,0,1,38173,11.2,42301,96,0,1598,3324,9.6,3817.3,0,0,1,24,24,75,0,0,0,0,36575,11.0,38977,95,0,-1598,-3324,9.5,3657.5
4807324562,0,0,0,1,26,21,63,0,0,0,0,36158,11.0,40085,85,0,-738,-1287,8.5,3615.8,0,0,0,21,26,46,0,0,0,0,36896,11.2,41372,100,0,738,1287,10.0,3689.6
4806766261,1,6,2,0,2,2,2,0,0,0,0,15474,6.8,18516,237,53,1577,483,29.0,1547.4,12,0,1,2,2,0,0,0,0,0,13897,7.0,18033,201,52,-1577,-483,25.3,1389.7
4806178907,1,0,0,1,43,26,91,0,0,0,0,41902,12.2,46714,125,0,5174,5621,12.5,4190.2,0,0,0,26,43,55,0,0,0,0,36728,11.2,41093,86,0,-5174,-5621,8.6,3672.8
4806159117,1,25,0,0,32,21,89,0,0,0,0,38121,11.4,42291,80,0,2278,4385,8.0,3812.1,0,0,1,21,32,51,0,0,0,0,35843,10.8,37906,83,0,-2278,-4385,8.3,3584.3
4803653922,1,360,11,1,30,27,85,0,0,0,2,39567,11.8,44337,120,0,111,2849,12.0,3956.7,19,0,0,26,29,74,0,0,0,0,39456,11.4,41488,97,0,-111,-2849,9.7,3945.6
4803439604,0,0,0,1,15,14,29,0,0,0,1,32905,10.4,35498,93,0,-1899,-1001,9.3,3290.5,0,0,0,14,15,40,0,0,0,0,34804,10.4,36499,99,0,1899,1001,9.9,3480.4
4803354343,1,74,2,1,4,1,4,0,0,0,0,16486,6.8,18493,202,68,868,-71,27.0,1648.6,15,2,0,1,4,1,1,1,0,0,15618,7.0,18564,228,56,-868,71,28.4,1561.8
4802604186,1,16,3,0,11,5,5,0,0,0,0,17635,7.0,18943,218,52,1836,2384,27.0,1763.5,16,1,1,5,11,5,1,1,0,0,15799,6.6,16559,211,52,-1836,-2384,26.3,1579.9
4802087026,1,16,9,1,8,5,7,0,0,0,0,18551,7.0,18093,226,48,2342,2303,27.4,1855.1,83,4,0,5,8,3,1,1,0,0,16209,6.4,15790,194,60,-2342,-2303,25.4,1620.9
4857375450,1,15,1,0,7,10,4,0,0,0,0,16814,6.8,16694,174,52,-1639,-1026,22.6,1681.4,12,2,1,10,7,12,1,1,0,0,18453,6.8,17720,192,46,1639,1026,23.8,1845.3
4857017658,1,12,3,0,5,3,5,1,1,0,0,17038,6.8,18188,235,56,-542,-778,29.1,1703.8,15,1,1,3,5,5,1,0,1,0,17580,7.4,18966,273,51,542,778,32.4,1758.0
4856968246,1,12,2,0,4,4,4,1,1,0,0,17123,7.2,18503,256,60,1522,420,31.6,1712.3,13,1,1,4,4,3,1,0,1,0,15601,6.8,18083,207,52,-1522,-420,25.9,1560.1
4856945550,1,15,0,0,2,5,1,0,0,0,0,15736,7.0,18666,240,64,258,728,30.4,1573.6,8,1,1,5,2,5,1,0,1,0,15478,6.8,17938,191,52,-258,-728,24.3,1547.8
4856036749,0,13,1,1,11,7,10,2,1,1,0,18777,7.0,18600,220,60,1928,441,28.0,1877.7,10,0,0,7,11,5,0,0,0,0,16849,7.0,18159,223,64,-1928,-441,28.7,1684.9
4855997541,0,18,1,1,3,5,3,0,0,0,0,15295,7.0,18270,229,48,-1526,-1350,27.7,1529.5,12,1,0,5,3,2,0,0,0,0,16821,7.4,19620,228,60,1526,1350,28.8,1682.1
4855977823,0,11,1,1,3,6,1,0,0,0,0,15372,6.8,17657,250,52,-1722,-1179,30.2,1537.2,9,0,0,6,3,10,1,1,0,0,17094,7.2,18836,236,56,1722,1179,29.2,1709.4
4851495306,1,7,1,1,5,2,8,0,0,0,0,16530,7.2,18613,229,44,1241,27,27.3,1653.0,12,0,0,2,5,1,1,1,0,0,15289,7.0,18586,233,72,-1241,-27,30.5,1528.9
4850725738,0,52,4,0,3,6,2,0,0,0,0,17460,6.6,17056,204,56,188,465,26.0,1746.0,13,3,1,6,3,6,0,0,0,0,17272,6.4,16591,222,48,-188,-465,27.0,1727.2
4850695295,0,13,3,0,1,3,2,0,0,0,0,13311,6.4,15089,201,44,-4124,-3957,24.5,1331.1,12,4,1,3,1,4,1,0,1,0,17435,7.2,19046,264,60,4124,3957,32.4,1743.5
4850676298,1,12,3,1,12,2,14,2,1,1,0,19811,7.0,19079,245,40,5935,3107,28.5,1981.1,13,3,0,2,12,1,0,0,0,0,13876,6.4,15972,191,56,-5935,-3107,24.7,1387.6
4850646452,0,10,2,1,3,6,4,0,0,0,0,14434,6.6,16395,194,44,-2589,-288,23.8,1443.4,14,2,0,6,3,6,0,0,0,0,17023,6.6,16683,182,36,2589,288,21.8,1702.3
4850627002,1,13,1,1,5,1,5,1,0,1,0,17979,7.2,18483,230,62,3732,1110,29.2,1797.9,14,1,0,1,5,0,0,0,0,0,14247,6.8,17373,214,34,-3732,-1110,24.8,1424.7
4850579870,1,17,2,0,5,10,5,0,0,0,0,16516,6.8,17152,176,48,-2788,-1125,22.4,1651.6,22,1,1,10,5,8,1,1,0,0,19304,7.0,18277,239,50,2788,1125,28.9,1930.4
4850183897,1,11,1,0,4,6,6,0,0,0,0,15752,6.4,15463,199,40,-1154,-2216,23.9,1575.2,7,3,1,6,4,7,0,0,0,0,16906,6.8,17679,200,52,1154,2216,25.2,1690.6
4850153971,1,11,1,1,5,8,3,0,0,0,0,15777,6.4,15930,188,47,-1356,-1468,23.5,1577.7,11,0,0,8,5,7,0,0,0,0,17133,7.0,17398,181,56,1356,1468,23.7,1713.3
4850124607,0,17,1,1,3,4,2,0,0,0,0,14516,6.4,16087,175,56,-2531,-664,23.1,1451.6,12,4,0,4,3,3,0,0,0,0,17047,6.4,16751,196,48,2531,664,24.4,1704.7
4850070398,0,12,4,1,6,6,7,0,0,0,0,16082,6.2,16275,176,47,-753,-1149,22.3,1608.2,13,3,0,6,6,5,0,0,0,0,16835,7.0,17424,185,61,753,1149,24.6,1683.5
4848866490,1,38,1,0,4,5,1,0,0,0,0,15465,7.4,19403,217,59,-1260,16,27.6,1546.5,13,16,1,5,4,7,1,1,0,0,16725,7.0,19387,230,76,1260,-16,30.6,1672.5
4848417069,1,17,2,1,8,4,13,0,0,0,0,19237,7.2,19061,235,66,2842,1241,30.1,1923.7,41,1,0,4,8,3,0,0,0,0,16395,6.8,17820,211,44,-2842,-1241,25.5,1639.5
4847869864,0,13,2,1,5,3,1,0,0,0,0,15528,7.0,18133,210,68,69,257,27.8,1552.8,13,1,0,3,5,2,0,0,0,0,15459,7.0,17876,204,52,-69,-257,25.6,1545.9
4847814157,1,11,0,1,7,8,5,0,0,0,0,18022,7.2,18604,229,64,1197,108,29.3,1802.2,5,0,0,8,7,11,0,0,0,0,16825,7.0,18496,202,44,-1197,-108,24.6,1682.5
4847746953,0,63,0,1,8,5,8,0,0,0,0,17413,7.0,17835,198,60,-887,-1205,25.8,1741.3,11,0,0,5,8,5,0,0,0,0,18300,6.8,19040,217,56,887,1205,27.3,1830.0
4847698073,1,13,0,0,4,5,2,0,0,0,0,16460,7.0,17619,180,56,411,645,23.6,1646.0,12,1,1,5,4,7,0,0,0,0,16049,6.8,16974,157,60,-411,-645,21.7,1604.9
4847659928,0,11,0,0,3,7,2,0,0,0,0,14128,6.4,16364,220,32,-2965,-2248,25.2,1412.8,7,0,1,7,3,3,1,1,0,0,17093,7.2,18612,204,58,2965,2248,26.2,1709.3
4847640918,1,10,2,1,11,3,9,0,0,0,0,18112,7.0,18361,187,52,4006,1903,23.9,1811.2,12,1,0,3,11,2,0,0,0,0,14106,6.6,16458,137,52,-4006,-1903,18.9,1410.6
4847595134,0,8,2,1,9,4,13,0,0,0,0,17314,7.0,17819,179,64,1701,954,24.3,1731.4,41,0,0,4,9,3,0,0,0,0,15613,6.8,16865,177,56,-1701,-954,23.3,1561.3
4811505711,1,10,0,1,30,13,54,0,0,0,2,37888,11.6,42814,77,63,1174,6158,14.0,3788.8,8,0,0,13,30,19,0,0,0,0,36714,10.6,36656,72,48,-1174,-6158,12.0,3671.4
4793702229,1,9,2,0,7,7,2,1,1,0,0,16748,6.8,18179,205,58,10,949,26.3,1674.8,12,1,1,7,7,4,0,0,0,0,16738,6.4,17230,207,60,-10,-949,26.7,1673.8
4793683104,0,39,1,0,1,9,1,0,0,0,0,14937,6.8,17461,208,56,-3904,-2658,26.4,1493.7,12,11,1,9,1,9,1,1,0,0,18841,7.4,20119,230,80,3904,2658,31.0,1884.1
4792915607,1,11,2,0,3,5,3,0,0,0,0,15139,7.0,18452,219,56,-1547,-170,27.5,1513.9,12,1,1,5,3,5,0,0,0,0,16686,7.2,18622,225,67,1547,170,29.2,1668.6
4792679314,1,12,2,0,9,5,7,0,0,0,0,19238,7.2,17907,242,44,2283,-176,28.6,1923.8,10,1,1,5,9,3,1,1,0,0,16955,7.0,18083,194,56,-2283,176,25.0,1695.5
4792659338,0,15,1,0,3,7,2,0,0,0,0,14999,7.0,17358,196,64,-2870,-1552,26.0,1499.9,12,1,1,7,3,6,1,1,0,0,17869,7.0,18910,228,55,2870,1552,28.3,1786.9
4792646182,1,15,2,1,11,2,11,1,1,0,0,18091,7.0,18121,209,68,3900,973,27.7,1809.1,9,1,0,2,11,1,0,0,0,0,14191,6.8,17148,195,64,-3900,-973,25.9,1419.1
4791228868,1,7,1,1,6,5,3,0,0,0,0,16030,7.0,18715,221,48,-1299,-252,26.9,1603.0,13,2,0,5,6,5,1,1,0,0,17329,7.2,18967,242,68,1299,252,31.0,1732.9
4791183493,1,67,1,1,4,4,3,0,0,0,0,16548,7.2,18735,189,64,-16,458,25.3,1654.8,10,0,0,4,4,6,0,0,0,0,16564,7.0,18277,204,62,16,-458,26.6,1656.4
4790970596,0,12,1,0,7,10,6,0,0,0,0,16071,6.8,17640,181,52,-2053,-531,23.3,1607.1,16,2,1,10,7,7,1,1,0,0,18124,7.0,18171,231,52,2053,531,28.3,1812.4
4790943660,1,11,2,0,5,6,4,1,1,0,0,16443,7.0,18335,211,64,-651,1383,27.5,1644.3,14,1,1,6,5,6,1,0,1,0,17094,6.8,16952,176,76,651,-1383,25.2,1709.4
4790920701,0,14,1,0,3,4,5,1,0,1,0,15105,6.6,16502,188,36,-1101,-242,22.4,1510.5,12,4,1,4,3,5,1,1,0,0,16206,6.6,16744,198,56,1101,242,25.4,1620.6
4794211355,1,15,1,0,1,7,1,1,1,0,0,15699,7.0,18091,201,47,-745,868,24.8,1569.9,14,2,1,7,1,4,0,0,0,0,16444,7.0,17223,186,48,745,-868,23.4,1644.4
4794169613,0,13,0,0,5,6,3,0,0,0,0,16077,7.0,17930,181,56,-471,808,23.7,1607.7,8,0,1,6,5,4,0,0,0,0,16548,6.8,17122,211,48,471,-808,25.9,1654.8
4794115417,0,15,3,0,4,4,6,1,1,0,0,16072,6.4,16167,202,34,323,163,23.6,1607.2,13,0,1,4,4,4,0,0,0,0,15749,6.2,16004,169,40,-323,-163,20.9,1574.9
4794093193,1,0,0,0,30,37,73,0,0,0,1,39460,11.6,44401,86,0,-2517,-1503,8.6,3946.0,0,0,1,37,30,102,0,0,0,0,41977,11.8,45904,104,0,2517,1503,10.4,4197.7
4793707223,1,0,0,1,47,29,129,0,0,0,2,44408,12.6,50045,112,0,4903,4851,11.2,4440.8,3,0,0,29,47,60,0,0,0,0,39505,11.8,45194,97,0,-4903,-4851,9.7,3950.5
4793690533,1,68,0,0,31,31,75,0,0,0,0,37783,11.2,43533,90,0,-2455,-2449,9.0,3778.3,8,0,1,31,31,90,0,0,0,0,40238,11.8,45982,97,0,2455,2449,9.7,4023.8
4793671667,1,12,0,1,6,2,7,1,1,0,0,18540,6.8,18033,238,51,4125,1858,28.9,1854.0,8,3,0,2,6,1,0,0,0,0,14415,6.4,16175,178,48,-4125,-1858,22.6,1441.5
4793656186,0,11,2,1,5,4,5,1,0,1,0,15969,6.6,16142,169,56,-416,-1723,22.5,1596.9,18,1,0,4,5,1,0,0,0,0,16385,6.8,17865,219,56,416,1723,27.5,1638.5
4793626387,1,13,2,1,5,7,5,1,1,0,0,17390,7.0,18063,201,59,171,575,26.0,1739.0,20,0,0,7,5,7,0,0,0,0,17219,6.8,17488,206,48,-171,-575,25.4,1721.9
4792358933,1,86,0,0,5,4,2,0,0,0,0,16730,6.8,18361,200,72,868,254,27.2,1673.0,33,1,1,4,5,4,0,0,0,0,15862,6.8,18107,215,48,-868,-254,26.3,1586.2
4792328147,1,12,1,1,4,4,1,0,0,0,0,16338,7.0,18158,235,64,656,2299,29.9,1633.8,17,1,0,4,4,4,0,0,0,0,15682,6.4,15859,171,51,-656,-2299,22.2,1568.2
4792295822,0,33,3,1,7,5,10,0,0,0,0,17885,7.0,18024,214,60,1793,-220,27.4,1788.5,70,3,0,5,7,8,1,1,0,0,16092,7.0,18244,197,72,-1793,220,26.9,1609.2
4792268824,1,24,0,1,22,26,46,0,0,0,0,38209,11.4,42419,112,0,2191,3367,11.2,3820.9,0,2,0,26,22,59,0,0,0,0,36018,10.8,39052,104,0,-2191,-3367,10.4,3601.8
4791830014,0,14,0,0,2,5,1,0,0,0,0,13918,6.8,16956,195,46,-3544,-2189,24.1,1391.8,13,1,1,5,2,3,0,0,0,0,17462,7.0,19145,251,61,3544,2189,31.2,1746.2
4791808429,0,15,2,1,2,2,2,0,0,0,0,16706,7.0,18519,256,48,823,153,30.4,1670.6,10,7,0,2,2,3,1,1,0,0,15883,7.2,18366,218,60,-823,-153,27.8,1588.3
4791765188,0,19,2,0,2,3,1,1,0,1,0,16130,6.8,17793,209,47,312,-723,25.6,1613.0,12,2,1,3,2,3,1,1,0,0,15818,6.8,18516,224,60,-312,723,28.4,1581.8
4790988902,1,0,3,0,32,28,86,0,0,0,2,39401,11.2,41715,116,0,-636,-1936,11.6,3940.1,22,0,1,28,32,77,0,0,0,0,40037,11.6,43651,104,0,636,1936,10.4,4003.7
4790967220,0,10,0,0,14,9,19,1,0,1,0,18655,6.6,16264,193,56,33,-51,24.9,1865.5,13,1,1,8,13,11,1,1,0,0,18622,6.6,16315,175,48,-33,51,22.3,1862.2
4790945360,0,33,2,0,4,6,2,1,1,0,0,15232,6.8,17650,212,52,-2130,-1218,26.4,1523.2,86,0,1,6,4,6,0,0,0,0,17362,7.0,18868,213,52,2130,1218,26.5,1736.2
4790933156,0,11,2,1,1,5,2,0,0,0,0,13008,6.4,15660,185,36,-3959,-2277,22.1,1300.8,10,1,0,5,1,3,0,0,0,0,16967,7.0,17937,215,60,3959,2277,27.5,1696.7
4829578295,1,17,1,1,2,4,0,0,0,0,0,15021,6.6,17557,243,60,-259,-662,30.3,1502.1,8,2,0,4,2,3,0,0,0,0,15280,6.8,18219,208,52,259,662,26.0,1528.0
4826670456,0,35,4,1,6,3,7,0,0,0,0,17220,7.0,18557,234,64,264,541,29.8,1722.0,15,8,0,3,6,4,0,0,0,0,16956,7.2,18016,242,60,-264,-541,30.2,1695.6
4826293032,0,54,0,0,2,4,3,0,0,0,0,15110,7.0,18626,233,60,-1181,-229,29.3,1511.0,81,2,1,4,2,2,1,0,1,0,16291,7.0,18855,260,56,1181,229,31.6,1629.1
4825408337,0,31,1,0,3,8,3,0,0,0,0,15222,6.6,17343,212,52,-3893,-1872,26.4,1522.2,11,1,1,8,3,16,1,1,0,0,19115,7.0,19215,242,52,3893,1872,29.4,1911.5
4825372674,1,13,1,1,7,8,6,0,0,0,0,17751,7.4,19186,236,68,-439,690,30.4,1775.1,14,1,0,8,7,7,0,0,0,0,18190,7.0,18496,177,52,439,-690,22.9,1819.0
4825314874,1,17,3,0,4,9,5,0,0,0,0,15366,7.0,17040,206,48,-2679,-916,25.4,1536.6,13,2,1,9,4,11,0,0,0,0,18045,7.0,17956,223,48,2679,916,27.1,1804.5
4822883078,1,0,0,1,31,18,79,0,0,0,1,38897,11.6,43965,107,0,3557,5377,10.7,3889.7,0,0,0,16,29,32,0,0,0,0,35340,10.8,38588,102,0,-3557,-5377,10.2,3534.0
4822720035,1,13,0,0,2,8,0,1,1,0,0,15030,6.8,18061,207,56,-2819,-1811,26.3,1503.0,7,0,1,8,2,4,0,0,0,0,17849,7.4,19872,221,64,2819,1811,28.5,1784.9
4822695597,1,20,1,1,7,1,9,1,1,0,0,16098,6.8,17028,201,40,1962,-949,24.1,1609.8,15,2,0,1,7,0,0,0,0,0,14136,7.0,17977,225,62,-1962,949,28.7,1413.6
4820755764,1,30,1,1,5,7,5,0,0,0,0,16215,6.8,17439,211,48,-2,-219,25.9,1621.5,15,11,0,7,5,6,0,0,0,0,16217,7.0,17658,181,52,2,219,23.3,1621.7
4818888213,1,53,2,1,8,5,7,0,0,0,0,18276,7.0,18172,198,56,1247,72,25.4,1827.6,7,0,0,5,8,5,0,0,0,0,17029,7.2,18100,221,52,-1247,-72,27.3,1702.9
4818802985,1,64,1,1,3,2,2,0,0,0,0,15303,7.0,18929,209,44,-842,891,25.3,1530.3,16,3,0,2,3,2,0,0,0,0,16145,6.8,18038,217,52,842,-891,26.9,1614.5
4817943481,0,13,0,1,13,22,27,0,0,0,1,34011,10.8,38689,98,43,-3183,-2600,14.1,3401.1,5,1,0,22,13,39,0,0,0,0,37194,11.2,41289,87,79,3183,2600,16.6,3719.4
4817917235,0,13,0,0,7,2,4,0,0,0,0,16038,6.8,17226,193,40,566,-1142,23.3,1603.8,13,0,1,2,7,1,0,0,0,0,15472,7.0,18368,238,68,-566,1142,30.6,1547.2
4817880428,0,33,0,1,4,5,3,0,0,0,0,15318,7.0,17541,214,46,-1264,-820,26.0,1531.8,12,1,0,5,4,4,1,1,0,0,16582,7.0,18361,194,60,1264,820,25.4,1658.2
4817688529,0,12,2,1,7,12,5,0,0,0,0,16985,6.4,15865,173,56,-3549,-2627,22.9,1698.5,11,1,0,12,7,8,0,0,0,0,20534,7.0,18492,228,63,3549,2627,29.1,2053.4
4817637487,1,11,2,1,7,1,9,1,1,0,0,16492,6.8,17929,186,52,2561,732,23.8,1649.2,30,0,0,1,7,0,0,0,0,0,13931,6.8,17197,218,56,-2561,-732,27.4,1393.1
4817622981,1,13,3,0,4,4,3,2,1,1,0,16295,7.0,18236,216,68,-838,617,28.4,1629.5,11,0,1,4,4,7,0,0,0,0,17133,6.8,17619,221,56,838,-617,27.7,1713.3
4816352810,0,90,0,0,22,23,46,0,0,0,0,34319,10.8,39546,73,0,-3928,-2034,7.3,3431.9,10,0,1,23,22,69,0,0,0,0,38247,11.4,41580,118,0,3928,2034,11.8,3824.7
4816319198,1,17,2,1,3,6,2,0,0,0,0,15293,7.0,18010,201,59,17,762,26.0,1529.3,10,0,0,6,3,5,0,0,0,0,15276,6.8,17248,204,32,-17,-762,23.6,1527.6
4857298035,1,13,1,1,9,8,14,1,1,0,0,18928,6.8,17601,230,40,1329,-933,27.0,1892.8,13,1,0,8,9,7,0,0,0,0,17599,7.0,18534,191,64,-1329,933,25.5,1759.9
4857241550,0,65,2,1,7,3,11,0,0,0,0,15701,6.8,17470,187,40,148,595,22.7,1570.1,16,1,0,3,7,2,1,1,0,0,15553,6.8,16875,201,68,-148,-595,26.9,1555.3
4857205565,0,14,2,0,4,8,5,1,1,0,0,14992,6.8,17503,188,48,-3983,-2103,23.6,1499.2,16,1,1,8,4,7,0,0,0,0,18975,7.2,19606,237,60,3983,2103,29.7,1897.5
4855006864,1,33,3,1,7,8,11,1,1,0,0,18420,7.2,18058,226,68,423,-630,29.4,1842.0,33,2,0,8,7,8,0,0,0,0,17997,7.0,18688,208,48,-423,630,25.6,1799.7
4854952358,1,14,3,1,9,4,12,1,1,0,0,17703,6.8,16556,227,40,1439,-452,26.7,1770.3,17,2,0,3,8,1,0,0,0,0,16264,6.8,17008,229,60,-1439,452,28.9,1626.4
4854910798,1,10,1,0,5,8,4,1,0,1,0,17002,7.0,18231,216,64,-15,316,28.0,1700.2,12,1,1,8,5,13,0,0,0,0,17017,6.8,17915,205,51,15,-316,25.6,1701.7
4854856703,1,12,1,0,7,6,5,0,0,0,0,17497,7.2,18627,203,60,736,435,26.3,1749.7,13,0,1,6,7,4,1,1,0,0,16761,7.0,18192,223,51,-736,-435,27.4,1676.1
4854623475,1,23,1,0,6,4,5,0,0,0,0,16714,7.2,19255,257,44,615,765,30.1,1671.4,12,1,1,4,6,5,1,1,0,0,16099,7.2,18490,227,72,-615,-765,29.9,1609.9
4854595045,0,34,0,1,4,11,3,0,0,0,0,15574,6.6,17183,178,65,-3933,-2545,24.3,1557.4,30,0,0,11,4,9,0,0,0,0,19507,7.4,19728,233,48,3933,2545,28.1,1950.7
4854563592,0,13,0,0,5,5,5,1,1,0,0,16030,6.8,17364,207,48,-1358,-2254,25.5,1603.0,16,1,1,5,5,2,1,0,1,0,17388,7.2,19618,211,60,1358,2254,27.1,1738.8
4854550117,0,14,0,0,1,5,2,0,0,0,0,13574,6.8,16620,137,72,-3560,-1957,20.9,1357.4,12,3,1,5,1,4,0,0,0,0,17134,7.0,18577,221,48,3560,1957,26.9,1713.4
4853824446,1,10,0,0,3,3,3,1,1,0,0,15327,6.8,18268,225,56,701,-681,28.1,1532.7,11,0,1,3,3,0,0,0,0,0,14626,7.2,18949,226,48,-701,681,27.4,1462.6
4853800204,1,0,0,0,15,23,13,0,0,0,0,46736,10.0,47500,0,0,17229,19000,0.0,4673.6,0,0,1,15,7,13,0,0,0,0,29507,6.0,28500,4,0,-17229,-19000,0.4,2950.7
4853762236,1,12,1,1,10,5,5,0,0,0,0,18416,7.0,18610,215,48,2629,1370,26.3,1841.6,11,2,0,5,10,6,0,0,0,0,15787,6.8,17240,210,37,-2629,-1370,24.7,1578.7
4853720725,0,9,1,1,3,4,2,0,0,0,0,15645,6.8,17433,216,55,-3120,-1084,27.1,1564.5,102,0,0,4,3,5,0,0,0,0,18765,7.0,18517,240,48,3120,1084,28.8,1876.5
4853700375,1,0,0,1,25,21,66,0,0,0,0,37842,11.2,40476,93,0,-46,-187,9.3,3784.2,0,0,0,21,25,41,0,0,0,0,37888,11.2,40663,116,0,46,187,11.6,3788.8
4853675106,1,99,3,0,30,28,84,0,0,0,0,37501,11.6,42683,119,0,-614,497,11.9,3750.1,37,0,1,28,30,68,0,0,0,0,38115,11.4,42186,131,0,614,-497,13.1,3811.5
4853452728,1,5,0,0,14,20,14,0,0,0,0,60656,13.0,60000,0,0,22744,27000,0.0,6065.6,0,0,1,13,7,14,0,0,0,0,37912,7.2,33000,0,0,-22744,-27000,0.0,3791.2
4857540042,0,15,2,0,8,6,6,0,0,0,0,17782,6.8,18353,211,44,883,-111,25.5,1778.2,14,1,1,6,8,2,0,0,0,0,16899,7.0,18464,208,60,-883,111,26.8,1689.9
4856707449,0,23,0,1,8,5,5,0,0,0,0,16174,6.4,15883,179,56,841,-774,23.5,1617.4,13,2,0,5,8,5,1,1,0,0,15333,6.6,16657,207,52,-841,774,25.9,1533.3
4855827020,0,14,0,1,6,7,5,0,0,0,0,16584,6.8,18044,198,68,626,660,26.6,1658.4,46,0,0,7,6,7,1,1,0,0,15958,6.8,17384,190,36,-626,-660,22.6,1595.8
4855784798,1,20,2,1,9,9,8,1,1,0,0,18828,6.6,17439,206,55,601,-1514,26.1,1882.8,15,2,0,9,9,7,0,0,0,0,18227,7.0,18953,199,56,-601,1514,25.5,1822.7
4855743698,1,14,2,1,7,5,4,0,0,0,0,16506,6.6,17435,194,48,1232,298,24.2,1650.6,15,2,0,5,7,4,0,0,0,0,15274,6.8,17137,181,64,-1232,-298,24.5,1527.4
4855710234,0,15,2,0,12,18,13,1,1,0,0,18897,6.6,17148,178,56,-4009,-2688,23.4,1889.7,13,4,1,18,12,28,0,0,0,0,22906,7.4,19836,218,60,4009,2688,27.8,2290.6
4854598955,1,12,2,0,6,4,1,0,0,0,0,16181,7.0,17894,233,51,-594,-604,28.4,1618.1,14,1,1,4,6,5,0,0,0,0,16775,7.2,18498,213,56,594,604,26.9,1677.5
4854578265,1,105,2,1,7,4,3,1,1,0,0,16125,6.8,17740,213,52,2201,629,26.5,1612.5,15,0,0,3,6,1,0,0,0,0,13924,6.8,17111,170,56,-2201,-629,22.6,1392.4
4854377589,0,11,2,0,1,3,0,0,0,0,0,15585,7.0,18206,199,44,-267,547,24.3,1558.5,11,0,1,3,1,0,1,0,1,0,15852,7.0,17659,223,56,267,-547,27.9,1585.2
4854363155,1,10,0,1,2,0,4,0,0,0,0,15472,6.6,17146,216,56,580,-1588,27.2,1547.2,13,0,0,0,2,0,0,0,0,0,14892,7.2,18734,224,68,-580,1588,29.2,1489.2
4854344009,0,15,1,1,3,4,5,0,0,0,0,15301,7.0,18135,199,68,-231,404,26.7,1530.1,11,2,0,4,3,4,0,0,0,0,15532,7.0,17731,211,59,231,-404,27.0,1553.2
4854322862,1,13,4,1,8,8,4,0,0,0,0,18196,7.2,18777,205,64,627,114,26.9,1819.6,23,1,0,8,8,7,0,0,0,0,17569,7.0,18663,214,60,-627,-114,27.4,1756.9
4853475470,1,12,0,0,7,6,5,0,0,0,0,16927,6.6,17008,159,60,-940,-541,21.9,1692.7,218,2,1,6,7,4,0,0,0,0,17867,6.8,17549,201,55,940,541,25.6,1786.7
4853459821,0,12,1,0,6,9,5,2,1,1,0,17125,6.8,18219,215,63,-1142,-1679,27.8,1712.5,9,0,1,9,6,6,0,0,0,0,18267,7.4,19898,193,68,1142,1679,26.1,1826.7
4853435268,0,10,3,0,1,4,0,0,0,0,0,14126,7.0,18336,205,56,-1591,148,26.1,1412.6,15,1,1,4,1,5,1,1,0,0,15717,7.0,18188,204,65,1591,-148,26.9,1571.7
4853373579,1,11,0,0,7,7,9,0,0,0,0,17471,6.8,17738,202,64,1054,295,26.6,1747.1,184,2,1,7,7,9,1,1,0,0,16417,6.8,17443,197,57,-1054,-295,25.4,1641.7
4853355481,0,12,2,0,4,5,4,0,0,0,0,16779,7.2,18759,241,68,-864,-206,30.9,1677.9,9,3,1,5,4,6,0,0,0,0,17643,7.2,18965,238,68,864,206,30.6,1764.3
4853334417,1,10,1,0,5,2,2,0,0,0,0,15596,7.2,18856,218,46,1386,1789,26.4,1559.6,22,0,1,2,5,2,0,0,0,0,14210,6.8,17067,189,54,-1386,-1789,24.3,1421.0
4855992801,1,13,5,1,12,5,10,0,0,0,0,19007,7.0,18565,213,50,4072,2769,26.3,1900.7,83,1,0,5,12,6,1,1,0,0,14935,6.6,15796,164,56,-4072,-2769,22.0,1493.5
4849635984,0,8,1,1,7,5,8,1,1,0,0,16644,6.8,17909,193,48,371,666,24.1,1664.4,12,0,0,5,7,3,0,0,0,0,16273,6.6,17243,192,54,-371,-666,24.6,1627.3
4849556952,0,10,0,0,2,7,0,0,0,0,0,15433,7.0,17988,186,64,-2835,-1241,25.0,1543.3,14,1,1,7,2,4,1,1,0,0,18268,7.0,19229,239,52,2835,1241,29.1,1826.8
4793201235,0,12,2,1,11,8,13,1,1,0,0,17634,6.6,16733,193,45,-1174,-601,23.8,1763.4,19,2,0,8,11,8,0,0,0,0,18808,6.8,17334,177,48,1174,601,22.5,1880.8
4793165518,0,10,2,0,1,5,1,0,0,0,0,14176,6.8,17807,239,48,-2322,-684,28.7,1417.6,16,0,1,5,1,4,1,0,1,0,16498,7.0,18491,210,64,2322,684,27.4,1649.8
4793139205,1,19,0,1,35,31,95,0,0,0,0,41857,11.8,46905,82,0,18,1272,8.2,4185.7,16,7,0,31,35,83,0,0,0,0,41839,11.8,45633,105,0,-18,-1272,10.5,4183.9
4788400723,0,12,1,0,9,9,8,0,0,0,0,18941,6.6,17297,176,68,1243,-277,24.4,1894.1,10,2,1,9,9,10,1,1,0,0,17698,7.0,17574,182,54,-1243,277,23.6,1769.8
4787584325,0,11,4,0,6,6,8,2,1,1,0,18790,7.0,18677,212,64,331,958,27.6,1879.0,102,1,1,6,6,7,0,0,0,0,18459,6.8,17719,217,44,-331,-958,26.1,1845.9
4787556239,0,10,0,0,2,10,2,0,0,0,0,15088,6.6,16570,209,60,-3543,-2233,26.9,1508.8,8,0,1,10,2,7,1,1,0,0,18631,7.4,18803,197,56,3543,2233,25.3,1863.1
4787437490,0,13,1,1,6,4,6,1,1,0,0,15930,6.8,17387,223,43,376,-528,26.6,1593.0,21,1,0,4,6,3,0,0,0,0,15554,7.2,17915,201,64,-376,528,26.5,1555.4
4787414347,0,11,0,1,5,12,9,0,0,0,0,15855,6.8,17102,193,56,-4582,-2347,24.9,1585.5,13,2,0,12,5,16,2,1,1,0,20437,7.4,19449,231,80,4582,2347,31.1,2043.7
4782302550,0,13,2,1,7,5,13,0,0,0,0,16603,6.4,16446,189,60,1160,520,24.9,1660.3,14,2,0,5,7,6,1,1,0,0,15443,6.4,15926,206,44,-1160,-520,25.0,1544.3
4781089235,0,100,0,1,7,7,3,0,0,0,0,17128,7.0,18180,212,48,294,537,26.0,1712.8,8,1,0,7,7,4,0,0,0,0,16834,7.0,17643,167,56,-294,-537,22.3,1683.4
4781074346,1,12,1,1,8,5,7,1,1,0,0,18329,7.0,18818,221,64,2873,2382,28.5,1832.9,11,0,0,5,8,5,0,0,0,0,15456,6.6,16436,167,48,-2873,-2382,21.5,1545.6
4779501154,1,15,2,1,9,3,12,1,1,0,0,18367,7.0,18227,206,67,2907,1304,27.3,1836.7,14,0,0,3,9,3,1,0,1,0,15460,6.6,16923,189,57,-2907,-1304,24.6,1546.0
4779475410,0,19,2,1,7,6,5,0,0,0,0,17376,6.8,17265,200,56,-1610,-1335,25.6,1737.6,18,0,0,6,7,7,2,1,1,0,18986,7.2,18600,232,56,1610,1335,28.8,1898.6
4776913856,1,11,1,0,8,8,8,0,0,0,0,19251,7.0,17223,196,44,-579,563,24.0,1925.1,15,2,1,8,8,10,0,0,0,0,19830,6.4,16660,195,56,579,-563,25.1,1983.0
4775803525,0,16,1,0,1,8,1,0,0,0,0,13420,6.6,16820,179,60,-5508,-1804,23.9,1342.0,8,0,1,8,1,6,0,0,0,0,18928,7.0,18624,221,54,5508,1804,27.5,1892.8
4775784879,0,12,0,1,3,5,3,0,0,0,0,15618,6.6,17168,204,59,-935,-896,26.3,1561.8,73,2,0,5,3,5,1,1,0,0,16553,6.8,18064,203,60,935,896,26.3,1655.3
4774742900,1,10,1,1,7,5,9,1,1,0,0,17435,7.0,17811,204,64,1810,572,26.8,1743.5,18,2,0,5,7,1,0,0,0,0,15625,6.8,17239,191,49,-1810,-572,24.0,1562.5
4856903460,0,32,2,1,8,4,6,1,1,0,0,16693,7.0,17825,177,61,1092,-1100,23.8,1669.3,35,0,0,3,7,0,0,0,0,0,15601,7.2,18925,197,66,-1092,1100,26.3,1560.1
4856873663,0,15,3,0,7,5,4,1,0,1,0,16729,6.8,16746,214,47,421,110,26.1,1672.9,13,1,1,5,7,5,0,0,0,0,16308,6.8,16636,220,40,-421,-110,26.0,1630.8
4856859345,0,11,1,0,4,7,3,0,0,0,0,14645,6.6,16736,201,47,-3303,-2227,24.8,1464.5,13,1,1,7,4,5,1,1,0,0,17948,7.2,18963,213,60,3303,2227,27.3,1794.8
4856834058,0,19,1,0,7,7,8,0,0,0,0,17184,6.8,17503,212,52,-1408,-1191,26.4,1718.4,11,3,1,6,6,7,0,0,0,0,18592,7.2,18694,213,44,1408,1191,25.7,1859.2
4856819293,0,15,1,0,5,6,1,1,0,1,0,15895,6.6,17121,193,44,-935,-20,23.7,1589.5,13,0,1,6,5,8,1,1,0,0,16830,6.8,17141,219,59,935,20,27.8,1683.0
4856794752,0,8,1,1,4,2,4,1,1,0,0,16567,7.4,18936,238,60,2047,976,29.8,1656.7,12,0,0,2,4,0,0,0,0,0,14520,6.6,17960,204,63,-2047,-976,26.7,1452.0
4856774840,0,15,0,1,4,4,3,1,1,0,0,15360,7.2,18429,173,54,-794,-216,22.7,1536.0,16,1,0,4,4,4,0,0,0,0,16154,7.2,18645,222,69,794,216,29.1,1615.4
4856757907,0,11,1,0,3,11,3,0,0,0,0,15568,6.8,17139,235,48,-2959,-136,28.3,1556.8,10,0,1,11,3,10,1,1,0,0,18527,6.8,17275,207,48,2959,136,25.5,1852.7
4856739556,0,30,1,0,5,7,6,0,0,0,0,17169,7.2,18026,216,61,0,460,27.7,1716.9,35,0,1,7,5,8,2,1,1,0,17169,6.8,17566,194,50,0,-460,24.4,1716.9
4856729243,1,10,1,0,1,6,1,0,0,0,0,14683,6.8,17820,212,64,-1894,-648,27.6,1468.3,13,0,1,6,1,5,0,0,0,0,16577,7.0,18468,223,52,1894,648,27.5,1657.7
4855742239,1,10,2,0,7,5,4,0,0,0,0,16034,6.8,17526,207,42,575,-297,24.9,1603.4,15,0,1,5,7,1,1,0,1,0,15459,7.0,17823,201,62,-575,297,26.3,1545.9
4853567150,1,12,1,0,8,5,7,0,0,0,0,17695,7.2,18425,233,36,2077,1385,26.9,1769.5,14,3,1,5,8,6,2,1,1,0,15618,6.6,17040,188,60,-2077,-1385,24.8,1561.8
4853534064,1,12,1,0,6,6,6,0,0,0,0,16137,6.6,17135,199,56,-28,-1927,25.5,1613.7,10,1,1,5,5,1,1,1,0,0,16165,7.0,19062,199,72,28,1927,27.1,1616.5
4853507072,0,14,0,1,4,6,3,0,0,0,0,17826,7.0,18712,261,56,444,-472,31.7,1782.6,11,2,0,6,4,9,1,1,0,0,17382,7.0,19184,228,52,-444,472,28.0,1738.2
4853360252,0,16,1,0,2,6,1,0,0,0,0,15671,6.8,18194,210,64,-1709,-621,27.4,1567.1,20,1,1,6,2,4,1,1,0,0,17380,7.2,18815,194,56,1709,621,25.0,1738.0
4853340172,1,16,1,1,5,4,6,0,0,0,0,15741,6.8,17315,209,64,635,-336,27.3,1574.1,16,2,0,4,5,4,0,0,0,0,15106,6.8,17651,211,44,-635,336,25.5,1510.6
4853320355,0,54,4,1,4,6,4,0,0,0,0,16421,6.8,16977,184,52,-395,-199,23.6,1642.1,15,4,0,6,4,5,1,1,0,0,16816,6.8,17176,214,48,395,199,26.2,1681.6
4853314767,1,12,1,0,8,6,6,1,1,0,0,17003,7.0,17744,229,48,-966,-1159,27.7,1700.3,18,0,1,6,8,3,1,0,1,0,17969,7.0,18903,227,56,966,1159,28.3,1796.9
4853290340,0,11,1,0,8,6,3,1,0,1,0,16643,7.4,19166,204,68,-444,492,27.2,1664.3,15,0,1,5,7,4,1,1,0,0,17087,7.0,18674,206,72,444,-492,27.8,1708.7
4856384276,1,0,0,0,16,13,26,0,0,0,0,62350,12.0,55000,0,0,26200,22000,0.0,6235.0,4,0,1,11,14,4,0,0,0,0,36150,7.2,33000,0,0,-26200,-22000,0.0,3615.0
4856361794,1,0,0,1,17,12,17,0,0,0,0,61325,12.0,55000,11,0,24060,22000,1.1,6132.5,0,0,0,7,12,8,0,0,0,0,37265,7.2,33000,9,0,-24060,-22000,0.9,3726.5
4856326725,1,0,1,1,11,24,16,0,0,0,0,59775,12.0,55000,4,0,20635,22000,0.4,5977.5,24,0,0,18,5,13,0,0,0,0,39140,7.2,33000,5,0,-20635,-22000,0.5,3914.0
4856303007,1,43,0,1,20,14,20,0,0,0,0,47350,10.0,47500,0,0,20200,19000,0.0,4735.0,0,0,0,6,12,7,0,0,0,0,27150,6.0,28500,0,0,-20200,-19000,0.0,2715.0
4856281761,1,0,0,1,22,18,17,0,0,0,0,48050,10.0,47500,0,0,20200,19000,0.0,4805.0,0,0,0,7,11,11,0,0,0,0,27850,6.0,28500,0,0,-20200,-19000,0.0,2785.0
4856244419,1,7,0,1,16,15,15,0,0,0,0,47010,10.0,47500,0,0,18780,19000,0.0,4701.0,0,0,0,12,13,9,0,0,0,0,28230,6.0,28500,0,0,-18780,-19000,0.0,2823.0
4856218041,1,4,0,1,19,21,25,0,0,0,0,48060,10.0,47500,1,0,19470,19000,0.1,4806.0,0,0,0,12,10,8,0,0,0,0,28590,6.0,28500,0,0,-19470,-19000,0.0,2859.0
4856194043,1,37,0,0,21,15,19,0,0,0,0,63892,12.0,55000,1,0,26956,22000,0.1,6389.2,95,0,1,10,16,11,0,0,0,0,36936,7.2,33000,0,0,-26956,-22000,0.0,3693.6
4855254296,1,15,1,1,5,3,3,0,0,0,0,18428,7.4,19803,235,56,3593,3040,29.1,1842.8,8,0,0,3,5,4,0,0,0,0,14835,6.4,16763,164,52,-3593,-3040,21.6,1483.5
4855224299,0,8,2,0,5,7,1,0,0,0,0,15415,6.8,17135,188,46,-1277,329,23.4,1541.5,9,0,1,7,5,5,1,0,1,0,16692,6.6,16806,187,46,1277,-329,23.3,1669.2
4854024408,0,19,0,0,4,2,1,0,0,0,0,14644,7.2,18025,207,39,-1836,-1276,24.6,1464.4,13,1,1,2,4,0,0,0,0,0,16480,7.2,19301,235,51,1836,1276,28.6,1648.0
4853972326,1,9,2,0,5,8,4,0,0,0,0,15146,6.6,16586,150,40,-3156,-2570,19.0,1514.6,9,3,1,8,5,5,1,1,0,0,18302,7.0,19156,227,60,3156,2570,28.7,1830.2
4853922532,0,31,0,0,5,5,3,1,1,0,0,14745,6.0,14440,143,69,-924,-2075,21.2,1474.5,32,1,1,5,5,8,0,0,0,0,15669,6.8,16515,189,50,924,2075,23.9,1566.9
4853899873,1,19,2,1,10,8,8,0,0,0,0,18318,7.0,18646,185,52,1819,1271,23.7,1831.8,70,2,0,8,10,4,0,0,0,0,16499,6.6,17375,174,52,-1819,-1271,22.6,1649.9
4852929418,1,63,1,0,6,2,7,0,0,0,0,17506,7.0,17679,176,56,1652,88,23.2,1750.6,10,2,1,2,6,2,0,0,0,0,15854,6.6,17591,238,52,-1652,-88,29.0,1585.4
4852011279,0,35,3,1,2,4,0,0,0,0,0,15130,6.8,18302,227,49,-178,643,27.6,1513.0,14,9,0,4,2,4,1,1,0,0,15308,6.8,17659,232,52,178,-643,28.4,1530.8
4851982977,1,41,1,0,2,6,1,0,0,0,0,14045,6.6,16944,183,52,-2667,-1868,23.5,1404.5,13,0,1,6,2,4,0,0,0,0,16712,6.8,18812,224,56,2667,1868,28.0,1671.2
4851959271,0,10,1,0,5,11,5,0,0,0,0,16992,6.6,17497,205,56,-2117,-1615,26.1,1699.2,9,2,1,11,5,15,0,0,0,0,19109,7.0,19112,226,48,2117,1615,27.4,1910.9
4850665250,0,34,1,1,9,3,3,0,0,0,0,17896,7.2,20226,210,62,1977,3000,27.2,1789.6,11,13,0,3,9,3,1,1,0,0,15919,6.8,17226,204,48,-1977,-3000,25.2,1591.9
4850045131,0,11,2,0,9,7,9,0,0,0,0,18315,6.8,18029,210,45,1629,39,25.5,1831.5,10,1,1,7,9,3,1,1,0,0,16686,7.0,17990,207,58,-1629,-39,26.5,1668.6
4837961853,0,12,18,1,6,7,5,0,0,0,0,17336,7.2,18169,212,62,119,-656,27.4,1733.6,40,1,0,7,6,5,1,1,0,0,17217,7.0,18825,220,50,-119,656,27.0,1721.7
4833803880,0,15,4,1,4,5,6,1,1,0,0,16061,6.8,16936,194,44,-1391,-1986,23.8,1606.1,14,2,0,5,4,6,0,0,0,0,17452,7.2,18922,209,72,1391,1986,28.1,1745.2
4833176215,0,13,0,0,2,6,1,0,0,0,0,14106,6.8,17452,216,52,-2441,-1836,26.8,1410.6,11,1,1,6,2,2,1,1,0,0,16547,7.2,19288,271,57,2441,1836,32.8,1654.7
4829393950,1,12,4,1,8,2,11,0,0,0,0,16695,6.6,16740,191,49,1378,-864,24.0,1669.5,90,1,0,2,8,1,1,1,0,0,15317,7.0,17604,216,42,-1378,864,25.8,1531.7
4829358612,0,90,3,1,4,8,4,0,0,0,0,16797,6.8,17134,199,44,425,-772,24.3,1679.7,12,4,0,8,4,3,1,1,0,0,16372,6.8,17906,211,56,-425,772,26.7,1637.2
4829320658,0,13,0,0,5,9,4,0,0,0,0,15987,6.8,17884,200,58,-1705,512,25.8,1598.7,10,0,1,9,5,6,0,0,0,0,17692,6.8,17372,191,52,1705,-512,24.3,1769.2
4829306258,0,47,4,0,2,11,3,0,0,0,0,14218,6.4,15936,183,56,-6103,-3556,23.9,1421.8,13,2,1,11,2,8,1,0,1,0,20321,7.2,19492,223,56,6103,3556,27.9,2032.1
4828321692,0,14,0,0,4,7,4,0,0,0,0,16136,7.0,18498,219,64,-753,-393,28.3,1613.6,180,1,1,7,4,7,1,1,0,0,16889,7.2,18891,223,58,753,393,28.1,1688.9
4822873548,0,7,11,0,3,5,4,0,0,0,0,15883,7.0,17497,244,40,-1473,-1367,28.4,1588.3,34,0,1,5,3,5,1,1,0,0,17356,7.4,18864,198,64,1473,1367,26.2,1735.6
4822756517,1,14,3,1,6,2,5,1,1,0,0,16548,7.0,18474,234,46,1640,743,28.0,1654.8,14,3,0,2,6,2,0,0,0,0,14908,6.8,17731,247,48,-1640,-743,29.5,1490.8
4822675674,0,7,0,0,1,5,0,0,0,0,0,12877,6.6,16077,180,52,-4245,-3628,23.2,1287.7,75,0,1,5,1,4,1,1,0,0,17122,7.2,19705,236,68,4245,3628,30.4,1712.2
4822650289,0,37,2,0,8,9,8,0,0,0,0,17480,7.0,18308,165,59,-1207,-727,22.4,1748.0,10,7,1,9,8,6,1,1,0,0,18687,7.2,19035,227,80,1207,727,30.7,1868.7
4820018817,0,14,2,0,3,4,3,0,0,0,0,16215,7.2,18521,246,51,525,899,29.7,1621.5,14,1,1,4,3,5,1,1,0,0,15690,6.8,17622,214,56,-525,-899,27.0,1569.0
4818704214,1,14,2,1,6,0,6,1,1,0,0,18071,7.0,18372,215,52,4240,1534,26.7,1807.1,10,1,0,0,6,0,1,0,1,0,13831,6.6,16838,206,52,-4240,-1534,25.8,1383.1
4816893825,0,12,4,1,3,0,5,0,0,0,0,15325,7.0,17952,200,57,1056,465,25.7,1532.5,20,1,0,0,3,0,0,0,0,0,14269,7.0,17487,203,64,-1056,-465,26.7,1426.9
4816140162,0,12,2,0,4,6,3,0,0,0,0,15615,6.6,17083,211,40,-1524,-1871,25.1,1561.5,12,0,1,6,4,7,1,1,0,0,17139,7.2,18954,198,58,1524,1871,25.6,1713.9
4816102239,1,12,2,1,3,2,6,0,0,0,0,15584,6.6,17735,211,52,-76,-333,26.3,1558.4,11,1,0,2,3,2,0,0,0,0,15660,7.0,18068,225,52,76,333,27.7,1566.0
4816061774,1,9,1,0,5,9,6,2,1,1,0,16259,7.0,17713,191,52,-2162,331,24.3,1625.9,13,0,1,9,5,7,0,0,0,0,18421,6.6,17382,202,56,2162,-331,25.8,1842.1
4813922339,0,35,2,0,3,3,4,1,1,0,0,15673,7.0,19117,232,60,32,-398,29.2,1567.3,15,10,1,3,3,2,1,0,1,0,15641,7.2,19515,240,69,-32,398,30.9,1564.1
4813895136,1,18,3,1,5,3,5,0,0,0,0,17462,7.0,18576,251,48,2307,777,29.9,1746.2,13,2,0,3,5,3,1,1,0,0,15155,6.8,17799,215,52,-2307,-777,26.7,1515.5
4858385323,1,14,0,0,19,26,50,0,0,0,0,35501,11.0,39983,95,0,-1549,-246,9.5,3550.1,23,1,1,26,19,58,0,0,0,0,37050,11.2,40229,107,0,1549,246,10.7,3705.0
4858357014,0,0,0,1,14,25,42,0,0,0,0,34235,10.4,35887,94,0,-3646,-7435,9.4,3423.5,0,0,0,25,14,65,0,0,0,0,37881,11.6,43322,111,0,3646,7435,11.1,3788.1
4858108760,0,6,0,1,4,4,5,0,0,0,0,15261,6.8,18096,183,52,-156,266,23.5,1526.1,14,0,0,4,4,5,1,1,0,0,15417,7.0,17830,199,66,156,-266,26.5,1541.7
4858085983,0,9,0,1,4,6,7,0,0,0,0,15133,6.6,16560,206,52,-2186,-2053,25.8,1513.3,13,1,0,6,4,4,0,0,0,0,17319,7.0,18613,234,47,2186,2053,28.1,1731.9
4858065018,1,13,1,1,7,5,1,0,0,0,0,15536,7.0,18309,169,52,1578,1823,22.1,1553.6,11,1,0,5,7,1,1,1,0,0,13958,6.6,16486,155,35,-1578,-1823,19.0,1395.8
4858035958,0,5,0,0,2,3,1,0,0,0,0,13752,6.6,16575,192,44,-1561,-849,23.6,1375.2,8,0,1,3,2,0,0,0,0,0,15313,7.0,17424,196,32,1561,849,22.8,1531.3
4858009474,1,22,0,1,12,7,5,0,0,0,0,18452,7.2,19390,189,47,2643,3627,23.6,1845.2,11,1,0,7,12,8,0,0,0,0,15809,6.4,15763,148,28,-2643,-3627,17.6,1580.9
4857957030,0,9,0,1,4,4,2,1,1,0,0,14093,6.6,16525,142,66,-685,-2559,20.8,1409.3,12,0,0,4,4,1,0,0,0,0,14778,7.2,19084,204,39,685,2559,24.3,1477.8
4857563727,0,13,0,0,2,2,2,0,0,0,0,14880,6.8,17678,186,56,1510,1531,24.2,1488.0,12,0,1,2,2,2,0,0,0,0,13370,6.6,16147,146,52,-1510,-1531,19.8,1337.0
4857546764,1,0,0,1,38,21,92,0,0,0,1,41186,12.0,45778,116,0,6383,6379,11.6,4118.6,198,0,0,20,37,49,0,0,0,0,34803,10.8,39399,80,0,-6383,-6379,8.0,3480.3
4857526795,1,0,0,1,12,17,14,0,0,0,0,59950,12.0,55000,1,0,22050,22000,0.1,5995.0,0,0,0,12,7,12,0,0,0,0,37900,7.2,33000,0,0,-22050,-22000,0.0,3790.0
4857363793,1,75,0,1,7,3,6,0,0,0,0,16266,6.8,17911,169,52,29,-521,22.1,1626.6,70,17,0,3,7,4,0,0,0,0,16237,6.8,18432,214,48,-29,521,26.2,1623.7
4857305331,1,12,1,1,5,4,3,0,0,0,0,15488,7.0,17867,202,56,196,798,25.8,1548.8,23,0,0,4,5,5,0,0,0,0,15292,6.6,17069,155,56,-196,-798,21.1,1529.2
4857253821,1,15,0,0,1,6,0,0,0,0,0,13486,6.6,17188,183,60,-2520,-1006,24.3,1348.6,7,0,1,6,1,5,0,0,0,0,16006,6.8,18194,179,40,2520,1006,21.9,1600.6
4857046430,1,11,1,1,6,8,3,1,1,0,0,16051,6.2,15021,158,40,-120,399,19.8,1605.1,15,0,0,8,6,12,0,0,0,0,16171,6.2,14622,132,47,120,-399,17.9,1617.1
4856984083,1,12,1,0,4,5,2,0,0,0,0,16258,7.0,18103,199,56,120,-274,25.5,1625.8,17,0,1,5,4,3,0,0,0,0,16138,6.8,18377,209,52,-120,274,26.1,1613.8
4856959285,1,10,0,0,4,4,1,0,0,0,0,14970,7.0,18099,180,55,-1423,-275,23.5,1497.0,10,0,1,4,4,2,0,0,0,0,16393,7.0,18374,207,48,1423,275,25.5,1639.3
4856942215,1,10,1,1,9,5,7,0,0,0,0,16463,6.6,17277,184,48,89,-832,23.2,1646.3,13,3,0,5,9,6,0,0,0,0,16374,6.8,18109,205,72,-89,832,27.7,1637.4
4856875841,1,1,0,0,23,22,43,0,0,0,2,37411,10.8,39999,118,0,55,173,11.8,3741.1,30,0,1,22,23,61,0,0,0,0,37356,10.8,39826,88,0,-55,-173,8.8,3735.6
4833792595,0,18,0,0,2,4,0,0,0,0,0,14991,7.0,18062,239,52,-1181,-658,29.1,1499.1,12,0,1,4,2,4,1,1,0,0,16172,7.0,18720,184,80,1181,658,26.4,1617.2
4833761626,1,14,2,1,7,4,6,0,0,0,0,17197,6.6,17409,190,38,722,844,22.8,1719.7,76,1,0,4,7,3,0,0,0,0,16475,6.8,16565,192,52,-722,-844,24.4,1647.5
4833732668,0,9,0,0,5,5,5,0,0,0,0,15970,6.4,17086,179,44,574,1120,22.3,1597.0,19,1,1,5,5,4,0,0,0,0,15396,6.6,15966,186,48,-574,-1120,23.4,1539.6
4833324880,0,9,1,0,4,7,0,0,0,0,0,15155,6.8,18127,213,52,-1418,739,26.5,1515.5,13,0,1,7,4,8,0,0,0,0,16573,6.8,17388,199,56,1418,-739,25.5,1657.3
4833288008,1,21,0,1,11,10,11,0,0,0,0,20286,6.8,16746,172,53,1968,-75,22.5,2028.6,7,0,0,10,11,7,0,0,0,0,18318,6.6,16821,181,34,-1968,75,21.5,1831.8
4822931957,1,12,2,0,7,10,6,0,0,0,0,17802,6.6,17035,205,40,491,-359,24.5,1780.2,11,0,1,10,7,11,1,1,0,0,17311,7.0,17394,133,64,-491,359,19.7,1731.1
4822890003,0,14,0,1,4,5,6,0,0,0,0,16058,6.8,17925,240,54,51,383,29.4,1605.8,11,1,0,5,4,8,0,0,0,0,16007,6.8,17542,226,52,-51,-383,27.8,1600.7
4787640299,0,19,1,0,6,11,7,0,0,0,0,16265,6.8,16529,205,44,-2292,-730,24.9,1626.5,11,1,1,11,6,8,0,0,0,0,18557,6.8,17259,200,60,2292,730,26.0,1855.7
4787618639,0,15,3,1,5,5,4,1,0,1,0,15788,6.6,16163,207,56,-436,-763,26.3,1578.8,12,0,0,5,5,7,1,1,0,0,16224,6.6,16926,190,48,436,763,23.8,1622.4
4787025838,1,13,2,1,11,5,7,0,0,0,0,19201,7.4,18998,217,64,3538,2071,28.1,1920.1,11,2,0,5,11,4,1,1,0,0,15663,6.6,16927,188,64,-3538,-2071,25.2,1566.3
4786460481,0,16,0,0,4,2,3,1,1,0,0,16817,6.8,18144,218,64,2096,700,28.2,1681.7,13,0,1,2,4,0,0,0,0,0,14721,6.8,17444,218,44,-2096,-700,26.2,1472.1
4786451218,0,52,1,0,1,5,2,0,0,0,0,14309,6.8,17296,225,52,-2987,-1640,27.7,1430.9,71,0,1,5,1,4,0,0,0,0,17296,7.2,18936,224,60,2987,1640,28.4,1729.6
4785278562,0,13,2,0,2,6,4,0,0,0,0,14406,6.6,17639,206,64,-1404,17,27.0,1440.6,18,1,1,6,2,7,0,0,0,0,15810,6.8,17622,187,44,1404,-17,23.1,1581.0
4783573715,0,14,1,0,5,4,4,0,0,0,0,15738,7.0,17784,171,50,-473,187,22.1,1573.8,8,2,1,4,5,4,0,0,0,0,16211,6.8,17597,212,50,473,-187,26.2,1621.1
4783527454,0,15,4,1,3,3,3,2,1,1,0,15531,6.8,17735,212,56,-285,-1604,26.8,1553.1,11,1,0,3,3,1,0,0,0,0,15816,7.0,19339,200,79,285,1604,27.9,1581.6
4783431442,1,15,1,0,5,5,8,0,0,0,0,17580,7.2,18159,226,48,2321,2971,27.4,1758.0,13,0,1,5,5,5,1,0,1,0,15259,6.2,15188,182,60,-2321,-2971,24.2,1525.9
4782160380,1,56,1,1,13,6,12,0,0,0,0,18618,7.0,18131,167,48,1182,1754,21.5,1861.8,13,2,0,6,13,5,1,1,0,0,17436,6.4,16377,194,48,-1182,-1754,24.2,1743.6
4781663808,0,12,2,1,4,8,4,1,1,0,0,16273,6.8,17058,195,42,-667,-332,23.7,1627.3,15,0,0,8,4,7,0,0,0,0,16940,6.8,17390,193,49,667,332,24.2,1694.0
4781607365,1,31,1,1,6,1,4,1,1,0,0,18103,7.4,19215,243,56,4116,1540,29.9,1810.3,30,0,0,1,6,0,0,0,0,0,13987,6.8,17675,208,60,-4116,-1540,26.8,1398.7
4781186942,1,17,0,0,4,2,5,1,1,0,0,16937,7.0,18592,223,66,3493,2894,28.9,1693.7,12,1,1,2,4,2,0,0,0,0,13444,6.6,15698,136,60,-3493,-2894,19.6,1344.4
4854904511,1,16,2,0,2,7,4,1,1,0,0,15637,6.6,16127,184,43,-1389,-1381,22.7,1563.7,15,1,1,7,2,7,0,0,0,0,17026,7.0,17508,194,44,1389,1381,23.8,1702.6
4851099005,0,13,4,0,3,3,4,0,0,0,0,16058,6.8,18055,223,60,-819,-740,28.3,1605.8,15,2,1,3,3,1,0,0,0,0,16877,7.0,18795,212,48,819,740,26.0,1687.7
4851051972,1,13,0,0,7,6,5,1,1,0,0,16068,6.8,16896,162,73,-2166,-1577,23.5,1606.8,9,0,1,6,7,7,0,0,0,0,18234,7.2,18473,210,54,2166,1577,26.4,1823.4
4851006823,1,26,0,1,10,3,7,1,1,0,0,18579,6.8,17698,215,48,3887,2229,26.3,1857.9,10,2,0,2,9,4,0,0,0,0,14692,6.2,15469,168,56,-3887,-2229,22.4,1469.2
4828381408,1,11,0,1,2,7,2,0,0,0,0,14224,6.4,16336,200,40,-2877,-1900,24.0,1422.4,8,1,0,7,2,9,1,1,0,0,17101,7.0,18236,189,48,2877,1900,23.7,1710.1
4828352510,0,9,0,1,4,3,1,0,0,0,0,13659,6.6,17441,207,29,-1613,-726,23.6,1365.9,15,1,0,2,3,1,1,1,0,0,15272,7.0,18167,206,59,1613,726,26.5,1527.2
4828323551,1,29,0,1,3,2,2,0,0,0,0,15449,7.0,18596,221,52,1693,1873,27.3,1544.9,6,14,0,2,3,2,0,0,0,0,13756,6.4,16723,193,39,-1693,-1873,23.2,1375.6
4828302265,1,53,3,1,8,7,9,0,0,0,0,17904,6.8,17619,192,48,2478,1854,24.0,1790.4,9,0,0,7,8,5,0,0,0,0,15426,6.6,15765,174,44,-2478,-1854,21.8,1542.6
4828265162,1,7,0,0,0,2,0,0,0,0,0,13900,6.8,17552,223,48,-1105,-760,27.1,1390.0,12,1,1,2,0,2,0,0,0,0,15005,7.0,18312,234,48,1105,760,28.2,1500.5
4826300051,1,0,0,0,28,24,65,0,0,0,0,36878,11.4,41789,100,0,-320,1004,10.0,3687.8,0,0,1,24,28,66,0,0,0,0,37198,11.2,40785,109,0,320,-1004,10.9,3719.8
4826288776,0,0,0,0,36,40,96,0,0,0,1,40365,12.0,46075,90,0,-4125,-3618,9.0,4036.5,0,0,1,40,36,103,0,0,0,0,44490,12.6,49693,115,0,4125,3618,11.5,4449.0
4763237788,0,20,0,1,30,20,81,0,0,0,0,38647,11.6,43360,116,0,2381,4035,11.6,3864.7,85,3,0,20,30,50,0,0,0,0,36266,11.0,39325,122,0,-2381,-4035,12.2,3626.6
4763222961,1,289,0,0,25,25,71,0,0,0,1,38423,11.6,42990,115,0,526,1777,11.5,3842.3,25,0,1,25,25,56,0,0,0,0,37897,11.0,41213,120,0,-526,-1777,12.0,3789.7
4763210157,1,35,0,0,25,27,72,0,0,0,0,38021,11.2,41458,112,0,-1284,85,11.2,3802.1,68,0,1,27,25,69,0,0,0,0,39305,11.2,41373,110,0,1284,-85,11.0,3930.5
4760783079,1,12,2,0,6,7,8,0,0,0,0,17485,7.0,19263,204,63,-301,1055,26.7,1748.5,9,1,1,7,6,15,1,1,0,0,17786,7.0,18208,239,60,301,-1055,29.9,1778.6
4760766671,1,14,4,0,8,6,8,1,1,0,0,17011,6.6,16506,179,51,544,681,23.0,1701.1,14,3,1,6,8,3,0,0,0,0,16467,6.4,15825,185,36,-544,-681,22.1,1646.7
4760760831,0,13,0,1,3,2,2,1,1,0,0,15059,7.2,18368,220,64,56,-424,28.4,1505.9,10,0,0,2,3,1,0,0,0,0,15003,7.2,18792,266,40,-56,424,30.6,1500.3
4760745332,1,14,4,1,6,3,3,1,1,0,0,17955,7.2,18366,215,68,2766,2502,28.3,1795.5,14,0,0,3,6,1,1,0,1,0,15189,6.6,15864,205,36,-2766,-2502,24.1,1518.9
4760729308,1,37,2,1,7,2,8,0,0,0,0,18987,7.2,19199,224,63,4412,1607,28.7,1898.7,11,16,0,2,7,0,0,0,0,0,14575,7.0,17592,175,48,-4412,-1607,22.3,1457.5
4811946167,1,8,2,1,5,6,8,1,1,0,0,15946,7.2,17899,208,60,-812,-72,26.8,1594.6,9,2,0,6,5,4,0,0,0,0,16758,7.0,17971,183,64,812,72,24.7,1675.8
4811917525,0,11,0,0,6,6,7,0,0,0,0,15876,6.6,17076,194,44,-1976,-809,23.8,1587.6,15,0,1,6,6,6,0,0,0,0,17852,7.0,17885,205,59,1976,809,26.4,1785.2
4811209920,0,12,1,0,2,9,2,0,0,0,0,14445,6.4,16058,202,48,-3347,-2408,25.0,1444.5,10,3,1,9,2,11,1,1,0,0,17792,7.0,18466,205,59,3347,2408,26.4,1779.2
4811175403,0,7,0,0,5,11,1,0,0,0,0,15237,6.8,17517,197,44,-4646,-1397,24.1,1523.7,12,0,1,11,5,12,1,1,0,0,19883,7.2,18914,208,60,4646,1397,26.8,1988.3
4811122557,1,15,3,1,3,1,3,0,0,0,0,14908,6.8,16551,199,52,-334,-1146,25.1,1490.8,11,1,0,1,3,0,0,0,0,0,15242,6.8,17697,209,48,334,1146,25.7,1524.2
4810607222,0,9,2,0,1,7,0,0,0,0,0,14414,6.8,17358,197,44,-2044,-649,24.1,1441.4,10,1,1,7,1,4,0,0,0,0,16458,7.0,18007,209,51,2044,649,26.0,1645.8
4810537422,1,13,3,0,6,6,6,0,0,0,0,17658,7.2,19323,215,59,487,1087,27.4,1765.8,22,2,1,6,6,7,0,0,0,0,17171,7.0,18236,221,51,-487,-1087,27.2,1717.1
4810491492,1,15,2,1,8,3,12,1,1,0,0,18808,7.4,19741,240,61,3895,3155,30.1,1880.8,15,0,0,3,8,2,0,0,0,0,14913,6.8,16586,223,60,-3895,-3155,28.3,1491.3
4810465142,0,11,2,1,3,3,3,0,0,0,0,15329,7.0,17355,198,51,-89,-1781,24.9,1532.9,13,0,0,3,3,2,1,1,0,0,15418,7.2,19136,220,72,89,1781,29.2,1541.8
4802399739,1,11,3,1,6,3,4,0,0,0,0,17196,7.2,18850,204,75,1059,845,27.9,1719.6,11,2,0,3,6,2,0,0,0,0,16137,6.8,18005,210,48,-1059,-845,25.8,1613.7
4801031781,0,39,0,0,7,7,9,1,1,0,0,17998,7.0,19265,182,72,-25,2104,25.4,1799.8,11,1,1,7,7,10,0,0,0,0,18023,6.6,17161,186,56,25,-2104,24.2,1802.3
4795382606,1,11,1,0,3,5,2,1,0,1,0,17425,6.6,17698,231,53,1221,1120,28.4,1742.5,141,2,1,5,3,6,1,1,0,0,16204,6.4,16578,195,52,-1221,-1120,24.7,1620.4
4795366814,1,15,1,0,10,5,5,0,0,0,0,18810,7.2,18806,193,60,2904,1862,25.3,1881.0,16,2,1,5,10,3,0,0,0,0,15906,6.6,16944,204,56,-2904,-1862,26.0,1590.6
4794363244,0,13,2,0,2,5,0,0,0,0,0,14479,6.8,17846,212,59,-3070,-967,27.1,1447.9,73,4,1,4,1,5,1,1,0,0,17549,7.0,18813,227,56,3070,967,28.3,1754.9
4787232619,0,9,1,1,8,12,11,1,1,0,0,17778,6.6,16606,188,48,-1825,-2490,23.6,1777.8,17,1,0,12,8,12,0,0,0,0,19603,7.2,19096,201,60,1825,2490,26.1,1960.3
4785328247,0,9,0,1,5,2,1,0,0,0,0,16277,7.4,19513,228,52,1741,2234,28.0,1627.7,17,2,0,2,5,2,0,0,0,0,14536,6.8,17279,212,56,-1741,-2234,26.8,1453.6
4750245342,0,17,1,1,8,4,9,0,0,0,0,18425,6.8,17966,219,48,2596,965,26.7,1842.5,13,2,0,4,8,3,1,0,1,0,15829,6.6,17001,208,52,-2596,-965,26.0,1582.9
4750144780,1,14,2,0,4,5,9,1,1,0,0,15581,6.8,17374,186,68,-2002,-1106,25.4,1558.1,14,0,1,5,4,5,0,0,0,0,17583,7.0,18480,244,59,2002,1106,30.3,1758.3
4750057071,1,17,2,1,6,4,1,1,1,0,0,16655,7.2,18147,209,57,737,1065,26.6,1665.5,33,1,0,4,6,4,0,0,0,0,15918,6.6,17082,195,46,-737,-1065,24.1,1591.8
4857025025,1,14,1,1,7,3,3,0,0,0,0,16227,6.6,17627,190,58,1042,-175,24.8,1622.7,12,2,0,3,7,5,1,1,0,0,15185,7.0,17802,211,64,-1042,175,27.5,1518.5
4856985917,1,15,2,1,6,3,3,0,0,0,0,18234,7.4,19165,226,53,2511,1409,27.9,1823.4,12,1,0,3,6,2,0,0,0,0,15723,7.0,17756,205,70,-2511,-1409,27.5,1572.3
4855107417,1,17,0,0,4,7,7,1,1,0,0,16368,6.8,16997,184,58,-623,-830,24.2,1636.8,13,3,1,7,4,11,0,0,0,0,16991,6.8,17827,205,56,623,830,26.1,1699.1
4852780341,1,11,1,1,8,5,8,0,0,0,0,16901,6.8,17775,214,40,1006,-267,25.4,1690.1,32,0,0,5,8,4,1,1,0,0,15895,7.0,18042,202,72,-1006,267,27.4,1589.5
4852733940,1,14,2,1,5,3,6,0,0,0,0,16290,6.8,17321,202,44,1281,478,24.6,1629.0,20,4,0,3,5,3,0,0,0,0,15009,6.6,16843,214,56,-1281,-478,27.0,1500.9
4851910649,1,9,0,1,3,2,5,0,0,0,0,15374,6.6,16710,194,44,940,-779,23.8,1537.4,16,2,0,2,3,0,0,0,0,0,14434,6.6,17489,220,60,-940,779,28.0,1443.4
4849961680,1,10,1,1,4,2,3,1,1,0,0,15881,6.6,18020,232,52,685,302,28.4,1588.1,24,2,0,2,4,4,0,0,0,0,15196,7.0,17718,217,62,-685,-302,27.9,1519.6
4844227851,1,14,3,0,5,5,6,1,1,0,0,16278,6.6,16545,193,60,1465,581,25.3,1627.8,194,1,1,5,5,4,0,0,0,0,14813,6.2,15964,183,44,-1465,-581,22.7,1481.3
4843282905,0,12,2,1,7,2,8,0,0,0,0,18163,7.0,17758,216,48,2267,974,26.4,1816.3,76,0,0,2,7,2,0,0,0,0,15896,6.4,16784,198,55,-2267,-974,25.3,1589.6
4843234499,0,15,1,0,6,10,12,1,1,0,0,16251,6.6,15934,164,40,-2199,-3137,20.4,1625.1,10,1,1,10,6,7,0,0,0,0,18450,7.0,19071,237,56,2199,3137,29.3,1845.0
4841167837,1,14,1,1,3,1,3,0,0,0,0,16227,6.8,17387,218,56,2643,35,27.4,1622.7,11,0,0,1,3,0,0,0,0,0,13584,6.8,17352,194,48,-2643,-35,24.2,1358.4
4830413094,0,13,1,1,6,6,11,0,0,0,0,16162,6.6,16912,189,48,-356,-1459,23.7,1616.2,14,2,0,6,6,3,1,1,0,0,16518,7.0,18371,201,64,356,1459,26.5,1651.8
4830376149,0,19,0,0,12,5,7,0,0,0,0,17711,6.8,18013,167,48,1982,620,21.5,1771.1,14,0,1,5,12,2,1,0,1,0,15729,7.0,17393,175,52,-1982,-620,22.7,1572.9
4756133581,0,10,0,0,9,9,7,0,0,0,0,22096,7.4,19924,222,45,3902,2091,26.7,2209.6,13,1,1,9,9,8,1,1,0,0,18194,7.0,17833,177,66,-3902,-2091,24.3,1819.4
4756097871,0,15,1,1,4,4,2,1,1,0,0,15806,7.0,17812,203,64,-96,-352,26.7,1580.6,17,0,0,3,3,1,0,0,0,0,15902,6.8,18164,192,56,96,352,24.8,1590.2
4754618295,1,19,0,1,7,2,3,1,1,0,0,16723,7.0,18504,221,52,2215,2160,27.3,1672.3,7,2,0,2,7,1,0,0,0,0,14508,6.4,16344,228,48,-2215,-2160,27.6,1450.8
4754583340,1,10,0,0,1,10,0,0,0,0,0,14256,6.4,15571,179,44,-4962,-5006,22.3,1425.6,12,2,1,10,1,7,1,1,0,0,19218,7.4,20577,234,60,4962,5006,29.4,1921.8
4754525456,1,15,4,1,7,1,6,0,0,0,0,18041,6.8,18119,218,44,3864,1124,26.2,1804.1,20,3,0,1,7,2,0,0,0,0,14177,6.8,16995,192,51,-3864,-1124,24.3,1417.7
4754258527,1,14,1,1,4,5,5,0,0,0,0,16814,7.0,18693,221,64,1254,71,28.5,1681.4,15,1,0,5,4,5,1,1,0,0,15560,7.2,18622,187,56,-1254,-71,24.3,1556.0
4855570926,1,63,0,1,16,14,17,0,0,0,0,62064,12.4,57000,0,0,24864,24000,0.0,6206.4,0,0,0,8,10,8,0,0,0,0,37200,7.2,33000,0,0,-24864,-24000,0.0,3720.0
4855563260,1,13,0,1,18,21,17,0,0,0,0,63050,12.0,55000,0,0,25500,22000,0.0,6305.0,0,0,0,11,8,15,0,0,0,0,37550,7.2,33000,0,0,-25500,-22000,0.0,3755.0
4855554586,1,7,0,0,13,18,7,0,0,0,0,45250,10.0,47500,0,0,16000,19000,0.0,4525.0,0,0,1,10,5,16,0,0,0,0,29250,6.0,28500,0,0,-16000,-19000,0.0,2925.0
4855189443,1,10,2,0,6,7,5,0,0,0,0,15847,6.8,18819,192,44,-1484,885,23.6,1584.7,245,1,1,7,6,12,0,0,0,0,17331,7.0,17934,213,48,1484,-885,26.1,1733.1
4855145036,1,13,2,1,6,5,7,0,0,0,0,16401,7.0,17906,212,72,369,-796,28.4,1640.1,14,2,0,5,6,5,1,1,0,0,16032,7.0,18702,218,59,-369,796,27.7,1603.2
4854408930,1,25,0,1,18,14,21,0,0,0,0,45950,10.0,47500,0,0,18100,19000,0.0,4595.0,4,0,0,10,14,7,0,0,0,0,27850,6.0,28500,0,0,-18100,-19000,0.0,2785.0
4854398432,1,0,0,1,17,12,16,0,0,0,0,47000,10.0,47500,0,0,19500,17820,0.0,4700.0,41,0,0,6,11,8,0,0,0,0,27500,6.2,29680,0,0,-19500,-17820,0.0,2750.0
4854389597,1,34,0,0,20,13,24,0,0,0,0,33000,10.0,47500,0,0,6900,19000,0.0,3300.0,0,0,1,7,14,3,0,0,0,0,26100,6.0,28500,0,0,-6900,-19000,0.0,2610.0
4854387104,1,45,0,1,12,21,11,0,0,0,0,60250,12.0,55000,0,0,21300,22000,0.0,6025.0,0,0,0,15,6,13,0,0,0,0,38950,7.2,33000,0,0,-21300,-22000,0.0,3895.0
4854379389,1,0,0,1,26,21,20,0,0,0,0,50674,10.0,47500,3,0,22265,19000,0.3,5067.4,34,0,0,7,12,13,0,0,0,0,28409,6.0,28500,0,0,-22265,-19000,0.0,2840.9
4851824530,0,14,0,0,8,10,11,0,0,0,0,17924,6.8,17136,197,62,-1172,-425,25.9,1792.4,13,2,1,10,8,12,1,1,0,0,19096,6.8,17561,206,49,1172,425,25.5,1909.6
4851764100,0,38,1,0,4,4,5,0,0,0,0,15927,6.4,15999,189,32,-488,-1384,22.1,1592.7,19,1,1,4,4,4,1,0,1,0,16415,6.8,17383,209,72,488,1384,28.1,1641.5
4851718412,1,26,0,0,10,6,12,0,0,0,0,19047,7.0,18565,228,56,3193,1306,28.4,1904.7,20,4,1,6,10,3,1,1,0,0,15854,6.6,17259,191,54,-3193,-1306,24.5,1585.4
4846132916,0,13,0,0,2,10,0,0,0,0,0,14121,6.6,16353,196,32,-3789,-1574,22.8,1412.1,33,0,1,10,2,15,1,1,0,0,17910,6.8,17927,190,58,3789,1574,24.8,1791.0
4846077645,0,15,2,1,12,5,12,1,1,0,0,19938,7.0,18427,241,45,4068,1090,28.6,1993.8,12,0,0,5,12,6,0,0,0,0,15870,6.8,17337,195,64,-4068,-1090,25.9,1587.0
4846037698,1,17,1,1,9,6,5,0,0,0,0,17484,7.0,18283,195,44,992,-60,23.9,1748.4,12,4,0,6,9,2,0,0,0,0,16492,7.0,18343,230,60,-992,60,29.0,1649.2
4845619721,1,9,3,0,5,6,3,0,0,0,0,16352,6.8,17691,190,62,-1028,-1146,25.2,1635.2,21,1,1,6,5,2,1,1,0,0,17380,7.2,18837,221,65,1028,1146,28.6,1738.0
4845615921,0,22,1,1,4,17,5,0,0,0,0,14818,6.2,15535,155,52,-7361,-3576,20.7,1481.8,14,1,0,17,4,20,1,1,0,0,22179,7.0,19111,237,48,7361,3576,28.5,2217.9
4845600336,0,15,1,0,6,9,4,1,0,1,0,15895,6.4,16358,192,56,-3026,-2869,24.8,1589.5,14,1,1,9,6,9,1,1,0,0,18921,7.0,19227,213,60,3026,2869,27.3,1892.1
4845580523,1,12,0,0,8,8,11,0,0,0,0,17831,6.8,17676,182,52,-60,1663,23.4,1783.1,13,0,1,8,8,7,1,1,0,0,17891,6.4,16013,200,44,60,-1663,24.4,1789.1
4856903460,0,32,2,1,8,4,6,1,1,0,0,16693,7.0,17825,177,61,1092,-1100,23.8,1669.3,35,0,0,3,7,0,0,0,0,0,15601,7.2,18925,197,66,-1092,1100,26.3,1560.1
4856873663,0,15,3,0,7,5,4,1,0,1,0,16729,6.8,16746,214,47,421,110,26.1,1672.9,13,1,1,5,7,5,0,0,0,0,16308,6.8,16636,220,40,-421,-110,26.0,1630.8
4856859345,0,11,1,0,4,7,3,0,0,0,0,14645,6.6,16736,201,47,-3303,-2227,24.8,1464.5,13,1,1,7,4,5,1,1,0,0,17948,7.2,18963,213,60,3303,2227,27.3,1794.8
4856834058,0,19,1,0,7,7,8,0,0,0,0,17184,6.8,17503,212,52,-1408,-1191,26.4,1718.4,11,3,1,6,6,7,0,0,0,0,18592,7.2,18694,213,44,1408,1191,25.7,1859.2
4856819293,0,15,1,0,5,6,1,1,0,1,0,15895,6.6,17121,193,44,-935,-20,23.7,1589.5,13,0,1,6,5,8,1,1,0,0,16830,6.8,17141,219,59,935,20,27.8,1683.0
4856794752,0,8,1,1,4,2,4,1,1,0,0,16567,7.4,18936,238,60,2047,976,29.8,1656.7,12,0,0,2,4,0,0,0,0,0,14520,6.6,17960,204,63,-2047,-976,26.7,1452.0
4856774840,0,15,0,1,4,4,3,1,1,0,0,15360,7.2,18429,173,54,-794,-216,22.7,1536.0,16,1,0,4,4,4,0,0,0,0,16154,7.2,18645,222,69,794,216,29.1,1615.4
4856757907,0,11,1,0,3,11,3,0,0,0,0,15568,6.8,17139,235,48,-2959,-136,28.3,1556.8,10,0,1,11,3,10,1,1,0,0,18527,6.8,17275,207,48,2959,136,25.5,1852.7
4856739556,0,30,1,0,5,7,6,0,0,0,0,17169,7.2,18026,216,61,0,460,27.7,1716.9,35,0,1,7,5,8,2,1,1,0,17169,6.8,17566,194,50,0,-460,24.4,1716.9
4856729243,1,10,1,0,1,6,1,0,0,0,0,14683,6.8,17820,212,64,-1894,-648,27.6,1468.3,13,0,1,6,1,5,0,0,0,0,16577,7.0,18468,223,52,1894,648,27.5,1657.7
4855742239,1,10,2,0,7,5,4,0,0,0,0,16034,6.8,17526,207,42,575,-297,24.9,1603.4,15,0,1,5,7,1,1,0,1,0,15459,7.0,17823,201,62,-575,297,26.3,1545.9
4853567150,1,12,1,0,8,5,7,0,0,0,0,17695,7.2,18425,233,36,2077,1385,26.9,1769.5,14,3,1,5,8,6,2,1,1,0,15618,6.6,17040,188,60,-2077,-1385,24.8,1561.8
4853534064,1,12,1,0,6,6,6,0,0,0,0,16137,6.6,17135,199,56,-28,-1927,25.5,1613.7,10,1,1,5,5,1,1,1,0,0,16165,7.0,19062,199,72,28,1927,27.1,1616.5
4853507072,0,14,0,1,4,6,3,0,0,0,0,17826,7.0,18712,261,56,444,-472,31.7,1782.6,11,2,0,6,4,9,1,1,0,0,17382,7.0,19184,228,52,-444,472,28.0,1738.2
4853360252,0,16,1,0,2,6,1,0,0,0,0,15671,6.8,18194,210,64,-1709,-621,27.4,1567.1,20,1,1,6,2,4,1,1,0,0,17380,7.2,18815,194,56,1709,621,25.0,1738.0
4853340172,1,16,1,1,5,4,6,0,0,0,0,15741,6.8,17315,209,64,635,-336,27.3,1574.1,16,2,0,4,5,4,0,0,0,0,15106,6.8,17651,211,44,-635,336,25.5,1510.6
4853320355,0,54,4,1,4,6,4,0,0,0,0,16421,6.8,16977,184,52,-395,-199,23.6,1642.1,15,4,0,6,4,5,1,1,0,0,16816,6.8,17176,214,48,395,199,26.2,1681.6
4853314767,1,12,1,0,8,6,6,1,1,0,0,17003,7.0,17744,229,48,-966,-1159,27.7,1700.3,18,0,1,6,8,3,1,0,1,0,17969,7.0,18903,227,56,966,1159,28.3,1796.9
4853290340,0,11,1,0,8,6,3,1,0,1,0,16643,7.4,19166,204,68,-444,492,27.2,1664.3,15,0,1,5,7,4,1,1,0,0,17087,7.0,18674,206,72,444,-492,27.8,1708.7
4855806506,0,12,0,0,0,2,0,1,1,0,0,15019,6.8,17540,221,62,-568,-1543,28.3,1501.9,13,0,1,2,0,2,0,0,0,0,15587,7.0,19083,223,68,568,1543,29.1,1558.7
4855498262,0,12,1,0,4,10,2,0,0,0,0,17538,6.8,16985,201,52,68,546,25.3,1753.8,8,0,1,10,4,13,1,1,0,0,17470,6.6,16439,191,48,-68,-546,23.9,1747.0
4855472557,0,15,2,0,2,6,2,0,0,0,0,15049,6.8,16963,204,44,-1454,-987,24.8,1504.9,20,1,1,6,2,7,1,1,0,0,16503,7.0,17950,194,63,1454,987,25.7,1650.3
4855454066,0,11,2,1,9,6,6,0,0,0,0,18206,7.2,18802,218,60,1830,306,27.8,1820.6,13,0,0,6,9,3,1,1,0,0,16376,7.0,18496,199,52,-1830,-306,25.1,1637.6
4855419024,0,14,1,0,2,2,3,1,1,0,0,14821,7.0,18432,206,60,-1065,-937,26.6,1482.1,13,1,1,2,2,1,1,0,1,0,15886,7.0,19369,226,68,1065,937,29.4,1588.6
4855373702,0,15,2,1,9,7,7,0,0,0,0,17811,7.0,18074,216,42,181,-516,25.8,1781.1,10,1,0,7,9,5,0,0,0,0,17630,6.8,18590,225,44,-181,516,26.9,1763.0
4855346032,1,9,4,1,14,6,8,0,0,0,0,21277,7.2,18925,221,44,5570,3324,26.5,2127.7,15,0,0,6,14,6,0,0,0,0,15707,6.4,15601,184,44,-5570,-3324,22.8,1570.7
4855288293,0,19,11,1,9,5,9,0,0,0,0,20511,7.2,20180,218,69,5080,3047,28.7,2051.1,35,2,0,5,9,4,0,0,0,0,15431,6.8,17133,193,34,-5080,-3047,22.7,1543.1
4855236837,1,38,2,0,8,7,7,1,1,0,0,16947,7.4,19468,220,64,-1102,273,28.4,1694.7,18,19,1,7,8,7,0,0,0,0,18049,7.0,19195,211,52,1102,-273,26.3,1804.9
4855175666,0,19,1,0,7,5,6,0,0,0,0,16464,6.6,17649,191,58,583,802,24.9,1646.4,15,3,1,5,7,3,1,1,0,0,15881,6.6,16847,204,44,-583,-802,24.8,1588.1
4855151108,1,0,0,1,31,16,73,0,0,0,2,38661,11.2,41593,114,0,4785,3655,11.4,3866.1,0,0,0,14,29,25,0,0,0,0,33876,10.8,37938,77,0,-4785,-3655,7.7,3387.6
4855117874,0,4,0,0,20,28,47,0,0,0,2,33982,10.4,36288,89,0,-7393,-9470,8.9,3398.2,0,0,1,26,18,77,0,0,0,0,41375,12.0,45758,109,0,7393,9470,10.9,4137.5
4855085023,0,0,0,0,26,29,55,0,0,0,2,38245,11.2,40183,97,0,-2029,-4061,9.7,3824.5,0,0,1,29,26,77,0,0,0,0,40274,11.4,44244,96,0,2029,4061,9.6,4027.4
4854978502,1,0,0,0,16,21,9,0,0,0,0,45600,10.0,47500,0,0,17400,17820,0.0,4560.0,0,0,1,10,5,15,0,0,0,0,28200,6.2,29680,0,0,-17400,-17820,0.0,2820.0
4854951386,1,17,3,0,14,16,19,0,0,0,0,59495,12.0,55000,4,0,24425,22000,0.4,5949.5,33,0,1,14,12,6,0,0,0,0,35070,7.2,33000,0,0,-24425,-22000,0.0,3507.0
4854923485,1,0,0,1,17,18,22,0,0,0,0,48050,12.8,59000,0,0,19500,26000,0.0,4805.0,0,0,0,13,12,8,0,0,0,0,28550,7.2,33000,0,0,-19500,-26000,0.0,2855.0
4854906646,1,115,0,1,14,14,14,0,0,0,0,60710,12.0,55000,0,0,23489,22000,0.0,6071.0,31,0,0,10,10,9,0,0,0,0,37221,7.2,33000,0,0,-23489,-22000,0.0,3722.1
4854885627,1,0,0,1,14,15,19,0,0,0,0,45250,10.0,47500,0,0,14600,19000,0.0,4525.0,0,0,0,11,10,8,0,0,0,0,30650,6.0,28500,0,0,-14600,-19000,0.0,3065.0
4854878766,1,0,0,1,15,14,18,0,0,0,0,61467,12.0,55000,0,0,24247,22000,0.0,6146.7,0,0,0,11,12,9,0,0,0,0,37220,7.2,33000,0,0,-24247,-22000,0.0,3722.0
4792084172,1,8,0,1,7,6,3,0,0,0,0,16869,6.6,16685,164,56,-1310,-1247,22.0,1686.9,8,0,0,6,7,7,0,0,0,0,18179,6.6,17932,224,44,1310,1247,26.8,1817.9
4791980240,1,13,2,0,4,5,7,0,0,0,0,16230,6.6,17256,209,52,-1395,-486,26.1,1623.0,15,1,1,5,4,3,1,0,1,0,17625,7.0,17742,210,52,1395,486,26.2,1762.5
4791254047,0,15,2,0,7,6,7,0,0,0,0,18005,6.8,17460,216,50,1142,1620,26.6,1800.5,13,3,1,6,7,9,0,0,0,0,16863,6.4,15840,181,40,-1142,-1620,22.1,1686.3
4790662936,0,1,0,1,18,32,43,0,0,0,1,35188,10.8,38568,104,0,-3266,-5157,10.4,3518.8,6,0,0,32,18,89,0,0,0,0,38454,11.6,43725,102,0,3266,5157,10.2,3845.4
4790582828,1,31,0,1,4,2,3,0,0,0,0,15451,6.8,18431,192,68,1414,325,26.0,1545.1,12,16,0,2,4,0,0,0,0,0,14037,7.0,18106,178,60,-1414,-325,23.8,1403.7
4790553381,0,32,0,1,4,7,3,0,0,0,0,14835,6.8,17504,179,44,-1418,-1334,22.3,1483.5,7,9,0,7,4,3,0,0,0,0,16253,7.2,18838,178,64,1418,1334,24.2,1625.3
4790534902,1,0,0,1,30,39,67,0,0,0,1,39271,11.8,43579,88,0,-3017,-3852,8.8,3927.1,0,0,0,39,30,105,0,0,0,0,42288,12.0,47431,92,0,3017,3852,9.2,4228.8
4790466124,0,33,0,1,6,7,5,1,0,1,0,17814,7.2,17691,205,63,325,-1030,26.8,1781.4,141,1,0,7,6,5,0,0,0,0,17489,6.8,18721,212,43,-325,1030,25.5,1748.9
4786947667,0,21,0,0,21,25,47,0,0,0,1,37755,11.0,40509,105,0,1626,1009,10.5,3775.5,0,33,1,24,20,60,0,0,0,0,36129,11.0,39500,95,0,-1626,-1009,9.5,3612.9
4786898522,0,12,0,1,3,2,2,1,1,0,0,14289,6.6,17540,204,58,-1158,43,26.2,1428.9,11,0,0,2,3,0,0,0,0,0,15447,6.8,17497,214,62,1158,-43,27.6,1544.7
4786867331,1,17,2,0,2,3,1,0,0,0,0,15271,6.8,17525,210,51,112,-486,26.1,1527.1,7,3,1,3,2,2,0,0,0,0,15159,7.0,18011,226,54,-112,486,28.0,1515.9
4786836233,1,19,0,1,8,3,4,0,0,0,0,18124,7.4,19839,219,62,3344,2287,28.1,1812.4,12,0,0,3,8,5,0,0,0,0,14780,7.0,17552,197,42,-3344,-2287,23.9,1478.0
4786797397,1,7,2,1,8,4,6,0,0,0,0,17357,6.8,17763,190,52,2076,571,24.2,1735.7,12,2,0,4,8,2,0,0,0,0,15281,6.6,17192,196,52,-2076,-571,24.8,1528.1
4785633643,1,11,1,0,4,2,4,0,0,0,0,16624,7.0,17855,220,43,1572,726,26.3,1662.4,12,1,1,2,4,2,0,0,0,0,15052,6.6,17129,209,51,-1572,-726,26.0,1505.2
4784314812,0,14,0,0,0,12,0,1,1,0,0,12789,6.2,15311,153,67,-6978,-3794,22.0,1278.9,14,2,1,12,0,11,0,0,0,0,19767,7.2,19105,227,61,6978,3794,28.8,1976.7
4784182496,0,180,0,1,14,6,35,0,0,0,0,34495,10.6,36523,124,0,3427,3942,12.4,3449.5,12,0,0,6,14,14,0,0,0,0,31068,9.8,32581,101,0,-3427,-3942,10.1,3106.8
4784142597,0,2,0,0,20,33,54,0,0,0,0,36837,10.8,37765,97,0,-4505,-7559,9.7,3683.7,0,0,1,33,20,109,0,0,0,0,41342,12.0,45324,113,0,4505,7559,11.3,4134.2
4784122646,0,17,15,0,2,5,3,0,0,0,0,14986,7.0,18047,202,55,-2669,-1312,25.7,1498.6,42,2,1,5,2,3,0,0,0,0,17655,7.0,19359,242,56,2669,1312,29.8,1765.5
4784093630,1,16,2,0,8,7,4,0,0,0,0,18214,7.2,18858,211,60,546,1509,27.1,1821.4,26,3,1,7,8,9,0,0,0,0,17668,6.8,17349,226,52,-546,-1509,27.8,1766.8
4783475572,1,13,0,1,4,2,6,1,1,0,0,15473,6.6,16491,186,55,1176,-883,24.1,1547.3,13,2,0,2,4,4,0,0,0,0,14297,6.8,17374,218,48,-1176,883,26.6,1429.7
4858377316,0,76,1,1,6,3,6,0,0,0,0,16070,6.6,17149,193,52,918,188,24.5,1607.0,12,4,0,3,6,5,0,0,0,0,15152,6.8,16961,193,48,-918,-188,24.1,1515.2
4858022064,1,100,1,0,7,7,3,1,1,0,0,16671,7.0,18494,223,52,884,814,27.5,1667.1,12,3,1,7,7,3,0,0,0,0,15787,6.6,17680,190,52,-884,-814,24.2,1578.7
4858003862,1,25,5,0,4,4,8,1,1,0,0,17629,7.2,18790,217,68,783,146,28.5,1762.9,77,4,1,4,4,2,0,0,0,0,16846,6.8,18644,235,60,-783,-146,29.5,1684.6
4857975396,0,77,1,0,5,2,5,0,0,0,0,15759,7.0,17531,197,64,1394,830,26.1,1575.9,10,0,1,2,5,1,0,0,0,0,14365,6.6,16701,193,44,-1394,-830,23.7,1436.5
4857563756,0,10,1,0,4,10,1,0,0,0,0,14971,6.8,17458,183,71,-3761,-885,25.4,1497.1,79,0,1,10,4,10,0,0,0,0,18732,7.0,18343,220,52,3761,885,27.2,1873.2
4857508883,0,21,4,1,7,7,13,2,1,1,0,17775,7.0,18600,246,68,-823,383,31.4,1777.5,79,3,0,7,7,9,0,0,0,0,18598,7.0,18217,202,64,823,-383,26.6,1859.8
4857477923,1,14,2,1,7,5,6,0,0,0,0,16142,6.8,17780,192,51,63,464,24.3,1614.2,86,0,0,5,7,3,1,1,0,0,16079,7.0,17316,219,44,-63,-464,26.3,1607.9
4854021459,1,11,3,1,5,1,5,0,0,0,0,17214,7.0,18264,200,43,3304,1137,24.3,1721.4,77,2,0,1,5,1,0,0,0,0,13910,6.8,17127,191,56,-3304,-1137,24.7,1391.0
4853946720,1,79,1,1,6,4,5,1,1,0,0,17483,7.0,18241,197,43,1790,731,24.0,1748.3,9,2,0,3,5,2,0,0,0,0,15693,6.6,17510,217,48,-1790,-731,26.5,1569.3
4853876690,0,77,2,0,2,3,2,0,0,0,0,15198,7.0,18454,227,65,577,1132,29.2,1519.8,15,1,1,3,2,2,1,1,0,0,14621,7.0,17322,199,50,-577,-1132,24.9,1462.1
4853640940,1,16,5,1,10,3,5,1,1,0,0,18425,7.0,19272,230,56,4090,4401,28.6,1842.5,72,2,0,3,10,4,0,0,0,0,14335,6.2,14871,167,48,-4090,-4401,21.5,1433.5
4853611918,0,10,4,1,5,5,5,0,0,0,0,16724,7.2,18802,224,64,307,197,28.8,1672.4,71,0,0,5,5,2,1,1,0,0,16417,7.0,18605,213,48,-307,-197,26.1,1641.7
4853564358,1,15,4,1,6,4,6,0,0,0,0,17752,6.8,17855,194,44,461,-490,23.8,1775.2,272,2,0,4,6,4,1,1,0,0,17291,7.0,18345,218,52,-461,490,27.0,1729.1
4853518952,0,9,0,1,7,4,3,0,0,0,0,17458,7.0,18828,207,60,1216,434,26.7,1745.8,84,0,0,4,7,4,1,1,0,0,16242,7.0,18394,213,64,-1216,-434,27.7,1624.2
4853460471,1,103,0,1,6,2,7,0,0,0,0,16720,6.6,17836,219,56,1734,438,27.5,1672.0,11,15,0,2,6,2,0,0,0,0,14986,6.6,17398,205,40,-1734,-438,24.5,1498.6
4851900817,1,76,16,0,5,4,5,0,0,0,0,15900,6.8,18080,202,64,-447,-585,26.6,1590.0,34,1,1,4,5,3,0,0,0,0,16347,7.2,18665,253,56,447,585,30.9,1634.7
4850456794,1,73,1,1,5,6,2,0,0,0,0,16204,6.6,17284,205,56,-411,-757,26.1,1620.4,13,0,0,6,5,4,0,0,0,0,16615,6.8,18041,212,60,411,757,27.2,1661.5
4849672478,0,14,0,0,1,4,1,1,1,0,0,14629,6.8,17542,187,56,-397,-65,24.3,1462.9,89,1,1,4,1,3,0,0,0,0,15026,6.8,17607,186,56,397,65,24.2,1502.6
4848806862,0,11,1,0,3,4,3,0,0,0,0,12829,6.8,16819,127,48,-2213,-703,17.5,1282.9,529,0,1,4,3,2,0,0,0,0,15042,6.8,17522,178,48,2213,703,22.6,1504.2
4848762520,0,244,1,0,2,4,1,1,1,0,0,13713,6.6,17354,174,39,-774,257,21.3,1371.3,13,1,1,4,2,2,0,0,0,0,14487,6.6,17097,180,56,774,-257,23.6,1448.7
4857147938,1,92,0,1,22,19,14,0,0,0,0,62770,12.0,55000,0,0,25522,22000,0.0,6277.0,0,0,0,8,11,13,0,0,0,0,37248,7.2,33000,0,0,-25522,-22000,0.0,3724.8
4857108584,1,0,0,1,14,12,12,0,0,0,0,45314,10.0,47500,0,0,18164,19000,0.0,4531.4,0,0,0,6,8,9,0,0,0,0,27150,6.0,28500,0,0,-18164,-19000,0.0,2715.0
4857093766,1,0,0,1,25,14,21,0,0,0,0,63750,12.0,55000,0,0,26900,21000,0.0,6375.0,0,0,0,7,18,8,0,0,0,0,36850,7.4,34000,0,0,-26900,-21000,0.0,3685.0
4857067219,1,232,0,1,18,10,18,0,0,0,0,45984,10.0,47500,0,0,20212,19000,0.0,4598.4,0,0,0,4,12,5,0,0,0,0,25772,6.0,28500,0,0,-20212,-19000,0.0,2577.2
4857044606,1,30,0,1,13,18,12,0,0,0,0,47000,10.0,47500,0,0,18732,19000,0.0,4700.0,0,2,0,10,5,11,0,0,0,0,28268,6.0,28500,2,0,-18732,-19000,0.2,2826.8
4857032802,1,184,0,0,16,12,18,0,0,0,0,48068,10.0,47500,0,0,19518,18000,0.0,4806.8,176,0,1,7,11,4,0,0,0,0,28550,6.2,29500,0,0,-19518,-18000,0.0,2855.0
4857010608,1,234,0,1,17,14,13,0,0,0,0,62170,12.0,55000,3,0,34736,22000,0.3,6217.0,22,0,0,7,10,10,0,0,0,0,27434,7.2,33000,4,0,-34736,-22000,0.4,2743.4
4856999459,1,4,0,1,17,15,17,0,0,0,0,61895,12.0,55000,3,0,25010,22000,0.3,6189.5,0,0,0,7,9,9,0,0,0,0,36885,7.2,33000,1,0,-25010,-22000,0.1,3688.5
4856985134,1,5,0,1,20,16,19,0,0,0,0,62750,12.8,61000,6,0,24150,25000,0.6,6275.0,0,0,0,10,14,9,0,0,0,0,38600,7.6,36000,6,0,-24150,-25000,0.6,3860.0
4856969705,1,4,6,1,20,18,19,0,0,0,0,64165,12.0,55000,2,0,26105,18000,0.2,6416.5,30,2,0,10,12,9,0,0,0,0,38060,8.0,37000,6,0,-26105,-18000,0.6,3806.0
4856954474,1,0,0,0,29,15,21,0,0,0,0,63130,12.0,55000,0,0,25580,22000,0.0,6313.0,8,0,1,5,19,11,0,0,0,0,37550,7.2,33000,0,0,-25580,-22000,0.0,3755.0
4856828240,0,0,2,1,31,26,88,0,0,0,0,38480,11.6,43423,90,0,1056,1795,9.0,3848.0,3,0,0,25,30,63,0,0,0,0,37424,11.4,41628,100,0,-1056,-1795,10.0,3742.4
4856813291,0,0,0,1,28,29,77,0,0,0,0,38538,11.6,43996,128,0,1135,1731,12.8,3853.8,0,0,0,29,28,59,0,0,0,0,37403,11.4,42265,117,0,-1135,-1731,11.7,3740.3
4856802911,0,0,0,1,15,18,43,0,0,0,1,34799,10.6,36440,113,0,270,-1989,11.3,3479.9,2,0,0,18,15,34,0,0,0,0,34529,10.8,38429,92,0,-270,1989,9.2,3452.9
4856783623,1,31,0,1,25,23,66,0,0,0,1,38718,11.2,41586,109,0,607,2295,10.9,3871.8,0,24,0,23,25,62,0,0,0,0,38111,11.0,39291,100,0,-607,-2295,10.0,3811.1
4856771691,1,0,0,1,22,16,56,0,0,0,0,36838,11.2,41992,111,0,1776,4797,11.1,3683.8,12,0,0,16,22,34,0,0,0,0,35062,10.8,37195,97,0,-1776,-4797,9.7,3506.2
4856763406,1,35,3,1,18,23,55,0,0,0,0,34684,10.8,36617,114,0,-1486,-3277,11.4,3468.4,21,0,0,23,18,66,0,0,0,0,36170,11.0,39894,96,0,1486,3277,9.6,3617.0
4856750719,1,0,0,0,21,17,60,0,0,0,1,37221,11.0,39782,93,0,373,1108,9.3,3722.1,9,0,1,17,21,38,0,0,0,0,36848,10.8,38674,107,0,-373,-1108,10.7,3684.8
4855048158,1,0,0,0,17,14,45,0,0,0,1,35881,10.8,37868,104,0,1665,1928,10.4,3588.1,0,0,1,14,17,26,0,0,0,0,34216,10.2,35940,108,0,-1665,-1928,10.8,3421.6
4855022917,0,0,0,0,13,17,32,0,0,0,0,33154,10.2,35496,101,0,-3568,-4707,10.1,3315.4,0,0,1,17,13,56,0,0,0,0,36722,10.8,40203,115,0,3568,4707,11.5,3672.2
4857362539,0,15,1,1,10,9,15,1,1,0,0,18894,6.8,17589,237,43,1529,341,28.0,1889.4,14,1,0,9,10,13,0,0,0,0,17365,6.8,17248,207,52,-1529,-341,25.9,1736.5
4856060129,0,17,1,1,9,6,7,0,0,0,0,18216,7.2,18129,223,55,2033,-325,27.8,1821.6,12,1,0,5,8,0,1,1,0,0,16183,6.8,18454,223,64,-2033,325,28.7,1618.3
4853902772,0,53,1,0,2,8,2,0,0,0,0,15484,6.8,17009,200,52,-3235,-1962,25.2,1548.4,13,0,1,8,2,9,1,0,1,0,18719,7.2,18971,217,60,3235,1962,27.7,1871.9
4851813483,1,72,1,0,8,8,5,1,0,1,0,18022,7.2,18524,211,58,1360,1465,26.9,1802.2,10,0,1,8,8,5,1,1,0,0,16662,6.8,17059,184,44,-1360,-1465,22.8,1666.2
4850702535,0,14,1,0,8,4,9,0,0,0,0,16523,7.0,17903,172,52,200,-25,22.4,1652.3,14,1,1,4,8,6,0,0,0,0,16323,6.8,17928,228,72,-200,25,30.0,1632.3
4848532508,0,11,1,1,5,4,7,0,0,0,0,16564,6.8,17511,191,52,196,254,24.3,1656.4,12,0,0,4,5,3,1,1,0,0,16368,6.8,17257,189,44,-196,-254,23.3,1636.8
4841075986,1,20,0,1,6,6,6,0,0,0,0,17025,6.8,17182,210,60,438,-1433,27.0,1702.5,12,1,0,6,6,3,1,1,0,0,16587,7.0,18615,225,40,-438,1433,26.5,1658.7
4835935636,1,13,0,1,7,4,7,1,1,0,0,16575,7.2,18722,205,76,1258,-151,28.1,1657.5,14,0,0,3,6,2,0,0,0,0,15317,7.4,18873,182,59,-1258,151,24.1,1531.7
4835853304,0,16,1,0,4,3,5,1,1,0,0,15624,6.8,16508,197,54,-955,-2461,25.1,1562.4,9,0,1,3,4,1,0,0,0,0,16579,7.0,18969,214,62,955,2461,27.6,1657.9
4835251050,1,15,4,1,6,1,8,0,0,0,0,17910,7.2,18582,251,62,4443,1496,31.3,1791.0,10,1,0,1,6,0,1,1,0,0,13467,6.8,17086,203,48,-4443,-1496,25.1,1346.7
4835215889,1,14,1,1,7,6,14,0,0,0,0,18166,7.0,17400,206,57,885,47,26.3,1816.6,9,2,0,6,7,5,1,1,0,0,17281,6.8,17353,221,48,-885,-47,26.9,1728.1
4835104757,1,13,2,1,7,3,5,0,0,0,0,18030,6.8,19131,256,55,3920,2571,31.1,1803.0,13,1,0,3,7,1,0,0,0,0,14110,6.6,16560,174,56,-3920,-2571,23.0,1411.0
4833933919,0,17,0,0,5,10,9,1,1,0,0,15741,6.2,15344,153,51,-4458,-4149,20.4,1574.1,242,3,1,10,5,10,0,0,0,0,20199,7.2,19493,212,48,4458,4149,26.0,2019.9
4832064102,0,15,2,0,1,6,0,0,0,0,0,15030,7.0,18027,217,67,-1775,-766,28.4,1503.0,15,2,1,6,1,3,1,1,0,0,16805,7.0,18793,208,52,1775,766,26.0,1680.5
4831989830,1,11,1,0,10,8,12,0,0,0,0,18910,6.6,17196,193,48,1364,-542,24.1,1891.0,19,2,1,8,10,3,0,0,0,0,17546,7.0,17738,182,51,-1364,542,23.3,1754.6
4830343857,1,12,2,1,5,2,4,0,0,0,0,15547,6.6,16891,202,50,739,-826,25.2,1554.7,13,3,0,2,5,1,1,1,0,0,14808,7.0,17717,211,64,-739,826,27.5,1480.8
4830181408,0,10,0,1,5,2,5,1,1,0,0,16187,7.0,19070,234,68,1297,319,30.2,1618.7,12,0,0,2,5,3,0,0,0,0,14890,7.2,18751,223,67,-1297,-319,29.0,1489.0
4827802171,0,11,0,1,3,2,1,0,0,0,0,14706,6.8,17415,207,36,-368,-844,24.3,1470.6,15,1,0,2,3,1,0,0,0,0,15074,6.8,18259,219,51,368,844,27.0,1507.4
4827645284,0,14,0,1,8,8,9,1,1,0,0,17000,6.8,17563,189,56,281,-230,24.5,1700.0,13,0,0,7,7,3,0,0,0,0,16719,6.6,17793,222,48,-281,230,27.0,1671.9
4827478684,0,189,1,0,3,8,2,0,0,0,0,15284,6.6,17511,212,50,-2813,-947,26.2,1528.4,15,3,1,8,3,6,1,1,0,0,18097,7.0,18458,199,64,2813,947,26.3,1809.7
4857477759,1,0,0,1,19,17,22,0,0,0,0,46650,10.0,47500,4,0,19500,17500,0.4,4665.0,0,0,0,9,11,6,0,0,0,0,27150,6.4,30000,0,0,-19500,-17500,0.0,2715.0
4857451960,1,11,0,1,14,19,12,0,0,0,0,46000,10.0,47500,3,0,16650,19000,0.3,4600.0,0,0,0,12,7,14,0,0,0,0,29350,6.0,28500,5,0,-16650,-19000,0.5,2935.0
4857422142,1,5,0,1,12,23,16,0,0,0,0,44976,10.0,47500,0,0,16728,19000,0.0,4497.6,0,0,0,15,4,13,0,0,0,0,28248,6.0,28500,0,0,-16728,-19000,0.0,2824.8
4857396474,1,0,6,1,18,17,15,0,0,0,0,62030,12.0,55000,0,0,23980,22000,0.0,6203.0,35,0,0,9,10,11,0,0,0,0,38050,7.2,33000,6,0,-23980,-22000,0.6,3805.0
4857376106,1,0,0,1,21,14,18,0,0,0,0,48050,12.0,55000,0,0,21600,22000,0.0,4805.0,0,0,0,6,13,8,0,0,0,0,26450,7.2,33000,0,0,-21600,-22000,0.0,2645.0
4857341600,1,51,0,1,13,15,14,0,0,0,0,45950,10.0,47500,0,0,18800,19000,0.0,4595.0,5,0,0,10,8,8,0,0,0,0,27150,6.0,28500,0,0,-18800,-19000,0.0,2715.0
4857318591,1,0,0,1,20,23,13,0,0,0,0,46752,10.0,47500,0,0,18877,19000,0.0,4675.2,0,0,0,11,8,15,0,0,0,0,27875,6.0,28500,1,0,-18877,-19000,0.1,2787.5
4856992210,1,13,2,1,8,7,5,0,0,0,0,17463,6.8,18011,212,52,498,204,26.4,1746.3,13,1,0,7,8,4,0,0,0,0,16965,6.8,17807,202,68,-498,-204,27.0,1696.5
4856159793,1,11,1,0,7,4,3,0,0,0,0,17354,6.8,17538,193,48,1478,-62,24.1,1735.4,9,0,1,4,7,1,1,1,0,0,15876,6.8,17600,188,60,-1478,62,24.8,1587.6
4855437103,1,41,0,1,19,17,20,0,0,0,0,46398,10.0,47500,0,0,13195,19000,0.0,4639.8,0,2,0,10,12,9,0,0,0,0,33203,6.0,28500,3,0,-13195,-19000,0.3,3320.3
4855422816,1,0,0,1,14,20,20,0,0,0,0,46770,10.0,47500,2,0,18155,17820,0.2,4677.0,0,0,0,13,7,9,0,0,0,0,28615,6.2,29680,1,0,-18155,-17820,0.1,2861.5
4855396223,1,18,0,1,22,16,27,0,0,0,0,47465,10.0,47500,2,0,19264,19000,0.2,4746.5,0,0,0,9,15,8,0,0,0,0,28201,6.0,28500,1,0,-19264,-19000,0.1,2820.1
4855378188,1,0,0,1,13,21,13,0,0,0,0,61650,12.0,55000,0,0,22700,22000,0.0,6165.0,0,0,0,15,7,14,0,0,0,0,38950,7.2,33000,0,0,-22700,-22000,0.0,3895.0
4855358222,1,0,0,0,9,21,12,0,0,0,0,60600,12.0,55000,0,0,22700,22000,0.0,6060.0,0,0,1,16,4,11,0,0,0,0,37900,7.2,33000,0,0,-22700,-22000,0.0,3790.0
4855336210,1,0,0,0,20,15,17,0,0,0,0,50901,10.0,47500,0,0,23718,19000,0.0,5090.1,0,0,1,9,14,11,0,0,0,0,27183,6.0,28500,0,0,-23718,-19000,0.0,2718.3
4855308241,1,0,0,1,15,14,15,0,0,0,0,46440,10.0,47500,0,0,19615,19000,0.0,4644.0,1,0,0,9,10,5,0,0,0,0,26825,6.0,28500,1,0,-19615,-19000,0.1,2682.5
4855287140,1,25,1,1,25,12,21,0,0,0,0,49217,10.2,48680,9,0,23467,20180,0.9,4921.7,0,0,0,4,17,5,0,0,0,0,25750,6.0,28500,0,0,-23467,-20180,0.0,2575.0
4855260243,1,25,0,1,20,15,18,0,0,0,0,47000,10.6,50500,0,0,18800,20820,0.0,4700.0,4,0,0,8,13,11,0,0,0,0,28200,6.2,29680,0,0,-18800,-20820,0.0,2820.0
4855234001,1,0,0,0,18,14,19,0,0,0,0,46300,10.0,47500,4,0,18800,19000,0.4,4630.0,0,0,1,7,11,7,0,0,0,0,27500,6.0,28500,4,0,-18800,-19000,0.4,2750.0
4855205966,1,1,0,1,19,18,23,0,0,0,0,47700,10.0,47500,0,0,20200,19000,0.0,4770.0,0,0,0,9,10,6,0,0,0,0,27500,6.0,28500,0,0,-20200,-19000,0.0,2750.0
4858270920,0,14,1,1,4,5,2,0,0,0,0,16214,7.0,17942,190,64,1451,1354,25.4,1621.4,13,0,0,4,3,4,1,1,0,0,14763,6.6,16588,178,52,-1451,-1354,23.0,1476.3
4858239056,1,12,0,1,9,4,2,0,0,0,0,16158,7.2,18605,214,48,1838,2144,26.2,1615.8,9,1,0,4,9,1,1,1,0,0,14320,6.6,16461,152,63,-1838,-2144,21.5,1432.0
4858195882,0,27,0,0,5,6,4,0,0,0,0,15677,7.0,17500,198,43,-944,-24,24.1,1567.7,4,0,1,6,5,8,0,0,0,0,16621,6.8,17524,212,56,944,24,26.8,1662.1
4858044675,0,10,2,1,2,3,2,0,0,0,0,15147,7.0,16928,206,44,-746,-1068,25.0,1514.7,17,0,0,3,2,4,1,1,0,0,15893,6.8,17996,200,64,746,1068,26.4,1589.3
4857361840,1,21,5,0,5,2,6,0,0,0,0,17831,6.6,17124,218,51,2592,-692,26.9,1783.1,15,1,1,2,5,1,0,0,0,0,15239,6.8,17816,180,52,-2592,692,23.2,1523.9
4857317847,0,80,1,0,4,1,3,0,0,0,0,15844,6.8,17872,194,52,1839,131,24.6,1584.4,17,1,1,1,4,3,0,0,0,0,14005,6.8,17741,200,64,-1839,-131,26.4,1400.5
4857272141,1,13,0,0,5,4,4,0,0,0,0,16532,7.6,19826,210,64,886,2204,27.4,1653.2,16,0,1,4,5,2,0,0,0,0,15646,7.0,17622,219,56,-886,-2204,27.5,1564.6
4856961656,0,16,0,1,7,6,3,0,0,0,0,16035,6.6,17039,187,56,1156,468,24.3,1603.5,11,1,0,5,6,5,0,0,0,0,14879,6.6,16571,159,48,-1156,-468,20.7,1487.9
4856923259,0,68,3,0,2,5,2,0,0,0,0,13436,6.4,16234,156,64,-2587,-1406,22.0,1343.6,9,2,1,5,2,3,0,0,0,0,16023,6.8,17640,205,51,2587,1406,25.6,1602.3
4856498250,1,14,2,1,7,5,6,1,1,0,0,18174,7.4,20007,250,60,3079,4141,31.0,1817.4,12,2,0,5,7,3,0,0,0,0,15095,6.2,15866,190,40,-3079,-4141,23.0,1509.5
4856402582,0,11,2,0,4,8,3,0,0,0,0,14997,6.6,16893,176,48,-1833,-1377,22.4,1499.7,11,0,1,8,4,2,1,1,0,0,16830,7.0,18270,216,60,1833,1377,27.6,1683.0
4856348451,1,13,2,0,1,4,0,0,0,0,0,14240,7.0,17948,219,52,-1956,100,27.1,1424.0,46,2,1,4,1,5,0,0,0,0,16196,6.8,17848,210,53,1956,-100,26.3,1619.6
4856294527,1,10,2,0,8,10,4,0,0,0,0,16499,6.8,17633,182,52,-2078,103,23.4,1649.9,17,1,1,10,8,13,1,1,0,0,18577,6.8,17530,203,44,2078,-103,24.7,1857.7
4856246404,0,54,2,1,7,8,13,0,0,0,0,16699,6.8,17554,173,52,-479,-995,22.5,1669.9,11,3,0,8,7,6,1,1,0,0,17178,7.2,18549,230,64,479,995,29.4,1717.8
4855470958,1,19,2,1,7,5,5,0,0,0,0,17502,7.0,17569,177,44,1334,-967,22.1,1750.2,10,1,0,5,7,3,1,1,0,0,16168,7.0,18536,230,48,-1334,967,27.8,1616.8
4855436195,0,69,4,1,2,2,2,0,0,0,0,16124,7.2,18381,191,55,667,404,24.6,1612.4,13,2,0,2,2,1,0,0,0,0,15457,7.2,17977,205,52,-667,-404,25.7,1545.7
4855393728,0,12,0,0,7,10,3,1,1,0,0,17530,7.2,18356,182,68,52,473,25.0,1753.0,12,1,1,9,6,6,0,0,0,0,17478,6.8,17883,171,64,-52,-473,23.5,1747.8
4855357927,1,13,2,1,7,4,5,1,0,1,0,18667,7.4,20185,232,67,3573,3206,29.9,1866.7,13,0,0,4,7,1,1,1,0,0,15094,6.6,16979,162,52,-3573,-3206,21.4,1509.4
4855208020,0,13,1,0,9,8,6,0,0,0,0,16418,6.8,16982,188,31,140,-451,21.9,1641.8,14,1,1,8,9,3,0,0,0,0,16278,6.8,17433,169,68,-140,451,23.7,1627.8
4858293479,1,0,3,1,33,23,81,0,0,0,1,42178,12.0,46840,126,0,4842,7067,12.6,4217.8,17,0,0,23,33,54,0,0,0,0,37336,10.8,39773,82,0,-4842,-7067,8.2,3733.6
4858274786,1,0,0,0,20,20,15,0,0,0,0,46650,10.0,47500,0,0,17400,19000,0.0,4665.0,0,0,1,12,12,13,0,0,0,0,29250,6.0,28500,0,0,-17400,-19000,0.0,2925.0
4858247956,1,0,0,0,14,15,17,0,0,0,0,48239,10.0,47500,0,0,19659,19000,0.0,4823.9,0,0,1,10,9,7,0,0,0,0,28580,6.0,28500,0,0,-19659,-19000,0.0,2858.0
4858224837,1,198,0,1,18,10,17,0,0,0,0,48486,10.0,47500,1,0,22358,19000,0.1,4848.6,2,0,0,4,12,4,0,0,0,0,26128,6.0,28500,0,0,-22358,-19000,0.0,2612.8
4856147841,1,0,0,1,27,30,71,0,0,0,1,38944,11.2,42497,88,0,-2054,-584,8.8,3894.4,0,0,0,30,27,84,0,0,0,0,40998,11.8,43081,95,0,2054,584,9.5,4099.8
4856114110,1,0,0,0,18,20,47,0,0,0,0,34505,10.6,38259,115,0,-2865,-177,11.5,3450.5,0,0,1,20,18,49,0,0,0,0,37370,10.8,38436,120,0,2865,177,12.0,3737.0
4856079663,0,0,0,0,21,26,67,0,0,0,0,36195,10.8,38441,95,0,-2903,-3677,9.5,3619.5,0,0,1,26,21,70,0,0,0,0,39098,11.6,42118,123,0,2903,3677,12.3,3909.8
4856042613,1,5,0,0,18,12,18,0,0,0,0,60950,12.4,57000,0,0,25500,24000,0.0,6095.0,0,0,1,5,11,7,0,0,0,0,35450,7.2,33000,0,0,-25500,-24000,0.0,3545.0
4856019980,1,22,0,1,20,12,20,0,0,0,0,47710,10.0,47500,1,0,20310,19000,0.1,4771.0,0,0,0,6,14,7,0,0,0,0,27400,6.0,28500,0,0,-20310,-19000,0.0,2740.0
4856003743,1,15,1,0,15,15,16,0,0,0,0,60960,12.8,59000,1,0,24110,26000,0.1,6096.0,0,0,1,10,10,7,0,0,0,0,36850,7.2,33000,0,0,-24110,-26000,0.0,3685.0
4855416504,1,0,0,1,14,12,11,0,0,0,0,45600,10.0,47500,0,0,18800,19000,0.0,4560.0,7,0,0,8,10,7,0,0,0,0,26800,6.0,28500,0,0,-18800,-19000,0.0,2680.0
4855400193,1,17,0,0,15,14,15,0,0,0,0,45637,10.0,47500,0,0,18081,19000,0.0,4563.7,0,0,1,10,11,10,0,0,0,0,27556,6.0,28500,0,0,-18081,-19000,0.0,2755.6
4855383838,1,0,0,1,16,19,15,0,0,0,0,46300,10.0,47500,0,0,17400,19000,0.0,4630.0,6,0,0,11,8,13,0,0,0,0,28900,6.0,28500,0,0,-17400,-19000,0.0,2890.0
4855363094,1,0,0,1,21,18,13,0,0,0,0,63750,12.0,55000,0,0,26200,22000,0.0,6375.0,0,0,0,8,11,12,0,0,0,0,37550,7.2,33000,0,0,-26200,-22000,0.0,3755.0
4855341349,1,0,0,1,21,17,25,0,0,0,0,63820,12.0,55000,0,0,26226,22000,0.0,6382.0,0,0,0,11,15,8,0,0,0,0,37594,7.2,33000,0,0,-26226,-22000,0.0,3759.4
4855177896,1,0,0,1,31,20,86,0,0,0,1,39859,11.6,42844,123,0,2648,2945,12.3,3985.9,0,0,0,20,31,44,0,0,0,0,37211,11.2,39899,98,0,-2648,-2945,9.8,3721.1
4855136892,0,2,0,0,26,26,68,0,0,0,0,38554,11.6,43121,97,0,443,2251,9.7,3855.4,0,0,1,26,26,68,0,0,0,0,38111,11.2,40870,96,0,-443,-2251,9.6,3811.1
4855097104,1,0,0,0,23,20,63,0,0,0,0,37201,11.2,40998,104,0,-20,1455,10.4,3720.1,2,0,1,20,23,44,0,0,0,0,37221,11.2,39543,102,0,20,-1455,10.2,3722.1
4854352392,1,30,0,1,20,10,20,0,0,0,0,46040,10.2,48680,0,0,20260,20180,0.0,4604.0,0,0,0,3,13,6,0,0,0,0,25780,6.0,28500,0,0,-20260,-20180,0.0,2578.0
4854346149,1,4,0,0,18,16,19,0,0,0,0,63425,12.0,55000,1,0,26200,22000,0.1,6342.5,3,0,1,11,13,11,0,0,0,0,37225,7.2,33000,1,0,-26200,-22000,0.1,3722.5
4838084699,1,12,3,0,7,4,7,0,0,0,0,16118,6.6,17157,181,63,103,-1158,24.4,1611.8,13,2,1,3,6,2,0,0,0,0,16015,7.0,18315,227,48,-103,1158,27.5,1601.5
4838047070,1,12,0,1,6,1,5,1,1,0,0,17750,7.4,19089,222,62,3340,3271,28.4,1775.0,15,1,0,1,6,1,0,0,0,0,14410,6.4,15818,194,47,-3340,-3271,24.1,1441.0
4784911880,0,15,2,1,6,7,4,0,0,0,0,17091,6.6,16978,217,63,-1143,-2430,28.0,1709.1,13,2,0,6,5,6,2,1,1,0,18234,7.2,19408,214,74,1143,2430,28.8,1823.4
4784889362,1,107,2,1,4,5,5,1,0,1,0,17419,7.0,19054,260,71,369,1889,33.1,1741.9,12,3,0,5,4,4,0,0,0,0,17050,6.8,17165,228,52,-369,-1889,28.0,1705.0
4784860417,1,12,0,0,3,4,4,0,0,0,0,16702,7.0,17997,199,64,922,1486,26.3,1670.2,7,2,1,4,3,5,0,0,0,0,15780,6.8,16511,218,52,-922,-1486,27.0,1578.0
4780685965,0,9,1,0,7,11,5,1,1,0,0,17275,6.8,17220,178,61,-1014,-1040,23.9,1727.5,12,1,1,11,7,5,0,0,0,0,18289,6.8,18260,188,56,1014,1040,24.4,1828.9
4780630946,1,16,4,0,13,6,10,0,0,0,0,19267,7.0,19785,243,56,1509,2118,29.9,1926.7,15,3,1,6,13,9,0,0,0,0,17758,7.0,17667,222,56,-1509,-2118,27.8,1775.8
4780591327,1,42,4,0,5,3,5,1,1,0,0,16627,7.0,18691,213,52,1686,808,26.5,1662.7,16,10,1,2,4,1,0,0,0,0,14941,6.8,17883,199,64,-1686,-808,26.3,1494.1
4780539980,0,13,2,0,5,9,5,0,0,0,0,15267,6.8,17809,180,60,-1726,6,24.0,1526.7,16,0,1,9,5,7,0,0,0,0,16993,7.0,17803,176,51,1726,-6,22.7,1699.3
4789325109,1,11,1,1,5,3,4,1,0,1,0,16585,6.8,18224,210,75,1551,1049,28.5,1658.5,15,2,0,3,5,2,0,0,0,0,15034,6.8,17175,212,48,-1551,-1049,26.0,1503.4
4777333652,0,13,2,0,8,13,12,0,0,0,0,17894,6.6,16632,198,44,-2893,-1368,24.2,1789.4,22,3,1,13,8,24,0,0,0,0,20787,6.8,18000,226,46,2893,1368,27.2,2078.7
4777311346,1,11,0,0,3,9,2,0,0,0,0,16779,7.0,18236,235,56,-2172,-1307,29.1,1677.9,13,1,1,9,3,7,1,1,0,0,18951,7.4,19543,215,64,2172,1307,27.9,1895.1
4763212568,1,12,2,1,11,2,7,0,0,0,0,20567,7.2,19843,232,64,6330,3344,29.6,2056.7,15,0,0,2,11,3,0,0,0,0,14237,6.6,16499,185,67,-6330,-3344,25.2,1423.7
4763195584,0,39,2,1,2,6,2,1,1,0,0,14777,6.8,17200,175,64,-2726,-2103,23.9,1477.7,14,0,0,6,2,7,0,0,0,0,17503,7.4,19303,221,76,2726,2103,29.7,1750.3
4763174360,1,77,3,1,7,4,7,1,1,0,0,18814,7.4,19292,220,68,2048,901,28.8,1881.4,12,0,0,4,7,4,0,0,0,0,16766,6.8,18391,232,44,-2048,-901,27.6,1676.6
4763144424,0,43,1,0,3,8,4,0,0,0,0,15510,6.6,16977,187,60,-2538,-1274,24.7,1551.0,11,1,1,8,3,11,1,1,0,0,18048,6.8,18251,237,44,2538,1274,28.1,1804.8
4763101145,1,19,2,0,6,3,9,1,0,1,0,18326,7.0,17903,224,56,1772,665,28.0,1832.6,14,2,1,3,6,3,0,0,0,0,16554,6.6,17238,221,56,-1772,-665,27.7,1655.4
4754664714,1,12,2,1,7,4,4,0,0,0,0,17890,7.0,19452,217,76,1683,917,29.3,1789.0,10,1,0,4,7,3,1,1,0,0,16207,7.2,18535,231,48,-1683,-917,27.9,1620.7
4754628462,0,16,2,1,5,8,5,0,0,0,0,16965,6.6,16860,203,52,-1778,407,25.5,1696.5,86,3,0,8,5,12,0,0,0,0,18743,6.8,16453,193,44,1778,-407,23.7,1874.3
4754585949,1,77,0,0,8,7,8,0,0,0,0,19167,7.2,18952,228,52,1108,1212,28.0,1916.7,13,0,1,7,8,7,0,0,0,0,18059,7.0,17740,201,56,-1108,-1212,25.7,1805.9
4754546185,0,11,3,0,6,4,8,1,1,0,0,18521,7.2,18775,196,62,2804,2008,25.8,1852.1,22,1,1,4,6,4,0,0,0,0,15717,6.6,16767,199,44,-2804,-2008,24.3,1571.7
4754498047,0,42,1,0,9,7,7,1,1,0,0,17928,7.0,17436,218,52,897,-143,27.0,1792.8,11,1,1,7,9,10,0,0,0,0,17031,6.8,17579,210,40,-897,143,25.0,1703.1
4752935161,1,15,1,1,5,5,2,1,1,0,0,15748,7.0,18042,183,64,-2873,-642,24.7,1574.8,15,4,0,5,5,8,0,0,0,0,18621,7.0,18684,245,39,2873,642,28.4,1862.1
4752900046,0,34,1,0,7,5,7,1,1,0,0,17499,7.0,18643,236,39,1917,1430,27.5,1749.9,13,4,1,5,7,6,0,0,0,0,15582,7.0,17213,211,55,-1917,-1430,26.6,1558.2
4752851933,1,15,3,1,7,2,8,1,1,0,0,18422,7.2,18120,208,47,3604,1690,25.5,1842.2,17,1,0,2,7,1,0,0,0,0,14818,6.4,16430,206,43,-3604,-1690,24.9,1481.8
4752814633,1,13,1,1,10,6,12,0,0,0,0,19872,7.0,18795,206,60,3278,2026,26.6,1987.2,13,1,0,6,10,7,0,0,0,0,16594,6.8,16769,159,44,-3278,-2026,20.3,1659.4
4751992182,1,13,5,1,4,1,3,0,0,0,0,15454,6.8,17891,222,48,1206,251,27.0,1545.4,20,0,0,1,4,1,1,1,0,0,14248,6.8,17640,195,48,-1206,-251,24.3,1424.8
4751945681,1,11,2,0,2,4,3,0,0,0,0,14363,6.8,17137,225,43,-772,315,26.8,1436.3,18,2,1,4,2,8,0,0,0,0,15135,6.8,16822,202,44,772,-315,24.6,1513.5
4751908706,0,15,1,1,5,4,6,0,0,0,0,16632,6.8,17954,243,55,-64,-683,29.8,1663.2,12,1,0,4,5,6,0,0,0,0,16696,7.0,18637,250,60,64,683,31.0,1669.6
4858435878,1,9,0,0,27,35,71,0,0,0,0,39150,11.6,43624,106,0,-2288,-1342,10.6,3915.0,3,0,1,35,27,73,0,0,0,0,41438,11.8,44966,111,0,2288,1342,11.1,4143.8
4858370406,1,143,0,1,9,7,10,0,0,0,0,17664,6.6,18208,217,56,2211,2551,27.3,1766.4,14,1,0,7,9,5,0,0,0,0,15453,6.6,15657,161,60,-2211,-2551,22.1,1545.3
4858100040,0,11,0,1,12,7,15,0,0,0,0,18466,6.4,16136,184,48,1795,99,23.2,1846.6,13,1,0,7,12,13,0,0,0,0,16671,6.6,16037,191,48,-1795,-99,23.9,1667.1
4857216032,0,12,18,0,6,6,6,1,1,0,0,17897,6.8,17944,235,40,950,727,27.5,1789.7,34,0,1,6,6,7,0,0,0,0,16947,6.8,17217,207,48,-950,-727,25.5,1694.7
4857168832,0,11,2,1,4,4,4,1,1,0,0,16387,7.0,17729,220,60,-216,-287,28.0,1638.7,23,2,0,4,4,3,0,0,0,0,16603,7.0,18016,213,60,216,287,27.3,1660.3
4854050265,1,29,0,1,28,29,63,0,0,0,0,38341,11.4,42640,96,0,-971,-185,9.6,3834.1,0,1,0,29,28,72,0,0,0,0,39312,11.2,42825,100,0,971,185,10.0,3931.2
4853723754,1,170,1,1,5,1,6,0,0,0,0,17103,7.0,18522,193,52,3001,940,24.5,1710.3,17,0,0,1,5,0,0,0,0,0,14102,6.6,17582,199,56,-3001,-940,25.5,1410.2
4852965014,0,34,0,1,24,27,55,0,0,0,0,38723,11.2,42067,108,0,-132,-267,10.8,3872.3,34,0,0,27,24,69,0,0,0,0,38855,11.4,42334,110,0,132,267,11.0,3885.5
4852884642,0,14,1,1,7,6,10,0,0,0,0,16922,6.6,15739,173,48,-791,-559,22.1,1692.2,10,0,0,6,7,9,1,1,0,0,17713,6.6,16298,202,52,791,559,25.4,1771.3
4851649085,0,14,0,0,3,7,1,1,1,0,0,14544,6.6,16498,178,62,-2044,-1516,24.0,1454.4,42,1,1,7,3,6,0,0,0,0,16588,7.0,18014,167,58,2044,1516,22.5,1658.8
4849742203,1,10,7,1,6,4,4,0,0,0,0,16222,6.6,17260,184,65,-267,-647,24.9,1622.2,37,0,0,4,6,5,1,1,0,0,16489,7.0,17907,216,44,267,647,26.0,1648.9
4848045491,1,15,30,1,40,26,94,0,0,0,1,40803,12.0,46794,116,0,1873,4388,11.6,4080.3,23,1,0,26,40,63,0,0,0,0,38930,11.2,42406,127,0,-1873,-4388,12.7,3893.0
4848030896,1,3,0,1,31,24,58,0,0,0,2,40122,11.4,44607,110,0,3300,3120,11.0,4012.2,0,0,0,24,31,68,0,0,0,0,36822,11.2,41487,78,0,-3300,-3120,7.8,3682.2
4847999893,0,8,0,0,0,5,0,0,0,0,0,13441,6.4,16555,194,62,-3917,-1905,25.6,1344.1,12,0,1,5,0,4,1,0,1,0,17358,7.0,18460,229,55,3917,1905,28.4,1735.8
4847959200,0,15,1,1,6,6,5,0,0,0,0,16244,6.8,18006,211,48,-1924,-1083,25.9,1624.4,18,3,0,5,5,7,0,0,0,0,18168,7.2,19089,237,48,1924,1083,28.5,1816.8
4847685595,0,25,0,1,23,25,49,0,0,0,1,37688,11.2,41022,119,0,-1093,-2061,11.9,3768.8,0,22,0,25,23,56,0,0,0,0,38781,11.6,43083,113,0,1093,2061,11.3,3878.1
4844270810,0,0,0,0,18,19,45,0,0,0,0,34176,10.6,36855,96,0,-1017,-1415,9.6,3417.6,71,0,1,19,18,54,0,0,0,0,35193,11.0,38270,114,0,1017,1415,11.4,3519.3
4842195240,0,20,0,0,23,39,42,0,0,0,0,36641,11.4,41464,104,0,-4262,-4068,10.4,3664.1,0,4,1,39,23,109,0,0,0,0,40903,11.8,45532,115,0,4262,4068,11.5,4090.3
4841361612,0,3,0,0,19,30,60,0,0,0,1,37368,11.2,40827,104,0,-2274,-1495,10.4,3736.8,0,0,1,30,19,88,0,0,0,0,39642,11.2,42322,104,0,2274,1495,10.4,3964.2
4856684936,0,12,1,0,4,7,3,0,0,0,0,16191,6.8,17934,246,57,-958,-135,30.3,1619.1,11,2,1,7,4,9,1,1,0,0,17149,6.8,18069,244,58,958,135,30.2,1714.9
4822324760,1,13,1,0,6,2,3,1,0,1,0,17059,7.6,21081,239,56,1540,2675,29.5,1705.9,6,1,1,2,6,3,0,0,0,0,15519,7.0,18406,210,76,-1540,-2675,28.6,1551.9
4786391122,0,76,1,1,5,9,4,0,0,0,0,16141,6.6,17217,195,44,-3209,-1015,23.9,1614.1,12,21,0,9,5,7,0,0,0,0,19350,7.0,18232,233,53,3209,1015,28.6,1935.0
4786374673,0,45,1,1,9,6,5,1,1,0,0,17241,6.6,16942,188,44,-607,544,23.2,1724.1,11,0,0,6,9,6,0,0,0,0,17848,6.6,16398,203,39,607,-544,24.2,1784.8
4769929560,0,10,0,0,5,14,5,1,1,0,0,17435,6.6,16927,183,48,-3989,-1161,23.1,1743.5,119,1,1,14,5,12,0,0,0,0,21424,7.0,18088,215,52,3989,1161,26.7,2142.4
4769889613,1,20,1,1,10,7,11,1,0,1,0,18671,7.0,18255,215,47,1438,1126,26.2,1867.1,15,2,0,7,10,7,1,1,0,0,17233,6.8,17129,191,48,-1438,-1126,23.9,1723.3
4769865399,1,63,2,1,6,4,7,0,0,0,0,17359,6.8,17021,215,41,2735,80,25.6,1735.9,9,0,0,4,6,4,0,0,0,0,14624,6.6,16941,180,55,-2735,-80,23.5,1462.4
4733578259,1,17,1,1,11,8,14,1,1,0,0,19381,7.0,17696,229,44,1323,-218,27.3,1938.1,65,3,0,8,11,10,1,0,1,0,18058,7.0,17914,216,60,-1323,218,27.6,1805.8
4733536698,1,15,0,1,3,2,5,0,0,0,0,16938,7.2,19412,245,80,1928,896,32.5,1693.8,11,0,0,2,3,3,1,1,0,0,15010,7.0,18516,221,55,-1928,-896,27.6,1501.0
4729499741,1,13,1,1,9,6,7,1,1,0,0,19359,7.4,18693,252,60,3540,2697,31.2,1935.9,14,1,0,6,9,6,0,0,0,0,15819,6.6,15996,179,50,-3540,-2697,22.9,1581.9
4729469305,1,15,1,0,4,4,2,0,0,0,0,17280,7.2,19087,234,60,-49,681,29.4,1728.0,11,1,1,4,4,3,1,1,0,0,17329,7.2,18406,231,52,49,-681,28.3,1732.9
4729442071,1,18,0,0,4,9,3,0,0,0,0,17091,7.0,18430,225,50,-628,1017,27.5,1709.1,12,1,1,9,4,8,2,1,1,0,17719,7.0,17413,201,56,628,-1017,25.7,1771.9
4729406514,1,15,1,1,8,3,12,1,1,0,0,17102,6.8,17862,182,37,525,161,21.9,1710.2,13,1,0,3,8,2,0,0,0,0,16577,7.0,17701,224,64,-525,-161,28.8,1657.7
4716091902,1,43,2,1,4,1,5,0,0,0,0,15689,6.8,17502,194,47,-536,-862,24.1,1568.9,15,2,0,1,4,1,1,1,0,0,16225,6.8,18364,222,72,536,862,29.4,1622.5
4716039732,0,10,3,1,7,8,6,1,1,0,0,17481,6.0,14118,140,48,-489,-2043,18.8,1748.1,15,0,0,8,7,8,0,0,0,0,17970,6.8,16161,160,60,489,2043,22.0,1797.0
4716006724,1,10,0,0,9,4,5,0,0,0,0,17903,7.0,18245,203,56,3788,1933,25.9,1790.3,9,0,1,3,8,1,0,0,0,0,14115,6.4,16312,163,68,-3788,-1933,23.1,1411.5
4715963837,0,13,1,1,10,9,14,1,1,0,0,22098,7.2,19009,219,60,3534,2869,27.9,2209.8,16,1,0,9,10,9,0,0,0,0,18564,6.6,16140,170,51,-3534,-2869,22.1,1856.4
4696142194,0,16,1,1,8,8,9,0,0,0,0,19542,7.2,18593,212,63,2928,1652,27.5,1954.2,9,1,0,8,8,11,0,0,0,0,16614,6.6,16941,183,36,-2928,-1652,21.9,1661.4
4696132286,1,10,1,1,6,3,4,0,0,0,0,16606,6.6,16987,196,44,2211,1282,24.0,1660.6,13,0,0,3,6,2,0,0,0,0,14395,6.4,15705,163,60,-2211,-1282,22.3,1439.5
4696119254,1,13,0,1,7,4,7,1,1,0,0,15939,6.6,16652,174,52,-858,-1165,22.6,1593.9,18,1,0,4,7,3,0,0,0,0,16797,6.8,17817,211,52,858,1165,26.3,1679.7
4853603004,0,8,0,0,5,5,2,0,0,0,0,16394,6.8,18223,190,64,-1035,649,25.4,1639.4,13,0,1,5,5,7,1,1,0,0,17429,6.8,17574,215,44,1035,-649,25.9,1742.9
4853573893,0,12,3,1,5,6,3,1,0,1,0,17014,6.6,16969,221,48,-600,-212,26.9,1701.4,11,2,0,6,5,6,0,0,0,0,17614,6.8,17181,199,56,600,212,25.5,1761.4
4840269614,1,12,0,0,9,4,5,0,0,0,0,17439,7.2,19145,196,43,2507,2303,23.9,1743.9,16,0,1,4,9,0,0,0,0,0,14932,6.8,16842,181,60,-2507,-2303,24.1,1493.2
4838728301,1,15,1,1,7,6,5,1,0,1,0,17969,7.2,19002,204,56,1366,1659,26.0,1796.9,10,1,0,6,7,10,1,1,0,0,16603,6.8,17343,198,62,-1366,-1659,26.0,1660.3
4837158441,0,12,0,1,5,10,5,0,0,0,0,16152,6.2,16047,192,36,-2638,-1591,22.8,1615.2,10,1,0,10,5,6,0,0,0,0,18790,7.0,17638,227,51,2638,1591,27.8,1879.0
4837115192,1,11,1,1,9,5,10,2,1,1,0,18489,6.8,17477,187,60,2725,1027,24.7,1848.9,9,0,0,5,9,4,0,0,0,0,15764,6.4,16450,208,43,-2725,-1027,25.1,1576.4
4833302209,0,12,2,1,5,7,0,0,0,0,0,15518,6.8,17528,209,64,-2130,-9,27.3,1551.8,12,1,0,7,5,7,0,0,0,0,17648,7.0,17537,181,56,2130,9,23.7,1764.8
4746964264,1,11,1,1,6,1,5,0,0,0,0,16916,6.8,17901,230,40,2402,1311,27.0,1691.6,36,3,0,1,6,2,1,1,0,0,14514,6.6,16590,183,64,-2402,-1311,24.7,1451.4
4746171025,1,11,2,1,5,5,5,1,0,1,0,16573,7.2,18723,215,51,1625,1342,26.6,1657.3,8,1,0,4,4,2,0,0,0,0,14948,6.8,17381,207,53,-1625,-1342,26.0,1494.8
4746154990,1,23,1,1,9,3,7,1,1,0,0,18411,7.0,19314,202,64,2879,1333,26.6,1841.1,10,0,0,3,9,1,0,0,0,0,15532,7.0,17981,230,64,-2879,-1333,29.4,1553.2
4746122680,1,14,0,0,4,2,3,0,0,0,0,16237,7.6,20369,239,60,-87,2084,29.9,1623.7,19,3,1,2,4,2,1,1,0,0,16324,7.0,18285,247,64,87,-2084,31.1,1632.4
4725816249,1,11,2,0,4,3,5,0,0,0,0,15727,7.2,17910,202,60,100,-173,26.2,1572.7,20,4,1,3,4,1,0,0,0,0,15627,6.8,18083,192,47,-100,173,23.9,1562.7
4724011523,0,11,2,1,4,5,6,0,0,0,0,16175,6.8,17251,195,56,-874,-1261,25.1,1617.5,10,1,0,5,4,6,1,0,1,0,17049,7.2,18512,204,64,874,1261,26.8,1704.9
4723997055,0,17,0,0,5,3,6,0,0,0,0,14986,6.2,15256,149,40,-866,-2616,18.9,1498.6,10,3,1,3,5,6,2,1,1,0,15852,7.0,17872,197,68,866,2616,26.5,1585.2
4714925973,0,10,2,0,5,6,6,0,0,0,0,16552,6.6,16389,203,50,-893,-1935,25.3,1655.2,12,2,1,6,5,7,0,0,0,0,17445,7.2,18324,205,60,893,1935,26.5,1744.5
4706192161,0,14,8,0,6,5,2,0,0,0,0,17159,7.0,18913,220,56,49,833,27.6,1715.9,34,3,1,5,6,4,0,0,0,0,17110,7.0,18080,215,60,-49,-833,27.5,1711.0
4705849952,1,31,0,1,6,6,8,1,1,0,0,16358,6.6,16904,197,68,-290,-974,26.5,1635.8,11,12,0,6,6,5,0,0,0,0,16648,6.6,17878,229,48,290,974,27.7,1664.8
4703347952,1,15,2,0,10,17,28,0,0,0,1,32817,9.8,33994,97,0,-990,-2608,9.7,3281.7,23,0,1,17,10,47,0,0,0,0,33807,10.6,36602,100,0,990,2608,10.0,3380.7
4703325464,1,20,1,0,32,28,66,0,0,0,1,40745,12.0,46141,87,0,2369,1252,8.7,4074.5,14,3,1,28,32,67,0,0,0,0,38376,11.8,44889,83,0,-2369,-1252,8.3,3837.6
4856368609,1,0,0,1,23,18,56,0,0,0,0,36591,11.2,40587,100,0,1553,1990,10.0,3659.1,15,0,0,18,23,37,0,0,0,0,35038,10.8,38597,103,0,-1553,-1990,10.3,3503.8
4856336978,1,9,0,0,23,25,65,0,0,0,1,39358,11.6,42875,112,0,2547,2267,11.2,3935.8,0,0,1,25,23,44,0,0,0,0,36811,11.0,40608,92,0,-2547,-2267,9.2,3681.1
4845139792,0,139,1,0,4,11,2,0,0,0,0,14740,6.2,15210,175,48,-3611,-3300,22.3,1474.0,10,2,1,11,4,8,1,1,0,0,18351,7.2,18510,194,64,3611,3300,25.8,1835.1
4844009664,1,12,1,0,1,10,2,1,1,0,0,13293,6.6,15631,179,52,-4325,-1614,23.1,1329.3,13,0,1,10,1,9,0,0,0,0,17618,6.6,17245,206,52,4325,1614,25.8,1761.8
4838072547,0,15,4,0,5,3,4,0,0,0,0,15431,6.6,16461,185,48,-1093,-755,23.3,1543.1,21,3,1,3,5,1,1,1,0,0,16524,6.8,17216,211,48,1093,755,25.9,1652.4
4838026101,1,16,1,0,6,4,1,0,0,0,0,17086,7.2,18839,235,64,1486,1907,29.9,1708.6,11,2,1,4,6,5,0,0,0,0,15600,6.8,16932,200,48,-1486,-1907,24.8,1560.0
4837997021,1,5,2,0,1,2,0,1,1,0,0,13592,6.6,17427,184,60,-2921,-1188,24.4,1359.2,12,0,1,2,1,3,1,0,1,0,16513,7.0,18615,211,66,2921,1188,27.7,1651.3
4837952901,1,9,1,0,1,4,1,0,0,0,0,14263,6.6,17481,234,60,-1948,-918,29.4,1426.3,15,1,1,4,1,3,0,0,0,0,16211,7.0,18399,206,68,1948,918,27.4,1621.1
4837913706,1,12,2,1,6,2,6,0,0,0,0,17589,7.2,19154,214,68,1577,1801,28.2,1758.9,17,0,0,2,6,1,0,0,0,0,16012,6.8,17353,208,48,-1577,-1801,25.6,1601.2
4837047779,1,7,2,1,8,6,7,0,0,0,0,17753,7.0,18357,199,60,1716,510,25.9,1775.3,16,0,0,5,7,3,1,1,0,0,16037,7.0,17847,205,60,-1716,-510,26.5,1603.7
4836986337,1,15,0,1,4,1,1,1,1,0,0,16341,7.2,19062,239,75,1690,486,31.4,1634.1,10,0,0,1,4,0,0,0,0,0,14651,7.2,18576,197,64,-1690,-486,26.1,1465.1
4836930359,0,37,0,1,7,6,5,0,0,0,0,16659,6.8,17283,201,56,971,265,25.7,1665.9,32,1,0,6,7,8,0,0,0,0,15688,6.6,17018,158,60,-971,-265,21.8,1568.8
4836647296,1,10,0,1,10,5,13,1,1,0,0,20710,7.0,18781,266,53,4699,1528,31.9,2071.0,14,0,0,5,10,3,1,0,1,0,16011,6.8,17253,214,50,-4699,-1528,26.4,1601.1
4836057075,1,14,0,1,12,4,18,0,0,0,0,19638,6.8,18398,241,43,4330,2031,28.4,1963.8,7,2,0,4,12,3,0,0,0,0,15308,6.6,16367,191,56,-4330,-2031,24.7,1530.8
4836008205,0,9,0,0,7,2,8,1,1,0,0,17026,6.8,17388,178,60,1881,796,23.8,1702.6,7,1,1,2,7,1,0,0,0,0,15145,6.8,16592,209,44,-1881,-796,25.3,1514.5
4835936467,0,14,0,0,1,4,1,0,0,0,0,15339,7.2,19073,223,56,159,1358,27.9,1533.9,48,0,1,4,1,10,0,0,0,0,15180,7.0,17715,197,60,-159,-1358,25.7,1518.0
4835689584,1,12,1,1,12,5,8,1,1,0,0,20332,7.0,18152,186,56,2844,1496,24.2,2033.2,11,0,0,5,12,4,0,0,0,0,17488,6.6,16656,208,44,-2844,-1496,25.2,1748.8
4835280804,1,12,1,0,11,9,8,1,0,1,0,17485,6.6,16395,169,40,-961,-1081,20.9,1748.5,15,0,1,9,11,7,1,1,0,0,18446,6.8,17476,210,56,961,1081,26.6,1844.6
4835251715,0,13,0,0,10,9,7,0,0,0,0,18535,6.8,17702,204,60,-1241,69,26.4,1853.5,10,0,1,9,10,9,0,0,0,0,19776,6.8,17633,197,60,1241,-69,25.7,1977.6
4835224514,1,13,2,1,6,1,8,1,1,0,0,15563,6.8,16727,179,50,887,612,22.9,1556.3,13,1,0,1,6,1,0,0,0,0,14676,6.6,16115,183,45,-887,-612,22.8,1467.6
4801698321,0,14,1,0,4,7,4,0,0,0,0,15482,6.6,17178,243,44,-2791,-821,28.7,1548.2,11,1,1,7,4,10,0,0,0,0,18273,6.8,17999,245,52,2791,821,29.7,1827.3
4801654359,1,12,0,1,3,2,1,1,0,1,0,16041,7.2,19279,217,72,-429,304,28.9,1604.1,10,1,0,2,3,1,1,1,0,0,16470,7.0,18975,248,64,429,-304,31.2,1647.0
4801611702,1,50,3,1,4,4,6,1,1,0,0,16404,7.2,18404,217,64,483,-307,28.1,1640.4,14,0,0,4,4,1,0,0,0,0,15921,7.2,18711,219,60,-483,307,27.9,1592.1
4801575310,0,11,0,1,3,5,1,0,0,0,0,15549,6.8,17675,207,56,-2608,-179,26.3,1554.9,12,1,0,5,3,5,0,0,0,0,18157,7.0,17854,232,40,2608,179,27.2,1815.7
4800751568,1,10,2,1,6,6,10,0,0,0,0,17289,6.4,16764,199,48,784,234,24.7,1728.9,14,1,0,6,6,8,1,1,0,0,16505,6.6,16530,233,60,-784,-234,29.3,1650.5
4789851250,0,13,2,0,3,7,2,0,0,0,0,14850,6.6,17522,189,52,-3619,-1239,24.1,1485.0,14,2,1,7,3,9,2,1,1,0,18469,6.8,18761,269,55,3619,1239,32.4,1846.9
4789785993,1,9,1,1,8,4,5,0,0,0,0,17809,7.4,19885,237,70,2994,4460,30.7,1780.9,11,0,0,4,8,2,0,0,0,0,14815,6.2,15425,168,52,-2994,-4460,22.0,1481.5
4787958997,0,31,0,0,8,10,6,1,1,0,0,16738,6.6,17198,175,56,-2017,482,23.1,1673.8,12,1,1,10,8,16,0,0,0,0,18755,6.6,16716,221,36,2017,-482,25.7,1875.5
4779821862,1,13,1,1,6,3,7,1,1,0,0,18158,7.2,18730,223,60,3190,1404,28.3,1815.8,14,2,0,3,6,3,0,0,0,0,14968,6.8,17326,183,60,-3190,-1404,24.3,1496.8
4778733102,0,14,0,1,5,5,6,1,1,0,0,17091,6.8,17584,209,48,841,446,25.7,1709.1,20,2,0,5,5,4,0,0,0,0,16250,6.8,17138,206,60,-841,-446,26.6,1625.0
4778718801,1,13,0,1,5,0,6,0,0,0,0,17301,7.0,18629,249,56,2968,1029,30.5,1730.1,10,1,0,0,5,0,0,0,0,0,14333,7.0,17600,235,52,-2968,-1029,28.7,1433.3
4778679048,0,14,1,0,6,8,5,1,1,0,0,15867,6.6,17104,179,58,-2449,-2126,23.7,1586.7,13,1,1,8,6,7,0,0,0,0,18316,7.4,19230,217,72,2449,2126,28.9,1831.6
4778646892,1,11,2,1,4,2,3,0,0,0,0,16542,7.0,19188,253,72,935,996,32.5,1654.2,12,1,0,2,4,0,1,1,0,0,15607,7.0,18192,224,72,-935,-996,29.6,1560.7
4778148346,1,14,1,1,7,2,7,1,0,1,0,17958,7.0,19104,233,64,2651,1995,29.7,1795.8,11,0,0,2,7,3,0,0,0,0,15307,6.8,17109,224,59,-2651,-1995,28.3,1530.7
4778112352,0,17,5,0,4,7,3,0,0,0,0,17071,6.8,16894,229,40,-1421,-746,26.9,1707.1,18,4,1,7,4,12,1,1,0,0,18492,6.8,17640,221,56,1421,746,27.7,1849.2
4714158318,1,13,1,0,5,6,6,0,0,0,0,16307,6.6,16710,185,54,-556,-840,23.9,1630.7,46,0,1,6,5,7,0,0,0,0,16863,6.8,17550,201,60,556,840,26.1,1686.3
4714139223,0,53,2,1,2,4,1,0,0,0,0,14087,6.6,16622,198,56,-3500,-1856,25.4,1408.7,12,3,0,4,2,3,0,0,0,0,17587,7.0,18478,238,44,3500,1856,28.2,1758.7
4712862655,0,48,1,0,2,6,3,1,1,0,0,15108,6.8,17040,194,60,-2695,-1972,25.4,1510.8,13,0,1,6,2,8,0,0,0,0,17803,7.0,19012,198,59,2695,1972,25.7,1780.3
4668102604,1,4,16,1,36,19,108,0,0,0,2,42659,12.0,45447,122,0,4761,4161,12.2,4265.9,25,0,0,19,36,29,0,0,0,0,37898,11.2,41286,83,0,-4761,-4161,8.3,3789.8
4662788514,0,17,0,1,27,26,60,0,0,0,2,39235,11.4,43128,96,0,-685,-1428,9.6,3923.5,0,0,0,26,27,67,0,0,0,0,39920,11.6,44556,90,0,685,1428,9.0,3992.0
4845229656,0,8,0,0,6,11,6,0,0,0,0,16200,6.8,17129,188,44,-1304,422,23.2,1620.0,10,0,1,11,6,12,0,0,0,0,17504,6.8,16707,189,40,1304,-422,22.9,1750.4
4843467346,1,20,2,1,10,3,9,1,1,0,0,17990,6.8,17891,216,44,3911,1041,26.0,1799.0,12,1,0,3,10,4,0,0,0,0,14079,6.6,16850,175,36,-3911,-1041,21.1,1407.9
4842230598,1,13,1,0,3,4,3,0,0,0,0,14916,7.0,17650,189,52,-564,-546,24.1,1491.6,11,1,1,4,3,0,0,0,0,0,15480,6.8,18196,229,52,564,546,28.1,1548.0
4839227949,1,14,0,1,6,1,6,0,0,0,0,16711,6.8,17966,195,59,2599,-177,25.4,1671.1,14,0,0,1,6,0,0,0,0,0,14112,7.0,18143,211,52,-2599,177,26.3,1411.2
4839105425,1,38,0,1,4,2,1,0,0,0,0,16132,7.0,18001,231,56,-279,-828,28.7,1613.2,8,16,0,2,4,2,0,0,0,0,16411,7.2,18829,219,64,279,828,28.3,1641.1
4838847457,1,20,2,1,5,3,5,1,1,0,0,17159,6.8,17998,216,52,2845,608,26.8,1715.9,12,0,0,3,5,3,0,0,0,0,14314,6.8,17390,175,59,-2845,-608,23.4,1431.4
4838816653,0,9,1,0,7,12,7,0,0,0,0,16558,7.0,17323,184,48,-2560,-2965,23.2,1655.8,10,1,1,11,6,8,0,0,0,0,19118,7.4,20288,194,68,2560,2965,26.2,1911.8
4838756335,1,85,0,0,1,3,1,0,0,0,0,13597,6.8,17210,189,60,-2018,-1061,24.9,1359.7,33,0,1,3,1,3,1,1,0,0,15615,6.8,18271,214,76,2018,1061,29.0,1561.5
4838733316,1,16,2,1,10,5,12,0,0,0,0,17557,6.8,17322,183,48,1930,468,23.1,1755.7,19,1,0,5,10,4,0,0,0,0,15627,6.8,16854,208,46,-1930,-468,25.4,1562.7
4838721892,0,15,1,0,2,9,1,0,0,0,0,13506,6.2,14698,161,48,-5143,-2613,20.9,1350.6,14,1,1,9,2,13,1,0,1,0,18649,6.8,17311,193,55,5143,2613,24.8,1864.9
4836044379,0,14,1,1,5,7,6,0,0,0,0,15125,6.8,16366,180,48,-1349,-1590,22.8,1512.5,14,3,0,7,5,6,1,1,0,0,16474,6.8,17956,199,64,1349,1590,26.3,1647.4
4834153184,1,11,1,0,4,6,8,1,1,0,0,14827,6.6,17101,215,48,-1885,-1220,26.3,1482.7,11,1,1,5,3,9,0,0,0,0,16712,7.0,18321,226,63,1885,1220,28.9,1671.2
4831063075,1,17,1,0,1,11,1,0,0,0,0,15187,6.8,16951,198,36,-3582,-2225,23.4,1518.7,14,2,1,11,1,9,1,1,0,0,18769,7.4,19176,206,60,3582,2225,26.6,1876.9
4827601156,0,16,1,1,5,4,5,0,0,0,0,16722,7.0,18507,239,52,776,274,29.1,1672.2,9,2,0,4,5,4,1,1,0,0,15946,7.2,18233,190,56,-776,-274,24.6,1594.6
4825792913,0,8,0,1,3,4,0,0,0,0,0,16586,7.2,18896,239,60,-1056,356,29.9,1658.6,7,0,0,4,3,2,0,0,0,0,17642,7.2,18540,201,68,1056,-356,26.9,1764.2
4823996389,1,163,1,1,5,2,8,0,0,0,0,16655,6.8,17158,197,48,1484,-910,24.5,1665.5,9,1,0,2,5,2,1,1,0,0,15171,7.0,18068,217,57,-1484,910,27.4,1517.1
4823044524,0,13,17,0,4,6,2,0,0,0,0,15668,7.0,18618,220,56,-616,-513,27.6,1566.8,35,2,1,6,4,3,1,1,0,0,16284,7.0,19131,207,64,616,513,27.1,1628.4
4820994556,0,51,1,0,2,4,0,0,0,0,0,13772,6.8,17776,205,52,-2136,-796,25.7,1377.2,13,2,1,4,2,4,2,1,1,0,15908,7.0,18572,251,50,2136,796,30.1,1590.8
4819985580,1,12,2,0,6,3,4,0,0,0,0,16237,7.0,17608,191,52,1088,1510,24.3,1623.7,12,2,1,3,6,2,0,0,0,0,15149,6.2,16098,215,32,-1088,-1510,24.7,1514.9
4858015722,1,17,3,0,8,7,2,0,0,0,0,18380,7.6,19547,213,60,855,1386,27.3,1838.0,8,1,1,7,8,10,0,0,0,0,17525,7.0,18161,187,52,-855,-1386,23.9,1752.5
4857990131,1,48,0,0,8,9,8,1,1,0,0,17225,7.0,17980,186,48,-79,67,23.4,1722.5,12,1,1,9,8,9,0,0,0,0,17304,6.8,17913,215,48,79,-67,26.3,1730.4
4857924853,0,14,0,1,3,6,3,0,0,0,0,14887,6.4,16080,179,36,-1205,-1243,21.5,1488.7,15,2,0,6,3,4,2,1,1,0,16092,6.8,17323,186,60,1205,1243,24.6,1609.2
4854361592,1,40,0,1,26,21,85,0,0,0,1,38592,11.4,42893,96,0,2640,2641,9.6,3859.2,46,1,0,21,26,52,0,0,0,0,35952,11.0,40252,99,0,-2640,-2641,9.9,3595.2
4854352587,1,0,0,0,24,25,60,0,0,0,1,39585,11.4,41998,112,0,-59,-766,11.2,3958.5,1,0,1,25,24,65,0,0,0,0,39644,11.6,42764,92,0,59,766,9.2,3964.4
4854338564,1,217,0,0,20,27,39,0,0,0,0,34770,10.8,38613,91,0,-2453,-1886,9.1,3477.0,0,0,1,27,20,65,0,0,0,0,37223,11.0,40499,95,0,2453,1886,9.5,3722.3
4854326111,1,1,1,1,26,20,64,0,0,0,2,36801,11.0,39581,105,0,-638,-2521,10.5,3680.1,32,0,0,20,26,59,0,0,0,0,37439,11.4,42102,99,0,638,2521,9.9,3743.9
4854309525,1,0,0,1,28,20,77,0,0,0,1,39537,11.4,41056,127,0,2342,1191,12.7,3953.7,0,0,0,20,28,51,0,0,0,0,37195,11.0,39865,96,0,-2342,-1191,9.6,3719.5
4854298839,1,107,0,0,15,16,26,0,0,0,0,36002,10.8,39057,95,0,-327,-423,9.5,3600.2,42,0,1,16,15,30,0,0,0,0,36329,11.0,39480,112,0,327,423,11.2,3632.9
4854260069,0,10,1,0,3,3,4,0,0,0,0,14790,6.6,17605,200,47,428,937,24.7,1479.0,11,2,1,3,3,4,0,0,0,0,14362,6.6,16668,167,64,-428,-937,23.1,1436.2
4854239905,0,18,0,1,7,7,5,0,0,0,0,17904,7.0,18312,214,56,676,489,27.0,1790.4,66,0,0,7,7,8,0,0,0,0,17228,6.8,17823,169,56,-676,-489,22.5,1722.8
4854216526,1,6,0,1,7,3,5,0,0,0,0,16950,7.2,20133,177,68,1286,1697,24.5,1695.0,10,0,0,3,7,2,0,0,0,0,15664,7.0,18436,184,64,-1286,-1697,24.8,1566.4
4854198889,0,12,0,0,4,12,3,0,0,0,0,15188,6.6,16182,182,48,-5869,-3830,23.0,1518.8,11,0,1,12,4,11,1,1,0,0,21057,7.4,20012,225,72,5869,3830,29.7,2105.7
4854154549,1,15,1,1,10,3,7,0,0,0,0,16712,6.6,17015,173,56,812,749,22.9,1671.2,14,1,0,3,10,1,0,0,0,0,15900,6.6,16266,202,48,-812,-749,25.0,1590.0
4854112955,1,12,2,1,5,5,4,0,0,0,0,16170,7.0,18180,205,48,-72,18,25.3,1617.0,14,1,0,5,5,5,0,0,0,0,16242,7.0,18162,204,51,72,-18,25.5,1624.2
4854055714,0,14,1,0,4,2,6,0,0,0,0,15297,6.8,17480,186,52,1259,440,23.8,1529.7,8,0,1,2,4,0,1,1,0,0,14038,6.8,17040,212,52,-1259,-440,26.4,1403.8
4853686317,1,9,0,1,6,2,5,1,1,0,0,16603,7.2,18321,202,64,2071,1323,26.6,1660.3,16,0,0,2,6,1,0,0,0,0,14532,6.8,16998,201,44,-2071,-1323,24.5,1453.2
4853651376,0,15,1,0,3,6,1,0,0,0,0,14449,6.8,17204,178,60,-2372,-1920,23.8,1444.9,11,2,1,6,3,3,0,0,0,0,16821,7.4,19124,229,64,2372,1920,29.3,1682.1
4853627141,1,11,0,0,12,6,12,0,0,0,0,19350,7.2,18391,173,64,2265,1600,23.7,1935.0,9,0,1,6,12,2,1,0,1,0,17085,6.6,16791,180,40,-2265,-1600,22.0,1708.5
4853118594,1,13,1,1,4,1,8,0,0,0,0,16155,7.2,17886,206,56,1466,848,26.2,1615.5,11,0,0,1,4,1,0,0,0,0,14689,6.8,17038,205,48,-1466,-848,25.3,1468.9
4858438816,1,352,0,0,17,20,21,0,0,0,0,47350,10.0,47600,0,0,18800,19100,0.0,4735.0,30,0,1,12,9,6,0,0,0,0,28550,6.0,28500,0,0,-18800,-19100,0.0,2855.0
4858414256,1,0,0,1,27,15,25,0,0,0,0,50850,10.2,48680,5,0,24050,17180,0.5,5085.0,0,0,0,4,16,5,0,0,0,0,26800,6.6,31500,1,0,-24050,-17180,0.1,2680.0
4857112594,0,13,2,0,4,9,6,0,0,0,0,14617,6.4,15491,171,36,-4762,-3137,20.7,1461.7,9,2,1,9,4,9,0,0,0,0,19379,7.0,18628,250,51,4762,3137,30.1,1937.9
4857076127,1,15,4,1,9,7,15,0,0,0,0,17933,6.8,17376,237,52,1049,-581,28.9,1793.3,16,3,0,7,9,13,0,0,0,0,16884,6.8,17957,216,56,-1049,581,27.2,1688.4
4855787768,1,141,4,1,4,1,5,1,1,0,0,16158,7.2,19195,228,68,2353,1772,29.6,1615.8,11,0,0,1,4,0,0,0,0,0,13805,6.8,17423,211,44,-2353,-1772,25.5,1380.5
4855756245,1,11,0,1,7,5,5,0,0,0,0,17303,7.0,18856,208,56,2293,1103,26.4,1730.3,11,1,0,5,7,3,1,1,0,0,15010,6.6,17753,180,54,-2293,-1103,23.4,1501.0
4855720411,1,13,0,1,3,2,3,1,1,0,0,14165,7.2,18356,173,44,-682,-487,21.7,1416.5,13,0,0,2,3,1,0,0,0,0,14847,7.0,18843,230,64,682,487,29.4,1484.7
4855700147,0,11,2,1,5,6,4,0,0,0,0,15869,6.8,17638,213,48,-67,-59,26.1,1586.9,78,1,0,6,5,6,1,1,0,0,15936,6.8,17697,193,52,67,59,24.5,1593.6
4852784280,1,11,2,1,3,0,8,1,1,0,0,16782,6.8,18058,189,60,2948,1061,24.9,1678.2,14,1,0,0,3,0,0,0,0,0,13834,6.8,16997,228,48,-2948,-1061,27.6,1383.4
4850749299,0,22,4,1,9,6,11,0,0,0,0,17696,6.8,17448,175,50,529,233,22.5,1769.6,11,1,0,6,9,6,0,0,0,0,17167,6.6,17215,208,50,-529,-233,25.8,1716.7
4847566139,0,15,1,1,11,6,9,1,1,0,0,17998,6.4,15998,149,36,1345,1367,18.5,1799.8,15,0,0,6,11,5,0,0,0,0,16653,6.2,14631,160,32,-1345,-1367,19.2,1665.3
4844888554,1,15,1,0,6,3,8,1,1,0,0,17387,6.8,17287,183,44,2039,-717,22.7,1738.7,11,1,1,3,6,2,0,0,0,0,15348,7.0,18004,199,52,-2039,717,25.1,1534.8
4844130164,0,125,0,1,3,7,3,0,0,0,0,14559,6.8,16930,179,48,-2052,-648,22.7,1455.9,9,1,0,7,3,6,0,0,0,0,16611,6.8,17578,204,52,2052,648,25.6,1661.1
4844092027,1,19,0,0,3,4,3,0,0,0,0,14556,6.6,16872,195,60,94,787,25.5,1455.6,12,2,1,4,3,3,0,0,0,0,14462,6.6,16085,182,48,-94,-787,23.0,1446.2
4843220719,1,16,0,0,2,8,2,0,0,0,0,14669,7.0,17410,187,52,-3012,-1384,23.9,1466.9,7,1,1,8,2,5,0,0,0,0,17681,7.2,18794,193,44,3012,1384,23.7,1768.1
4842352188,1,8,2,1,6,4,6,0,0,0,0,16123,7.2,18077,189,48,600,257,23.7,1612.3,13,0,0,4,6,2,0,0,0,0,15523,7.0,17820,199,60,-600,-257,25.9,1552.3
4842278489,1,41,0,1,7,5,5,0,0,0,0,15255,6.6,17293,170,40,-599,-648,21.0,1525.5,11,13,0,5,7,1,0,0,0,0,15854,6.6,17941,210,56,599,648,26.6,1585.4
4841872893,1,14,2,0,4,4,4,0,0,0,0,16203,7.0,18357,223,52,417,256,27.5,1620.3,72,0,1,4,4,3,1,1,0,0,15786,7.0,18101,196,48,-417,-256,24.4,1578.6
4841842518,1,22,1,1,7,8,6,0,0,0,0,17644,6.8,18008,198,44,337,-636,24.2,1764.4,17,4,0,8,7,6,1,1,0,0,17307,7.2,18644,206,52,-337,636,25.8,1730.7
4841817437,0,137,1,1,3,7,3,0,0,0,0,15638,6.6,16953,199,44,-1365,-587,24.3,1563.8,15,4,0,7,3,9,1,1,0,0,17003,6.8,17540,217,52,1365,587,26.9,1700.3
4858070391,1,27,2,0,11,7,8,0,0,0,0,17982,7.2,18396,216,36,1207,816,25.2,1798.2,14,7,1,7,11,5,0,0,0,0,16775,6.8,17580,194,52,-1207,-816,24.6,1677.5
4857688568,1,21,3,1,13,8,11,1,1,0,0,19102,6.8,18090,225,49,2122,1379,27.4,1910.2,17,0,0,8,13,4,0,0,0,0,16980,6.8,16711,152,47,-2122,-1379,19.9,1698.0
4857661529,1,4,0,1,20,18,20,0,0,0,0,48050,12.0,55000,0,0,18623,22000,0.0,4805.0,0,0,0,10,12,8,0,0,0,0,29427,7.2,33000,0,0,-18623,-22000,0.0,2942.7
4857645313,1,12,2,0,6,6,5,0,0,0,0,16870,6.8,17946,216,50,1260,1432,26.6,1687.0,98,1,1,6,6,5,1,1,0,0,15610,6.6,16514,193,64,-1260,-1432,25.7,1561.0
4857624281,0,13,0,1,1,8,0,1,1,0,0,13939,6.6,16661,209,59,-2072,-1665,26.8,1393.9,10,1,0,8,1,5,0,0,0,0,16011,7.2,18326,190,60,2072,1665,25.0,1601.1
4856993629,1,77,1,0,5,6,2,0,0,0,0,16988,7.0,18848,251,48,182,503,29.9,1698.8,12,2,1,6,5,11,0,0,0,0,16806,7.0,18345,219,48,-182,-503,26.7,1680.6
4856675279,1,176,0,1,22,13,18,0,0,0,0,48400,10.0,47500,0,0,21594,18900,0.0,4840.0,176,0,0,4,13,9,0,0,0,0,26806,6.0,28600,0,0,-21594,-18900,0.0,2680.6
4856669373,1,0,0,1,17,16,22,0,0,0,0,61382,12.0,55000,2,0,24160,22000,0.2,6138.2,15,0,0,10,11,9,0,0,0,0,37222,7.2,33000,0,0,-24160,-22000,0.0,3722.2
4856668844,1,2,0,1,22,17,23,0,0,0,0,64800,12.0,55000,0,0,28300,22000,0.0,6480.0,3,0,0,9,14,8,0,0,0,0,36500,7.2,33000,0,0,-28300,-22000,0.0,3650.0
4856662877,1,0,0,1,10,17,7,0,0,0,0,45250,10.0,47500,0,0,17400,19000,0.0,4525.0,0,0,0,11,4,12,0,0,0,0,27850,6.0,28500,0,0,-17400,-19000,0.0,2785.0
4856649319,0,8,3,1,8,6,10,1,1,0,0,17399,6.6,16392,178,52,113,-887,23.0,1739.9,80,1,0,6,8,4,1,0,1,0,17286,6.8,17279,198,56,-113,887,25.4,1728.6
4856401489,0,2,0,1,23,27,51,0,0,0,1,38004,11.2,42002,115,0,197,-30,11.5,3800.4,0,0,0,27,23,66,0,0,0,0,37807,11.4,42032,101,0,-197,30,10.1,3780.7
4856381395,1,0,3,0,27,28,68,0,0,0,1,38956,11.2,41379,116,0,103,133,11.6,3895.6,7,0,1,28,27,81,0,0,0,0,38853,11.0,41246,111,0,-103,-133,11.1,3885.3
4854337940,1,0,0,0,13,15,18,0,0,0,0,46315,10.0,47500,0,0,18815,19000,0.0,4631.5,2,0,1,10,8,8,0,0,0,0,27500,6.0,28500,0,0,-18815,-19000,0.0,2750.0
4854321305,1,90,0,0,15,16,12,0,0,0,0,46007,10.0,47500,0,1,17412,19000,0.1,4600.7,0,0,1,8,7,11,0,0,0,0,28595,6.0,28500,0,0,-17412,-19000,0.0,2859.5
4854309205,1,0,0,1,12,19,14,0,0,0,0,45454,10.0,47500,4,0,16744,19000,0.4,4545.4,0,0,0,14,7,9,0,0,0,0,28710,6.0,28500,2,0,-16744,-19000,0.2,2871.0
4853878262,1,0,0,1,14,17,16,0,0,0,0,45950,10.0,47500,0,0,16700,17820,0.0,4595.0,0,0,0,11,8,10,0,0,0,0,29250,6.2,29680,0,0,-16700,-17820,0.0,2925.0
4853812648,0,17,1,0,8,7,8,0,0,0,0,16876,6.6,17152,198,54,493,-724,25.2,1687.6,46,1,1,7,8,3,0,0,0,0,16383,6.8,17876,191,53,-493,724,24.4,1638.3
4853774690,1,12,0,1,8,1,5,0,0,0,0,18366,7.0,18669,206,39,3611,1324,24.5,1836.6,17,1,0,1,8,1,1,1,0,0,14755,6.8,17345,199,64,-3611,-1324,26.3,1475.5
4853747211,0,8,11,0,1,6,0,0,0,0,0,13899,6.6,16108,176,56,-3951,-2378,23.2,1389.9,39,1,1,6,1,7,1,1,0,0,17850,7.0,18486,206,56,3951,2378,26.2,1785.0
4855008210,0,0,0,0,21,21,55,0,0,0,1,36025,11.0,38907,90,0,-1500,-1049,9.0,3602.5,0,0,1,21,21,46,0,0,0,0,37525,11.0,39956,113,0,1500,1049,11.3,3752.5
4850905976,0,11,2,0,3,2,2,1,1,0,0,15945,7.2,19132,237,68,-228,655,30.5,1594.5,15,2,1,2,3,2,0,0,0,0,16173,7.0,18477,230,56,228,-655,28.6,1617.3
4850205833,1,0,0,0,39,27,119,0,0,0,1,41998,11.6,45865,108,0,153,-354,10.8,4199.8,133,0,1,27,39,66,0,0,0,0,41845,12.0,46219,113,0,-153,354,11.3,4184.5
4850182235,1,22,0,0,17,25,46,0,0,0,0,35328,10.4,36909,95,0,-996,-2039,9.5,3532.8,19,3,1,25,17,69,0,0,0,0,36324,11.0,38948,98,0,996,2039,9.8,3632.4
4846105286,1,0,0,1,28,21,86,0,0,0,3,39111,11.0,40172,107,0,2103,754,10.7,3911.1,0,0,0,21,28,47,0,0,0,0,37008,10.8,39418,101,0,-2103,-754,10.1,3700.8
4846087777,0,9,1,1,18,20,30,0,0,0,1,35963,10.8,38550,110,0,-737,-36,11.0,3596.3,11,1,0,20,18,57,0,0,0,0,36700,11.0,38586,106,0,737,36,10.6,3670.0
4846059808,1,25,0,1,19,19,41,0,0,0,0,36440,10.8,39207,105,0,-103,255,10.5,3644.0,13,11,0,19,19,58,0,0,0,0,36543,11.0,38952,111,0,103,-255,11.1,3654.3
4844357710,1,0,0,1,26,19,77,0,0,0,1,37288,11.0,39700,109,0,1805,1325,10.9,3728.8,0,0,0,19,26,51,0,0,0,0,35483,10.8,38375,104,0,-1805,-1325,10.4,3548.3
4844344071,1,30,0,1,28,16,77,0,0,0,0,39076,11.4,42213,92,0,3796,4579,9.2,3907.6,0,2,0,16,28,30,0,0,0,0,35280,11.0,37634,105,0,-3796,-4579,10.5,3528.0
4842438402,0,11,1,1,5,3,6,0,0,0,0,15549,6.6,17494,219,40,-924,-1279,25.9,1554.9,22,1,0,3,5,2,0,0,0,0,16473,7.2,18773,244,64,924,1279,30.8,1647.3
4842386222,1,9,0,1,5,5,4,0,0,0,0,16864,7.0,17808,199,52,1824,480,25.1,1686.4,14,0,0,5,5,3,0,0,0,0,15040,6.6,17328,197,52,-1824,-480,24.9,1504.0
4837265955,0,0,0,1,28,35,72,0,0,0,0,37254,11.4,41774,80,0,-3284,-3919,8.0,3725.4,0,0,0,35,28,54,0,0,0,0,40538,11.8,45693,104,0,3284,3919,10.4,4053.8
4837234063,0,43,0,0,14,18,40,0,0,0,0,31709,10.8,37484,92,59,-2379,-2245,15.1,3170.9,14,0,1,18,14,39,0,0,0,0,34088,11.2,39729,104,55,2379,2245,15.9,3408.8
4828746797,1,0,0,1,31,33,76,0,0,0,0,40481,11.8,45220,109,0,603,1149,10.9,4048.1,12,0,0,33,31,85,0,0,0,0,39878,11.8,44071,113,0,-603,-1149,11.3,3987.8
4828721955,1,0,0,0,21,22,53,0,0,0,0,36709,10.8,38726,115,0,23,454,11.5,3670.9,0,0,1,22,21,56,0,0,0,0,36686,11.0,38272,96,0,-23,-454,9.6,3668.6
4828692318,0,17,0,0,19,12,43,0,0,0,1,37006,10.8,38579,71,65,2747,1686,13.6,3700.6,43,0,1,11,18,26,0,0,0,0,34259,10.6,36893,58,39,-2747,-1686,9.7,3425.9
4827938536,0,11,0,0,4,5,2,0,0,0,0,15047,7.0,18027,174,50,-1588,-303,22.4,1504.7,13,0,1,5,4,5,1,1,0,0,16635,6.6,18330,191,72,1588,303,26.3,1663.5
4827894251,1,12,2,0,11,1,4,0,0,0,0,19049,7.6,20577,231,72,6171,4499,30.3,1904.9,13,0,1,1,11,0,0,0,0,0,12878,6.4,16078,173,52,-6171,-4499,22.5,1287.8
4826513555,1,10,1,1,4,8,1,0,0,0,0,15824,7.0,18129,231,68,-1067,-64,29.9,1582.4,79,1,0,8,4,8,1,1,0,0,16891,7.0,18193,205,56,1067,64,26.1,1689.1
4826475762,0,16,2,0,2,4,2,0,0,0,0,14638,7.0,18112,234,48,-1144,-375,28.2,1463.8,15,1,1,4,2,4,0,0,0,0,15782,6.8,18487,228,52,1144,375,28.0,1578.2
4856975705,1,13,2,1,8,4,8,1,1,0,0,18400,7.2,19049,214,64,2765,1800,27.8,1840.0,11,0,0,4,8,5,0,0,0,0,15635,6.6,17249,197,48,-2765,-1800,24.5,1563.5
4856946716,1,36,3,0,14,11,20,0,0,0,0,21194,6.8,17080,201,44,2836,1820,24.5,2119.4,36,3,1,11,14,21,0,0,0,0,18358,6.4,15260,161,44,-2836,-1820,20.5,1835.8
4856927150,0,12,1,1,6,4,6,0,0,0,0,17316,6.8,18048,220,68,281,-1047,28.8,1731.6,12,1,0,4,6,2,0,0,0,0,17035,7.0,19095,244,72,-281,1047,31.6,1703.5
4856565937,0,14,1,0,3,6,1,1,1,0,0,14721,6.6,15916,191,52,-1372,-2127,24.3,1472.1,4,4,1,6,3,5,0,0,0,0,16093,7.0,18043,201,48,1372,2127,24.9,1609.3
4856533157,0,32,3,0,2,1,0,0,0,0,0,15340,7.2,19268,237,55,-771,208,29.2,1534.0,32,1,1,1,2,2,0,0,0,0,16111,7.2,19060,235,76,771,-208,31.1,1611.1
4856499658,1,49,2,1,6,3,7,0,0,0,0,16075,6.6,17162,188,50,943,80,23.8,1607.5,8,1,0,3,6,5,0,0,0,0,15132,6.8,17082,204,50,-943,-80,25.4,1513.2
4855396241,1,14,0,1,6,2,6,0,0,0,0,17636,7.0,19406,233,47,4066,3045,28.0,1763.6,11,1,0,2,6,0,0,0,0,0,13570,6.6,16361,180,56,-4066,-3045,23.6,1357.0
4855371123,0,9,2,0,1,4,1,0,0,0,0,15329,7.0,17931,198,49,-1347,-1569,24.7,1532.9,11,1,1,4,1,1,1,1,0,0,16676,7.2,19500,235,74,1347,1569,30.9,1667.6
4855015615,0,31,0,1,3,4,4,0,0,0,0,15211,6.6,16929,207,52,-1292,-1167,25.9,1521.1,41,1,0,4,3,2,1,0,1,0,16503,6.8,18096,221,56,1292,1167,27.7,1650.3
4854973122,1,15,1,1,7,5,12,0,0,0,0,17507,6.8,17282,231,40,1794,-125,27.1,1750.7,11,0,0,5,7,2,0,0,0,0,15713,7.0,17407,179,64,-1794,125,24.3,1571.3
4854936824,1,19,1,0,4,5,5,0,0,0,0,16439,6.8,18774,210,60,263,1282,27.0,1643.9,13,2,1,5,4,10,0,0,0,0,16176,6.6,17492,230,52,-263,-1282,28.2,1617.6
4854061866,1,9,0,0,5,5,4,1,1,0,0,16965,7.0,18182,213,64,634,-232,27.7,1696.5,11,1,1,5,5,5,0,0,0,0,16331,7.0,18414,226,60,-634,232,28.6,1633.1
4853997408,0,13,3,1,1,5,1,1,1,0,0,15706,6.8,18600,197,60,-747,-113,25.7,1570.6,7,0,0,5,1,2,0,0,0,0,16453,7.2,18713,228,56,747,113,28.4,1645.3
4853932307,0,13,0,1,5,6,4,0,0,0,0,16351,6.6,17542,203,52,-1261,383,25.5,1635.1,13,1,0,6,5,6,0,0,0,0,17612,6.8,17159,206,56,1261,-383,26.2,1761.2
4852904715,0,13,1,0,7,9,4,0,0,0,0,15982,6.6,17139,202,52,-2480,-1000,25.4,1598.2,15,0,1,9,7,6,0,0,0,0,18462,7.0,18139,191,64,2480,1000,25.5,1846.2
4851026462,0,10,0,1,5,4,8,0,0,0,0,17099,6.6,17750,205,48,1929,-422,25.3,1709.9,14,1,0,4,5,1,1,1,0,0,15170,6.8,18172,219,60,-1929,422,27.9,1517.0
4851003386,1,19,1,1,3,2,1,0,0,0,0,14714,7.0,18006,205,68,212,-174,27.3,1471.4,9,1,0,2,3,0,0,0,0,0,14502,6.8,18180,232,52,-212,174,28.4,1450.2
4850131717,0,8,0,0,4,6,3,0,0,0,0,15075,6.6,17135,199,54,-1389,-685,25.3,1507.5,10,1,1,6,4,7,1,1,0,0,16464,6.8,17820,225,64,1389,685,28.9,1646.4
4850096395,0,12,0,0,4,8,4,0,0,0,0,17025,6.8,17535,224,46,-1076,-1541,27.0,1702.5,11,1,1,8,4,7,0,0,0,0,18101,7.2,19076,241,60,1076,1541,30.1,1810.1
4850038082,0,11,0,1,7,2,7,0,0,0,0,17720,7.0,18590,223,51,3051,1222,27.4,1772.0,12,2,0,2,7,1,1,1,0,0,14669,7.0,17368,178,60,-3051,-1222,23.8,1466.9
4759702330,1,29,0,0,8,10,8,0,0,0,0,18539,7.0,18338,218,59,844,354,27.7,1853.9,12,0,1,10,8,8,0,0,0,0,17695,6.8,17984,205,54,-844,-354,25.9,1769.5
4758652237,1,14,6,1,13,3,9,2,1,1,0,21291,7.6,20936,224,60,3942,2951,28.4,2129.1,19,1,0,3,13,2,0,0,0,0,17349,6.8,17985,207,68,-3942,-2951,27.5,1734.9
4748502066,1,12,1,0,4,3,6,0,0,0,0,16796,7.2,18462,205,56,-21,-971,26.1,1679.6,13,1,1,3,4,5,0,0,0,0,16817,7.2,19433,265,62,21,971,32.7,1681.7
4748463012,0,9,0,0,2,12,1,0,0,0,0,15002,7.0,16940,181,60,-5471,-1766,24.1,1500.2,9,0,1,12,2,20,1,1,0,0,20473,7.2,18706,240,50,5471,1766,29.0,2047.3
4748421373,0,12,1,1,8,8,7,0,0,0,0,17529,6.8,17550,196,50,-1122,786,24.6,1752.9,31,3,0,8,8,11,0,0,0,0,18651,6.6,16764,238,44,1122,-786,28.2,1865.1
4748368411,1,16,3,1,12,4,10,1,1,0,0,18372,7.2,17737,205,56,2666,831,26.1,1837.2,14,1,0,4,12,4,1,0,1,0,15706,6.8,16906,228,48,-2666,-831,27.6,1570.6
4298340758,0,15,2,0,6,4,6,1,1,0,0,17122,7.2,19296,221,60,-1214,-43,28.1,1712.2,15,3,1,4,6,5,0,0,0,0,18336,7.2,19339,221,52,1214,43,27.3,1833.6
4298266260,0,14,0,1,2,5,1,0,0,0,0,14671,7.0,17322,199,63,-2262,-2089,26.2,1467.1,20,1,0,5,2,4,0,0,0,0,16933,7.2,19411,228,53,2262,2089,28.1,1693.3
4298252947,0,13,2,0,2,3,4,0,0,0,0,14138,6.6,17487,206,44,-2695,-2571,25.0,1413.8,13,1,1,3,2,1,1,1,0,0,16833,7.2,20058,249,79,2695,2571,32.8,1683.3
4298198786,0,15,1,0,4,4,2,1,1,0,0,15601,7.0,18375,201,68,-996,-248,26.9,1560.1,13,0,1,4,4,3,1,0,1,0,16597,7.4,18623,202,48,996,248,25.0,1659.7
4298195529,1,13,0,1,5,6,3,0,0,0,0,17457,7.2,19753,213,60,333,-862,27.3,1745.7,12,3,0,6,5,3,1,1,0,0,17124,7.4,20615,237,72,-333,862,30.9,1712.4
4297589641,0,13,1,0,2,15,1,0,0,0,0,14415,6.4,15568,196,57,-7824,-6081,25.3,1441.5,13,2,1,15,2,11,0,0,0,0,22239,8.0,21649,230,59,7824,6081,28.9,2223.9
4293579754,0,21,0,0,6,11,9,0,0,0,0,17678,6.8,17939,162,36,-524,-497,19.8,1767.8,13,1,1,11,6,7,2,1,1,0,18202,7.2,18436,229,57,524,497,28.6,1820.2
4293524368,0,12,1,0,6,10,6,0,0,0,0,15187,6.6,16616,173,52,-4605,-1940,22.5,1518.7,14,2,1,10,6,13,1,1,0,0,19792,7.2,18556,229,64,4605,1940,29.3,1979.2
4293490611,0,13,2,0,8,8,10,0,0,0,0,16204,6.8,16479,168,44,-2990,-2644,21.2,1620.4,13,2,1,8,8,4,1,1,0,0,19194,7.2,19123,213,71,2990,2644,28.4,1919.4
4293432853,0,16,3,1,6,6,6,0,0,0,0,17389,7.2,18208,229,38,86,233,26.7,1738.9,15,3,0,6,6,7,0,0,0,0,17303,7.0,17975,229,60,-86,-233,28.9,1730.3
4288348932,0,10,3,0,7,8,6,0,0,0,0,15868,6.6,16768,175,36,-4964,-2499,21.1,1586.8,16,2,1,8,7,8,1,0,1,0,20832,7.2,19267,210,76,4964,2499,28.6,2083.2
4288362879,0,13,2,0,4,14,5,0,0,0,0,14842,6.4,15404,182,44,-9414,-5929,22.6,1484.2,14,3,1,14,4,12,1,0,1,0,24256,7.6,21333,272,59,9414,5929,33.1,2425.6
4858460796,1,0,0,0,16,18,18,0,0,0,0,61650,12.0,55000,0,0,24800,22000,0.0,6165.0,0,0,1,12,10,10,0,0,0,0,36850,7.2,33000,0,0,-24800,-22000,0.0,3685.0
4858435500,1,27,2,1,17,18,15,0,0,0,0,46785,10.0,47500,5,0,17535,19000,0.5,4678.5,0,0,0,9,8,11,0,0,0,0,29250,6.0,28500,0,0,-17535,-19000,0.0,2925.0
4858410136,1,1,0,1,13,17,15,0,0,0,0,61650,12.0,55000,0,0,24100,22000,0.0,6165.0,0,0,0,13,9,8,0,0,0,0,37550,7.2,33000,0,0,-24100,-22000,0.0,3755.0
4858382844,1,41,0,0,15,21,20,0,0,0,0,46300,10.0,47500,0,0,18800,19000,0.0,4630.0,0,0,1,12,6,10,0,0,0,0,27500,6.0,28500,0,0,-18800,-19000,0.0,2750.0
4858116383,0,11,0,0,8,8,8,0,0,0,0,16910,6.6,16920,229,40,188,-1004,26.9,1691.0,11,1,1,7,7,6,0,0,0,0,16722,6.8,17924,228,40,-188,1004,26.8,1672.2
4858082351,1,15,1,0,1,4,0,0,0,0,0,14098,6.8,18076,181,56,-1930,884,23.7,1409.8,12,2,1,4,1,4,1,1,0,0,16028,7.0,17192,202,60,1930,-884,26.2,1602.8
4858064467,1,29,2,1,15,16,14,0,0,0,0,61415,12.8,59000,4,0,24900,26000,0.4,6141.5,0,3,0,8,7,9,0,0,0,0,36515,7.2,33000,0,0,-24900,-26000,0.0,3651.5
4857935119,1,234,0,1,19,15,17,0,0,0,0,61008,12.0,55000,1,0,23440,22000,0.1,6100.8,0,0,0,7,11,8,0,0,0,0,37568,7.2,33000,0,0,-23440,-22000,0.0,3756.8
4857901807,1,0,0,0,13,18,13,0,0,0,0,45260,10.0,47500,0,0,16685,19000,0.0,4526.0,0,0,1,11,6,12,0,0,0,0,28575,6.0,28500,0,0,-16685,-19000,0.0,2857.5
4857882453,1,3,0,1,17,13,15,0,0,0,0,46670,10.0,47500,0,0,20900,19000,0.0,4667.0,2,0,0,5,9,5,0,0,0,0,25770,6.0,28500,0,0,-20900,-19000,0.0,2577.0
4857457772,1,26,1,0,12,20,15,0,0,0,0,47705,10.2,48680,12,0,18980,20180,1.2,4770.5,3,2,1,16,8,10,0,0,0,0,28725,6.0,28500,0,0,-18980,-20180,0.0,2872.5
4857428019,1,112,0,0,13,17,14,0,0,0,0,47842,10.0,47500,2,0,18085,19000,0.2,4784.2,26,0,1,14,10,11,0,0,0,0,29757,6.0,28500,2,0,-18085,-19000,0.2,2975.7
4857378752,1,6,0,1,18,16,19,0,0,0,0,60250,12.0,55000,0,0,23400,22000,0.0,6025.0,4,0,0,10,12,10,0,0,0,0,36850,7.2,33000,0,0,-23400,-22000,0.0,3685.0
4857355985,1,332,0,0,16,23,16,0,0,0,0,62000,12.0,55000,0,0,23375,22000,0.0,6200.0,5,0,1,13,6,16,0,0,0,0,38625,7.2,33000,1,0,-23375,-22000,0.1,3862.5
4857066046,1,66,0,0,20,16,20,0,0,0,0,64800,12.0,55000,0,0,26200,22000,0.0,6480.0,0,0,1,9,13,11,0,0,0,0,38600,7.2,33000,0,0,-26200,-22000,0.0,3860.0
4857048917,1,19,0,0,17,16,17,0,0,0,0,60950,12.8,59000,0,0,23400,26000,0.0,6095.0,5,0,1,10,11,9,0,0,0,0,37550,7.2,33000,0,0,-23400,-26000,0.0,3755.0
4856999430,1,4,0,1,25,12,15,0,0,0,0,63780,12.0,55000,0,0,25515,22000,0.0,6378.0,89,0,0,4,17,12,0,0,0,0,38265,7.2,33000,0,0,-25515,-22000,0.0,3826.5
4856508213,1,0,0,1,14,18,17,0,0,0,0,47700,10.0,47500,0,0,17400,19000,0.0,4770.0,5,0,0,16,12,14,0,0,0,0,30300,6.0,28500,0,0,-17400,-19000,0.0,3030.0
4856483730,1,5,0,0,16,19,24,0,0,0,0,56350,12.0,55000,0,0,20950,22000,0.0,5635.0,2,0,1,16,13,14,0,0,0,0,35400,7.2,33000,1,0,-20950,-22000,0.1,3540.0
4856061489,1,0,0,0,19,19,25,0,0,0,0,49058,10.6,50500,1,0,20158,22000,0.1,4905.8,0,0,1,12,12,7,0,0,0,0,28900,6.0,28500,0,0,-20158,-22000,0.0,2890.0
4839968981,1,31,1,1,4,5,3,0,0,0,0,16548,6.8,18380,230,45,-1333,328,27.5,1654.8,35,0,0,5,4,7,0,0,0,0,17881,7.0,18052,205,46,1333,-328,25.1,1788.1
4839934729,1,14,2,0,8,6,6,1,1,0,0,18545,7.2,19110,223,60,3632,2525,28.3,1854.5,14,0,1,6,8,2,0,0,0,0,14913,6.8,16585,171,35,-3632,-2525,20.6,1491.3
4839906424,0,19,2,1,5,5,5,0,0,0,0,18038,7.2,18582,243,60,2637,1503,30.3,1803.8,11,0,0,5,5,3,1,1,0,0,15401,6.8,17079,218,48,-2637,-1503,26.6,1540.1
4825844548,1,0,0,1,31,22,95,0,0,0,2,41425,12.0,45927,124,0,5041,6939,12.4,4142.5,0,0,0,22,31,60,0,0,0,0,36384,10.8,38988,99,0,-5041,-6939,9.9,3638.4
4825816743,0,26,4,1,23,20,53,0,0,0,1,38064,11.2,40527,118,0,1280,-737,11.8,3806.4,11,7,0,20,23,57,0,0,0,0,36784,11.4,41264,120,0,-1280,737,12.0,3678.4
4825791025,0,7,0,0,16,22,29,0,0,0,1,36184,11.0,38690,93,0,-2079,-675,9.3,3618.4,0,2,1,22,16,59,0,0,0,0,38263,10.8,39365,121,0,2079,675,12.1,3826.3
4825776171,0,26,0,1,13,29,38,0,0,0,1,34166,10.4,37306,61,0,-6637,-5745,6.1,3416.6,3,0,0,29,13,83,0,0,0,0,40803,11.6,43051,129,0,6637,5745,12.9,4080.3
4825748404,0,0,0,0,25,36,63,0,0,0,0,37434,11.0,39778,94,0,-4563,-6779,9.4,3743.4,0,0,1,36,25,86,0,0,0,0,41997,11.8,46557,109,0,4563,6779,10.9,4199.7
4825454527,0,34,0,1,21,21,48,0,0,0,1,39445,11.2,41776,116,0,1134,470,11.6,3944.5,34,0,0,21,21,42,0,0,0,0,38311,11.4,41306,106,0,-1134,-470,10.6,3831.1
4825401180,1,0,0,1,32,24,84,0,0,0,1,39486,11.4,43065,122,0,2378,3098,12.2,3948.6,0,0,0,24,32,49,0,0,0,0,37108,11.0,39967,106,0,-2378,-3098,10.6,3710.8
4825367690,0,0,0,1,23,25,63,0,0,0,1,36774,10.6,38453,82,0,-3947,-3166,8.2,3677.4,0,0,0,25,23,78,0,0,0,0,40721,11.2,41619,115,0,3947,3166,11.5,4072.1
4824907814,0,17,1,1,26,30,73,0,0,0,0,40201,11.8,44141,117,0,2393,-178,11.7,4020.1,19,0,0,30,26,79,0,0,0,0,37808,11.8,44319,102,0,-2393,178,10.2,3780.8
4824884877,1,18,0,0,26,18,72,0,0,0,0,36782,11.4,40938,87,0,2219,3219,8.7,3678.2,0,0,1,17,25,33,0,0,0,0,34563,10.8,37719,118,0,-2219,-3219,11.8,3456.3
4824580736,0,0,0,0,25,28,59,0,0,0,1,38432,11.6,42145,94,0,-391,-1889,9.4,3843.2,0,0,1,28,25,73,0,0,0,0,38823,11.6,44034,115,0,391,1889,11.5,3882.3
4824565893,0,0,0,1,24,13,71,0,0,0,0,35165,10.8,37706,97,0,-1851,-1766,9.7,3516.5,0,0,0,13,24,33,0,0,0,0,37016,11.0,39472,104,0,1851,1766,10.4,3701.6
4824528737,0,0,0,0,27,25,56,0,0,0,0,37025,11.2,42357,108,0,-477,1083,10.8,3702.5,0,0,1,25,27,59,0,0,0,0,37502,11.2,41274,114,0,477,-1083,11.4,3750.2
4824516047,1,0,0,0,28,29,78,0,0,0,2,40855,11.6,43995,107,0,375,709,10.7,4085.5,0,0,1,29,28,77,0,0,0,0,40480,11.6,43286,106,0,-375,-709,10.6,4048.0
4824465446,0,11,2,1,8,10,15,0,0,0,0,17550,6.0,14499,176,36,-747,-2136,21.2,1755.0,12,1,0,10,8,9,0,0,0,0,18297,6.6,16635,221,32,747,2136,25.3,1829.7
4824417443,1,69,3,0,7,4,8,2,1,1,0,16810,6.8,17926,226,48,1444,1400,27.4,1681.0,16,1,1,4,7,9,0,0,0,0,15366,6.6,16526,216,44,-1444,-1400,26.0,1536.6
4824391281,0,9,0,1,5,3,2,0,0,0,0,15957,7.2,18274,224,44,1673,1075,26.8,1595.7,11,0,0,1,3,1,0,0,0,0,14284,6.8,17199,227,48,-1673,-1075,27.5,1428.4
4858302754,1,93,0,1,12,15,22,0,0,0,0,45275,10.0,47500,1,0,18800,19000,0.1,4527.5,40,0,0,12,9,4,0,0,0,0,26475,6.0,28500,1,0,-18800,-19000,0.1,2647.5
4858270102,1,16,0,1,9,20,14,0,0,0,0,44625,10.6,50500,2,0,15350,22000,0.2,4462.5,5,0,0,17,6,13,0,0,0,0,29275,6.0,28500,1,0,-15350,-22000,0.1,2927.5
4858184274,0,15,1,0,4,5,4,0,0,0,0,15370,6.6,16796,208,59,-2003,-1321,26.7,1537.0,15,1,1,5,4,3,0,0,0,0,17373,7.0,18117,219,56,2003,1321,27.5,1737.3
4858144470,1,13,1,1,3,2,2,1,0,1,0,16109,7.2,18869,210,62,772,906,27.2,1610.9,12,1,0,2,3,2,1,1,0,0,15337,6.8,17963,229,62,-772,-906,29.1,1533.7
4855321503,0,0,0,1,28,24,61,0,0,0,1,38813,11.2,41442,117,0,2500,1133,11.7,3881.3,0,0,0,23,27,55,0,0,0,0,36313,11.2,40309,91,0,-2500,-1133,9.1,3631.3
4855291531,0,8,0,0,23,27,70,0,0,0,0,36952,11.2,40024,70,0,-1257,-2517,7.0,3695.2,4,0,1,27,23,79,0,0,0,0,38209,11.4,42541,104,0,1257,2517,10.4,3820.9
4855272958,1,0,0,1,21,29,40,0,0,0,0,35359,10.6,37444,126,0,-3403,-3357,12.6,3535.9,6,0,0,29,21,71,0,0,0,0,38762,11.4,40801,106,0,3403,3357,10.6,3876.2
4855224585,1,4,0,1,31,28,68,0,0,0,1,40106,11.4,43853,112,0,3493,335,11.2,4010.6,89,2,0,28,31,61,0,0,0,0,36613,11.6,43518,92,0,-3493,-335,9.2,3661.3
4853989024,0,0,0,1,27,31,79,0,0,0,0,38104,11.6,43437,103,0,-2122,-2613,10.3,3810.4,0,0,0,31,27,77,0,0,0,0,40226,12.0,46050,100,0,2122,2613,10.0,4022.6
4852726476,1,0,0,0,13,11,41,0,0,0,1,33618,10.6,35968,104,0,607,346,10.4,3361.8,19,0,1,11,13,26,0,0,0,0,33011,10.4,35622,86,0,-607,-346,8.6,3301.1
4852711753,1,0,0,1,24,16,77,0,0,0,1,38468,11.2,41555,111,0,5115,6580,11.1,3846.8,0,0,0,16,24,34,0,0,0,0,33353,10.4,34975,70,0,-5115,-6580,7.0,3335.3
4852687985,1,0,0,0,30,21,76,0,0,0,1,38941,11.6,42413,109,0,3917,3566,10.9,3894.1,140,0,1,20,29,46,0,0,0,0,35024,11.0,38847,96,0,-3917,-3566,9.6,3502.4
4852652243,1,1,0,1,20,24,52,0,0,0,0,36610,11.2,40911,103,0,829,1308,10.3,3661.0,26,0,0,24,20,55,0,0,0,0,35781,10.8,39603,100,0,-829,-1308,10.0,3578.1
4852441205,1,12,0,1,9,6,9,0,0,0,0,17111,7.0,17975,185,59,202,-28,24.4,1711.1,8,1,0,6,9,5,0,0,0,0,16909,6.8,18003,230,48,-202,28,27.8,1690.9
4851957330,0,1,0,0,15,21,33,0,0,0,0,36093,10.8,38369,109,0,343,-990,10.9,3609.3,92,0,1,21,15,53,0,0,0,0,35750,10.8,39359,112,0,-343,990,11.2,3575.0
4851923686,0,3,0,1,35,34,100,0,0,0,1,40020,11.8,45214,90,0,-1544,-415,9.0,4002.0,12,0,0,34,35,95,0,0,0,0,41564,11.8,45629,107,0,1544,415,10.7,4156.4
4851908847,0,0,0,0,18,36,33,0,0,0,2,36127,10.8,37663,104,0,-6472,-8876,10.4,3612.7,19,0,1,36,18,101,0,0,0,0,42599,12.2,46539,112,0,6472,8876,11.2,4259.9
4850048028,0,0,0,1,24,25,63,0,0,0,2,38032,10.8,40207,102,0,398,-1123,10.2,3803.2,0,0,0,25,24,58,0,0,0,0,37634,11.2,41330,102,0,-398,1123,10.2,3763.4
4849206889,0,0,0,0,22,26,46,0,0,0,1,35993,10.6,38389,83,0,-2886,-2647,8.3,3599.3,0,0,1,26,22,75,0,0,0,0,38879,11.2,41036,127,0,2886,2647,12.7,3887.9
4849186640,0,92,0,0,22,29,52,0,0,0,1,36904,11.2,41753,94,0,-3217,-1982,9.4,3690.4,0,0,1,29,22,45,0,0,0,0,40121,11.4,43735,103,0,3217,1982,10.3,4012.1
4851172911,1,38,0,0,10,5,10,0,0,0,0,18480,6.8,17081,181,48,2556,-290,22.9,1848.0,40,2,1,5,10,3,0,0,0,0,15924,6.6,17371,185,54,-2556,290,23.9,1592.4
4851155011,0,35,16,0,4,10,5,0,0,0,0,17082,6.8,17452,186,64,-593,588,25.0,1708.2,46,0,1,10,4,15,1,1,0,0,17675,6.8,16864,184,48,593,-588,23.2,1767.5
4851129364,0,14,2,0,7,5,11,0,0,0,0,16983,6.8,17865,211,44,-220,-1606,25.5,1698.3,15,1,1,5,7,2,0,0,0,0,17203,7.4,19471,232,64,220,1606,29.6,1720.3
4851106121,1,13,2,0,5,9,6,0,0,0,0,18135,6.8,17132,203,36,144,201,23.9,1813.5,14,0,1,9,5,6,1,1,0,0,17991,6.8,16931,195,64,-144,-201,25.9,1799.1
4840475868,0,10,1,0,7,10,2,1,1,0,0,16326,7.0,17629,152,58,-1861,-88,21.0,1632.6,83,0,1,10,7,3,0,0,0,0,18187,6.8,17717,204,42,1861,88,24.6,1818.7
4840427276,1,10,0,0,3,4,3,0,0,0,0,15494,7.0,17630,199,52,-1836,-1389,25.1,1549.4,9,2,1,4,3,5,0,0,0,0,17330,7.0,19019,203,54,1836,1389,25.7,1733.0
4840365072,1,11,2,0,7,6,5,1,1,0,0,17554,6.8,17108,219,40,1712,-1021,25.9,1755.4,14,1,1,6,7,2,0,0,0,0,15842,7.0,18129,180,56,-1712,1021,23.6,1584.2
4840329850,0,52,0,0,1,3,2,0,0,0,0,13940,6.6,16906,182,48,-1019,-232,23.0,1394.0,12,1,1,3,1,5,0,0,0,0,14959,6.4,17138,213,52,1019,232,26.5,1495.9
4839938971,1,7,1,1,7,4,3,0,0,0,0,16578,7.0,18642,194,48,1646,1422,24.2,1657.8,13,0,0,4,7,3,0,0,0,0,14932,6.6,17220,188,49,-1646,-1422,23.7,1493.2
4839359439,0,47,0,1,3,3,2,0,0,0,0,14854,6.8,18006,202,50,-187,351,25.2,1485.4,15,1,0,3,3,1,0,0,0,0,15041,6.8,17655,181,67,187,-351,24.8,1504.1
4839324391,1,36,1,0,8,7,8,0,0,0,0,18093,7.0,17645,214,40,1627,-399,25.4,1809.3,12,16,1,7,8,2,1,1,0,0,16466,7.0,18044,195,40,-1627,399,23.5,1646.6
4838433049,0,11,2,0,2,1,4,0,0,0,0,15709,7.2,19097,250,56,-186,-933,30.6,1570.9,81,0,1,1,2,1,1,1,0,0,15895,7.4,20030,226,72,186,933,29.8,1589.5
4838399208,1,12,0,1,4,0,5,0,0,0,0,15541,6.8,18333,191,58,2777,2082,24.9,1554.1,11,2,0,0,4,0,0,0,0,0,12764,6.4,16251,203,36,-2777,-2082,23.9,1276.4
4838350579,1,11,10,0,3,6,2,0,0,0,0,15113,6.8,17728,213,48,-1900,-919,26.1,1511.3,32,0,1,6,3,4,0,0,0,0,17013,7.2,18647,231,68,1900,919,29.9,1701.3
4838316958,1,17,1,0,7,4,11,0,0,0,0,17934,7.0,18361,226,46,1678,1685,27.2,1793.4,13,1,1,4,7,5,0,0,0,0,16256,6.6,16676,195,46,-1678,-1685,24.1,1625.6
4838069977,0,0,0,0,16,29,33,0,0,0,1,35223,10.6,38049,86,0,-4795,-5906,8.6,3522.3,0,0,1,29,16,84,0,0,0,0,40018,11.6,43955,118,0,4795,5906,11.8,4001.8
4838028495,1,20,1,1,5,3,10,0,0,0,0,16616,6.8,18141,236,60,1812,726,29.6,1661.6,10,1,0,3,5,4,0,0,0,0,14804,6.6,17415,192,52,-1812,-726,24.4,1480.4
4837060008,1,12,0,0,4,4,1,0,0,0,0,16105,6.8,18196,201,48,179,88,24.9,1610.5,15,0,1,4,4,7,0,0,0,0,15926,7.0,18108,178,64,-179,-88,24.2,1592.6
4837012833,0,14,3,1,10,6,8,1,0,1,0,17866,6.6,16733,176,52,610,-304,22.8,1786.6,13,2,0,6,10,4,0,0,0,0,17256,6.6,17037,179,52,-610,304,23.1,1725.6
4836962435,0,9,0,1,4,5,3,0,0,0,0,15342,6.8,17589,208,48,-1739,-1125,25.6,1534.2,17,1,0,5,4,5,0,0,0,0,17081,7.2,18714,222,52,1739,1125,27.4,1708.1
4858377995,0,11,1,1,9,4,13,0,0,0,0,17835,6.8,17433,203,40,1809,279,24.3,1783.5,10,1,0,4,9,5,0,0,0,0,16026,6.6,17154,179,64,-1809,-279,24.3,1602.6
4858261633,1,8,0,1,6,3,9,0,0,0,0,16071,6.8,17727,207,48,1236,205,25.5,1607.1,13,1,0,3,6,1,0,0,0,0,14835,6.8,17522,184,72,-1236,-205,25.6,1483.5
4858167900,0,0,0,1,20,20,41,0,0,0,0,35541,10.8,38874,85,0,-31,-620,8.5,3554.1,2,0,0,20,20,50,0,0,0,0,35572,10.8,39494,110,0,31,620,11.0,3557.2
4857222358,0,10,1,0,2,4,0,1,1,0,0,15098,7.0,18188,216,60,-1449,-105,27.6,1509.8,11,0,1,4,2,3,1,0,1,0,16547,7.0,18293,244,48,1449,105,29.2,1654.7
4857173839,0,0,3,0,14,25,24,0,0,0,0,33428,10.4,36548,106,0,-3988,-5205,10.6,3342.8,16,0,1,25,14,60,0,0,0,0,37416,11.4,41753,113,0,3988,5205,11.3,3741.6
4856329241,1,0,0,0,23,16,61,0,0,0,0,37313,11.0,41643,110,0,823,2135,11.0,3731.3,2,0,1,16,23,38,0,0,0,0,36490,10.8,39508,110,0,-823,-2135,11.0,3649.0
4856286334,1,1,3,0,13,19,30,0,0,0,0,33904,10.6,36789,102,0,-5185,-3872,10.2,3390.4,4,0,1,19,13,45,0,0,0,0,39089,11.2,40661,126,0,5185,3872,12.6,3908.9
4856201300,0,0,0,1,24,26,73,0,0,0,1,37689,11.0,40662,106,0,-120,1093,10.6,3768.9,0,0,0,26,24,67,0,0,0,0,37809,11.0,39569,120,0,120,-1093,12.0,3780.9
4856173434,0,0,0,1,25,22,65,0,0,0,0,36449,11.0,40462,89,0,-1153,-1451,8.9,3644.9,0,0,0,22,25,52,0,0,0,0,37602,11.4,41913,102,0,1153,1451,10.2,3760.2
4856131289,1,0,0,1,23,23,49,0,0,0,1,37224,11.0,41038,112,0,792,499,11.2,3722.4,0,0,0,23,23,44,0,0,0,0,36432,11.2,40539,99,0,-792,-499,9.9,3643.2
4856099700,1,0,0,1,36,25,101,0,0,0,1,42308,12.0,45506,114,0,5527,5262,11.4,4230.8,0,0,0,25,36,54,0,0,0,0,36781,11.0,40244,81,0,-5527,-5262,8.1,3678.1
4856029111,1,14,0,0,3,5,2,0,0,0,0,15585,7.0,18608,198,76,-296,715,27.4,1558.5,10,2,1,5,3,4,1,1,0,0,15881,6.6,17893,219,52,296,-715,27.1,1588.1
4855279465,1,13,3,0,1,6,1,0,0,0,0,16619,7.0,18961,254,56,-950,1046,31.0,1661.9,13,0,1,6,1,7,1,1,0,0,17569,6.8,17915,184,52,950,-1046,23.6,1756.9
4855230050,0,12,2,0,3,8,4,1,0,1,0,14728,6.8,17501,191,48,-4212,-1833,23.9,1472.8,15,2,1,8,3,6,1,1,0,0,18940,7.2,19334,220,76,4212,1833,29.6,1894.0
4855025507,1,0,0,1,38,29,89,0,0,0,2,42982,12.6,48771,112,0,3378,6214,11.2,4298.2,0,0,0,29,38,74,0,0,0,0,39604,11.6,42557,82,0,-3378,-6214,8.2,3960.4
4854149488,0,7,1,1,2,6,5,0,0,0,0,14249,6.6,16709,192,44,-3811,-1466,23.6,1424.9,7,0,0,6,2,8,0,0,0,0,18060,7.0,18175,216,59,3811,1466,27.5,1806.0
4854021529,1,30,0,0,7,5,3,0,0,0,0,17922,7.0,18352,216,56,1091,744,27.2,1792.2,34,0,1,5,7,6,0,0,0,0,16831,6.6,17608,163,64,-1091,-744,22.7,1683.1
4852938089,1,47,1,0,3,7,3,0,0,0,0,15808,7.0,18248,207,44,-1658,-115,25.1,1580.8,11,0,1,7,3,7,1,1,0,0,17466,7.2,18363,210,60,1658,115,27.0,1746.6
4852765513,0,0,0,1,27,32,66,0,0,0,0,38107,11.4,42039,92,0,-648,-1927,9.2,3810.7,3,0,0,32,27,69,0,0,0,0,38755,11.6,43966,100,0,648,1927,10.0,3875.5
4851879817,0,15,2,0,6,12,5,1,1,0,0,17147,6.6,17389,205,55,-2009,-975,26.0,1714.7,13,4,1,12,6,8,0,0,0,0,19156,7.0,18364,215,52,2009,975,26.7,1915.6
4846634426,0,12,1,0,9,7,5,0,0,0,0,18615,7.0,18341,209,64,206,1114,27.3,1861.5,35,1,1,7,9,6,0,0,0,0,18409,6.8,17227,196,36,-206,-1114,23.2,1840.9
4846589642,1,15,1,0,7,5,7,0,0,0,0,16848,6.8,17944,208,60,1718,232,26.8,1684.8,11,0,1,5,7,4,0,0,0,0,15130,6.8,17712,185,48,-1718,-232,23.3,1513.0
4846566201,0,9,4,0,3,8,3,0,0,0,0,15832,6.8,17867,210,40,-2944,-1471,25.0,1583.2,13,2,1,8,3,11,1,1,0,0,18776,7.4,19338,236,68,2944,1471,30.4,1877.6
4846544496,0,14,1,0,4,10,6,0,0,0,0,15727,6.6,16050,167,52,-2456,-2353,21.9,1572.7,9,2,1,10,4,4,1,1,0,0,18183,7.2,18403,263,56,2456,2353,31.9,1818.3
4846535806,0,12,0,1,8,10,7,1,0,1,0,18275,7.0,18529,195,76,1130,476,27.1,1827.5,13,2,0,10,8,14,1,1,0,0,17145,6.6,18053,200,54,-1130,-476,25.4,1714.5
4846515196,1,13,1,0,5,6,4,0,0,0,0,17014,6.8,18088,216,55,1199,1040,27.1,1701.4,13,3,1,6,5,9,0,0,0,0,15815,6.8,17048,202,52,-1199,-1040,25.4,1581.5
4846497983,0,18,0,0,7,7,2,0,0,0,0,16677,7.0,18689,207,68,598,2046,27.5,1667.7,14,1,1,7,7,8,1,1,0,0,16079,6.8,16643,189,48,-598,-2046,23.7,1607.9
4846479771,1,14,1,1,6,3,3,0,0,0,0,17280,7.2,19254,217,66,1971,1885,28.3,1728.0,13,2,0,3,6,4,1,0,1,0,15309,7.0,17369,218,59,-1971,-1885,27.7,1530.9
4845980318,0,16,2,0,4,11,2,1,1,0,0,14764,6.8,16870,209,46,-4420,-1782,25.5,1476.4,12,2,1,11,4,9,0,0,0,0,19184,7.0,18652,203,60,4420,1782,26.3,1918.4
4845957882,1,12,1,1,9,3,6,0,0,0,0,19258,7.4,20698,248,67,4347,1787,31.5,1925.8,9,1,0,3,9,1,1,1,0,0,14911,7.4,18911,198,72,-4347,-1787,27.0,1491.1
4845910075,1,73,0,0,4,9,3,0,0,0,1,17130,6.6,17239,190,56,-637,-664,24.6,1713.0,11,0,1,9,4,4,1,1,0,0,17767,6.8,17903,213,71,637,664,28.4,1776.7
4832442622,0,9,0,0,3,13,2,0,0,0,0,14606,6.8,17363,193,56,-5194,-45,24.9,1460.6,9,0,1,13,3,17,1,1,0,0,19800,6.8,17408,197,52,5194,45,24.9,1980.0
4814612121,0,9,0,0,3,2,2,0,0,0,0,15664,6.8,18105,240,52,626,-863,29.2,1566.4,8,0,1,2,3,1,1,1,0,0,15038,7.4,18968,233,62,-626,863,29.5,1503.8
4814588470,0,23,1,0,9,7,10,0,0,0,0,17067,6.8,17483,197,52,-923,25,24.9,1706.7,13,1,1,7,9,5,0,0,0,0,17990,6.6,17458,203,56,923,-25,25.9,1799.0
4810568868,1,41,1,1,7,2,4,0,0,0,0,16428,7.0,19111,236,56,1785,1048,29.2,1642.8,11,1,0,1,6,0,0,0,0,0,14643,7.0,18063,208,68,-1785,-1048,27.6,1464.3
4810519765,1,9,0,1,11,4,6,0,0,0,0,17396,6.8,18480,196,44,3112,1111,24.0,1739.6,100,1,0,4,11,0,0,0,0,0,14284,6.8,17369,189,44,-3112,-1111,23.3,1428.4
4810465677,1,11,0,1,2,2,1,0,0,0,0,14211,6.8,17778,176,60,118,343,23.6,1421.1,13,1,0,2,2,0,0,0,0,0,14093,6.8,17435,218,37,-118,-343,25.5,1409.3
4810450958,1,15,0,1,11,2,9,1,0,1,0,19932,7.2,18947,219,46,7027,3412,26.5,1993.2,27,0,0,2,11,3,0,0,0,0,12905,6.2,15535,149,41,-7027,-3412,19.0,1290.5
4810390226,0,11,0,0,5,8,2,0,0,0,0,14711,6.8,16650,167,52,-2320,-2283,21.9,1471.1,12,0,1,8,5,3,1,1,0,0,17031,7.2,18933,200,52,2320,2283,25.2,1703.1
4810339646,0,10,3,1,5,12,2,0,0,0,0,15582,6.6,16441,152,40,-2540,-1760,19.2,1558.2,11,1,0,12,5,7,0,0,0,0,18122,6.8,18201,164,48,2540,1760,21.2,1812.2
4858424901,0,67,3,1,12,3,11,0,0,0,0,20969,7.2,19956,237,52,6060,3463,28.9,2096.9,12,1,0,3,12,4,1,1,0,0,14909,6.8,16493,154,60,-6060,-3463,21.4,1490.9
4858384410,0,14,1,1,4,3,1,0,0,0,0,14901,7.0,18448,219,44,-463,-470,26.3,1490.1,14,1,0,3,4,2,1,1,0,0,15364,7.0,18918,205,76,463,470,28.1,1536.4
4858337700,1,12,0,1,8,7,4,0,0,0,0,18500,7.4,18871,219,51,1580,1614,27.0,1850.0,11,0,0,7,8,5,1,1,0,0,16920,6.8,17257,175,60,-1580,-1614,23.5,1692.0
4858290484,0,12,3,1,5,8,2,1,1,0,0,15568,6.6,16625,183,56,-1755,-244,23.9,1556.8,172,3,0,8,5,9,0,0,0,0,17323,6.6,16869,221,47,1755,244,26.8,1732.3
4858254676,1,12,2,1,6,1,6,1,1,0,0,18232,7.6,20276,235,80,4819,3894,31.5,1823.2,12,2,0,1,6,0,0,0,0,0,13413,6.6,16382,172,52,-4819,-3894,22.4,1341.3
4858232748,0,16,1,1,4,5,7,0,0,0,0,15135,6.8,17478,189,72,-1759,-2199,26.1,1513.5,11,4,0,5,4,6,1,1,0,0,16894,7.4,19677,240,52,1759,2199,29.2,1689.4
4858114961,1,11,1,0,2,10,2,0,0,0,0,15271,6.8,16938,203,48,-1916,-557,25.1,1527.1,44,1,1,10,2,6,0,0,0,0,17187,7.0,17495,207,52,1916,557,25.9,1718.7
4858077169,0,69,0,0,1,4,1,0,0,0,0,15803,6.6,16870,217,60,693,-15,27.7,1580.3,12,0,1,4,1,3,0,0,0,0,15110,6.8,16885,236,39,-693,15,27.5,1511.0
4858042549,1,13,2,1,10,3,12,0,0,0,0,18985,7.4,19599,237,56,3377,3462,29.3,1898.5,21,1,0,3,10,2,0,0,0,0,15608,6.4,16137,211,52,-3377,-3462,26.3,1560.8
4858000626,1,14,2,0,4,4,4,0,0,0,0,16815,7.0,17874,212,44,434,1248,25.6,1681.5,12,1,1,4,4,4,0,0,0,0,16381,6.8,16626,188,44,-434,-1248,23.2,1638.1
4857982935,0,73,1,0,2,5,0,0,0,0,0,14003,6.6,16270,188,48,-2522,-687,23.6,1400.3,14,0,1,5,2,5,0,0,0,0,16525,6.8,16957,207,48,2522,687,25.5,1652.5
4857590910,1,11,1,1,7,5,6,1,1,0,0,17151,7.0,17704,197,68,1217,632,26.5,1715.1,11,2,0,5,7,5,0,0,0,0,15934,6.6,17072,194,60,-1217,-632,25.4,1593.4
4857557511,0,12,0,0,4,6,5,0,0,0,0,16004,7.0,17759,215,51,-783,-966,26.6,1600.4,17,1,1,6,4,5,1,1,0,0,16787,7.0,18725,216,60,783,966,27.6,1678.7
4857518188,0,8,0,1,6,5,3,0,0,0,0,14637,5.8,13779,130,44,-3427,-3650,17.4,1463.7,13,0,0,5,6,7,1,0,1,0,18064,6.8,17429,211,42,3427,3650,25.3,1806.4
4857461306,1,11,1,0,3,3,2,0,0,0,0,15224,7.0,18431,229,56,-659,671,28.5,1522.4,15,0,1,3,3,5,1,0,1,0,15883,6.8,17760,201,72,659,-671,27.3,1588.3
4857415677,1,15,2,1,5,3,1,0,0,0,0,16403,7.0,18373,204,73,2017,1455,27.7,1640.3,11,0,0,3,5,5,0,0,0,0,14386,6.8,16918,196,50,-2017,-1455,24.6,1438.6
4857340418,0,18,0,1,5,3,3,0,0,0,0,17066,7.4,19765,238,71,1637,875,30.9,1706.6,10,0,0,3,5,3,1,1,0,0,15429,7.2,18890,208,60,-1637,-875,26.8,1542.9
4857298240,1,8,0,0,1,3,0,0,0,0,0,14914,6.8,17192,204,68,-593,-684,27.2,1491.4,13,1,1,3,1,3,1,1,0,0,15507,6.8,17876,227,56,593,684,28.3,1550.7
4857238827,1,14,1,0,3,4,5,1,1,0,0,15435,6.8,18186,216,64,45,-80,28.0,1543.5,12,2,1,4,3,3,0,0,0,0,15390,7.2,18266,205,59,-45,80,26.4,1539.0
4857197144,1,13,0,0,5,6,8,0,0,0,0,16685,6.6,17388,201,44,407,-792,24.5,1668.5,14,0,1,6,5,4,1,0,1,0,16278,7.0,18180,206,64,-407,792,27.0,1627.8
4835192847,1,12,1,0,5,2,4,0,0,0,0,16110,6.6,17328,197,26,442,-439,22.3,1611.0,9,0,1,2,5,2,0,0,0,0,15668,6.8,17767,203,54,-442,439,25.7,1566.8
4834971073,1,111,1,1,16,5,46,0,0,0,0,35756,11.2,42590,108,75,6554,5549,18.3,3575.6,12,0,0,4,15,9,0,0,0,0,29202,10.8,37041,87,59,-6554,-5549,14.6,2920.2
4834941227,1,10,0,1,30,22,50,0,0,0,1,41891,12.0,46030,86,67,5095,6399,15.3,4189.1,6,0,0,21,29,29,0,0,0,0,36796,10.8,39631,79,47,-5095,-6399,12.6,3679.6
4834905603,0,10,0,0,6,20,23,0,0,0,0,25822,9.4,28764,83,35,-8828,-7460,11.8,2582.2,14,1,1,20,6,46,0,0,0,0,34650,10.4,36224,95,55,8828,7460,15.0,3465.0
4834878131,1,41,3,1,23,12,60,0,0,0,0,38686,12.0,45374,96,63,3483,7248,15.9,3868.6,53,0,0,12,23,22,0,0,0,0,35203,10.8,38126,90,67,-3483,-7248,15.7,3520.3
4827928292,1,94,0,1,8,5,18,0,0,0,0,36027,11.2,40081,107,60,6493,6256,16.7,3602.7,23,0,0,5,8,9,0,0,0,0,29534,10.2,33825,87,51,-6493,-6256,13.8,2953.4
4822100516,1,13,2,1,10,6,15,0,0,0,0,32528,10.8,36452,99,52,4015,3012,15.1,3252.8,12,0,0,6,10,8,0,0,0,0,28513,10.2,33440,80,55,-4015,-3012,13.5,2851.3
4822079976,1,134,3,1,5,2,6,1,1,0,0,15789,7.0,17887,188,44,2088,744,23.2,1578.9,9,0,0,2,5,0,0,0,0,0,13701,6.6,17143,166,54,-2088,-744,22.0,1370.1
4821855881,1,31,0,1,24,19,51,0,0,0,1,39568,11.4,42659,80,64,2599,7161,14.4,3956.8,14,0,0,19,24,38,0,0,0,0,36969,10.4,35498,71,47,-2599,-7161,11.8,3696.9
4821820466,1,23,0,1,9,11,15,0,0,0,0,33543,11.0,39234,132,66,1511,2275,19.8,3354.3,12,0,0,11,9,15,0,0,0,0,32032,10.8,36959,92,66,-1511,-2275,15.8,3203.2
4821607232,1,15,0,1,23,12,41,0,0,0,2,38956,11.4,42023,140,55,4772,195,19.5,3895.6,9,0,0,11,22,19,0,0,0,0,34184,11.4,41828,98,55,-4772,-195,15.3,3418.4
4821579739,0,14,0,0,11,25,19,0,0,0,1,30421,9.2,29451,47,39,-3796,-5752,8.6,3042.1,27,1,1,25,11,46,0,0,0,0,34217,10.6,35203,57,47,3796,5752,10.4,3421.7
4821551514,0,23,1,1,27,18,45,0,0,0,1,39728,11.6,44314,71,47,4274,5893,11.8,3972.8,147,0,0,18,27,34,0,0,0,0,35454,10.8,38421,89,64,-4274,-5893,15.3,3545.4
4821538766,1,12,0,1,20,15,41,0,0,0,2,36632,11.2,39967,110,57,-551,958,16.7,3663.2,28,0,0,15,20,28,0,0,0,0,37183,11.0,39009,78,62,551,-958,14.0,3718.3
4821525905,0,53,1,0,9,16,18,0,0,0,0,31974,10.6,36166,110,40,-4184,-4302,15.0,3197.4,47,0,1,16,9,29,0,0,0,0,36158,10.8,40468,79,63,4184,4302,14.2,3615.8
4820684279,1,40,0,1,22,28,48,0,0,0,0,34107,10.6,37416,53,49,-3824,-5125,10.2,3410.7,26,2,0,28,22,54,0,0,0,0,37931,11.6,42541,57,71,3824,5125,12.8,3793.1
4820665752,0,21,0,1,13,27,17,0,0,0,3,35411,11.0,39372,71,47,-5923,-4224,11.8,3541.1,9,0,0,27,13,62,0,0,0,0,41334,11.8,43596,88,65,5923,4224,15.3,4133.4
4820607818,0,29,0,1,13,24,26,0,0,0,0,33648,10.2,35425,74,47,-1634,-5023,12.1,3364.8,18,1,0,24,13,50,0,0,0,0,35282,11.2,40448,58,67,1634,5023,12.5,3528.2
4856192149,0,13,2,1,6,8,8,0,0,0,0,15520,6.4,15374,169,42,-3221,-1749,21.1,1552.0,109,3,0,8,6,9,0,0,0,0,18741,6.8,17123,179,72,3221,1749,25.1,1874.1
4855152325,1,7,2,1,4,5,6,0,0,0,0,15344,7.0,17028,198,54,-795,-1837,25.2,1534.4,14,1,0,5,4,2,0,0,0,0,16139,7.2,18865,208,72,795,1837,28.0,1613.9
4855103567,1,9,2,1,7,9,9,0,0,0,0,16603,6.8,17164,196,56,-784,-668,25.2,1660.3,14,0,0,9,7,6,0,0,0,0,17387,6.8,17832,205,48,784,668,25.3,1738.7
4855061840,0,14,0,0,6,8,6,0,0,0,0,17008,6.8,17581,189,52,-166,623,24.1,1700.8,11,0,1,7,5,12,0,0,0,0,17174,6.8,16958,217,44,166,-623,26.1,1717.4
4855027961,1,0,0,1,17,21,46,0,0,0,1,36033,10.8,39154,95,0,1619,410,9.5,3603.3,0,0,0,21,17,51,0,0,0,0,34414,10.8,38744,98,0,-1619,-410,9.8,3441.4
4854997271,1,127,0,1,11,15,26,0,0,0,0,32862,10.0,33392,119,0,-304,-1750,11.9,3286.2,0,0,0,15,11,40,0,0,0,0,33166,10.2,35142,109,0,304,1750,10.9,3316.6
4854956655,1,25,0,0,12,15,37,0,0,0,0,32825,10.0,34050,112,0,-46,134,11.2,3282.5,31,25,1,15,12,46,0,0,0,0,32871,10.0,33916,85,0,46,-134,8.5,3287.1
4854208822,0,10,1,1,9,6,3,0,0,0,0,15870,7.2,18573,210,44,-1862,-2430,25.4,1587.0,14,0,0,6,9,3,1,1,0,0,17732,7.4,21003,259,68,1862,2430,32.7,1773.2
4854131488,0,10,0,1,12,3,7,0,0,0,0,16694,7.0,18286,193,36,1977,1420,22.9,1669.4,10,1,0,3,12,1,0,0,0,0,14717,6.6,16866,194,52,-1977,-1420,24.6,1471.7
4854104621,1,0,0,1,33,18,84,0,0,0,1,41121,12.0,44771,118,0,6673,7443,11.8,4112.1,79,0,0,18,33,39,0,0,0,0,34448,10.6,37328,81,0,-6673,-7443,8.1,3444.8
4854033395,0,19,1,1,6,3,6,1,1,0,0,16361,7.0,18364,205,60,725,886,26.5,1636.1,11,0,0,3,6,3,0,0,0,0,15636,6.8,17478,206,56,-725,-886,26.2,1563.6
4847927953,1,11,0,1,5,4,3,2,1,1,0,17082,7.0,18603,198,60,1420,687,25.8,1708.2,116,0,0,4,5,3,0,0,0,0,15662,6.8,17916,179,56,-1420,-687,23.5,1566.2
4847129475,1,12,1,1,5,7,2,0,0,0,0,18042,7.0,18615,245,52,2148,2479,29.7,1804.2,16,0,0,7,5,4,0,0,0,0,15894,6.6,16136,164,48,-2148,-2479,21.2,1589.4
4847088679,0,44,0,0,2,5,0,0,0,0,0,14421,6.4,16853,210,56,-2326,-2684,26.6,1442.1,71,3,1,5,2,4,1,1,0,0,16747,7.4,19537,196,84,2326,2684,28.0,1674.7
4847038170,0,11,0,0,7,5,6,0,0,0,0,17428,7.0,18486,208,68,799,-1352,27.6,1742.8,47,0,1,5,7,6,1,1,0,0,16629,7.4,19838,216,76,-799,1352,29.2,1662.9
4846585729,0,32,1,0,5,5,3,0,0,0,0,14975,6.6,17083,198,40,-1213,-549,23.8,1497.5,30,0,1,5,5,5,0,0,0,0,16188,7.0,17632,226,40,1213,549,26.6,1618.8
4841328282,1,10,0,0,22,12,39,0,0,0,1,38106,11.4,43753,105,63,5250,6182,16.8,3810.6,9,1,1,12,22,20,0,0,0,0,32856,10.8,37571,83,67,-5250,-6182,15.0,3285.6
4841306129,1,16,0,1,25,9,60,0,0,0,2,40619,12.0,46645,98,84,11879,8689,18.2,4061.9,45,0,0,9,25,18,0,0,0,0,28740,10.8,37956,90,45,-11879,-8689,13.5,2874.0
4841249247,0,14,3,1,8,6,6,0,0,0,0,17064,7.0,18513,208,60,375,1012,26.8,1706.4,16,1,0,6,8,8,0,0,0,0,16689,6.8,17501,199,52,-375,-1012,25.1,1668.9
4841211736,1,19,1,1,10,10,12,1,1,0,0,19063,7.0,17908,181,64,-134,285,24.5,1906.3,14,1,0,10,10,8,0,0,0,0,19197,6.8,17623,193,52,134,-285,24.5,1919.7
4797266443,0,0,0,0,22,28,55,0,0,0,1,37516,11.0,39725,102,0,-705,-2084,10.2,3751.6,0,0,1,28,22,64,0,0,0,0,38221,11.2,41809,104,0,705,2084,10.4,3822.1
4795020996,0,0,0,0,21,19,50,0,0,0,2,37009,11.4,41786,116,0,53,2643,11.6,3700.9,0,0,1,19,21,50,0,0,0,0,36956,10.8,39143,116,0,-53,-2643,11.6,3695.6
4794992053,1,0,0,0,26,32,62,0,0,0,1,39124,11.8,45659,107,0,1712,3695,10.7,3912.4,0,0,1,32,26,69,0,0,0,0,37412,11.4,41964,86,0,-1712,-3695,8.6,3741.2
4791138915,1,0,0,0,27,26,59,0,0,0,0,37532,11.6,42929,111,0,456,2420,11.1,3753.2,3,0,1,26,27,69,0,0,0,0,37076,11.0,40509,103,0,-456,-2420,10.3,3707.6
4791039729,1,14,0,0,8,10,6,0,0,0,0,18599,6.6,17073,198,64,631,643,26.2,1859.9,13,1,1,10,8,7,0,0,0,0,17968,6.6,16430,205,32,-631,-643,23.7,1796.8
4789138963,1,0,0,1,32,26,90,0,0,0,1,41130,12.0,46516,104,0,3066,4378,10.4,4113.0,0,0,0,26,32,68,0,0,0,0,38064,11.6,42138,99,0,-3066,-4378,9.9,3806.4
4789126427,0,0,24,0,23,32,43,0,0,0,1,36761,11.0,40336,89,0,-3341,-4046,8.9,3676.1,20,0,1,32,23,74,0,0,0,0,40102,11.6,44382,138,0,3341,4046,13.8,4010.2
4789105186,0,13,1,0,3,6,2,0,0,0,0,15227,6.8,17929,223,60,-2955,-1128,28.3,1522.7,24,2,1,6,3,6,1,1,0,0,18182,7.2,19057,242,64,2955,1128,30.6,1818.2
4789078581,0,9,0,1,7,9,2,1,1,0,0,18564,7.0,18300,205,60,520,494,26.5,1856.4,103,1,0,9,7,8,0,0,0,0,18044,7.0,17806,177,47,-520,-494,22.4,1804.4
4786692509,1,14,0,1,9,3,13,1,1,0,0,19734,7.4,19456,236,62,4620,1770,29.8,1973.4,11,1,0,3,9,3,0,0,0,0,15114,6.8,17686,199,70,-4620,-1770,26.9,1511.4
4786672783,1,22,1,1,9,4,12,1,1,0,0,16575,6.6,17668,152,60,1154,452,21.2,1657.5,13,1,0,4,9,3,0,0,0,0,15421,6.8,17216,222,52,-1154,-452,27.4,1542.1
4786641569,1,12,2,1,7,4,5,0,0,0,0,17386,7.2,18323,236,54,594,1318,29.0,1738.6,12,1,0,4,7,3,0,0,0,0,16792,6.6,17005,205,56,-594,-1318,26.1,1679.2
4776222010,0,13,0,0,4,6,2,0,0,0,0,15089,7.0,18541,158,72,-2252,-16,23.0,1508.9,10,0,1,6,4,6,0,0,0,0,17341,7.0,18557,200,52,2252,16,25.2,1734.1
4775450586,1,20,0,0,3,6,3,0,0,0,0,15548,7.2,18184,210,68,-454,158,27.8,1554.8,12,0,1,6,3,5,1,1,0,0,16002,6.8,18026,224,48,454,-158,27.2,1600.2
4775419723,0,13,1,0,3,5,1,0,0,0,0,15131,6.8,17269,200,40,-1355,-1445,24.0,1513.1,11,1,1,5,3,3,0,0,0,0,16486,7.0,18714,241,52,1355,1445,29.3,1648.6
4774373503,0,11,4,1,5,1,7,0,0,0,0,16796,7.0,18919,211,59,1945,1528,27.0,1679.6,13,0,0,1,5,0,1,1,0,0,14851,6.8,17391,238,40,-1945,-1528,27.8,1485.1
4773932480,1,13,4,1,7,1,11,1,1,0,0,17041,7.2,17692,233,56,3584,1255,28.9,1704.1,14,1,0,1,7,0,0,0,0,0,13457,6.6,16437,191,60,-3584,-1255,25.1,1345.7
4728771457,1,0,0,0,15,13,22,0,0,0,0,62350,12.0,55000,0,0,26900,22000,0.0,6235.0,0,0,1,10,12,3,0,0,0,0,35450,7.2,33000,0,0,-26900,-22000,0.0,3545.0
4609361896,0,17,2,1,9,9,8,0,0,0,0,16441,6.6,16720,177,44,-12,-625,22.1,1644.1,74,1,0,9,9,4,1,1,0,0,16453,6.8,17345,187,48,12,625,23.5,1645.3
4609330524,1,5,0,0,3,5,2,0,0,0,0,14100,6.8,17824,176,48,-2010,-365,22.4,1410.0,10,1,1,5,3,5,0,0,0,0,16110,6.8,18189,198,49,2010,365,24.7,1611.0
4836514173,1,0,0,0,22,17,54,0,0,0,0,38093,11.0,39904,110,0,2868,3744,11.0,3809.3,0,0,1,17,22,49,0,0,0,0,35225,10.6,36160,85,0,-2868,-3744,8.5,3522.5
4836493470,1,10,4,1,11,1,12,0,0,0,0,18692,7.0,18639,211,52,4700,2210,26.3,1869.2,13,0,0,1,11,2,0,0,0,0,13992,6.4,16429,178,56,-4700,-2210,23.4,1399.2
4836465717,1,10,1,1,4,5,2,0,0,0,0,16002,7.0,18115,202,56,-475,-77,25.8,1600.2,10,0,0,5,4,5,1,0,1,0,16477,6.8,18192,203,60,475,77,26.3,1647.7
4836450839,1,16,4,1,8,2,6,0,0,0,0,18195,7.0,18292,235,49,2451,1476,28.4,1819.5,11,0,0,2,8,1,0,0,0,0,15744,6.6,16816,213,50,-2451,-1476,26.3,1574.4
4836422214,0,12,1,0,5,4,3,0,0,0,0,15955,6.8,17310,199,58,569,98,25.7,1595.5,13,1,1,4,5,3,1,1,0,0,15386,6.8,17212,189,57,-569,-98,24.6,1538.6
4836399725,0,10,3,0,4,6,2,0,0,0,0,15277,6.8,17379,189,56,-1970,-987,24.5,1527.7,10,1,1,6,4,7,0,0,0,0,17247,7.0,18366,216,56,1970,987,27.2,1724.7
4836381362,0,33,1,1,7,5,12,2,1,1,0,17300,7.0,17474,203,52,56,361,25.5,1730.0,16,10,0,5,7,8,0,0,0,0,17244,6.6,17113,172,56,-56,-361,22.8,1724.4
4836362249,0,10,0,0,2,5,0,0,0,0,0,13702,6.6,17145,180,47,-4243,-1815,22.7,1370.2,14,1,1,5,2,2,1,1,0,0,17945,7.2,18960,241,48,4243,1815,28.9,1794.5
4836353969,0,30,0,0,18,34,46,0,0,0,1,34382,10.6,36733,89,0,-6514,-6718,8.9,3438.2,88,1,1,34,18,76,0,0,0,0,40896,11.6,43451,121,0,6514,6718,12.1,4089.6
4834968179,1,13,3,1,9,3,14,0,0,0,0,17730,6.8,16657,201,36,1858,-521,23.7,1773.0,15,2,0,3,9,3,0,0,0,0,15872,6.8,17178,204,54,-1858,521,25.8,1587.2
4834759042,0,107,5,1,6,2,7,1,0,1,0,17473,6.8,17129,185,52,1785,-109,23.7,1747.3,14,1,0,2,6,2,1,1,0,0,15688,6.8,17238,187,56,-1785,109,24.3,1568.8
4834729525,1,13,0,1,11,2,8,1,1,0,0,19215,7.2,19098,224,64,4704,2164,28.8,1921.5,11,1,0,2,11,1,0,0,0,0,14511,6.6,16934,212,56,-4704,-2164,26.8,1451.1
4834632666,1,24,1,0,6,5,8,1,1,0,0,16660,6.8,17202,200,44,795,-553,24.4,1666.0,8,0,1,5,6,3,0,0,0,0,15865,7.0,17755,218,64,-795,553,28.2,1586.5
4834612498,1,14,0,1,6,0,6,1,0,1,0,18000,7.2,19439,233,60,3620,2821,29.3,1800.0,11,1,0,0,6,0,0,0,0,0,14380,6.8,16618,171,48,-3620,-2821,21.9,1438.0
4834588121,0,77,3,0,6,6,10,0,0,0,0,17333,6.8,17825,201,48,-329,-484,24.9,1733.3,19,2,1,6,6,9,0,0,0,0,17662,6.8,18309,220,68,329,484,28.8,1766.2
4834562713,1,11,4,1,10,9,15,0,0,0,0,18622,6.6,16743,190,40,505,-283,23.0,1862.2,9,3,0,9,10,9,0,0,0,0,18117,6.8,17026,213,52,-505,283,26.5,1811.7
4834300923,1,11,2,1,2,3,4,1,0,1,0,15981,6.8,18171,242,48,1330,842,29.0,1598.1,13,3,0,3,2,4,1,1,0,0,14651,6.8,17329,201,64,-1330,-842,26.5,1465.1
4833031796,1,0,0,1,21,17,68,0,0,0,0,35633,11.0,38893,112,0,1099,3142,11.2,3563.3,2,0,0,17,21,41,0,0,0,0,34534,10.2,35751,105,0,-1099,-3142,10.5,3453.4
4830461577,1,68,0,0,34,28,79,0,0,0,1,42310,11.8,46003,101,0,3552,2609,10.1,4231.0,3,0,1,28,34,61,0,0,0,0,38758,11.4,43394,90,0,-3552,-2609,9.0,3875.8
4830433666,0,0,0,0,22,26,41,0,0,0,2,37589,11.4,41506,97,0,-94,953,9.7,3758.9,0,0,1,26,22,70,0,0,0,0,37683,11.2,40553,115,0,94,-953,11.5,3768.3
4856698209,1,15,0,0,14,14,20,0,0,0,0,62756,12.4,57000,0,0,24812,24000,0.0,6275.6,0,0,1,14,14,4,0,0,0,0,37944,7.2,33000,0,0,-24812,-24000,0.0,3794.4
4856689707,1,0,0,1,18,18,21,0,0,0,0,53250,12.0,55000,0,0,22700,22000,0.0,5325.0,0,0,0,10,10,9,0,0,0,0,30550,7.2,33000,0,0,-22700,-22000,0.0,3055.0
4856690953,1,1,0,0,13,23,16,0,0,0,0,53800,12.2,56000,0,0,15500,23000,0.0,5380.0,41,0,1,15,5,13,0,0,0,0,38300,7.2,33000,0,0,-15500,-23000,0.0,3830.0
4856681527,1,0,0,1,21,13,22,0,0,0,0,63415,13.0,62500,0,0,26215,28000,0.0,6341.5,0,0,0,9,17,8,0,0,0,0,37200,7.4,34500,0,0,-26215,-28000,0.0,3720.0
4856678351,1,0,0,0,21,19,15,0,0,0,0,48050,10.0,47500,0,0,20900,19000,0.0,4805.0,0,0,1,8,10,7,0,0,0,0,27150,6.0,28500,0,0,-20900,-19000,0.0,2715.0
4856670570,1,18,0,0,18,19,12,0,0,0,0,61360,12.0,55000,0,0,22730,22000,0.0,6136.0,0,1,1,13,12,13,0,0,0,0,38630,7.2,33000,1,0,-22730,-22000,0.1,3863.0
4856668302,1,4,0,0,16,18,16,0,0,0,0,46300,10.0,47500,0,0,15300,19000,0.0,4630.0,33,0,1,9,7,7,0,0,0,0,31000,6.0,28500,0,0,-15300,-19000,0.0,3100.0
4855569555,1,23,2,1,18,18,15,0,0,0,0,63095,12.0,55000,3,0,24845,22000,0.3,6309.5,59,0,0,11,11,13,0,0,0,0,38250,7.2,33000,0,0,-24845,-22000,0.0,3825.0
4855571824,1,0,0,1,24,17,19,0,0,0,0,47700,10.0,47500,0,0,20200,19000,0.0,4770.0,0,0,0,6,13,11,0,0,0,0,27500,6.0,28500,0,0,-20200,-19000,0.0,2750.0
4855564329,1,0,0,1,15,14,15,0,0,0,0,45600,10.0,47500,0,0,16000,19000,0.0,4560.0,0,0,0,8,9,8,0,0,0,0,29600,6.0,28500,0,0,-16000,-19000,0.0,2960.0
4855562118,1,0,0,1,20,20,18,0,0,0,0,48385,10.0,47500,6,0,19735,19000,0.6,4838.5,0,0,0,11,11,12,0,0,0,0,28650,6.0,28500,1,0,-19735,-19000,0.1,2865.0
4855559756,1,0,0,0,17,16,15,0,0,0,0,46383,10.0,47500,1,0,18129,19000,0.1,4638.3,23,0,1,9,10,10,0,0,0,0,28254,6.0,28500,0,0,-18129,-19000,0.0,2825.4
4854249257,1,0,0,1,18,13,21,0,0,0,0,64100,12.0,55000,0,0,28300,22000,0.0,6410.0,5,0,0,6,11,5,0,0,0,0,35800,7.2,33000,0,0,-28300,-22000,0.0,3580.0
4853223731,1,5,0,1,19,12,20,0,0,0,0,63400,12.0,55000,0,0,26900,22000,0.0,6340.0,0,0,0,7,14,5,0,0,0,0,36500,7.2,33000,0,0,-26900,-22000,0.0,3650.0
4853220340,1,14,0,1,26,15,29,0,0,0,0,64450,12.8,59000,0,0,27600,26000,0.0,6445.0,0,0,0,8,19,7,0,0,0,0,36850,7.2,33000,0,0,-27600,-26000,0.0,3685.0
4853216972,1,9,0,1,18,18,20,0,0,0,0,62950,13.8,66500,0,0,24994,29000,0.0,6295.0,0,0,0,15,15,12,0,0,0,0,37956,7.8,37500,0,0,-24994,-29000,0.0,3795.6
4853203536,1,0,0,1,17,18,19,0,0,0,0,47000,10.0,47500,0,0,18800,19000,0.0,4700.0,0,0,0,11,10,12,0,0,0,0,28200,6.0,28500,0,0,-18800,-19000,0.0,2820.0
4853193688,1,0,0,0,15,19,17,0,0,0,0,63592,12.0,55000,8,0,26692,22000,0.8,6359.2,61,0,1,14,10,9,0,0,0,0,36900,7.2,33000,6,0,-26692,-22000,0.6,3690.0
4853186434,1,0,0,1,21,11,20,0,0,0,0,48492,10.0,47500,0,0,21342,19000,0.0,4849.2,0,0,0,5,15,4,0,0,0,0,27150,6.0,28500,0,0,-21342,-19000,0.0,2715.0
4853174416,1,0,0,1,17,24,22,0,0,0,0,63050,12.8,60500,0,0,24068,23000,0.0,6305.0,0,0,0,17,10,15,0,0,0,0,38982,7.8,37500,0,0,-24068,-23000,0.0,3898.2
4857550609,1,17,0,1,3,6,2,2,1,1,0,16005,6.8,18178,202,68,35,276,27.0,1600.5,13,3,0,6,3,4,0,0,0,0,15970,7.2,17902,209,48,-35,-276,25.7,1597.0
4857391127,0,10,1,1,4,10,4,0,0,0,0,16328,6.6,15890,188,53,-1383,-1923,24.1,1632.8,12,1,0,10,4,2,0,0,0,0,17711,6.8,17813,204,45,1383,1923,24.9,1771.1
4857323916,1,13,1,0,5,9,4,0,0,0,0,16197,7.0,17864,206,60,-2736,-1462,26.6,1619.7,23,4,1,9,5,8,1,0,1,0,18933,7.2,19326,255,60,2736,1462,31.5,1893.3
4857197435,0,11,1,0,3,7,1,1,1,0,0,15749,7.2,18427,217,64,-2931,-249,28.1,1574.9,22,1,1,7,3,9,0,0,0,0,18680,7.0,18676,247,60,2931,249,30.7,1868.0
4857161926,1,19,1,1,5,2,3,0,0,0,0,16010,7.2,18065,193,48,-32,-859,24.1,1601.0,220,3,0,2,5,0,1,1,0,0,16042,7.2,18924,245,68,32,859,31.3,1604.2
4856491943,1,10,1,1,4,6,5,1,1,0,0,15900,7.0,17544,166,52,-1039,262,21.8,1590.0,14,1,0,6,4,6,1,0,1,0,16939,6.8,17282,205,56,1039,-262,26.1,1693.9
4856436107,1,23,2,1,5,2,4,0,0,0,0,17487,7.0,18410,232,48,2854,845,28.0,1748.7,14,0,0,2,5,3,1,1,0,0,14633,6.8,17565,207,64,-2854,-845,27.1,1463.3
4855211073,1,16,4,1,9,6,8,2,1,1,0,18030,7.2,19090,204,60,1770,901,26.4,1803.0,22,0,0,6,9,3,0,0,0,0,16260,7.2,18189,222,52,-1770,-901,27.4,1626.0
4855141010,1,12,0,1,3,2,3,1,1,0,0,15010,7.0,18433,192,60,-12,2,25.2,1501.0,16,1,0,2,3,0,0,0,0,0,15022,7.0,18431,236,52,12,-2,28.8,1502.2
4855055417,0,13,1,0,1,2,0,0,0,0,0,14981,6.8,17848,236,46,434,154,28.2,1498.1,9,0,1,2,1,0,0,0,0,0,14547,6.8,17694,187,51,-434,-154,23.8,1454.7
4854085087,1,13,2,1,4,5,5,0,0,0,0,16182,6.8,18185,201,48,414,603,24.9,1618.2,11,0,0,5,4,3,0,0,0,0,15768,6.6,17582,196,64,-414,-603,26.0,1576.8
4854000682,0,10,0,0,3,6,1,1,1,0,0,15154,7.2,18397,221,52,-2060,264,27.3,1515.4,14,1,1,6,3,5,0,0,0,0,17214,6.8,18133,215,60,2060,-264,27.5,1721.4
4852572903,1,9,0,1,4,3,5,0,0,0,0,15776,6.8,17162,193,54,645,881,24.7,1577.6,10,0,0,3,4,4,0,0,0,0,15131,6.6,16281,198,52,-645,-881,25.0,1513.1
4826893044,1,16,0,1,6,2,3,0,0,0,0,17849,7.2,18984,204,60,3785,1572,26.4,1784.9,7,0,0,2,6,0,0,0,0,0,14064,6.8,17412,186,64,-3785,-1572,25.0,1406.4
4826860866,0,57,0,1,2,2,3,1,1,0,0,15246,7.0,18201,202,60,-369,-177,26.2,1524.6,14,0,0,2,2,2,0,0,0,0,15615,7.2,18378,246,52,369,177,29.8,1561.5
4824983749,0,13,0,0,3,9,4,0,0,0,0,14402,6.6,15856,184,60,-3285,-2646,24.4,1440.2,10,0,1,9,3,8,1,1,0,0,17687,7.0,18502,224,44,3285,2646,26.8,1768.7
4824025721,1,13,1,1,1,1,0,1,0,1,0,16061,7.0,18842,227,68,2417,1484,29.5,1606.1,13,1,0,1,1,1,1,1,0,0,13644,6.8,17358,176,48,-2417,-1484,22.4,1364.4
4823958837,0,15,0,0,1,5,1,0,0,0,0,14785,6.6,16971,191,57,-1184,-837,24.8,1478.5,14,1,1,5,1,3,1,1,0,0,15969,7.2,17808,200,49,1184,837,24.9,1596.9
4823100658,1,13,1,1,9,5,8,0,0,0,0,17285,7.2,18309,183,50,616,474,23.3,1728.5,13,1,0,5,9,6,0,0,0,0,16669,7.0,17835,212,53,-616,-474,26.5,1666.9
4822711983,1,123,3,0,3,3,3,0,0,0,0,15498,7.0,18432,223,72,-308,-116,29.5,1549.8,12,1,1,3,3,2,1,1,0,0,15806,7.2,18548,209,64,308,116,27.3,1580.6
4858169784,1,23,1,0,2,3,4,0,0,0,0,14907,6.8,18237,214,54,-82,-714,26.8,1490.7,9,2,1,3,2,2,0,0,0,0,14989,7.2,18951,215,64,82,714,27.9,1498.9
4858128767,0,14,2,1,6,5,3,1,1,0,0,15934,7.0,17622,184,64,159,286,24.8,1593.4,14,1,0,5,6,6,0,0,0,0,15775,6.8,17336,171,48,-159,-286,21.9,1577.5
4858072759,1,27,1,1,19,22,18,0,0,0,0,63150,12.0,55000,3,0,23500,22000,0.3,6315.0,0,0,0,13,10,10,0,0,0,0,39650,7.2,33000,0,0,-23500,-22000,0.0,3965.0
4855488762,1,0,0,1,20,17,23,0,0,0,0,62700,12.0,55000,0,0,25318,22000,0.0,6270.0,0,0,0,10,13,8,0,0,0,0,37382,7.2,33000,0,0,-25318,-22000,0.0,3738.2
4853125435,0,14,0,0,6,2,4,0,0,0,0,16164,7.0,17717,187,52,-323,-330,23.9,1616.4,16,0,1,2,6,1,0,0,0,0,16487,7.0,18047,219,68,323,330,28.7,1648.7
4851579097,1,11,2,0,6,3,5,0,0,0,0,16298,7.0,18200,196,52,1059,549,24.8,1629.8,10,1,1,3,6,1,0,0,0,0,15239,7.0,17651,223,56,-1059,-549,27.9,1523.9
4851534603,0,17,0,1,6,5,5,1,1,0,1,16453,6.6,16896,198,60,-914,-1129,25.8,1645.3,149,0,0,5,6,5,0,0,0,0,17367,7.2,18025,208,60,914,1129,26.8,1736.7
4851501801,0,14,1,0,2,3,5,1,1,0,0,14718,7.0,17465,198,64,-259,-1510,26.2,1471.8,12,1,1,3,2,2,0,0,0,0,14977,7.2,18975,213,48,259,1510,26.1,1497.7
4849239371,1,0,0,0,18,19,45,0,0,0,0,35826,10.8,39224,113,0,270,884,11.3,3582.6,0,0,1,19,18,27,0,0,0,0,35556,10.6,38340,102,0,-270,-884,10.2,3555.6
4849226779,1,0,0,1,18,18,40,0,0,0,0,35900,11.0,38566,118,0,1542,1705,11.8,3590.0,9,0,0,18,18,40,0,0,0,0,34358,10.6,36861,103,0,-1542,-1705,10.3,3435.8
4849203366,0,0,0,0,23,40,45,0,0,0,1,37433,11.0,40389,101,0,-3116,-4668,10.1,3743.3,0,0,1,40,23,85,0,0,0,0,40549,11.8,45057,95,0,3116,4668,9.5,4054.9
4846236639,0,32,0,0,12,10,11,2,1,1,0,18801,6.6,16844,172,68,1425,-139,24.0,1880.1,33,1,1,10,12,7,0,0,0,0,17376,7.0,16983,154,48,-1425,139,20.2,1737.6
4846135267,0,8,0,0,6,10,3,0,0,0,0,14731,6.4,15793,143,56,-3299,-1801,19.9,1473.1,12,3,1,10,6,11,1,1,0,0,18030,6.8,17594,187,40,3299,1801,22.7,1803.0
4846095134,0,12,0,1,4,7,2,1,1,0,0,15025,6.6,17052,193,56,-1336,-795,24.9,1502.5,8,0,0,7,4,6,0,0,0,0,16361,7.0,17847,166,59,1336,795,22.5,1636.1
4844948420,1,11,0,1,9,4,13,1,1,0,0,18114,6.6,16174,167,44,1795,38,21.1,1811.4,10,1,0,4,9,2,0,0,0,0,16319,6.6,16136,164,60,-1795,-38,22.4,1631.9
4844892290,0,12,0,1,5,4,4,1,1,0,0,16343,7.0,18535,188,60,1519,1122,24.8,1634.3,18,0,0,4,5,4,0,0,0,0,14824,6.8,17413,176,52,-1519,-1122,22.8,1482.4
4844855169,0,9,1,0,2,5,0,0,0,0,0,13340,6.6,16625,173,40,-3089,-276,21.3,1334.0,12,1,1,5,2,5,0,0,0,0,16429,6.6,16901,211,48,3089,276,25.9,1642.9
4844821472,1,35,3,0,0,2,0,0,0,0,0,14900,6.8,17532,224,52,-10,-783,27.6,1490.0,37,3,1,2,0,2,0,0,0,0,14910,7.0,18315,171,60,10,783,23.1,1491.0
4844806354,1,10,0,1,6,2,2,1,1,0,0,17284,7.2,19451,224,60,3419,2824,28.4,1728.4,11,0,0,2,6,4,0,0,0,0,13865,6.4,16627,190,48,-3419,-2824,23.8,1386.5
4813978078,0,13,2,1,5,6,6,1,1,0,0,16600,7.0,18735,237,59,-1953,-636,29.6,1660.0,87,0,0,5,4,4,0,0,0,0,18553,7.2,19371,228,72,1953,636,30.0,1855.3
4813190165,0,8,0,1,11,2,10,1,1,0,0,18310,7.2,19250,218,64,4032,2816,28.2,1831.0,13,0,0,2,11,1,0,0,0,0,14278,6.4,16434,188,55,-4032,-2816,24.3,1427.8
4813160739,0,15,1,1,2,6,1,0,0,0,0,14029,6.6,16203,175,50,-3622,-2520,22.5,1402.9,31,1,0,6,2,4,1,1,0,0,17651,7.2,18723,249,49,3622,2520,29.8,1765.1
4813109538,0,33,1,1,6,5,9,2,1,1,0,19287,7.0,18615,215,52,3250,1022,26.7,1928.7,16,1,0,5,6,1,0,0,0,0,16037,7.0,17593,216,60,-3250,-1022,27.6,1603.7
4813078012,1,12,0,1,9,2,10,0,0,0,0,18557,6.6,17278,192,35,4624,793,22.7,1855.7,14,0,0,2,9,1,0,0,0,0,13933,6.4,16485,169,53,-4624,-793,22.2,1393.3
4495628582,1,10,2,1,7,8,4,0,0,0,0,19074,6.8,17821,210,52,1105,-40,26.2,1907.4,13,0,0,8,7,6,0,0,0,0,17969,6.8,17861,211,52,-1105,40,26.3,1796.9
4492517755,1,11,4,1,7,3,9,0,0,0,0,17672,7.2,18972,202,48,2609,1453,25.0,1767.2,14,0,0,3,7,3,0,0,0,0,15063,6.8,17519,235,52,-2609,-1453,28.7,1506.3
4492145557,0,13,0,1,3,4,3,0,0,0,0,16233,6.8,18334,249,48,-335,-826,29.7,1623.3,74,0,0,4,3,7,0,0,0,0,16568,7.2,19160,179,76,335,826,25.5,1656.8
4492112254,0,14,3,0,3,5,3,0,0,0,0,15897,6.8,18206,218,52,-876,-383,27.0,1589.7,14,1,1,5,3,3,1,1,0,0,16773,7.0,18589,219,64,876,383,28.3,1677.3
4491286379,1,0,0,0,22,17,56,0,0,0,2,38744,11.4,41141,115,0,2660,4303,11.5,3874.4,0,0,1,17,22,40,0,0,0,0,36084,10.8,36838,105,0,-2660,-4303,10.5,3608.4
4491254625,0,13,0,0,9,10,7,0,0,0,0,16740,6.8,16242,182,50,-1386,-1436,23.2,1674.0,10,6,1,10,9,14,0,0,0,0,18126,7.0,17678,198,44,1386,1436,24.2,1812.6
4491228980,1,13,0,1,14,6,10,0,0,0,0,20991,7.4,19698,243,58,4507,1732,30.1,2099.1,6,0,0,6,14,3,0,0,0,0,16484,6.6,17966,178,64,-4507,-1732,24.2,1648.4
4491175605,1,8,1,1,5,3,4,2,1,1,0,16830,7.0,19323,195,60,1663,1313,25.5,1683.0,10,0,0,3,5,4,0,0,0,0,15167,6.8,18010,223,55,-1663,-1313,27.8,1516.7
4491137603,0,11,1,0,3,8,3,0,0,0,0,15587,7.0,17372,195,63,-2766,-2185,25.8,1558.7,13,1,1,8,3,6,0,0,0,0,18353,7.2,19557,224,52,2766,2185,27.6,1835.3
4490889598,1,59,1,0,10,8,8,0,0,0,0,19115,7.0,17557,215,47,1966,-281,26.2,1911.5,31,9,1,8,10,4,1,1,0,0,17149,7.0,17838,195,45,-1966,281,24.0,1714.9
4490832540,0,17,2,1,7,6,6,1,1,0,0,16874,7.2,18493,218,48,413,-504,26.6,1687.4,14,3,0,6,7,5,0,0,0,0,16461,7.2,18997,225,60,-413,504,28.5,1646.1
4490811276,0,13,1,0,4,6,3,0,0,0,0,16158,6.8,18223,201,52,-2692,-1893,25.3,1615.8,10,4,1,6,4,7,1,1,0,0,18850,7.4,20116,220,78,2692,1893,29.8,1885.0
4490328067,0,15,2,0,10,11,6,0,0,0,0,18490,7.0,18371,217,48,-1275,-205,26.5,1849.0,11,2,1,11,10,11,1,1,0,0,19765,6.8,18576,196,60,1275,205,25.6,1976.5
4490280540,1,16,4,0,3,5,2,0,0,0,0,15587,6.6,17808,210,81,13,899,29.1,1558.7,32,6,1,5,3,10,1,1,0,0,15574,6.6,16909,203,53,-13,-899,25.6,1557.4
4858237721,1,0,0,0,16,21,23,0,0,0,0,62560,12.6,59500,2,0,24195,22000,0.2,6256.0,0,0,1,16,11,10,0,0,0,0,38365,7.8,37500,1,0,-24195,-22000,0.1,3836.5
4858218228,1,56,1,0,10,22,13,0,0,0,0,59863,12.0,55000,2,0,21568,22000,0.2,5986.3,5,7,1,16,4,13,0,0,0,0,38295,7.2,33000,1,0,-21568,-22000,0.1,3829.5
4858190649,1,28,4,0,14,20,15,0,0,0,0,62594,12.0,55000,3,0,25631,22000,0.3,6259.4,0,3,1,12,6,12,0,0,0,0,36963,7.2,33000,0,0,-25631,-22000,0.0,3696.3
4857060020,1,81,2,0,5,5,4,1,1,0,0,15576,6.8,17396,199,52,-846,-47,25.1,1557.6,20,1,1,5,5,8,0,0,0,0,16422,6.8,17443,212,52,846,47,26.4,1642.2
4857034850,1,17,3,1,10,6,13,0,0,0,0,19824,7.0,19143,205,48,2595,867,25.3,1982.4,10,1,0,6,10,5,1,1,0,0,17229,7.0,18276,187,56,-2595,-867,24.3,1722.9
4855447122,0,8,1,1,4,6,4,1,1,0,0,16815,7.2,19300,228,64,-41,383,29.2,1681.5,9,0,0,6,4,2,0,0,0,0,16856,7.2,18917,197,52,41,-383,24.9,1685.6
4855408418,1,14,0,0,5,2,3,1,1,0,0,17028,7.2,19069,238,40,2709,2676,27.8,1702.8,13,2,1,2,5,3,0,0,0,0,14319,6.6,16393,216,52,-2709,-2676,26.8,1431.9
4852059747,0,11,1,0,7,5,6,0,0,0,0,17689,7.0,19125,200,52,1175,1955,25.2,1768.9,11,0,1,5,7,7,0,0,0,0,16514,6.8,17170,199,52,-1175,-1955,25.1,1651.4
4852037376,1,16,0,0,4,4,5,0,0,0,0,17097,7.0,18574,201,52,1501,765,25.3,1709.7,15,2,1,4,4,5,0,0,0,0,15596,7.0,17809,215,40,-1501,-765,25.5,1559.6
4844132610,1,25,0,1,2,3,0,0,0,0,0,14893,7.0,17864,206,71,-1235,-1430,27.7,1489.3,10,3,0,3,2,3,0,0,0,0,16128,7.4,19294,208,64,1235,1430,27.2,1612.8
4844089514,0,14,0,1,3,6,0,1,1,0,0,15298,7.0,18024,229,60,-997,-89,28.9,1529.8,9,2,0,6,3,11,0,0,0,0,16295,7.0,18113,195,60,997,89,25.5,1629.5
4834810034,0,32,3,1,8,4,8,1,1,0,0,17231,7.0,18629,220,52,2144,-241,27.2,1723.1,38,1,0,4,8,1,0,0,0,0,15087,6.8,18870,220,50,-2144,241,27.0,1508.7
4834776784,0,76,2,0,7,8,9,1,1,0,0,16762,7.0,18414,191,55,-1128,1252,24.6,1676.2,10,3,1,8,7,9,0,0,0,0,17890,6.6,17162,187,48,1128,-1252,23.5,1789.0
4831182368,1,13,1,1,12,4,16,0,0,0,0,20660,6.8,17255,208,52,2877,56,26.0,2066.0,221,0,0,4,12,5,0,0,0,0,17783,6.6,17199,215,43,-2877,-56,25.8,1778.3
4824620005,0,12,2,0,4,6,4,0,0,0,0,14820,6.6,16603,207,45,-2465,-1890,25.2,1482.0,13,1,1,6,4,5,1,1,0,0,17285,7.0,18493,229,67,2465,1890,29.6,1728.5
4824271585,0,11,2,0,7,10,7,0,0,0,0,17316,7.0,18019,222,52,-1892,-1079,27.4,1731.6,12,2,1,10,7,12,1,1,0,0,19208,7.2,19098,208,59,1892,1079,26.7,1920.8
4824080960,0,14,2,0,5,11,6,0,0,0,0,18202,6.8,17310,201,59,307,-479,26.0,1820.2,14,0,1,11,5,16,0,0,0,0,17895,7.0,17789,208,44,-307,479,25.2,1789.5
4824042885,0,12,0,1,7,2,8,1,1,0,0,16156,6.4,16392,169,60,1640,531,22.9,1615.6,12,0,0,2,7,2,0,0,0,0,14516,6.4,15861,195,44,-1640,-531,23.9,1451.6
4821934739,1,91,0,1,19,4,29,0,0,0,1,37393,11.4,42451,82,75,7675,9607,15.7,3739.3,209,0,0,4,19,9,0,0,0,0,29718,10.0,32844,92,43,-7675,-9607,13.5,2971.8
4821911217,0,12,0,0,15,11,26,0,0,0,1,36013,10.4,35899,77,44,520,-2407,12.1,3601.3,14,0,1,11,15,22,0,0,0,0,35493,11.0,38306,55,59,-520,2407,11.4,3549.3
4847212525,0,34,1,1,4,6,6,0,0,0,0,15808,6.8,17847,194,55,-1844,-673,24.9,1580.8,33,2,0,6,4,5,0,0,0,0,17652,7.0,18520,206,52,1844,673,25.8,1765.2
4847196051,0,14,0,1,6,7,6,0,0,0,0,16285,6.8,17269,193,52,-1334,-1148,24.5,1628.5,15,2,0,7,6,9,1,1,0,0,17619,7.0,18417,199,56,1334,1148,25.5,1761.9
4847142546,0,16,0,0,4,6,2,1,1,0,0,15596,6.4,16314,172,54,218,203,22.6,1559.6,10,1,1,6,4,6,0,0,0,0,15378,6.6,16111,172,48,-218,-203,22.0,1537.8
4847112353,1,12,0,0,5,4,5,0,0,0,0,16523,6.8,18313,203,60,1521,431,26.3,1652.3,5,0,1,4,5,1,0,0,0,0,15002,6.8,17882,195,60,-1521,-431,25.5,1500.2
4847088830,0,81,1,1,5,5,3,0,0,0,0,14693,6.4,16729,158,56,187,-22,21.4,1469.3,14,0,0,5,5,3,0,0,0,0,14506,6.6,16751,166,40,-187,22,20.6,1450.6
4847025898,1,59,0,1,10,5,8,1,1,0,0,18179,6.8,18431,188,44,877,434,23.2,1817.9,12,0,0,5,10,6,0,0,0,0,17302,7.2,17997,203,56,-877,-434,25.9,1730.2
4846973705,0,12,0,1,8,4,8,0,0,0,0,15958,6.8,18101,166,52,520,549,21.8,1595.8,17,1,0,4,8,4,0,0,0,0,15438,6.8,17552,187,52,-520,-549,23.9,1543.8
4846924365,0,14,1,1,4,4,2,0,0,0,0,15984,6.6,17442,209,52,819,-749,26.1,1598.4,15,2,0,4,4,4,0,0,0,0,15165,7.0,18191,200,60,-819,749,26.0,1516.5
4846199982,0,11,1,0,10,8,6,0,0,0,0,17723,6.8,17235,179,52,1131,-1041,23.1,1772.3,11,1,1,8,10,2,0,0,0,0,16592,7.0,18276,203,38,-1131,1041,24.1,1659.2
4846144765,1,100,2,1,6,2,3,0,0,0,0,15465,7.4,18772,196,60,1555,1023,25.6,1546.5,36,1,0,2,6,3,0,0,0,0,13910,6.8,17749,173,56,-1555,-1023,22.9,1391.0
4846099315,0,41,0,0,1,4,0,0,0,0,0,12889,7.2,18222,140,60,-3268,-582,20.0,1288.9,11,1,1,4,1,4,0,0,0,0,16157,7.0,18804,199,52,3268,582,25.1,1615.7
4846049751,0,14,10,0,4,5,3,0,0,0,0,15728,6.6,16892,181,48,532,-57,22.9,1572.8,31,3,1,5,4,3,0,0,0,0,15196,6.8,16949,186,52,-532,57,23.8,1519.6
4844390654,0,13,0,1,6,4,4,0,0,0,0,16281,6.8,17455,181,52,77,481,23.3,1628.1,122,1,0,4,6,4,0,0,0,0,16204,6.8,16974,195,49,-77,-481,24.4,1620.4
4844338512,1,21,1,1,9,6,7,0,0,0,0,17876,6.8,17404,182,45,2266,843,22.7,1787.6,12,1,0,5,8,7,1,1,0,0,15610,6.4,16561,175,54,-2266,-843,22.9,1561.0
4844302828,1,33,2,1,6,5,3,0,0,0,0,15956,6.8,18125,196,60,533,140,25.6,1595.6,43,2,0,5,6,1,0,0,0,0,15423,7.0,17985,176,48,-533,-140,22.4,1542.3
4844268258,1,12,2,1,4,1,4,0,0,0,0,16146,7.2,19577,215,72,1413,1065,28.7,1614.6,9,0,0,1,4,1,0,0,0,0,14733,7.2,18512,240,56,-1413,-1065,29.6,1473.3
4843514726,1,12,0,1,5,2,3,1,1,0,0,16778,6.8,18344,223,60,2014,1426,28.3,1677.8,11,0,0,2,5,4,0,0,0,0,14764,6.8,16918,190,48,-2014,-1426,23.8,1476.4
4843478980,0,12,1,1,9,8,9,1,1,0,1,18250,6.6,16382,164,56,-2364,146,22.0,1825.0,15,1,0,8,9,10,0,0,0,0,20614,6.6,16236,195,4,2364,-146,19.9,2061.4
4843431056,0,16,1,1,4,5,4,0,0,0,0,15255,7.0,17938,205,68,299,146,27.3,1525.5,12,0,0,5,4,3,1,1,0,0,14956,7.0,17792,167,56,-299,-146,22.3,1495.6
4842596664,0,9,1,1,1,2,1,1,1,0,0,14457,7.0,18206,229,68,-866,615,29.7,1445.7,12,3,0,2,1,1,0,0,0,0,15323,6.8,17591,247,48,866,-615,29.5,1532.3
4856115342,0,18,0,0,7,7,3,1,1,0,0,16557,7.0,18361,178,68,220,1107,24.6,1655.7,13,3,1,7,7,5,0,0,0,0,16337,6.8,17254,207,48,-220,-1107,25.5,1633.7
4856066848,0,13,1,0,6,6,8,0,0,0,0,16089,6.6,17000,188,40,-777,124,22.8,1608.9,10,2,1,6,6,7,1,1,0,0,16866,6.6,16876,217,48,777,-124,26.5,1686.6
4855085878,1,0,0,1,11,15,12,0,0,0,0,44900,10.0,47500,0,0,17400,19000,0.0,4490.0,0,0,0,10,6,11,0,0,0,0,27500,6.0,28500,0,0,-17400,-19000,0.0,2750.0
4855052186,1,4,0,1,18,12,18,0,0,0,0,45250,10.0,47500,0,0,16900,19000,0.0,4525.0,0,0,0,9,15,7,0,0,0,0,28350,6.0,28500,0,0,-16900,-19000,0.0,2835.0
4854995486,0,8,0,1,6,8,6,0,0,0,0,16757,7.2,19099,220,64,-1807,-655,28.4,1675.7,16,1,0,8,6,7,2,1,1,0,18564,7.4,19754,241,64,1807,655,30.5,1856.4
4854941721,1,146,0,1,8,7,5,0,0,0,0,17114,6.8,18697,193,52,448,1436,24.5,1711.4,9,1,0,7,8,5,0,0,0,0,16666,6.8,17261,184,52,-448,-1436,23.6,1666.6
4854593922,1,9,0,0,2,9,2,0,0,0,0,16094,6.8,17151,190,72,-2336,-1759,26.2,1609.4,13,0,1,9,2,12,1,1,0,0,18430,7.0,18910,202,55,2336,1759,25.7,1843.0
4853852000,1,12,1,1,10,3,16,0,0,0,1,19801,7.2,18181,223,59,3644,385,28.2,1980.1,10,1,0,3,10,2,1,1,0,0,16157,6.8,17796,206,68,-3644,-385,27.4,1615.7
4853816369,1,11,0,1,10,1,7,2,1,1,0,19324,7.4,19436,214,64,2289,1353,27.8,1932.4,9,0,0,1,10,1,0,0,0,0,17035,7.0,18083,182,50,-2289,-1353,23.2,1703.5
4848789375,0,15,2,0,3,5,0,0,0,0,0,15009,6.8,17568,166,64,-984,572,23.0,1500.9,27,0,1,5,3,5,0,0,0,0,15993,6.6,16996,198,40,984,-572,23.8,1599.3
4848753296,1,9,1,0,6,2,4,1,1,0,0,16130,7.2,19052,225,48,336,1158,27.3,1613.0,14,0,1,2,6,1,0,0,0,0,15794,6.8,17894,204,58,-336,-1158,26.2,1579.4
4846834913,0,28,1,0,4,3,4,0,0,0,0,15923,6.6,16865,201,44,-709,1,24.5,1592.3,16,6,1,3,4,5,0,0,0,0,16632,6.6,16864,178,41,709,-1,21.9,1663.2
4846783714,0,11,2,0,7,5,7,0,0,0,0,17201,7.0,17867,180,56,-64,-775,23.6,1720.1,14,1,1,5,7,3,1,0,1,0,17265,7.0,18642,219,52,64,775,27.1,1726.5
4842208783,1,33,1,1,5,4,0,0,0,0,0,17529,7.0,18392,219,48,2296,914,26.7,1752.9,11,20,0,4,5,4,0,0,0,0,15233,6.8,17478,183,52,-2296,-914,23.5,1523.3
4842174736,0,7,0,1,5,3,1,0,0,0,0,15114,7.0,18072,198,46,-65,177,24.4,1511.4,11,0,0,3,5,1,1,1,0,0,15179,7.0,17895,199,65,65,-177,26.4,1517.9
4841155565,1,11,2,1,10,4,8,0,0,0,0,18199,6.8,17344,199,48,2231,549,24.7,1819.9,13,1,0,4,10,4,1,1,0,0,15968,6.6,16795,185,48,-2231,-549,23.3,1596.8
4841120058,1,11,1,0,7,4,2,1,1,0,0,16490,6.8,18447,199,56,125,1016,25.5,1649.0,14,1,1,4,7,3,0,0,0,0,16365,7.0,17431,186,56,-125,-1016,24.2,1636.5
4840122689,0,9,1,0,4,3,5,0,0,0,0,17164,7.6,20129,251,66,2055,2362,31.7,1716.4,19,0,1,3,4,3,0,0,0,0,15109,6.8,17767,217,61,-2055,-2362,27.8,1510.9
4840068933,1,13,0,0,5,9,3,0,0,0,0,15955,6.6,16130,133,52,-3303,-3582,18.5,1595.5,12,1,1,9,5,10,1,1,0,0,19258,7.2,19712,224,64,3303,3582,28.8,1925.8
4840016407,1,12,1,0,4,11,4,0,0,0,0,15557,6.2,14921,159,48,-3872,-4032,20.7,1555.7,17,3,1,11,4,8,0,0,0,0,19429,7.2,18953,202,60,3872,4032,26.2,1942.9
4858442063,1,15,0,1,5,3,15,1,1,0,0,17528,7.2,19548,235,79,3593,4148,31.4,1752.8,13,0,0,3,5,5,0,0,0,0,13935,6.4,15400,176,36,-3593,-4148,21.2,1393.5
4858368273,1,10,1,0,5,4,6,0,0,0,0,16055,6.8,17584,237,44,-655,124,28.1,1605.5,12,1,1,4,5,4,0,0,0,0,16710,6.8,17460,259,52,655,-124,31.1,1671.0
4858300723,1,13,3,1,8,0,8,0,0,0,0,18280,7.0,19004,217,56,5694,3175,27.3,1828.0,9,1,0,0,8,0,0,0,0,0,12586,6.4,15829,168,52,-5694,-3175,22.0,1258.6
4857553741,1,14,1,0,11,3,15,0,0,0,0,19262,7.2,18495,231,63,4210,2277,29.4,1926.2,66,0,1,3,11,4,1,1,0,0,15052,6.4,16218,162,43,-4210,-2277,20.5,1505.2
4857510811,1,13,0,0,6,4,3,0,0,0,0,16082,7.0,18015,230,48,635,1797,27.8,1608.2,15,2,1,4,6,6,1,1,0,0,15447,6.6,16218,189,56,-635,-1797,24.5,1544.7
4857450197,0,16,3,1,2,3,1,0,0,0,0,14905,6.8,17122,188,60,-87,-498,24.8,1490.5,19,3,0,3,2,1,0,0,0,0,14992,7.0,17620,196,49,87,498,24.5,1499.2
4857401081,1,45,0,0,25,22,62,0,0,0,1,39486,11.6,42224,102,0,2546,2651,10.2,3948.6,0,1,1,22,25,47,0,0,0,0,36940,11.0,39573,114,0,-2546,-2651,11.4,3694.0
4857185666,0,11,1,0,8,3,6,1,1,0,0,16298,6.6,17384,182,32,-120,-374,21.4,1629.8,160,1,1,3,8,1,0,0,0,0,16418,6.8,17758,181,60,120,374,24.1,1641.8
4857169040,0,0,0,0,29,23,76,0,0,0,1,39048,11.2,39941,117,0,588,-2545,11.7,3904.8,0,0,1,23,29,45,0,0,0,0,38460,11.4,42486,118,0,-588,2545,11.8,3846.0
4857143250,1,245,4,1,19,14,39,0,0,0,0,37619,11.0,40101,129,0,3016,2840,12.9,3761.9,6,0,0,14,19,32,0,0,0,0,34603,10.6,37261,96,0,-3016,-2840,9.6,3460.3
4855090755,0,13,0,1,6,4,5,0,0,0,0,16149,6.6,16472,206,36,593,-2351,24.2,1614.9,11,0,0,4,6,1,0,0,0,0,15556,7.0,18823,194,76,-593,2351,27.0,1555.6
4854208407,1,10,5,1,9,7,19,1,0,1,0,18674,7.0,17677,204,39,2486,730,24.3,1867.4,18,0,0,7,9,6,0,0,0,0,16188,6.6,16947,230,35,-2486,-730,26.5,1618.8
4854152614,1,12,1,1,4,1,3,0,0,0,0,15414,6.8,17666,210,44,588,203,25.4,1541.4,16,2,0,1,4,1,0,0,0,0,14826,7.0,17463,175,60,-588,-203,23.5,1482.6
4854090470,0,8,3,1,5,4,4,0,0,0,0,16523,7.0,18520,201,60,720,224,26.1,1652.3,12,0,0,4,5,2,0,0,0,0,15803,7.2,18296,224,44,-720,-224,26.8,1580.3
4854031646,1,28,1,1,2,3,2,0,0,0,0,14513,6.6,17849,213,64,-1124,-263,27.7,1451.3,15,10,0,3,2,1,1,1,0,0,15637,7.0,18112,189,52,1124,263,24.1,1563.7
4853918087,0,14,1,0,4,4,1,0,0,0,0,14737,7.0,18251,175,60,-1331,518,23.5,1473.7,11,1,1,4,4,4,1,1,0,0,16068,7.0,17733,223,55,1331,-518,27.8,1606.8
4853854482,0,17,1,1,4,3,4,0,0,0,0,16006,6.8,16996,224,52,1963,-333,27.6,1600.6,9,3,0,3,4,0,1,1,0,0,14043,6.8,17329,190,44,-1963,333,23.4,1404.3
4853082426,0,17,3,0,2,6,0,0,0,0,0,15062,6.8,18161,206,59,-3696,-597,26.5,1506.2,11,2,1,6,2,8,0,0,0,0,18758,7.0,18758,242,52,3696,597,29.4,1875.8
4853029347,1,15,1,1,4,0,2,1,0,1,0,16684,7.0,19228,239,60,2772,412,29.9,1668.4,11,2,0,0,4,0,1,1,0,0,13912,7.0,18816,225,68,-2772,-412,29.3,1391.2
4852981680,0,9,1,1,4,2,3,0,0,0,0,15526,7.0,18539,233,51,315,-231,28.4,1552.6,15,0,0,2,4,2,1,0,1,0,15211,7.2,18770,211,72,-315,231,28.3,1521.1
4858222733,1,0,2,1,14,12,11,0,0,0,0,30790,9.0,40000,5,0,12225,16000,0.5,3079.0,14,0,0,7,9,6,0,0,0,0,18565,5.4,24000,0,0,-12225,-16000,0.0,1856.5
4858207833,1,0,0,1,24,11,18,0,0,0,0,49150,10.0,47500,1,0,22950,19000,0.1,4915.0,0,0,0,2,15,5,0,0,0,0,26200,6.0,28500,2,0,-22950,-19000,0.2,2620.0
4858171587,1,0,0,0,19,14,19,0,0,0,0,48400,10.0,47500,0,0,21600,16000,0.0,4840.0,0,0,1,7,12,6,0,0,0,0,26800,6.6,31500,0,0,-21600,-16000,0.0,2680.0
4857665202,1,0,0,1,19,16,20,0,0,0,0,62080,12.2,56000,0,0,25580,23000,0.0,6208.0,0,0,0,7,10,7,0,0,0,0,36500,7.2,33000,0,0,-25580,-23000,0.0,3650.0
4856378734,1,9,0,1,21,15,22,0,0,0,0,65150,12.0,55000,0,0,27600,22000,0.0,6515.0,0,0,0,9,15,10,0,0,0,0,37550,7.2,33000,0,0,-27600,-22000,0.0,3755.0
4856345465,1,0,0,0,17,11,19,0,0,0,0,47000,10.0,47500,0,0,20200,19000,0.0,4700.0,0,0,1,6,12,3,0,0,0,0,26800,6.0,28500,0,0,-20200,-19000,0.0,2680.0
4856318788,1,41,0,1,16,23,10,0,0,0,0,44900,10.0,47500,0,0,16000,16000,0.0,4490.0,0,0,0,12,5,15,0,0,0,0,28900,6.6,31500,0,0,-16000,-16000,0.0,2890.0
4856263052,0,1,0,0,21,22,62,0,0,0,0,35436,11.0,39716,97,0,-1010,-264,9.7,3543.6,36,0,1,22,21,56,0,0,0,0,36446,11.2,39980,97,0,1010,264,9.7,3644.6
4856225567,1,0,0,1,27,14,78,0,0,0,1,37673,11.0,39714,108,0,2580,3906,10.8,3767.3,0,0,0,14,27,25,0,0,0,0,35093,10.4,35808,107,0,-2580,-3906,10.7,3509.3
4856182951,1,0,0,1,19,12,54,0,0,0,0,35174,10.8,37781,114,0,1626,2156,11.4,3517.4,0,0,0,12,19,28,0,0,0,0,33548,10.2,35625,94,0,-1626,-2156,9.4,3354.8
4856141852,1,0,0,1,27,17,25,0,0,0,0,50500,10.0,47500,0,0,21600,19000,0.0,5050.0,0,0,0,4,14,10,0,0,0,0,28900,6.0,28500,0,0,-21600,-19000,0.0,2890.0
4855860139,0,8,0,1,31,31,67,0,0,0,0,39413,11.8,45291,100,0,-99,1854,10.0,3941.3,0,2,0,31,31,70,0,0,0,0,39512,11.8,43437,114,0,99,-1854,11.4,3951.2
4855830718,0,1,6,1,26,26,47,0,0,0,1,38644,11.4,41824,125,0,1458,1255,12.5,3864.4,13,0,0,25,25,54,0,0,0,0,37186,11.0,40569,94,0,-1458,-1255,9.4,3718.6
4855556215,1,0,0,1,13,17,23,0,0,0,0,48750,10.0,47500,5,0,20200,19000,0.5,4875.0,0,0,0,13,9,5,0,0,0,0,28550,6.0,28500,3,0,-20200,-19000,0.3,2855.0
4855551041,1,353,0,1,10,20,11,0,0,0,0,45657,10.0,47799,0,0,16757,19299,0.0,4565.7,0,0,0,16,6,15,0,0,0,0,28900,6.0,28500,0,0,-16757,-19299,0.0,2890.0
4855544999,1,8,0,1,15,17,15,0,0,0,0,46395,10.0,47500,1,0,18216,19000,0.1,4639.5,0,0,0,10,8,8,0,0,0,0,28179,6.0,28500,1,0,-18216,-19000,0.1,2817.9
4855534690,1,4,0,0,22,19,24,0,0,0,0,49100,10.0,47500,0,0,20900,19000,0.0,4910.0,0,0,1,9,12,9,0,0,0,0,28200,6.0,28500,0,0,-20900,-19000,0.0,2820.0
4855533932,1,0,0,1,16,17,19,0,0,0,0,47437,10.0,47500,3,0,20287,19000,0.3,4743.7,8,0,0,11,10,8,0,0,0,0,27150,6.0,28500,0,0,-20287,-19000,0.0,2715.0
4855523418,1,0,0,0,20,21,20,0,0,0,0,64525,12.0,55000,0,0,27630,22000,0.0,6452.5,0,0,1,12,11,9,0,0,0,0,36895,7.2,33000,0,0,-27630,-22000,0.0,3689.5
4855517328,1,0,0,1,9,22,12,0,0,0,0,45784,10.0,47500,0,0,16149,19000,0.0,4578.4,0,0,0,17,4,12,0,0,0,0,29635,6.0,28500,0,0,-16149,-19000,0.0,2963.5
4763533589,1,0,0,0,25,32,65,0,0,0,1,38937,11.6,42844,100,0,-858,-1196,10.0,3893.7,0,0,1,32,25,78,0,0,0,0,39795,11.6,44040,107,0,858,1196,10.7,3979.5
4763497524,1,13,0,1,3,2,3,0,0,0,0,16360,7.0,18810,231,68,1397,1096,29.9,1636.0,12,0,0,2,3,2,0,0,0,0,14963,7.0,17714,214,68,-1397,-1096,28.2,1496.3
4762882443,1,43,2,1,5,3,8,0,0,0,0,15102,6.8,17022,164,55,-1251,-1347,21.9,1510.2,16,0,0,3,5,2,1,1,0,0,16353,7.2,18369,208,64,1251,1347,27.2,1635.3
4762854890,1,12,2,1,6,3,5,0,0,0,0,17301,6.8,18025,205,48,1173,-944,25.3,1730.1,12,0,0,3,6,1,0,0,0,0,16128,7.4,18969,218,80,-1173,944,29.8,1612.8
4762704768,1,18,0,1,7,5,6,0,0,0,0,18266,6.6,17488,210,56,2785,1788,26.6,1826.6,7,0,0,5,7,2,0,0,0,0,15481,6.6,15700,148,56,-2785,-1788,20.4,1548.1
4762671556,0,8,0,1,3,8,2,0,0,0,0,14887,6.8,17139,195,52,-1433,-645,24.7,1488.7,10,0,0,8,3,7,1,1,0,0,16320,6.8,17784,173,50,1433,645,22.3,1632.0
4761874443,1,8,2,1,6,5,3,0,0,0,0,16251,7.0,18166,218,56,471,459,27.4,1625.1,11,0,0,5,6,6,0,0,0,0,15780,7.0,17707,223,44,-471,-459,26.7,1578.0
4761853845,1,11,0,1,9,3,8,0,0,0,0,17369,6.8,17592,177,72,3536,1713,24.9,1736.9,14,0,0,3,9,4,0,0,0,0,13833,6.4,15879,177,44,-3536,-1713,22.1,1383.3
4761833829,0,10,0,1,12,4,8,0,0,0,0,18417,7.2,19044,196,56,2800,471,25.2,1841.7,346,1,0,4,12,0,1,1,0,0,15617,7.2,18573,221,68,-2800,-471,28.9,1561.7
4761813510,1,0,2,1,35,27,88,0,0,0,1,43469,12.0,46804,122,0,4169,4063,12.2,4346.9,2,0,0,27,35,65,0,0,0,0,39300,11.2,42741,101,0,-4169,-4063,10.1,3930.0
4761297459,0,13,0,0,2,3,1,0,0,0,0,14449,6.8,18395,215,40,-1183,-665,25.5,1444.9,11,0,1,3,2,1,0,0,0,0,15632,7.0,19060,230,75,1183,665,30.5,1563.2
4761249554,1,10,1,1,8,3,4,0,0,0,0,16955,6.8,17743,223,48,3090,2096,27.1,1695.5,88,3,0,3,8,2,1,1,0,0,13865,6.4,15647,147,52,-3090,-2096,19.9,1386.5
4760995606,1,17,0,0,2,3,1,1,0,1,0,14565,6.8,17690,188,64,-522,458,25.2,1456.5,15,2,1,3,2,2,0,0,0,0,15087,6.6,17232,234,56,522,-458,29.0,1508.7
4760975708,0,14,2,0,0,7,0,0,0,0,0,13687,6.8,16957,200,64,-3857,-2181,26.4,1368.7,14,5,1,7,0,6,1,1,0,0,17544,7.4,19138,219,71,3857,2181,29.0,1754.4
4760960581,0,12,2,1,5,5,3,0,0,0,0,15828,6.8,17091,208,52,-3001,-1688,26.0,1582.8,10,1,0,5,5,5,1,0,1,0,18829,6.8,18779,252,56,3001,1688,30.8,1882.9
4760943682,0,9,1,0,3,12,4,1,1,0,0,16163,6.4,16148,178,64,-5154,-3403,24.2,1616.3,16,0,1,12,3,9,0,0,0,0,21317,7.2,19551,212,39,5154,3403,25.1,2131.7
4760514720,0,13,2,1,2,4,4,0,0,0,0,15220,6.8,17218,181,52,-1762,-2606,23.3,1522.0,13,2,0,4,2,4,0,0,0,0,16982,7.6,19824,270,68,1762,2606,33.8,1698.2
4760467749,1,13,0,0,8,7,5,0,0,0,0,17550,7.0,17432,193,55,1023,-43,24.8,1755.0,7,1,1,7,8,5,0,0,0,0,16527,7.0,17475,201,48,-1023,43,24.9,1652.7
4760419114,0,18,1,1,5,1,3,1,1,0,0,15907,7.0,18138,197,52,1511,960,24.9,1590.7,6,1,0,1,5,1,0,0,0,0,14396,6.6,17178,221,64,-1511,-960,28.5,1439.6
4760391088,1,76,1,1,7,3,6,1,1,0,0,18199,6.8,17878,219,63,2989,647,28.2,1819.9,12,0,0,3,7,3,0,0,0,0,15210,6.6,17231,195,56,-2989,-647,25.1,1521.0
4858054849,1,10,2,0,3,4,0,0,0,0,0,14935,6.8,18065,216,52,-580,-246,26.8,1493.5,12,1,1,4,3,3,1,1,0,0,15515,7.0,18311,216,76,580,246,29.2,1551.5
4858014221,0,12,0,1,7,5,8,0,0,0,0,16668,6.8,17708,190,44,612,-523,23.4,1666.8,12,2,0,5,7,4,0,0,0,0,16056,6.8,18231,218,56,-612,523,27.4,1605.6
4857987266,1,0,0,1,39,23,92,0,0,0,1,42375,12.2,49010,103,0,6643,9058,10.3,4237.5,0,0,0,23,39,50,0,0,0,0,35732,11.2,39952,79,0,-6643,-9058,7.9,3573.2
4856875404,1,14,2,1,8,2,13,0,0,0,0,17385,6.6,16506,182,52,4105,2067,23.4,1738.5,26,2,0,2,8,3,0,0,0,0,13280,6.0,14439,152,50,-4105,-2067,20.2,1328.0
4856865839,0,14,0,0,19,31,53,0,0,0,0,35527,11.0,40365,100,0,-3326,-3996,10.0,3552.7,0,0,1,31,19,60,0,0,0,0,38853,11.8,44361,106,0,3326,3996,10.6,3885.3
4854798069,0,14,1,0,5,4,6,0,0,0,0,15395,6.6,16937,202,60,-744,-1436,26.2,1539.5,11,0,1,4,5,5,1,1,0,0,16139,6.8,18373,222,60,744,1436,28.2,1613.9
4854471657,0,82,1,1,3,2,2,0,0,0,0,15295,6.8,17926,170,65,-170,-115,23.5,1529.5,11,1,0,2,3,2,1,1,0,0,15465,6.8,18041,225,56,170,115,28.1,1546.5
4854455218,1,2,0,1,29,25,81,0,0,0,1,39688,11.8,43942,111,0,3284,3447,11.1,3968.8,11,1,0,25,29,50,0,0,0,0,36404,11.2,40495,96,0,-3284,-3447,9.6,3640.4
4853499299,1,7,0,0,35,28,98,0,0,0,2,42970,11.8,46158,104,0,5069,3118,10.4,4297.0,0,0,1,28,35,57,0,0,0,0,37901,11.4,43040,77,0,-5069,-3118,7.7,3790.1
4852522971,0,17,16,0,5,9,2,0,0,0,0,15978,7.0,17763,184,56,-2003,-694,24.0,1597.8,33,0,1,9,5,5,0,0,0,0,17981,7.0,18457,215,48,2003,694,26.3,1798.1
4852486958,1,10,1,1,8,2,9,0,0,0,0,19500,7.6,20069,206,56,4732,2905,26.2,1950.0,11,0,0,2,8,2,0,0,0,0,14768,6.8,17164,200,63,-4732,-2905,26.3,1476.8
4852316715,1,9,2,0,7,2,5,1,1,0,0,16656,7.0,18812,211,56,2448,846,26.7,1665.6,8,0,1,2,7,1,0,0,0,0,14208,7.0,17966,188,60,-2448,-846,24.8,1420.8
4851374126,1,12,1,0,2,2,2,0,0,0,0,16696,6.8,18048,214,60,2786,1224,27.4,1669.6,13,0,1,2,2,0,0,0,0,0,13910,6.8,16824,176,64,-2786,-1224,24.0,1391.0
4851349076,1,16,1,0,4,5,5,0,0,0,0,16410,6.8,17902,234,44,-144,-593,27.8,1641.0,73,2,1,5,4,5,0,0,0,0,16554,7.0,18495,219,67,144,593,28.6,1655.4
4851338923,0,0,2,1,27,23,76,0,0,0,2,38665,10.8,40215,92,0,348,-1787,9.2,3866.5,19,0,0,23,27,57,0,0,0,0,38317,11.4,42002,90,0,-348,1787,9.0,3831.7
4850501300,1,11,0,1,2,1,2,1,1,0,0,15271,7.0,18730,224,64,-363,-90,28.8,1527.1,12,1,0,1,2,2,1,0,1,0,15634,7.0,18820,236,56,363,90,29.2,1563.4
4850474202,1,28,2,0,8,6,3,0,0,0,0,15641,6.4,15907,167,36,-1756,-2637,20.3,1564.1,13,0,1,6,8,5,2,1,1,0,17397,7.2,18544,216,68,1756,2637,28.4,1739.7
4850465777,1,26,0,1,25,27,53,0,0,0,1,37332,11.4,41766,106,0,-2037,-708,10.6,3733.2,0,27,0,27,25,73,0,0,0,0,39369,11.4,42474,106,0,2037,708,10.6,3936.9
4828222925,0,16,1,0,4,10,3,0,0,0,0,16187,6.8,17313,189,56,-2524,-235,24.5,1618.7,12,4,1,10,4,11,1,1,0,0,18711,7.0,17548,245,50,2524,235,29.5,1871.1
4828204869,1,11,0,1,4,2,3,0,0,0,0,17037,7.2,18424,243,60,1736,852,30.3,1703.7,11,2,0,2,4,1,1,1,0,0,15301,7.0,17572,213,52,-1736,-852,26.5,1530.1
4827321554,0,10,3,0,4,4,5,1,1,0,0,16569,7.2,20032,219,56,866,2406,27.5,1656.9,10,1,1,4,4,3,0,0,0,0,15703,6.6,17626,208,68,-866,-2406,27.6,1570.3
4827287310,0,11,4,1,5,4,4,0,0,0,0,17305,7.2,18588,232,56,1851,1055,28.8,1730.5,11,3,0,4,5,3,1,1,0,0,15454,6.8,17533,198,64,-1851,-1055,26.2,1545.4
4820459733,1,11,2,1,6,9,5,0,0,0,0,17977,7.4,19210,210,51,-459,839,26.1,1797.7,12,2,0,9,6,7,0,0,0,0,18436,7.4,18371,206,60,459,-839,26.6,1843.6
4788958558,0,234,1,1,5,3,8,1,1,0,0,16388,6.6,17664,214,59,452,-189,27.3,1638.8,73,6,0,3,5,2,0,0,0,0,15936,6.8,17853,199,80,-452,189,27.9,1593.6
4774786541,0,9,0,1,7,6,5,0,0,0,0,16425,7.0,18947,202,53,-2454,-752,25.5,1642.5,76,1,0,6,7,9,1,1,0,0,18879,7.4,19699,252,72,2454,752,32.4,1887.9
4769534596,0,13,1,0,6,6,7,0,0,0,0,17480,7.2,18847,208,68,506,831,27.6,1748.0,10,3,1,6,6,5,1,1,0,0,16974,6.8,18016,216,50,-506,-831,26.6,1697.4
4722249144,1,15,0,0,27,19,60,0,0,0,0,37514,11.0,42411,81,0,965,1624,8.1,3751.4,0,3,1,19,27,33,0,0,0,0,36549,11.2,40787,108,0,-965,-1624,10.8,3654.9
4721358411,0,14,0,0,5,13,1,0,0,0,0,14377,6.4,15689,148,52,-4339,-1979,20.0,1437.7,6,2,1,12,4,11,1,1,0,0,18716,6.8,17668,181,44,4339,1979,22.5,1871.6
4715712907,1,14,4,1,5,3,4,1,1,0,0,16820,7.2,17885,222,60,277,-1254,28.2,1682.0,16,2,0,3,5,2,0,0,0,0,16543,7.2,19139,212,59,-277,1254,27.1,1654.3
4709842246,0,14,5,0,2,6,0,0,0,0,0,14842,7.2,18851,226,52,-1803,598,27.8,1484.2,15,3,1,6,2,7,1,0,1,0,16645,7.0,18253,206,60,1803,-598,26.6,1664.5
4705215684,0,14,0,1,6,4,3,0,0,0,0,16187,7.0,17850,231,46,1026,983,27.7,1618.7,12,1,0,4,6,2,0,0,0,0,15161,6.8,16867,213,45,-1026,-983,25.8,1516.1
4705089339,1,9,1,1,3,5,1,1,1,0,0,15819,6.8,17649,211,56,-978,-203,26.7,1581.9,11,3,0,5,3,4,0,0,0,0,16797,6.8,17852,216,59,978,203,27.5,1679.7
4705055442,0,10,1,0,6,7,8,0,0,0,0,16580,6.4,16132,208,46,-386,-1282,25.4,1658.0,12,1,1,7,6,5,0,0,0,0,16966,6.8,17414,203,61,386,1282,26.4,1696.6
4704163638,0,12,0,0,3,6,0,0,0,0,0,14423,6.8,17931,190,64,-1824,-347,25.4,1442.3,8,1,1,6,3,7,0,0,0,0,16247,7.0,18278,199,38,1824,347,23.7,1624.7
4704131491,0,17,0,1,4,5,1,0,0,0,0,15355,6.8,18149,202,52,82,-45,25.4,1535.5,9,0,0,5,4,2,0,0,0,0,15273,6.8,18194,209,52,-82,45,26.1,1527.3
4704101787,1,12,20,0,7,4,6,0,0,0,0,16395,6.4,17198,161,52,280,-1223,21.3,1639.5,32,2,1,4,7,1,0,0,0,0,16115,7.2,18421,231,68,-280,1223,29.9,1611.5
4696400985,1,13,1,1,13,4,12,2,1,1,0,20258,6.6,17017,198,46,3972,2145,24.4,2025.8,10,1,0,4,13,4,0,0,0,0,16286,6.2,14872,149,45,-3972,-2145,19.4,1628.6
4696379643,0,11,2,0,2,7,3,0,0,0,0,15157,7.0,17154,184,56,-4905,-4397,24.0,1515.7,18,1,1,7,2,8,2,1,1,0,20062,7.8,21551,215,72,4905,4397,28.7,2006.2
4837263089,0,21,0,0,1,3,2,0,0,0,0,15008,6.8,17754,258,48,-339,486,30.6,1500.8,9,3,1,3,1,1,0,0,0,0,15347,6.6,17268,202,56,339,-486,25.8,1534.7
4837209772,1,11,0,0,5,3,4,1,0,1,0,16444,6.8,18412,213,54,820,73,26.7,1644.4,11,2,1,3,5,2,0,0,0,0,15624,7.0,18339,195,60,-820,-73,25.5,1562.4
4819569095,0,16,5,0,6,9,8,1,1,0,0,17424,6.6,17447,202,56,-1182,-236,25.8,1742.4,17,5,1,9,6,9,0,0,0,0,18606,7.0,17683,193,44,1182,236,23.7,1860.6
4819537708,0,13,5,1,11,5,23,0,0,0,0,18698,7.0,18786,221,60,1633,-511,28.1,1869.8,13,1,0,5,11,4,1,1,0,0,17065,7.4,19297,247,70,-1633,511,31.7,1706.5
4819517553,1,10,2,0,3,3,2,1,1,0,0,15347,7.0,18298,218,72,-276,298,29.0,1534.7,12,1,1,3,3,3,0,0,0,0,15623,6.8,18000,216,48,276,-298,26.4,1562.3
4819505968,1,17,2,1,6,1,4,0,0,0,0,16917,7.2,19184,256,50,2108,1593,30.6,1691.7,14,1,0,1,6,1,0,0,0,0,14809,7.0,17591,239,56,-2108,-1593,29.5,1480.9
4801597010,0,15,1,1,8,6,6,0,0,0,0,17079,7.0,17675,223,44,-9,-657,26.7,1707.9,11,1,0,6,8,4,0,0,0,0,17088,7.0,18332,193,55,9,657,24.8,1708.8
4715563079,0,12,2,0,9,7,7,1,1,0,0,18162,6.8,17392,203,51,863,-1108,25.4,1816.2,12,0,1,7,9,4,0,0,0,0,17299,7.0,18500,211,52,-863,1108,26.3,1729.9
4715541887,1,14,1,0,5,3,9,0,0,0,0,15622,6.8,17868,214,60,-633,-977,27.4,1562.2,11,2,1,3,5,0,0,0,0,0,16255,7.0,18845,257,48,633,977,30.5,1625.5
4713613698,0,52,1,0,3,8,2,0,0,0,0,15284,6.6,16976,198,60,-2583,-1678,25.8,1528.4,12,1,1,8,3,6,0,0,0,0,17867,7.0,18654,235,64,2583,1678,29.9,1786.7
4712604363,1,13,3,1,13,5,17,1,1,0,0,19214,6.8,17833,219,51,4369,2605,27.0,1921.4,67,0,0,4,12,6,0,0,0,0,14845,6.4,15228,165,48,-4369,-2605,21.3,1484.5
4712581230,1,20,3,0,5,5,7,1,1,0,0,17242,6.8,17767,234,52,209,-429,28.6,1724.2,108,3,1,5,5,6,0,0,0,0,17033,7.0,18196,233,64,-209,429,29.7,1703.3
4712518470,0,13,1,1,6,8,4,1,1,0,0,16334,6.8,17006,213,59,-2378,-1208,27.2,1633.4,11,2,0,8,6,9,0,0,0,0,18712,6.8,18214,250,44,2378,1208,29.4,1871.2
4712502278,0,12,1,0,3,10,1,0,0,0,0,14382,6.8,17295,202,56,-4915,-2510,25.8,1438.2,17,3,1,10,3,9,1,1,0,0,19297,7.2,19805,243,52,4915,2510,29.5,1929.7
4712432053,0,12,2,0,1,1,1,0,0,0,0,14770,6.6,17482,225,60,-384,133,28.5,1477.0,10,5,1,1,1,2,0,0,0,0,15154,6.6,17349,222,48,384,-133,27.0,1515.4
4711759391,1,14,0,1,4,7,4,1,1,0,0,16933,7.2,19155,237,64,-311,623,30.1,1693.3,19,3,0,7,4,6,0,0,0,0,17244,7.0,18532,254,52,311,-623,30.6,1724.4
4711743114,1,11,1,1,9,6,9,1,1,0,0,18257,7.0,17363,187,52,1352,-636,23.9,1825.7,18,1,0,6,9,5,0,0,0,0,16905,7.0,17999,222,56,-1352,636,27.8,1690.5
4711728858,1,7,1,0,8,2,12,1,1,0,0,17442,6.8,18021,191,60,2456,1242,25.1,1744.2,8,1,1,2,8,5,0,0,0,0,14986,6.8,16779,209,44,-2456,-1242,25.3,1498.6
4711562417,0,10,0,0,4,2,5,1,1,0,0,16527,6.8,17981,223,52,1062,349,27.5,1652.7,9,0,1,2,4,1,1,0,1,0,15465,6.8,17632,204,60,-1062,-349,26.4,1546.5
4850012128,0,14,1,0,3,7,3,1,0,1,0,15314,6.8,17492,221,54,-1740,-839,27.5,1531.4,13,0,1,7,3,7,1,1,0,0,17054,6.8,18331,233,54,1740,839,28.7,1705.4
4796617442,1,17,4,0,7,6,7,1,0,1,0,17771,6.8,16903,185,40,413,398,22.5,1777.1,18,1,1,6,7,4,0,0,0,0,17358,6.6,16505,205,56,-413,-398,26.1,1735.8
4795122130,1,24,2,0,5,5,6,1,1,0,0,15312,6.6,17190,199,60,-1119,-631,25.9,1531.2,23,1,1,5,5,4,0,0,0,0,16431,6.8,17821,244,48,1119,631,29.2,1643.1
4795071693,1,22,1,0,3,5,1,1,1,0,0,14723,6.8,17390,241,48,-1660,-436,28.9,1472.3,10,1,1,5,3,6,0,0,0,0,16383,7.0,17826,220,70,1660,436,29.0,1638.3
4795040237,1,13,3,1,6,3,4,0,0,0,0,17346,7.4,18897,230,60,2863,1596,29.0,1734.6,16,2,0,3,6,0,1,1,0,0,14483,6.8,17301,192,76,-2863,-1596,26.8,1448.3
4791763375,1,20,2,0,5,3,6,0,0,0,0,16427,6.6,17912,215,54,-275,-1542,26.9,1642.7,13,2,1,3,5,2,0,0,0,0,16702,7.4,19454,239,70,275,1542,30.9,1670.2
4791588039,1,13,3,1,8,7,6,0,0,0,0,18067,7.2,19630,227,67,1757,1944,29.4,1806.7,12,1,0,7,8,6,0,0,0,0,16310,7.2,17686,203,52,-1757,-1944,25.5,1631.0
4791566423,1,13,3,0,7,9,5,0,0,0,0,18419,7.2,18484,215,68,492,1233,28.3,1841.9,11,1,1,9,7,9,0,0,0,0,17927,6.8,17251,211,63,-492,-1233,27.4,1792.7
4790260729,1,14,3,0,5,6,2,1,1,0,0,16296,7.2,18896,226,68,-379,409,29.4,1629.6,14,1,1,6,5,7,0,0,0,0,16675,7.0,18487,218,48,379,-409,26.6,1667.5
4790247083,0,71,1,1,3,4,0,2,1,1,0,14905,7.0,18146,209,60,-2207,-1035,26.9,1490.5,13,2,0,4,3,4,0,0,0,0,17112,7.0,19181,246,62,2207,1035,30.8,1711.2
4789299822,0,21,0,1,4,5,3,1,1,0,0,15946,6.8,18100,206,72,403,1063,27.8,1594.6,13,1,0,5,4,3,1,0,1,0,15543,6.8,17037,188,52,-403,-1063,24.0,1554.3
4789275916,0,15,1,0,3,4,7,0,0,0,0,16334,6.6,17625,227,56,448,1160,28.3,1633.4,104,1,1,4,3,3,0,0,0,0,15886,6.6,16465,195,51,-448,-1160,24.6,1588.6
4789092225,1,18,1,1,8,5,12,1,1,0,0,17595,6.6,17028,222,44,2329,2100,26.6,1759.5,13,2,0,5,8,11,0,0,0,0,15266,6.0,14928,171,56,-2329,-2100,22.7,1526.6
4789068067,1,18,2,1,7,5,8,0,0,0,0,16738,6.6,16710,210,54,704,-186,26.4,1673.8,16,2,0,5,7,6,1,1,0,0,16034,6.6,16896,189,52,-704,186,24.1,1603.4
4789038589,0,42,0,1,6,6,7,0,0,0,0,16222,6.6,16727,200,40,-520,-1295,24.0,1622.2,19,0,0,6,6,6,0,0,0,0,16742,7.0,18022,209,59,520,1295,26.8,1674.2
4788763612,0,12,0,1,5,3,1,1,0,1,0,17640,7.0,19575,223,56,1705,2629,27.9,1764.0,14,0,0,3,5,4,1,1,0,0,15935,6.8,16946,207,63,-1705,-2629,27.0,1593.5
4788477683,0,16,1,1,7,12,8,0,0,0,0,15698,6.4,15601,144,44,-3522,-3406,18.8,1569.8,16,1,0,12,7,12,1,1,0,0,19220,7.0,19007,191,60,3522,3406,25.1,1922.0
4788449933,0,40,0,1,7,3,8,0,0,0,0,16988,6.8,16962,188,56,1068,-919,24.4,1698.8,14,0,0,3,7,3,1,0,1,0,15920,7.0,17881,206,62,-1068,919,26.8,1592.0
4788367925,1,75,3,0,4,9,4,1,1,0,0,16063,7.0,19049,193,64,-1408,427,25.7,1606.3,13,20,1,9,4,7,0,0,0,0,17471,7.0,18622,209,60,1408,-427,26.9,1747.1
4784964965,1,11,1,0,4,10,2,1,1,0,0,14760,6.4,16190,171,52,-3228,-2116,22.3,1476.0,16,1,1,10,4,9,0,0,0,0,17988,6.8,18306,202,48,3228,2116,25.0,1798.8
4848417069,1,17,2,1,8,4,13,0,0,0,0,19237,7.2,19061,235,66,2842,1241,30.1,1923.7,41,1,0,4,8,3,0,0,0,0,16395,6.8,17820,211,44,-2842,-1241,25.5,1639.5
4847869864,0,13,2,1,5,3,1,0,0,0,0,15528,7.0,18133,210,68,69,257,27.8,1552.8,13,1,0,3,5,2,0,0,0,0,15459,7.0,17876,204,52,-69,-257,25.6,1545.9
4847814157,1,11,0,1,7,8,5,0,0,0,0,18022,7.2,18604,229,64,1197,108,29.3,1802.2,5,0,0,8,7,11,0,0,0,0,16825,7.0,18496,202,44,-1197,-108,24.6,1682.5
4847746953,0,63,0,1,8,5,8,0,0,0,0,17413,7.0,17835,198,60,-887,-1205,25.8,1741.3,11,0,0,5,8,5,0,0,0,0,18300,6.8,19040,217,56,887,1205,27.3,1830.0
4847698073,1,13,0,0,4,5,2,0,0,0,0,16460,7.0,17619,180,56,411,645,23.6,1646.0,12,1,1,5,4,7,0,0,0,0,16049,6.8,16974,157,60,-411,-645,21.7,1604.9
4847659928,0,11,0,0,3,7,2,0,0,0,0,14128,6.4,16364,220,32,-2965,-2248,25.2,1412.8,7,0,1,7,3,3,1,1,0,0,17093,7.2,18612,204,58,2965,2248,26.2,1709.3
4847640918,1,10,2,1,11,3,9,0,0,0,0,18112,7.0,18361,187,52,4006,1903,23.9,1811.2,12,1,0,3,11,2,0,0,0,0,14106,6.6,16458,137,52,-4006,-1903,18.9,1410.6
4847595134,0,8,2,1,9,4,13,0,0,0,0,17314,7.0,17819,179,64,1701,954,24.3,1731.4,41,0,0,4,9,3,0,0,0,0,15613,6.8,16865,177,56,-1701,-954,23.3,1561.3
4811505711,1,10,0,1,30,13,54,0,0,0,2,37888,11.6,42814,77,63,1174,6158,14.0,3788.8,8,0,0,13,30,19,0,0,0,0,36714,10.6,36656,72,48,-1174,-6158,12.0,3671.4
4793702229,1,9,2,0,7,7,2,1,1,0,0,16748,6.8,18179,205,58,10,949,26.3,1674.8,12,1,1,7,7,4,0,0,0,0,16738,6.4,17230,207,60,-10,-949,26.7,1673.8
4793683104,0,39,1,0,1,9,1,0,0,0,0,14937,6.8,17461,208,56,-3904,-2658,26.4,1493.7,12,11,1,9,1,9,1,1,0,0,18841,7.4,20119,230,80,3904,2658,31.0,1884.1
4792915607,1,11,2,0,3,5,3,0,0,0,0,15139,7.0,18452,219,56,-1547,-170,27.5,1513.9,12,1,1,5,3,5,0,0,0,0,16686,7.2,18622,225,67,1547,170,29.2,1668.6
4792679314,1,12,2,0,9,5,7,0,0,0,0,19238,7.2,17907,242,44,2283,-176,28.6,1923.8,10,1,1,5,9,3,1,1,0,0,16955,7.0,18083,194,56,-2283,176,25.0,1695.5
4792659338,0,15,1,0,3,7,2,0,0,0,0,14999,7.0,17358,196,64,-2870,-1552,26.0,1499.9,12,1,1,7,3,6,1,1,0,0,17869,7.0,18910,228,55,2870,1552,28.3,1786.9
4792646182,1,15,2,1,11,2,11,1,1,0,0,18091,7.0,18121,209,68,3900,973,27.7,1809.1,9,1,0,2,11,1,0,0,0,0,14191,6.8,17148,195,64,-3900,-973,25.9,1419.1
4791228868,1,7,1,1,6,5,3,0,0,0,0,16030,7.0,18715,221,48,-1299,-252,26.9,1603.0,13,2,0,5,6,5,1,1,0,0,17329,7.2,18967,242,68,1299,252,31.0,1732.9
4791183493,1,67,1,1,4,4,3,0,0,0,0,16548,7.2,18735,189,64,-16,458,25.3,1654.8,10,0,0,4,4,6,0,0,0,0,16564,7.0,18277,204,62,16,-458,26.6,1656.4
4790970596,0,12,1,0,7,10,6,0,0,0,0,16071,6.8,17640,181,52,-2053,-531,23.3,1607.1,16,2,1,10,7,7,1,1,0,0,18124,7.0,18171,231,52,2053,531,28.3,1812.4
4790943660,1,11,2,0,5,6,4,1,1,0,0,16443,7.0,18335,211,64,-651,1383,27.5,1644.3,14,1,1,6,5,6,1,0,1,0,17094,6.8,16952,176,76,651,-1383,25.2,1709.4
4790920701,0,14,1,0,3,4,5,1,0,1,0,15105,6.6,16502,188,36,-1101,-242,22.4,1510.5,12,4,1,4,3,5,1,1,0,0,16206,6.6,16744,198,56,1101,242,25.4,1620.6
4858026814,1,79,0,1,15,24,18,0,0,0,0,61665,12.6,59500,0,0,19077,22000,0.0,6166.5,0,0,0,15,6,14,0,0,0,0,42588,7.8,37500,0,0,-19077,-22000,0.0,4258.8
4857997283,1,30,3,1,22,18,22,0,0,0,0,48865,10.0,47500,4,0,21015,19000,0.4,4886.5,0,0,0,11,15,7,0,0,0,0,27850,6.0,28500,0,0,-21015,-19000,0.0,2785.0
4857980279,1,0,0,0,14,16,16,0,0,0,0,60355,12.0,55000,1,0,21954,22000,0.1,6035.5,0,0,1,11,9,10,0,0,0,0,38401,7.2,33000,1,0,-21954,-22000,0.1,3840.1
4857966527,1,0,0,1,16,18,19,0,0,0,0,62105,12.0,55000,0,0,24845,22000,0.0,6210.5,0,0,0,15,13,13,0,0,0,0,37260,7.2,33000,0,0,-24845,-22000,0.0,3726.0
4857953469,1,0,0,1,15,20,20,0,0,0,0,61300,12.2,56000,0,0,24800,23000,0.0,6130.0,0,0,0,14,9,12,0,0,0,0,36500,7.2,33000,0,0,-24800,-23000,0.0,3650.0
4857905898,1,0,0,0,18,14,18,0,0,0,0,62352,12.0,55000,0,0,26202,22000,0.0,6235.2,7,0,1,8,12,7,0,0,0,0,36150,7.2,33000,0,0,-26202,-22000,0.0,3615.0
4857891061,1,17,0,0,13,21,11,0,0,0,0,47025,10.2,48680,1,0,17425,20180,0.1,4702.5,0,0,1,11,3,15,0,0,0,0,29600,6.0,28500,0,0,-17425,-20180,0.0,2960.0
4857878251,1,6,0,1,15,18,19,0,0,0,0,46240,10.0,47500,0,0,24690,19000,0.0,4624.0,0,0,0,14,11,9,0,0,0,0,21550,6.0,28500,0,0,-24690,-19000,0.0,2155.0
4857835450,1,0,0,0,15,21,26,0,0,0,0,64105,12.8,59000,7,0,25380,26000,0.7,6410.5,0,0,1,18,12,10,0,0,0,0,38725,7.2,33000,7,0,-25380,-26000,0.7,3872.5
4857823708,1,0,0,1,17,17,16,0,0,0,0,58241,12.0,55000,10,0,23741,22000,1.0,5824.1,0,0,0,11,11,11,0,0,0,0,34500,7.2,33000,5,0,-23741,-22000,0.5,3450.0
4857132219,1,14,0,1,4,6,6,0,0,0,0,16014,6.8,17693,183,56,-79,25,23.9,1601.4,12,3,0,6,4,5,0,0,0,0,16093,7.0,17668,243,44,79,-25,28.7,1609.3
4855650648,1,0,0,1,33,23,92,0,0,0,0,39840,11.8,43926,104,0,4053,3916,10.4,3984.0,0,0,0,23,33,52,0,0,0,0,35787,11.2,40010,91,0,-4053,-3916,9.1,3578.7
4855640656,1,0,0,1,38,26,96,0,0,0,0,39595,11.8,43795,101,0,198,-445,10.1,3959.5,0,0,0,26,38,52,0,0,0,0,39397,11.6,44240,99,0,-198,445,9.9,3939.7
4853976675,1,2,10,0,14,26,33,0,0,0,0,34630,10.6,36874,117,0,-3587,-3863,11.7,3463.0,26,0,1,26,14,73,0,0,0,0,38217,11.2,40737,115,0,3587,3863,11.5,3821.7
4853363523,1,19,5,1,20,11,41,0,0,0,2,37224,11.0,40417,108,0,4687,2828,10.8,3722.4,25,3,0,11,20,16,0,0,0,0,32537,10.6,37589,73,0,-4687,-2828,7.3,3253.7
4853343856,1,0,0,0,28,31,64,0,0,0,0,41240,12.0,44709,108,0,2584,1601,10.8,4124.0,0,0,1,31,28,79,0,0,0,0,38656,11.6,43108,89,0,-2584,-1601,8.9,3865.6
4852871040,1,2,0,1,20,29,44,0,0,0,1,36466,10.8,39308,103,0,-4017,-4353,10.3,3646.6,17,0,0,29,20,78,0,0,0,0,40483,11.6,43661,112,0,4017,4353,11.2,4048.3
4851783278,1,16,1,1,3,4,2,0,0,0,0,14888,7.0,18157,211,56,-1204,-560,26.7,1488.8,10,0,0,4,3,3,1,1,0,0,16092,7.0,18717,234,63,1204,560,29.7,1609.2
4850369605,1,0,0,1,32,21,85,0,0,0,1,40746,11.4,43360,117,0,3297,3022,11.7,4074.6,16,0,0,21,32,43,0,0,0,0,37449,11.2,40338,92,0,-3297,-3022,9.2,3744.9
4849438549,0,12,3,0,5,5,4,0,0,0,0,16195,7.2,18948,216,48,607,2035,26.4,1619.5,14,1,1,5,5,6,1,1,0,0,15588,6.6,16913,202,64,-607,-2035,26.6,1558.8
4847509872,1,59,2,0,4,6,4,0,0,0,0,16243,7.2,18970,188,64,-508,1299,25.2,1624.3,14,0,1,6,4,4,0,0,0,0,16751,7.0,17671,202,56,508,-1299,25.8,1675.1
4846482547,1,11,0,0,3,4,2,1,0,1,0,15362,7.0,18975,237,64,-520,254,30.1,1536.2,11,0,1,4,3,2,1,1,0,0,15882,7.0,18721,235,72,520,-254,30.7,1588.2
4846470593,1,13,3,1,7,2,7,1,1,0,0,17240,7.0,19492,192,72,2331,1567,26.4,1724.0,10,2,0,1,6,1,0,0,0,0,14909,6.8,17925,248,64,-2331,-1567,31.2,1490.9
4845601989,1,8,3,1,4,3,2,1,1,0,0,17162,7.4,18815,249,64,1549,1731,31.3,1716.2,16,0,0,3,4,6,0,0,0,0,15613,6.6,17084,236,47,-1549,-1731,28.3,1561.3
4844777264,0,23,1,1,4,4,7,0,0,0,0,15277,6.8,17222,176,60,-1745,-981,23.6,1527.7,19,0,0,4,4,4,0,0,0,0,17022,7.0,18203,216,66,1745,981,28.2,1702.2
4843859586,0,15,2,1,10,6,12,0,0,0,0,19208,6.8,17473,192,47,2183,148,23.9,1920.8,115,0,0,6,10,7,1,1,0,0,17025,6.8,17325,220,48,-2183,-148,26.8,1702.5
4842941450,0,12,0,0,2,9,2,0,0,0,0,13693,6.4,15944,192,39,-4239,-2100,23.1,1369.3,14,1,1,9,2,7,1,0,1,0,17932,6.8,18044,206,52,4239,2100,25.8,1793.2
4842869684,1,15,3,0,5,7,2,0,0,0,0,16422,7.0,18174,206,68,-606,1627,27.4,1642.2,17,4,1,7,5,5,1,1,0,0,17028,6.8,16547,209,44,606,-1627,25.3,1702.8
4841799042,0,12,0,0,5,8,7,0,0,0,0,15904,6.4,15934,215,40,-1657,-1882,25.5,1590.4,11,1,1,8,5,4,1,1,0,0,17561,6.6,17816,200,60,1657,1882,26.0,1756.1
4841685132,0,13,2,0,4,7,3,0,0,0,0,15157,7.0,17701,199,52,-1947,-556,25.1,1515.7,11,2,1,7,4,4,1,1,0,0,17104,7.0,18257,230,60,1947,556,29.0,1710.4
4832925122,0,12,1,1,5,1,2,0,0,0,0,15285,6.8,17013,218,48,-559,-465,26.6,1528.5,21,0,0,1,5,0,0,0,0,0,15844,6.8,17478,218,50,559,465,26.8,1584.4
4821357971,0,36,2,1,4,3,5,1,1,0,0,15947,7.0,18007,223,60,677,-76,28.3,1594.7,32,1,0,3,4,3,0,0,0,0,15270,7.0,18083,214,52,-677,76,26.6,1527.0
4820339843,1,13,0,1,13,7,8,0,0,0,0,19507,7.2,18893,204,51,4522,2482,25.5,1950.7,8,1,0,7,13,4,1,1,0,0,14985,6.4,16411,177,48,-4522,-2482,22.5,1498.5
4818818413,1,11,1,1,4,3,2,0,0,0,0,16545,7.0,18268,197,68,1385,457,26.5,1654.5,11,1,0,3,4,3,0,0,0,0,15160,7.0,17811,189,64,-1385,-457,25.3,1516.0
4817602934,0,12,0,0,6,23,8,0,0,0,0,26187,10.4,34642,74,51,-5439,-1360,12.5,2618.7,10,0,1,23,6,37,0,0,0,0,31626,10.6,36002,70,47,5439,1360,11.7,3162.6
4817592376,0,23,3,1,11,16,25,0,0,0,1,29200,10.4,34946,57,39,-8939,-8039,9.6,2920.0,44,1,0,15,10,15,0,0,0,0,38139,11.6,42985,128,67,8939,8039,19.5,3813.9
4817024171,0,12,3,1,7,5,9,0,0,0,0,17740,6.8,17497,211,52,840,-11,26.3,1774.0,14,1,0,5,7,4,0,0,0,0,16900,7.0,17508,219,44,-840,11,26.3,1690.0
4816726844,0,130,0,0,3,11,2,0,0,0,0,14276,6.6,16471,189,60,-4455,-4114,24.9,1427.6,27,0,1,11,3,9,1,1,0,0,18731,7.4,20585,208,52,4455,4114,26.0,1873.1
4816111451,1,16,1,0,10,5,9,0,0,0,0,18936,6.8,17537,204,46,2988,707,25.0,1893.6,74,1,1,5,10,4,1,1,0,0,15948,6.8,16830,198,66,-2988,-707,26.4,1594.8
4815792028,0,12,0,0,4,8,6,0,0,0,0,15388,6.4,16734,199,56,-1531,-1771,25.5,1538.8,13,0,1,8,4,6,1,1,0,0,16919,7.0,18505,210,59,1531,1771,26.9,1691.9
4858211391,1,17,2,1,6,6,10,1,1,0,0,17055,7.0,18009,222,60,683,580,28.2,1705.5,12,2,0,6,6,8,0,0,0,0,16372,6.6,17429,210,44,-683,-580,25.4,1637.2
4857862866,0,14,1,0,4,6,5,0,0,0,0,15602,6.2,14982,168,52,-1232,-2247,22.0,1560.2,12,3,1,6,4,10,1,1,0,0,16834,6.6,17229,191,55,1232,2247,24.6,1683.4
4857837018,1,17,7,1,9,3,5,0,0,0,0,18324,7.0,19037,218,52,3666,2266,27.0,1832.4,100,0,0,3,9,3,0,0,0,0,14658,6.8,16771,174,52,-3666,-2266,22.6,1465.8
4857816607,0,12,0,0,7,9,5,0,0,0,0,16514,7.0,18166,196,58,-1842,54,25.4,1651.4,16,4,1,9,7,12,1,1,0,0,18356,7.0,18112,244,50,1842,-54,29.4,1835.6
4857304155,1,9,0,0,6,7,6,1,1,0,0,16098,7.0,17549,196,58,-1429,-1205,25.4,1609.8,11,0,1,7,6,3,0,0,0,0,17527,7.2,18754,216,62,1429,1205,27.8,1752.7
4857222364,1,12,0,1,5,6,5,0,0,0,0,15977,6.6,17442,197,52,-453,781,24.9,1597.7,98,2,0,6,5,7,0,0,0,0,16430,6.6,16661,201,52,453,-781,25.3,1643.0
4857178219,0,13,1,1,6,5,3,0,0,0,0,15066,6.4,16943,192,44,-2474,-1517,23.6,1506.6,13,1,0,5,6,6,0,0,0,0,17540,6.8,18460,221,48,2474,1517,26.9,1754.0
4857123129,0,23,1,1,3,0,3,0,0,0,0,15696,6.8,17394,211,44,-425,-880,25.5,1569.6,12,0,0,0,3,0,0,0,0,0,16121,7.0,18274,225,52,425,880,27.7,1612.1
4857083185,1,9,1,0,3,6,2,0,0,0,0,15005,6.6,17432,198,61,-2400,-947,25.9,1500.5,12,2,1,6,3,7,0,0,0,0,17405,7.4,18379,237,60,2400,947,29.7,1740.5
4856631407,1,0,0,1,18,13,16,0,0,0,0,32700,9.0,40000,0,0,14900,16000,0.0,3270.0,0,0,0,7,12,6,0,0,0,0,17800,5.4,24000,0,0,-14900,-16000,0.0,1780.0
4856622591,1,0,0,1,15,16,17,0,0,0,0,62000,12.4,57000,0,0,25468,24000,0.0,6200.0,0,0,0,11,10,7,0,0,0,0,36532,7.2,33000,0,0,-25468,-24000,0.0,3653.2
4856612352,0,77,4,0,3,7,2,1,0,1,0,14653,6.8,17136,183,49,-2400,-2301,23.2,1465.3,15,2,1,7,3,6,0,0,0,0,17053,7.2,19437,219,52,2400,2301,27.1,1705.3
4856593906,0,15,2,1,2,2,1,0,0,0,0,14577,7.0,17945,216,58,-735,-1179,27.4,1457.7,12,0,0,2,2,2,1,1,0,0,15312,7.2,19124,241,57,735,1179,29.8,1531.2
4856576325,1,0,0,1,16,16,17,0,0,0,0,47065,10.0,47500,1,0,18815,19000,0.1,4706.5,70,0,0,10,10,9,0,0,0,0,28250,6.0,28500,0,0,-18815,-19000,0.0,2825.0
4856567039,1,0,0,0,11,21,21,0,0,0,0,60606,12.0,55000,2,0,22706,22000,0.2,6060.6,34,0,1,17,7,9,0,0,0,0,37900,7.2,33000,0,0,-22706,-22000,0.0,3790.0
4856544701,1,0,0,1,16,18,16,0,0,0,0,46300,10.0,47500,0,0,20400,19000,0.0,4630.0,0,0,0,11,9,11,0,0,0,0,25900,6.0,28500,0,0,-20400,-19000,0.0,2590.0
4856350156,0,13,0,1,4,5,3,0,0,0,0,16701,7.0,17930,196,44,605,459,24.0,1670.1,12,1,0,5,4,4,0,0,0,0,16096,6.8,17471,229,51,-605,-459,28.0,1609.6
4856322131,0,0,0,1,37,29,101,0,0,0,2,41735,11.8,45537,103,0,1736,3392,10.3,4173.5,0,0,0,29,37,75,0,0,0,0,39999,11.4,42145,93,0,-1736,-3392,9.3,3999.9
4856290013,1,0,0,1,16,15,46,0,0,0,2,36783,11.0,37702,119,0,4082,2214,11.9,3678.3,0,0,0,15,16,39,0,0,0,0,32701,10.4,35488,92,0,-4082,-2214,9.2,3270.1
4856252992,0,0,0,1,20,25,55,0,0,0,2,36485,10.8,38944,113,0,-722,-491,11.3,3648.5,0,0,0,25,20,68,0,0,0,0,37207,10.8,39435,116,0,722,491,11.6,3720.7
4858438998,1,24,1,1,13,18,13,0,0,0,0,60960,12.0,55000,4,0,22000,22000,0.4,6096.0,0,1,0,12,7,11,0,0,0,0,38960,7.2,33000,8,0,-22000,-22000,0.8,3896.0
4858265341,1,0,0,1,16,17,22,0,0,0,0,48765,10.0,47500,0,0,20915,19000,0.0,4876.5,0,0,0,12,11,8,0,0,0,0,27850,6.0,28500,0,0,-20915,-19000,0.0,2785.0
4858198792,1,176,0,1,14,12,12,0,0,0,0,45950,10.0,47500,0,0,16700,19000,0.0,4595.0,176,0,0,8,10,7,0,0,0,0,29250,6.0,28500,0,0,-16700,-19000,0.0,2925.0
4858179915,1,2,0,0,18,15,15,0,0,0,0,47000,10.0,47500,0,1,19500,19000,0.1,4700.0,0,0,1,9,12,12,0,0,0,0,27500,6.0,28500,0,0,-19500,-19000,0.0,2750.0
4858157300,1,0,0,0,12,23,13,0,0,0,0,47115,10.0,47500,1,0,18185,19000,0.1,4711.5,0,0,1,17,6,11,0,0,0,0,28930,6.0,28500,0,0,-18185,-19000,0.0,2893.0
4858130678,1,33,0,1,13,20,22,0,0,0,0,60980,12.0,55000,0,0,23219,22000,0.0,6098.0,0,0,0,16,9,9,0,0,0,0,37761,7.2,33000,0,0,-23219,-22000,0.0,3776.1
4858113719,1,0,0,1,26,11,22,0,0,0,0,63830,12.0,55000,0,0,27620,22000,0.0,6383.0,0,0,0,5,20,6,0,0,0,0,36210,7.2,33000,0,0,-27620,-22000,0.0,3621.0
4858100184,1,0,0,0,11,20,12,0,0,0,0,60950,12.0,55000,0,0,22700,22000,0.0,6095.0,22,0,1,17,8,13,0,0,0,0,38250,7.2,33000,0,0,-22700,-22000,0.0,3825.0
4858080352,1,4,2,1,18,19,15,0,0,0,0,61665,12.0,55000,0,0,23305,22000,0.0,6166.5,32,1,0,9,8,12,0,0,0,0,38360,7.2,33000,4,0,-23305,-22000,0.4,3836.0
4858067228,1,0,0,1,16,25,19,0,0,0,0,52350,13.0,62500,0,0,13400,25000,0.0,5235.0,0,0,0,16,7,14,0,0,0,0,38950,7.8,37500,0,0,-13400,-25000,0.0,3895.0
4857928502,0,76,0,1,5,3,2,1,0,1,0,15832,7.0,17780,171,41,-1661,-2319,21.2,1583.2,10,1,0,3,5,2,0,0,0,0,17493,7.4,20099,225,69,1661,2319,29.4,1749.3
4857916298,1,8,0,1,21,17,21,0,0,0,0,49100,10.0,47500,0,0,21600,19000,0.0,4910.0,0,0,0,8,12,6,0,0,0,0,27500,6.0,28500,0,0,-21600,-19000,0.0,2750.0
4857904668,1,6,0,1,17,19,15,0,0,0,0,65500,13.0,62500,0,0,24744,25000,0.0,6550.0,0,0,0,12,10,12,0,0,0,0,40756,7.8,37500,0,0,-24744,-25000,0.0,4075.6
4857884639,0,15,0,0,5,11,4,0,0,0,0,15888,6.6,16184,201,48,-1976,-1357,24.9,1588.8,12,0,1,11,5,9,1,1,0,0,17864,6.8,17541,180,58,1976,1357,23.8,1786.4
4857870435,0,13,1,0,4,10,6,0,0,0,0,15127,6.6,17068,160,60,-3393,-1397,22.0,1512.7,16,2,1,10,4,13,0,0,0,0,18520,7.2,18465,210,52,3393,1397,26.2,1852.0
4857857494,1,176,0,1,18,17,13,0,0,0,0,46705,10.0,47500,1,0,18065,18975,0.1,4670.5,176,0,0,9,10,10,0,0,0,0,28640,6.0,28525,0,0,-18065,-18975,0.0,2864.0
4857849384,1,180,0,0,22,17,26,0,0,0,0,47422,10.0,47500,1,0,20212,19000,0.1,4742.2,0,0,1,8,13,6,0,0,0,0,27210,6.0,28500,1,0,-20212,-19000,0.1,2721.0
4857839384,1,440,0,0,17,18,15,0,0,0,0,46155,10.0,47525,0,0,24590,19025,0.0,4615.5,0,0,1,11,10,9,0,0,0,0,21565,6.0,28500,0,0,-24590,-19025,0.0,2156.5
4857766519,1,11,0,1,17,12,17,0,0,0,0,46300,10.0,47500,0,0,19500,19000,0.0,4630.0,0,0,0,7,12,5,0,0,0,0,26800,6.0,28500,0,0,-19500,-19000,0.0,2680.0
4857762046,1,0,0,0,15,22,16,0,0,0,0,48750,10.0,47500,0,0,19500,19000,0.0,4875.0,0,0,1,13,6,12,0,0,0,0,29250,6.0,28500,0,0,-19500,-19000,0.0,2925.0
4858415313,1,15,1,1,6,6,6,1,1,0,0,18465,7.0,17545,184,63,1327,57,24.7,1846.5,12,1,0,6,6,8,0,0,0,0,17138,6.8,17488,214,60,-1327,-57,27.4,1713.8
4858362874,0,13,1,1,5,7,4,0,0,0,0,14648,6.6,16350,173,36,-3599,-2924,20.9,1464.8,20,1,0,7,5,3,0,0,0,0,18247,7.0,19274,224,56,3599,2924,28.0,1824.7
4858308993,1,11,4,0,1,6,3,1,0,1,0,14776,6.6,17093,195,48,-4299,-1657,24.3,1477.6,49,0,1,6,1,8,0,0,0,0,19075,7.2,18750,251,56,4299,1657,30.7,1907.5
4857597891,0,12,3,0,2,6,1,0,0,0,0,13680,6.8,17131,179,56,-3793,-2196,23.5,1368.0,14,2,1,6,2,2,0,0,0,0,17473,7.2,19327,230,64,3793,2196,29.4,1747.3
4857505347,0,19,0,1,9,6,6,1,1,0,0,17698,6.6,17208,220,48,1847,-1309,26.8,1769.8,19,0,0,6,9,2,0,0,0,0,15851,7.2,18517,220,56,-1847,1309,27.6,1585.1
4857373882,0,14,1,0,4,10,4,1,1,0,0,17420,7.0,17890,232,44,-957,-274,27.6,1742.0,12,1,1,10,4,11,0,0,0,0,18377,6.8,18164,210,52,957,274,26.2,1837.7
4856409133,1,15,1,1,3,1,3,1,1,0,0,16400,6.8,18430,230,56,2547,1905,28.6,1640.0,11,1,0,1,3,1,0,0,0,0,13853,6.6,16525,207,48,-2547,-1905,25.5,1385.3
4856355957,0,16,2,0,3,2,3,0,0,0,0,15848,7.0,18593,245,55,212,62,30.0,1584.8,88,3,1,2,3,2,1,1,0,0,15636,7.2,18531,225,52,-212,-62,27.7,1563.6
4856203711,0,9,1,0,3,5,7,0,0,0,0,15017,6.8,16663,214,45,-1708,-730,25.9,1501.7,11,0,1,5,3,7,0,0,0,0,16725,6.8,17393,226,58,1708,730,28.4,1672.5
4856132921,0,4,1,1,4,8,2,0,0,0,0,16199,6.6,16897,210,48,-1391,-1430,25.8,1619.9,10,0,0,8,4,6,1,1,0,0,17590,7.0,18327,222,44,1391,1430,26.6,1759.0
4856074386,0,13,0,1,4,2,5,1,0,1,0,16398,6.8,18667,222,56,479,487,27.8,1639.8,10,0,0,2,4,2,1,1,0,0,15919,6.8,18180,229,48,-479,-487,27.7,1591.9
4856026076,0,10,0,0,3,10,2,0,0,0,0,14539,6.8,17428,186,44,-3622,-1086,23.0,1453.9,11,0,1,10,3,7,0,0,0,0,18161,7.2,18514,240,51,3622,1086,29.1,1816.1
4855960342,0,23,0,0,4,4,2,1,0,1,0,15706,7.2,18767,215,56,393,465,27.1,1570.6,80,1,1,4,4,2,1,1,0,0,15313,7.0,18302,195,68,-393,-465,26.3,1531.3
4855915531,1,11,1,0,5,2,4,0,0,0,0,16808,7.0,18484,221,56,3059,2490,27.7,1680.8,14,1,1,2,5,1,1,1,0,0,13749,6.6,15994,176,52,-3059,-2490,22.8,1374.9
4855874561,0,24,0,1,8,4,10,1,1,0,0,17638,6.6,17393,209,44,1319,-888,25.3,1763.8,13,0,0,4,8,2,1,0,1,0,16319,7.0,18281,213,52,-1319,888,26.5,1631.9
4855500302,0,12,1,1,6,4,4,0,0,0,0,16312,6.8,17806,201,48,616,625,24.9,1631.2,11,2,0,4,6,4,0,0,0,0,15696,6.8,17181,213,56,-616,-625,26.9,1569.6
4855471493,1,23,2,1,3,5,3,1,1,0,0,14828,7.0,17754,189,60,-1886,-1350,24.9,1482.8,18,3,0,5,3,3,0,0,0,0,16714,7.2,19104,231,48,1886,1350,27.9,1671.4
4855183515,0,117,2,0,2,5,1,0,0,0,0,15004,7.2,18794,232,76,-1577,741,30.8,1500.4,12,2,1,5,2,4,0,0,0,0,16581,6.8,18053,234,48,1577,-741,28.2,1658.1
4848284053,0,11,1,1,5,7,1,0,0,0,0,15418,6.2,16104,170,47,-1645,-832,21.7,1541.8,80,1,0,7,5,9,1,1,0,0,17063,6.8,16936,176,64,1645,832,24.0,1706.3
4852779485,0,10,0,0,5,17,4,0,0,0,0,16307,6.4,16725,204,47,-5662,-3788,25.1,1630.7,12,2,1,17,5,16,1,1,0,0,21969,7.8,20513,261,58,5662,3788,31.9,2196.9
4852743357,1,34,3,1,5,7,5,1,1,0,0,16543,6.6,17015,218,48,-884,-1316,26.6,1654.3,31,3,0,7,5,10,0,0,0,0,17427,6.8,18331,192,52,884,1316,24.4,1742.7
4852026100,0,36,3,0,4,4,3,0,0,0,0,16344,7.0,17494,206,48,846,-406,25.4,1634.4,70,2,1,4,4,3,0,0,0,0,15498,7.2,17900,189,44,-846,406,23.3,1549.8
4851130431,1,39,0,1,32,39,65,0,0,0,0,39041,11.8,46034,103,0,-1109,-297,10.3,3904.1,0,2,0,39,32,76,0,0,0,0,40150,12.0,46331,106,0,1109,297,10.6,4015.0
4851118762,0,19,0,0,20,30,42,0,0,0,0,34681,10.6,37705,102,0,-3204,-6062,10.2,3468.1,0,10,1,30,20,86,0,0,0,0,37885,11.6,43767,97,0,3204,6062,9.7,3788.5
4851067939,0,15,1,0,8,5,7,0,0,0,0,18331,7.0,18691,239,52,1496,1667,29.1,1833.1,9,2,1,5,8,5,0,0,0,0,16835,6.6,17024,214,52,-1496,-1667,26.6,1683.5
4850687200,0,11,3,0,3,8,1,0,0,0,0,15375,7.0,18524,213,72,-3309,-295,28.5,1537.5,14,0,1,8,3,9,1,1,0,0,18684,7.0,18819,242,48,3309,295,29.0,1868.4
4850524311,1,73,2,1,8,4,7,1,1,0,0,19669,7.0,18638,238,44,4810,1353,28.2,1966.9,14,0,0,4,8,3,0,0,0,0,14859,6.8,17285,200,53,-4810,-1353,25.3,1485.9
4850129915,0,15,0,0,5,9,1,0,0,0,0,15813,6.8,17870,219,48,-2307,59,26.7,1581.3,10,1,1,8,4,13,1,1,0,0,18120,7.0,17811,208,68,2307,-59,27.6,1812.0
4848684721,1,16,19,1,6,12,7,0,0,0,0,16813,7.0,17457,209,56,-2364,-839,26.5,1681.3,50,1,0,12,6,14,0,0,0,0,19177,6.8,18296,232,52,2364,839,28.4,1917.7
4848654153,0,10,0,0,4,5,4,0,0,0,0,16523,7.0,18078,202,61,-1036,-577,26.3,1652.3,15,2,1,5,4,4,1,1,0,0,17559,7.2,18655,215,54,1036,577,26.9,1755.9
4848245612,0,15,2,0,8,6,5,0,0,0,0,17467,7.0,18981,228,56,244,721,28.4,1746.7,17,2,1,6,8,7,0,0,0,0,17223,7.0,18260,241,58,-244,-721,29.9,1722.3
4848227043,0,12,1,0,2,6,2,0,0,0,0,15971,7.0,17807,243,54,-525,-887,29.7,1597.1,23,2,1,6,2,2,1,1,0,0,16496,7.4,18694,215,68,525,887,28.3,1649.6
4848196542,0,17,0,0,10,9,10,0,0,0,0,18470,6.8,17702,202,60,303,169,26.2,1847.0,13,3,1,9,10,17,1,1,0,0,18167,6.8,17533,201,44,-303,-169,24.5,1816.7
4848170245,0,14,1,0,6,5,6,0,0,0,0,16207,6.8,17650,217,48,885,-738,26.5,1620.7,13,0,1,5,6,1,0,0,0,0,15322,7.0,18388,190,68,-885,738,25.8,1532.2
4848130664,1,23,2,0,5,6,3,0,0,0,0,17149,7.0,18469,202,50,-132,167,25.2,1714.9,12,0,1,6,5,2,0,0,0,0,17281,7.0,18302,200,56,132,-167,25.6,1728.1
4847544762,0,11,1,0,5,9,6,0,0,0,0,17339,6.8,17187,205,48,-2063,-1780,25.3,1733.9,13,0,1,9,5,11,1,1,0,0,19402,7.2,18967,213,44,2063,1780,25.7,1940.2
4847502828,0,33,0,1,5,5,4,0,0,0,0,17270,6.4,17198,168,60,927,760,22.8,1727.0,34,1,0,5,5,6,0,0,0,0,16343,6.8,16438,190,40,-927,-760,23.0,1634.3
4847475747,0,11,1,0,7,7,5,0,0,0,0,16657,6.8,17519,190,50,0,487,24.0,1665.7,15,1,1,7,7,8,0,0,0,0,16657,6.8,17032,177,50,0,-487,22.7,1665.7
4849258967,0,12,1,1,5,7,5,0,0,0,0,16579,6.6,16106,217,43,-1047,-1654,26.0,1657.9,11,2,0,7,5,5,0,0,0,0,17626,7.0,17760,195,60,1047,1654,25.5,1762.6
4849225612,1,11,0,0,6,8,6,0,0,0,0,16828,7.0,18320,180,68,-723,138,24.8,1682.8,12,0,1,8,6,3,1,1,0,0,17551,7.0,18182,208,44,723,-138,25.2,1755.1
4849208092,1,29,0,0,1,6,0,0,0,0,0,14752,6.8,16592,184,52,-1525,-1864,23.6,1475.2,27,1,1,6,1,3,0,0,0,0,16277,6.8,18456,213,48,1525,1864,26.1,1627.7
4848219146,0,26,0,0,1,3,1,0,0,0,0,13571,6.8,17226,186,44,-1878,-2410,23.0,1357.1,32,0,1,3,1,1,0,0,0,0,15449,7.2,19636,225,67,1878,2410,29.2,1544.9
4848185244,0,176,1,0,5,3,6,0,0,0,0,15119,6.4,16344,177,49,-669,-1148,22.6,1511.9,64,1,1,3,5,2,0,0,0,0,15788,6.6,17492,213,53,669,1148,26.6,1578.8
4845366253,1,0,0,1,31,17,72,0,0,0,0,39930,11.8,43963,114,0,4996,7787,11.4,3993.0,0,0,0,17,31,47,0,0,0,0,34934,10.4,36176,91,0,-4996,-7787,9.1,3493.4
4845339468,1,15,2,0,4,5,7,0,0,0,0,16021,6.8,17060,184,60,-541,248,24.4,1602.1,14,1,1,5,4,8,1,1,0,0,16562,6.4,16812,221,32,541,-248,25.3,1656.2
4845321907,1,47,0,1,4,5,1,0,0,0,0,15159,7.2,18818,188,68,-178,1029,25.6,1515.9,9,0,0,5,4,2,0,0,0,0,15337,6.8,17789,215,68,178,-1029,28.3,1533.7
4845295617,0,0,0,1,22,30,54,0,0,0,0,37066,11.4,41423,92,0,-293,263,9.2,3706.6,0,0,0,30,22,82,0,0,0,0,37359,11.0,41160,107,0,293,-263,10.7,3735.9
4845256389,1,11,2,1,5,10,2,0,0,0,0,15757,6.8,16318,203,40,-2838,-2902,24.3,1575.7,12,1,0,10,5,8,0,0,0,0,18595,7.0,19220,223,48,2838,2902,27.1,1859.5
4844437143,0,3,0,0,29,30,74,0,0,0,1,39304,11.6,43089,118,0,-354,-1632,11.8,3930.4,24,0,1,30,29,75,0,0,0,0,39658,11.8,44721,111,0,354,1632,11.1,3965.8
4844397749,1,8,1,0,7,11,4,0,0,0,0,16931,6.8,18179,208,48,-1526,634,25.6,1693.1,83,0,1,11,7,11,1,0,1,0,18457,6.8,17545,170,60,1526,-634,23.0,1845.7
4844306421,1,12,4,1,7,1,3,1,1,0,0,16294,6.8,17663,213,44,1915,345,25.7,1629.4,14,0,0,1,7,1,1,0,1,0,14379,6.8,17318,210,56,-1915,-345,26.6,1437.9
4841578558,1,61,0,1,4,3,6,1,1,0,0,15955,6.8,18102,194,48,1302,251,24.2,1595.5,12,0,0,3,4,2,0,0,0,0,14653,6.8,17851,184,48,-1302,-251,23.2,1465.3
4841548397,0,18,1,1,2,4,4,0,0,0,0,14960,6.8,17239,200,52,-1109,-885,25.2,1496.0,82,1,0,4,2,4,1,1,0,0,16069,7.0,18124,216,56,1109,885,27.2,1606.9
4840521061,1,15,1,1,7,5,12,0,0,0,0,17399,6.6,17164,226,56,1513,-964,28.2,1739.9,13,0,0,5,7,6,1,1,0,0,15886,7.0,18128,237,56,-1513,964,29.3,1588.6
4840490574,0,19,0,1,2,5,1,0,0,0,0,14785,7.0,17203,227,48,-279,218,27.5,1478.5,11,1,0,5,2,7,1,1,0,0,15064,6.4,16985,178,56,279,-218,23.4,1506.4
4840143784,1,98,1,0,8,4,12,1,1,0,0,16955,7.0,17696,219,60,3088,1133,27.9,1695.5,9,0,1,4,8,2,0,0,0,0,13867,6.8,16563,153,43,-3088,-1133,19.6,1386.7
4840030449,0,8,0,1,9,6,10,0,0,0,0,18367,7.2,19598,235,40,1875,1310,27.5,1836.7,13,0,0,6,9,2,0,0,0,0,16492,7.2,18288,217,60,-1875,-1310,27.7,1649.2
4839376812,1,82,0,0,7,6,4,0,0,0,0,16848,7.4,19480,195,68,848,249,26.3,1684.8,10,0,1,6,7,3,1,1,0,0,16000,7.2,19231,210,55,-848,-249,26.5,1600.0
4857671393,0,16,0,0,7,9,4,1,1,0,0,16865,6.8,17288,226,40,-2855,-1268,26.6,1686.5,16,1,1,9,7,10,0,0,0,0,19720,7.0,18556,209,47,2855,1268,25.6,1972.0
4857660528,0,27,2,1,5,6,3,0,0,0,0,15573,6.4,16256,190,36,-2512,-1880,22.6,1557.3,12,1,0,6,5,5,0,0,0,0,18085,7.0,18136,216,40,2512,1880,25.6,1808.5
4857643450,1,12,1,1,5,4,4,0,0,0,1,16622,6.6,17266,197,56,1719,-654,25.3,1662.2,13,0,0,4,5,2,0,0,0,0,14903,6.8,17920,188,64,-1719,654,25.2,1490.3
4857620896,1,12,2,0,7,5,1,0,0,0,0,16455,7.0,18028,222,48,-304,696,27.0,1645.5,24,2,1,5,7,5,0,0,0,0,16759,6.8,17332,222,52,304,-696,27.4,1675.9
4854686718,1,70,2,1,8,4,8,0,0,0,0,17174,6.6,16682,199,56,2346,1076,25.5,1717.4,9,2,0,4,8,5,0,0,0,0,14828,6.4,15606,174,51,-2346,-1076,22.5,1482.8
4816081890,0,15,0,0,1,4,1,1,1,0,0,16274,6.8,18198,223,59,457,992,28.2,1627.4,13,1,1,4,1,3,0,0,0,0,15817,6.8,17206,202,50,-457,-992,25.2,1581.7
4765914438,1,0,0,0,29,26,64,0,0,0,0,40528,11.6,43858,109,0,2104,571,10.9,4052.8,0,0,1,26,29,72,0,0,0,0,38424,11.4,43287,116,0,-2104,-571,11.6,3842.4
4765906397,1,68,0,0,28,17,78,0,0,0,1,37630,10.8,39781,106,0,55,-483,10.6,3763.0,0,0,1,17,28,40,0,0,0,0,37575,11.0,40264,111,0,-55,483,11.1,3757.5
4765902300,0,0,0,1,29,26,74,0,0,0,2,41572,11.6,43610,98,0,2636,-463,9.8,4157.2,0,0,0,26,29,73,0,0,0,0,38936,11.8,44073,106,0,-2636,463,10.6,3893.6
4765902755,1,14,0,1,31,19,70,0,0,0,1,39778,11.6,43671,108,0,2629,2184,10.8,3977.8,27,0,0,19,31,39,0,0,0,0,37149,11.4,41487,113,0,-2629,-2184,11.3,3714.9
4765891573,0,0,0,1,27,29,57,0,0,0,1,37973,11.0,41316,109,0,-370,-2683,10.9,3797.3,20,0,0,29,27,84,0,0,0,0,38343,11.4,43999,106,0,370,2683,10.6,3834.3
4765885658,0,34,0,1,27,27,54,0,0,0,2,38573,11.4,42162,104,0,789,-2314,10.4,3857.3,77,0,0,25,25,63,0,0,0,0,37784,11.6,44476,95,0,-789,2314,9.5,3778.4
4765884355,0,19,0,0,18,20,48,0,0,0,2,38589,11.0,41389,105,0,1970,135,10.5,3858.9,21,4,1,20,18,59,0,0,0,0,36619,11.6,41254,102,0,-1970,-135,10.2,3661.9
4765881831,0,21,0,0,24,34,62,0,0,0,1,36944,11.0,39422,108,0,-2618,-2733,10.8,3694.4,0,4,1,34,24,105,0,0,0,0,39562,11.4,42155,118,0,2618,2733,11.8,3956.2
4765865141,1,0,0,1,22,18,61,0,0,0,1,37394,11.0,38717,120,0,1801,220,12.0,3739.4,69,0,0,18,22,34,0,0,0,0,35593,10.6,38497,110,0,-1801,-220,11.0,3559.3
4762624226,1,10,0,1,21,10,23,1,1,0,0,22649,6.6,17601,224,56,4057,1349,28.0,2264.9,9,0,0,10,21,11,0,0,0,0,18592,6.4,16252,194,64,-4057,-1349,25.8,1859.2
4762604002,0,13,1,0,4,4,3,1,0,1,0,16721,6.6,17219,198,44,1142,-214,24.2,1672.1,14,0,1,4,4,2,1,1,0,0,15579,6.6,17433,160,64,-1142,214,22.4,1557.9
4755949364,1,13,4,0,5,6,4,1,1,0,0,16710,6.8,18086,200,64,386,-37,26.4,1671.0,10,3,1,6,5,2,1,0,1,0,16324,7.0,18123,206,56,-386,37,26.2,1632.4
4858329610,0,9,0,0,2,9,1,0,0,0,0,14125,7.0,17839,207,51,-2201,-562,25.8,1412.5,13,0,1,9,2,7,1,1,0,0,16326,7.2,18401,174,60,2201,562,23.4,1632.6
4858268574,1,35,0,0,4,2,2,0,0,0,0,15006,7.0,18384,184,48,-231,849,23.2,1500.6,82,16,1,2,4,1,0,0,0,0,15237,6.8,17535,184,56,231,-849,24.0,1523.7
4856313909,0,0,0,1,38,23,113,0,0,0,0,40516,11.8,46132,91,0,1009,2317,9.1,4051.6,0,0,0,23,38,57,0,0,0,0,39507,11.6,43815,104,0,-1009,-2317,10.4,3950.7
4856266475,0,0,0,1,22,26,54,0,0,0,0,36729,10.8,39621,104,0,-2706,-3642,10.4,3672.9,0,0,0,26,22,59,0,0,0,0,39435,11.6,43263,112,0,2706,3642,11.2,3943.5
4856216777,1,0,0,0,29,28,72,0,0,0,2,37860,11.6,43534,92,0,-1534,-70,9.2,3786.0,1,0,1,28,29,54,0,0,0,0,39394,11.8,43604,115,0,1534,70,11.5,3939.4
4856149696,0,0,0,0,33,36,89,0,0,0,0,40846,12.0,46447,123,0,127,397,12.3,4084.6,0,0,1,36,33,63,0,0,0,0,40719,11.8,46050,87,0,-127,-397,8.7,4071.9
4843331095,1,0,0,1,22,16,51,0,0,0,0,35971,11.2,40386,95,0,1558,2621,9.5,3597.1,0,0,0,16,22,37,0,0,0,0,34413,10.8,37765,109,0,-1558,-2621,10.9,3441.3
4843309052,1,0,0,0,23,26,62,0,0,0,2,38531,11.6,42474,101,0,522,265,10.1,3853.1,0,0,1,26,23,55,0,0,0,0,38009,11.6,42209,76,0,-522,-265,7.6,3800.9
4843271676,1,0,0,0,11,13,32,0,0,0,1,33242,10.0,33794,99,0,-528,-2071,9.9,3324.2,0,0,1,13,11,31,0,0,0,0,33770,10.6,35865,88,0,528,2071,8.8,3377.0
4842322466,1,19,0,1,25,24,57,0,0,0,1,37052,10.8,39486,111,0,2116,1823,11.1,3705.2,0,7,0,23,24,65,0,0,0,0,34936,11.0,37663,110,0,-2116,-1823,11.0,3493.6
4842286849,1,3,0,1,20,19,51,0,0,0,1,37619,11.0,40188,95,0,1634,1285,9.5,3761.9,0,0,0,19,20,55,0,0,0,0,35985,10.8,38903,94,0,-1634,-1285,9.4,3598.5
4842246013,1,2,0,1,35,23,94,0,0,0,1,41801,11.8,45825,111,0,4270,6395,11.1,4180.1,0,0,0,23,35,48,0,0,0,0,37531,10.8,39430,88,0,-4270,-6395,8.8,3753.1
4841497183,0,0,22,1,26,28,64,0,0,0,0,36742,10.8,38258,92,0,-3751,-6510,9.2,3674.2,25,0,0,28,26,73,0,0,0,0,40493,12.0,44768,109,0,3751,6510,10.9,4049.3
4841469621,0,0,1,1,21,25,49,0,0,0,0,35472,10.8,38392,103,0,-2474,-3089,10.3,3547.2,9,0,0,25,21,63,0,0,0,0,37946,11.4,41481,110,0,2474,3089,11.0,3794.6
4841447345,1,14,0,0,28,25,68,0,0,0,1,38132,11.2,41742,97,0,512,1362,9.7,3813.2,0,0,1,25,28,65,0,0,0,0,37620,11.2,40380,122,0,-512,-1362,12.2,3762.0
4841420779,0,13,0,1,22,22,56,0,0,0,0,36079,10.8,40394,107,0,768,596,10.7,3607.9,0,2,0,22,22,55,0,0,0,0,35311,11.0,39798,113,0,-768,-596,11.3,3531.1
4838213858,0,52,2,0,0,4,0,1,0,1,0,13892,6.6,17036,185,48,-2103,-1198,23.3,1389.2,11,1,1,4,0,3,0,0,0,0,15995,7.0,18234,235,64,2103,1198,29.9,1599.5
4838162082,1,197,0,1,4,8,2,0,0,0,0,15337,6.8,17774,191,56,-2545,-1123,24.7,1533.7,12,0,0,8,4,7,0,0,0,0,17882,7.2,18897,231,56,2545,1123,28.7,1788.2
4837288641,1,85,1,0,3,2,4,0,0,0,0,15509,6.6,17248,173,58,797,378,23.1,1550.9,191,1,1,2,3,2,1,1,0,0,14712,7.0,16870,193,46,-797,-378,23.9,1471.2
4856143337,1,48,0,1,17,19,16,0,0,0,0,62350,12.0,55000,0,0,24100,22000,0.0,6235.0,28,0,0,12,10,9,0,0,0,0,38250,7.2,33000,0,0,-24100,-22000,0.0,3825.0
4856119293,1,0,0,1,24,18,13,0,0,0,0,46650,10.0,47500,0,0,18100,19000,0.0,4665.0,0,0,0,8,14,12,0,0,0,0,28550,6.0,28500,0,0,-18100,-19000,0.0,2855.0
4856102945,1,19,0,1,17,15,25,0,0,0,0,61300,12.0,55000,0,0,24050,22000,0.0,6130.0,0,0,0,11,13,9,0,0,0,0,37250,7.2,33000,1,0,-24050,-22000,0.1,3725.0
4856077162,1,57,0,1,25,12,22,0,0,0,0,48400,10.0,47500,0,0,21600,19000,0.0,4840.0,0,0,0,6,19,7,0,0,0,0,26800,6.0,28500,0,0,-21600,-19000,0.0,2680.0
4856053962,1,5,0,0,21,20,19,0,0,0,0,53650,12.0,55000,0,0,16100,22000,0.0,5365.0,74,0,1,11,12,11,0,0,0,0,37550,7.2,33000,0,0,-16100,-22000,0.0,3755.0
4856029220,1,5,0,1,15,22,15,0,0,0,0,47730,10.0,47500,0,0,18085,19000,0.0,4773.0,0,0,0,16,9,13,0,0,0,0,29645,6.0,28500,0,0,-18085,-19000,0.0,2964.5
4855845302,1,102,1,1,10,8,11,1,1,0,0,18059,6.6,16709,205,52,-662,-1278,25.7,1805.9,13,1,0,8,10,8,1,0,1,0,18721,6.8,17987,209,48,662,1278,25.7,1872.1
4855808318,1,39,0,1,4,5,3,0,0,0,0,15048,6.8,16646,204,32,-117,-142,23.6,1504.8,34,2,0,5,4,5,1,1,0,0,15165,6.8,16788,199,56,117,142,25.5,1516.5
4854644803,1,9,1,1,5,6,1,0,0,0,0,16831,7.2,18519,226,60,624,293,28.6,1683.1,14,1,0,6,5,6,1,1,0,0,16207,6.8,18226,180,52,-624,-293,23.2,1620.7
4854617263,1,28,1,0,9,2,5,0,0,0,0,18021,7.0,19085,202,52,3866,1491,25.4,1802.1,35,1,1,2,9,1,0,0,0,0,14155,7.0,17594,194,52,-3866,-1491,24.6,1415.5
4853472705,1,20,0,1,7,2,6,0,0,0,0,16569,6.8,18188,188,52,1976,258,24.0,1656.9,8,0,0,2,7,1,1,1,0,0,14593,6.8,17930,216,63,-1976,-258,27.9,1459.3
4852404554,0,10,0,1,6,8,7,0,0,0,0,16885,6.6,16254,206,48,-1113,-1165,25.4,1688.5,76,0,0,8,6,10,1,1,0,0,17998,6.8,17419,194,44,1113,1165,23.8,1799.8
4852382354,1,73,3,1,6,2,5,1,1,0,0,16360,7.0,18435,205,44,1699,-385,24.9,1636.0,15,2,0,2,6,0,0,0,0,0,14661,7.0,18820,213,55,-1699,385,26.8,1466.1
4849632219,1,269,1,1,11,5,12,1,1,0,0,19976,7.6,19606,195,56,2629,590,25.1,1997.6,19,2,0,5,11,4,1,0,1,0,17347,7.2,19016,237,52,-2629,-590,28.9,1734.7
4849598604,1,6,0,0,4,5,6,0,0,0,0,17613,7.4,18204,200,59,1405,850,25.9,1761.3,7,0,1,5,4,5,0,0,0,0,16208,6.8,17354,193,56,-1405,-850,24.9,1620.8
4848823153,0,11,0,1,6,3,3,0,0,0,0,15974,6.6,17188,212,52,-25,-368,26.4,1597.4,16,1,0,3,6,1,0,0,0,0,15999,7.0,17556,212,51,25,368,26.3,1599.9
4846615605,0,34,0,0,9,11,8,0,0,0,0,18875,6.8,18158,197,56,1164,-10,25.3,1887.5,26,1,1,11,9,6,0,0,0,0,17711,7.0,18168,190,52,-1164,10,24.2,1771.1
4840928556,0,14,0,1,2,3,1,1,1,0,0,15229,6.8,18504,196,64,283,1533,26.0,1522.9,15,0,0,3,2,7,0,0,0,0,14946,6.6,16971,204,56,-283,-1533,26.0,1494.6
4840897186,1,11,3,0,6,3,7,0,0,0,0,16716,6.8,17503,199,47,-41,-407,24.6,1671.6,11,0,1,3,6,3,0,0,0,0,16757,6.8,17910,251,56,41,407,30.7,1675.7
4852223985,0,0,0,1,26,31,58,0,0,0,1,39173,11.6,44067,91,0,-701,-1353,9.1,3917.3,0,0,0,31,26,71,0,0,0,0,39874,12.0,45420,103,0,701,1353,10.3,3987.4
4852208457,0,10,2,0,4,3,4,0,0,0,0,16931,7.0,19116,245,56,1736,1936,30.1,1693.1,10,1,1,3,4,2,2,1,1,0,15195,7.0,17180,216,64,-1736,-1936,28.0,1519.5
4852202953,1,0,0,1,23,14,69,0,0,0,1,37814,11.4,41346,115,0,3209,5533,11.5,3781.4,0,0,0,14,23,39,0,0,0,0,34605,10.4,35813,107,0,-3209,-5533,10.7,3460.5
4852191306,1,0,0,0,28,25,64,0,0,0,1,40281,12.0,46357,108,0,1495,3916,10.8,4028.1,0,0,1,25,28,54,0,0,0,0,38786,11.4,42441,109,0,-1495,-3916,10.9,3878.6
4852179369,0,5,0,1,9,6,6,0,0,0,0,18175,7.0,18290,227,56,1985,544,28.3,1817.5,19,1,0,6,9,5,0,0,0,0,16190,6.8,17746,160,64,-1985,-544,22.4,1619.0
4852172060,1,16,4,1,12,3,12,0,0,0,0,18201,6.6,17099,186,37,2522,1337,22.3,1820.1,14,3,0,3,12,2,0,0,0,0,15679,6.4,15762,204,44,-2522,-1337,24.8,1567.9
4845092047,0,0,0,0,28,29,66,0,0,0,0,37842,11.4,42673,95,0,493,493,9.5,3784.2,18,0,1,29,28,61,0,0,0,0,37349,11.4,42180,93,0,-493,-493,9.3,3734.9
4845059859,1,0,0,1,27,19,69,0,0,0,0,38354,11.4,42414,112,0,3255,3989,11.2,3835.4,129,0,0,19,27,42,0,0,0,0,35099,11.0,38425,96,0,-3255,-3989,9.6,3509.9
4844371134,1,8,0,0,4,5,2,0,0,0,0,16196,6.8,17678,232,60,-964,-179,29.2,1619.6,6,0,1,5,4,5,0,0,0,0,17160,6.8,17857,183,58,964,179,24.1,1716.0
4844341621,1,12,3,0,6,6,3,0,0,0,0,17153,7.0,18695,198,52,1349,1008,25.0,1715.3,11,2,1,6,6,4,0,0,0,0,15804,6.8,17687,172,51,-1349,-1008,22.3,1580.4
4844322202,0,9,2,1,6,10,5,1,1,0,0,15913,6.6,17314,174,52,-1713,-2734,22.6,1591.3,14,0,0,10,6,4,0,0,0,0,17626,7.2,20048,216,64,1713,2734,28.0,1762.6
4844290195,0,12,4,0,6,7,5,1,1,0,0,15277,6.6,16215,184,48,-2411,-1420,23.2,1527.7,25,0,1,7,6,4,1,0,1,0,17688,7.0,17635,191,49,2411,1420,24.0,1768.8
4842853577,0,137,1,1,7,9,6,0,0,0,0,16333,6.8,17285,183,46,-2072,-2287,22.9,1633.3,12,0,0,9,7,5,0,0,0,0,18405,7.2,19572,210,58,2072,2287,26.8,1840.5
4842402238,1,8,0,0,7,11,3,0,0,0,0,17461,6.8,18311,195,64,-2880,-816,25.9,1746.1,85,1,1,11,7,11,0,0,0,0,20341,7.2,19127,222,52,2880,816,27.4,2034.1
4842354984,1,12,1,0,20,18,39,0,0,0,1,36638,11.4,41365,87,54,874,2687,14.1,3663.8,33,0,1,18,20,37,0,0,0,0,35764,11.0,38678,71,61,-874,-2687,13.2,3576.4
4842294371,0,16,1,0,8,4,2,0,0,0,0,16524,6.8,17989,231,51,1390,612,28.2,1652.4,15,2,1,4,8,7,1,1,0,0,15134,6.8,17377,189,53,-1390,-612,24.2,1513.4
4842259066,0,13,4,0,9,15,5,0,0,0,0,16960,6.8,17674,197,56,-3001,-1983,25.3,1696.0,13,3,1,15,9,9,0,0,0,0,19961,7.4,19657,240,48,3001,1983,28.8,1996.1
4842159793,0,11,0,0,13,22,28,0,0,0,1,33608,10.4,35872,99,0,-3220,-3187,9.9,3360.8,0,0,1,22,13,52,0,0,0,0,36828,11.0,39059,97,0,3220,3187,9.7,3682.8
4842133504,1,0,0,1,29,25,67,0,0,0,0,39117,11.8,44224,97,0,167,365,9.7,3911.7,17,0,0,25,29,63,0,0,0,0,38950,11.6,43859,96,0,-167,-365,9.6,3895.0
4842103472,1,29,0,1,17,20,33,0,0,0,1,34844,10.6,37228,111,0,-1831,-2006,11.1,3484.4,0,2,0,20,17,44,0,0,0,0,36675,11.0,39234,119,0,1831,2006,11.9,3667.5
4854931414,1,50,2,0,12,7,16,1,1,0,0,19170,6.8,17807,180,56,2768,538,23.6,1917.0,12,0,1,7,12,5,0,0,0,0,16402,6.6,17269,193,48,-2768,-538,24.1,1640.2
4851496118,1,13,4,1,4,5,5,0,0,0,0,15971,6.8,17915,241,48,906,731,28.9,1597.1,13,2,0,5,4,6,1,0,1,0,15065,6.8,17184,181,48,-906,-731,22.9,1506.5
4851471304,0,13,1,0,0,3,0,1,0,1,0,13637,6.8,18192,226,56,-1895,-321,28.2,1363.7,11,0,1,3,0,4,1,1,0,0,15532,7.0,18513,223,60,1895,321,28.3,1553.2
4851182460,0,10,0,0,2,12,0,0,0,0,0,14283,6.6,14918,179,44,-5420,-3680,22.3,1428.3,6,0,1,12,2,6,0,0,0,0,19703,7.0,18598,232,43,5420,3680,27.5,1970.3
4851168680,1,12,1,1,7,4,10,1,1,0,0,17995,6.8,17212,207,48,2728,-460,25.5,1799.5,12,2,0,4,7,2,0,0,0,0,15267,6.6,17672,194,59,-2728,460,25.3,1526.7
4850705918,1,11,3,1,10,7,12,1,1,0,0,18804,7.2,18939,240,67,1676,2920,30.7,1880.4,17,2,0,7,10,8,0,0,0,0,17128,6.4,16019,167,44,-1676,-2920,21.1,1712.8
4850680713,1,51,1,1,9,6,4,0,0,0,0,17615,7.2,19129,188,76,2082,1766,26.4,1761.5,12,0,0,6,9,2,0,0,0,0,15533,7.0,17363,196,47,-2082,-1766,24.3,1553.3
4849685546,0,48,2,0,4,7,3,0,0,0,0,16068,6.6,16536,194,47,-1013,-107,24.1,1606.8,40,15,1,7,4,10,0,0,0,0,17081,6.8,16643,214,36,1013,107,25.0,1708.1
4848869625,1,12,1,0,4,1,2,1,1,0,0,15472,6.8,17782,215,52,359,861,26.7,1547.2,13,0,1,1,4,1,0,0,0,0,15113,6.8,16921,202,52,-359,-861,25.4,1511.3
4848809525,0,12,1,1,8,10,11,0,0,0,0,17531,6.6,16551,182,52,-1714,-1932,23.4,1753.1,13,1,0,10,8,10,1,1,0,0,19245,6.8,18483,204,48,1714,1932,25.2,1924.5
4848712883,1,16,2,0,3,5,7,1,0,1,0,17451,7.4,19027,227,60,310,1444,28.7,1745.1,13,2,1,5,3,5,1,1,0,0,17141,6.8,17583,209,60,-310,-1444,26.9,1714.1
4848664437,1,41,2,1,4,3,4,0,0,0,0,16811,7.2,18911,207,55,774,863,26.2,1681.1,8,17,0,3,4,3,0,0,0,0,16037,6.8,18048,225,60,-774,-863,28.5,1603.7
4848638018,1,11,1,1,4,0,3,0,0,0,0,16370,7.2,18801,242,56,2638,1057,29.8,1637.0,20,0,0,0,4,0,0,0,0,0,13732,7.0,17744,194,60,-2638,-1057,25.4,1373.2
4847609265,1,11,2,1,3,2,4,1,1,0,0,15978,6.8,17615,246,60,1719,1026,30.6,1597.8,11,1,0,2,3,3,0,0,0,0,14259,6.6,16589,203,50,-1719,-1026,25.3,1425.9
4847589492,1,9,3,1,4,3,7,0,0,0,0,15851,6.6,17450,212,52,240,-811,26.4,1585.1,15,4,0,3,4,2,0,0,0,0,15611,7.0,18261,250,60,-240,811,31.0,1561.1
4847575894,0,20,0,0,2,10,0,0,0,0,0,14183,6.6,16517,214,59,-5575,-2297,27.3,1418.3,13,2,1,10,2,14,1,1,0,0,19758,7.0,18814,220,44,5575,2297,26.4,1975.8
4845169550,0,18,1,1,7,4,6,0,0,0,0,17109,6.6,17523,208,36,497,152,24.4,1710.9,11,1,0,4,7,5,0,0,0,0,16612,6.8,17371,182,71,-497,-152,25.3,1661.2
4845142602,1,28,0,0,7,4,10,0,0,0,0,17427,7.0,17965,214,61,2877,1790,27.5,1742.7,29,0,1,4,7,3,0,0,0,0,14550,6.6,16175,180,49,-2877,-1790,22.9,1455.0
4845116091,1,13,0,0,6,2,2,1,1,0,0,15887,7.0,18172,197,60,699,1219,25.7,1588.7,10,2,1,2,6,3,0,0,0,0,15188,6.6,16953,229,56,-699,-1219,28.5,1518.8
4858037060,1,10,0,0,7,10,7,0,0,0,0,18676,7.0,18786,203,76,1117,1990,27.9,1867.6,10,0,1,10,7,11,0,0,0,0,17559,6.6,16796,176,36,-1117,-1990,21.2,1755.9
4857315977,1,10,0,1,5,4,6,0,0,0,0,17551,7.2,18842,236,60,1604,315,29.6,1755.1,9,0,0,3,4,2,0,0,0,0,15947,7.2,18527,201,64,-1604,-315,26.5,1594.7
4857269622,0,11,0,1,6,9,2,0,0,0,0,15189,6.8,17066,209,42,-3007,-2243,25.1,1518.9,11,2,0,9,6,8,1,1,0,0,18196,7.0,19309,200,76,3007,2243,27.6,1819.6
4857227744,1,10,0,1,7,3,8,0,0,0,0,16378,7.0,17488,214,41,1690,-382,25.5,1637.8,11,0,0,3,7,2,0,0,0,0,14688,7.0,17870,183,62,-1690,382,24.5,1468.8
4857192266,1,10,1,1,12,7,1,0,0,0,0,17966,6.8,18449,205,59,2407,2606,26.4,1796.6,88,1,0,7,12,5,1,1,0,0,15559,6.4,15843,157,60,-2407,-2606,21.7,1555.9
4857154839,1,15,1,1,12,3,12,1,1,0,0,18351,7.4,18916,207,60,2474,1443,26.7,1835.1,10,0,0,3,12,2,0,0,0,0,15877,6.8,17473,202,60,-2474,-1443,26.2,1587.7
4857107891,1,10,1,0,7,2,7,1,1,0,0,16859,7.2,18763,191,72,1989,836,26.3,1685.9,17,2,1,2,7,2,0,0,0,0,14870,6.8,17927,201,48,-1989,-836,24.9,1487.0
4856303168,0,9,1,0,5,5,7,0,0,0,0,15375,6.8,17319,195,48,-1360,-1831,24.3,1537.5,12,1,1,5,5,1,0,0,0,0,16735,7.2,19150,227,68,1360,1831,29.5,1673.5
4856248754,1,12,2,0,3,9,1,0,0,0,0,15181,6.8,18472,192,71,-1929,479,26.3,1518.1,13,0,1,9,3,7,0,0,0,0,17110,6.8,17993,231,40,1929,-479,27.1,1711.0
4856198650,1,33,2,0,4,4,1,1,0,1,0,15753,7.2,19704,233,56,-159,730,28.9,1575.3,33,1,1,4,4,2,0,0,0,0,15912,7.2,18974,202,68,159,-730,27.0,1591.2
4856020217,1,16,2,1,4,7,0,0,0,0,0,15806,7.0,18549,218,72,-1100,-188,29.0,1580.6,12,4,0,7,4,8,0,0,0,0,16906,6.8,18737,225,59,1100,188,28.4,1690.6
4855969043,0,65,0,0,1,2,0,0,0,0,0,14071,6.8,17984,205,52,-1217,-285,25.7,1407.1,18,0,1,2,1,3,0,0,0,0,15288,6.8,18269,213,64,1217,285,27.7,1528.8
4854779948,1,11,0,1,5,5,4,0,0,0,0,15860,7.2,18231,216,48,-893,-410,26.4,1586.0,14,1,0,5,5,2,0,0,0,0,16753,7.2,18641,219,64,893,410,28.3,1675.3
4854762259,1,4,0,0,15,20,15,0,0,0,0,45642,12.0,55000,0,0,16714,22000,0.0,4564.2,0,0,1,12,7,14,0,0,0,0,28928,7.2,33000,0,2,-16714,-22000,0.2,2892.8
4850931136,0,9,1,0,3,6,4,0,0,0,0,14102,6.6,16243,179,44,-1629,-2390,22.3,1410.2,13,0,1,6,3,3,0,0,0,0,15731,7.0,18633,181,60,1629,2390,24.1,1573.1
4850006987,1,18,1,1,9,4,6,0,0,0,0,17750,7.0,19038,231,57,2420,1517,28.8,1775.0,10,1,0,4,9,3,0,0,0,0,15330,6.8,17521,203,55,-2420,-1517,25.8,1533.0
4849958149,0,12,2,1,7,4,6,1,1,0,0,17993,7.0,19303,238,64,2092,1958,30.2,1799.3,16,2,0,4,7,5,0,0,0,0,15901,6.8,17345,213,48,-2092,-1958,26.1,1590.1
4849892420,1,27,0,0,7,7,8,1,1,0,0,16417,6.8,18111,149,75,-209,451,22.4,1641.7,9,12,1,7,7,3,0,0,0,0,16626,6.6,17660,173,68,209,-451,24.1,1662.6
4858105296,1,11,0,1,8,6,10,0,0,0,0,16728,6.4,16972,192,48,-244,-1159,24.0,1672.8,15,0,0,6,8,5,0,0,0,0,16972,7.0,18131,213,48,244,1159,26.1,1697.2
4858073184,0,67,0,1,8,7,4,0,0,0,0,17131,7.0,17651,187,64,929,411,25.1,1713.1,9,0,0,7,8,8,0,0,0,0,16202,6.8,17240,208,44,-929,-411,25.2,1620.2
4857652922,0,9,1,0,3,3,2,0,0,0,0,15494,6.8,18270,171,60,-205,456,23.1,1549.4,12,0,1,3,3,4,0,0,0,0,15699,6.8,17814,166,55,205,-456,22.1,1569.9
4857632008,1,9,0,0,5,6,3,1,1,0,0,16285,7.0,18160,205,52,976,503,25.7,1628.5,7,1,1,6,5,5,0,0,0,0,15309,6.6,17657,164,54,-976,-503,21.8,1530.9
4857620101,1,8,0,0,9,5,4,0,0,0,0,16762,7.2,19197,176,66,2402,3134,24.2,1676.2,17,0,1,5,9,5,1,1,0,0,14360,6.4,16063,165,55,-2402,-3134,22.0,1436.0
4857596779,1,11,0,0,4,7,3,0,0,0,0,14987,6.4,15925,163,40,-1270,-2519,20.3,1498.7,204,0,1,7,4,5,1,1,0,0,16257,6.8,18444,155,48,1270,2519,20.3,1625.7
4857565496,1,30,1,1,10,4,7,1,0,1,0,18481,7.2,19238,179,52,3249,1930,23.1,1848.1,30,0,0,4,10,2,0,0,0,0,15232,6.6,17308,178,52,-3249,-1930,23.0,1523.2
4857538192,0,13,1,0,5,8,4,1,0,1,0,14723,6.2,15089,124,40,-2888,-3444,16.4,1472.3,10,1,1,8,5,8,0,0,0,0,17611,6.8,18533,185,55,2888,3444,24.0,1761.1
4857506522,1,13,2,1,12,5,15,1,1,0,0,18199,7.2,18114,197,46,3644,2788,24.3,1819.9,7,1,0,5,12,4,0,0,0,0,14555,6.2,15326,179,22,-3644,-2788,20.1,1455.5
4857459846,1,10,3,0,4,4,4,1,0,1,0,15596,7.0,17860,199,60,-331,-260,25.9,1559.6,10,2,1,4,4,2,0,0,0,0,15927,6.8,18120,222,60,331,260,28.2,1592.7
4857378439,1,28,1,1,6,2,4,0,0,0,0,16472,6.8,17795,196,49,3583,1551,24.5,1647.2,9,0,0,2,6,2,0,0,0,0,12889,6.6,16244,135,49,-3583,-1551,18.4,1288.9
4857056358,1,13,0,1,2,1,1,1,1,0,0,14752,6.6,16848,218,56,996,-911,27.4,1475.2,14,0,0,1,2,0,0,0,0,0,13756,6.8,17759,196,52,-996,911,24.8,1375.6
4856713028,0,10,0,0,6,7,7,0,0,0,0,15760,6.8,17318,194,44,-1081,-534,23.8,1576.0,17,2,1,7,6,6,0,0,0,0,16841,6.8,17852,219,52,1081,534,27.1,1684.1
4856408452,1,169,1,1,8,5,9,0,0,0,0,17746,6.8,17758,198,56,1684,793,25.4,1774.6,9,3,0,5,8,4,0,0,0,0,16062,6.8,16965,210,44,-1684,-793,25.4,1606.2
4856300692,1,19,0,0,6,6,7,0,0,0,0,17575,7.2,19069,193,64,784,49,25.7,1757.5,14,3,1,6,6,6,0,0,0,0,16791,7.0,19020,205,68,-784,-49,27.3,1679.1
4857358906,1,5,1,1,22,9,22,0,0,0,0,64239,12.2,56000,1,0,29076,23000,0.1,6423.9,104,0,0,5,18,6,0,0,0,0,35163,7.2,33000,0,0,-29076,-23000,0.0,3516.3
4857286174,1,0,0,1,22,12,21,0,0,0,0,63464,12.0,55000,0,0,24765,22000,0.0,6346.4,3,0,0,7,17,7,0,0,0,0,38699,7.2,33000,1,0,-24765,-22000,0.1,3869.9
4857257674,1,8,0,0,14,18,11,0,0,0,0,61490,12.0,55000,3,0,24260,22000,0.3,6149.0,0,0,1,11,7,14,0,0,0,0,37230,7.2,33000,0,0,-24260,-22000,0.0,3723.0
4857237144,1,0,0,0,21,25,16,0,0,0,0,47034,10.6,50500,0,0,18120,22000,0.0,4703.4,18,0,1,13,9,15,0,0,0,0,28914,6.0,28500,0,0,-18120,-22000,0.0,2891.4
4856324724,1,6,0,1,20,15,16,0,0,0,0,45975,10.2,48680,1,0,18125,20180,0.1,4597.5,0,0,0,7,12,12,0,0,0,0,27850,6.0,28500,0,0,-18125,-20180,0.0,2785.0
4856297528,1,3,0,1,13,17,17,0,0,0,0,44550,10.0,47500,0,0,15300,16000,0.0,4455.0,0,0,0,12,8,10,0,0,0,0,29250,6.6,31500,0,0,-15300,-16000,0.0,2925.0
4855818138,0,31,1,1,11,4,19,1,1,0,1,21040,7.0,18027,213,44,5980,920,25.7,2104.0,10,0,0,4,11,3,0,0,0,0,15060,6.8,17107,196,60,-5980,-920,25.6,1506.0
4855330252,1,0,0,1,25,21,26,0,0,0,0,48050,10.0,47500,0,0,19500,19000,0.0,4805.0,0,0,0,9,13,10,0,0,0,0,28550,6.0,28500,0,0,-19500,-19000,0.0,2855.0
4855303608,1,6,0,1,16,18,18,0,0,0,0,47375,10.0,47500,1,0,18100,19000,0.1,4737.5,22,0,0,13,11,12,0,0,0,0,29275,6.0,28500,1,0,-18100,-19000,0.1,2927.5
4855288008,1,0,0,1,23,16,24,0,0,0,0,48050,10.0,47500,8,0,20200,19000,0.8,4805.0,5,0,0,6,13,6,0,0,0,0,27850,6.0,28500,0,0,-20200,-19000,0.0,2785.0
4855170978,1,0,0,1,20,16,20,0,0,0,0,47750,10.0,47500,0,0,21640,19000,0.0,4775.0,0,0,0,7,11,6,0,0,0,0,26110,6.0,28500,0,0,-21640,-19000,0.0,2611.0
4855117573,1,21,1,0,9,8,9,0,0,0,0,17951,6.4,15572,177,37,242,-1026,21.4,1795.1,29,0,1,8,9,10,0,0,0,0,17709,6.6,16598,174,42,-242,1026,21.6,1770.9
4854046618,1,83,0,1,16,17,13,0,0,0,0,62021,12.0,55000,0,0,24028,22000,0.0,6202.1,24,0,0,8,7,11,0,0,0,0,37993,7.2,33000,2,0,-24028,-22000,0.2,3799.3
4854014695,1,0,1,1,18,24,16,0,0,0,0,46900,10.0,47500,10,0,16950,19000,1.0,4690.0,25,0,0,14,8,17,0,0,0,0,29950,6.0,28500,0,0,-16950,-19000,0.0,2995.0
4853898546,0,33,0,1,6,3,5,1,1,0,0,17289,7.0,17135,224,48,1033,-1412,27.2,1728.9,41,2,0,3,6,3,0,0,0,0,16256,6.8,18547,203,64,-1033,1412,26.7,1625.6
4853691269,0,11,1,1,4,6,5,0,0,0,0,15099,6.6,16389,155,48,-2363,-2357,20.3,1509.9,14,2,0,6,4,7,1,1,0,0,17462,7.0,18746,226,60,2363,2357,28.6,1746.2
4850899891,1,25,1,1,12,8,8,1,1,0,0,18703,6.8,17814,218,48,1173,1671,26.6,1870.3,12,0,0,8,12,8,0,0,0,0,17530,6.6,16143,161,52,-1173,-1671,21.3,1753.0
4849039471,1,10,1,1,2,1,1,0,0,0,0,15274,7.0,18496,219,56,1627,1399,27.5,1527.4,14,1,0,1,2,1,0,0,0,0,13647,6.8,17097,190,59,-1627,-1399,24.9,1364.7
4847897956,1,185,0,0,9,4,8,2,1,1,0,18478,7.2,18441,215,52,4217,1828,26.7,1847.8,11,0,1,4,9,1,0,0,0,0,14261,6.8,16613,175,56,-4217,-1828,23.1,1426.1
4858455814,0,136,0,0,3,10,1,1,0,1,0,15402,6.8,17673,209,54,-4107,-1232,26.3,1540.2,32,1,1,10,3,8,0,0,0,0,19509,7.0,18905,215,48,4107,1232,26.3,1950.9
4856862542,0,13,0,1,9,11,7,0,0,0,0,18444,7.0,17581,185,56,-1055,-219,24.1,1844.4,11,1,0,11,9,13,0,0,0,0,19499,7.0,17800,214,32,1055,219,24.6,1949.9
4856842679,0,15,0,0,2,6,2,0,0,0,0,14020,6.6,15761,183,47,-4733,-2928,23.0,1402.0,11,0,1,6,2,4,2,1,1,0,18753,7.0,18689,244,60,4733,2928,30.4,1875.3
4856819665,1,13,0,0,3,3,2,0,0,0,0,15887,6.6,17230,197,52,1325,1630,24.9,1588.7,11,0,1,3,3,2,0,0,0,0,14562,6.4,15600,171,44,-1325,-1630,21.5,1456.2
4856803760,1,158,0,1,3,5,0,1,1,0,0,16422,7.2,19778,275,56,602,1137,33.1,1642.2,10,0,0,4,2,1,0,0,0,0,15820,7.0,18641,239,60,-602,-1137,29.9,1582.0
4856765496,1,16,4,1,5,2,4,1,1,0,0,16255,7.0,18316,234,62,1075,-169,29.6,1625.5,12,4,0,2,5,2,0,0,0,0,15180,6.8,18485,247,56,-1075,169,30.3,1518.0
4856747342,1,11,1,0,4,3,5,1,0,1,0,17347,7.4,19623,237,68,1627,2117,30.5,1734.7,19,2,1,3,4,3,0,0,0,0,15720,6.8,17506,197,40,-1627,-2117,23.7,1572.0
4856736794,0,7,2,0,5,12,2,0,0,0,0,15573,6.6,15888,189,46,-1864,-1106,23.5,1557.3,181,1,1,12,5,9,1,1,0,0,17437,6.6,16994,159,52,1864,1106,21.1,1743.7
4856727776,1,17,0,0,7,5,5,0,0,0,0,16487,7.0,17976,202,46,829,515,24.8,1648.7,14,3,1,5,7,4,0,0,0,0,15658,6.6,17461,221,54,-829,-515,27.5,1565.8
4856708471,1,17,1,0,6,6,5,0,0,0,0,17594,7.2,18905,217,50,1599,808,26.7,1759.4,16,1,1,6,6,2,1,1,0,0,15995,7.0,18097,210,52,-1599,-808,26.2,1599.5
4856699930,0,12,0,0,1,5,0,0,0,0,0,16132,7.0,18019,207,56,-958,-1238,26.3,1613.2,10,0,1,5,1,3,1,1,0,0,17090,7.0,19257,247,52,958,1238,29.9,1709.0
4856689141,0,17,1,1,8,6,7,0,0,0,0,17665,7.0,17652,235,48,1025,-1125,28.3,1766.5,13,2,0,6,8,4,1,1,0,0,16640,7.2,18777,227,64,-1025,1125,29.1,1664.0
4856675695,0,11,0,0,6,8,4,0,0,0,0,16255,7.0,18009,204,60,-2115,-353,26.4,1625.5,13,0,1,8,6,5,1,1,0,0,18370,7.2,18362,208,46,2115,353,25.4,1837.0
4856667421,1,9,1,0,4,10,0,0,0,0,0,14356,6.6,16458,172,60,-3846,-855,23.2,1435.6,15,2,1,10,4,10,0,0,0,0,18202,6.8,17313,178,44,3846,855,22.2,1820.2
4856654987,1,6,0,0,3,2,3,0,0,0,0,14625,6.6,17487,196,72,-1594,-333,26.8,1462.5,72,0,1,2,3,3,0,0,0,0,16219,7.0,17820,257,56,1594,333,31.3,1621.9
4856626971,1,9,0,0,3,10,4,0,0,0,0,15945,6.6,16891,217,60,-2365,-2107,27.7,1594.5,12,0,1,10,3,9,1,1,0,0,18310,7.0,18998,229,56,2365,2107,28.5,1831.0
4856593289,1,10,0,1,4,7,2,0,0,0,0,17095,7.0,18405,210,64,-145,577,27.4,1709.5,8,0,0,7,4,6,0,0,0,0,17240,6.8,17828,216,60,145,-577,27.6,1724.0
4855815303,1,17,0,0,11,8,8,0,0,0,0,19755,7.0,19192,212,64,2209,1138,27.6,1975.5,11,1,1,8,11,5,1,1,0,0,17546,7.0,18054,196,55,-2209,-1138,25.1,1754.6
4815400142,1,34,0,1,4,7,1,1,0,1,0,16359,7.2,19399,234,67,-918,1074,30.1,1635.9,12,18,0,7,4,7,1,1,0,0,17277,7.0,18325,177,56,918,-1074,23.3,1727.7
4814938369,0,11,1,1,4,9,6,0,0,0,0,17959,7.0,17765,210,63,809,-231,27.3,1795.9,10,2,0,9,4,9,0,0,0,0,17150,6.8,17996,210,41,-809,231,25.1,1715.0
4814910302,0,11,1,1,3,3,4,0,0,0,0,16218,7.0,17881,196,69,1252,44,26.5,1621.8,10,0,0,3,3,2,0,0,0,0,14966,6.8,17837,196,56,-1252,-44,25.2,1496.6
4814888479,1,6,1,1,10,4,15,1,1,0,0,19081,7.2,19506,240,72,3802,2351,31.2,1908.1,12,0,0,4,10,6,0,0,0,0,15279,6.6,17155,208,59,-3802,-2351,26.7,1527.9
4814828057,1,14,3,0,7,5,7,0,0,0,0,17666,7.6,19892,232,76,2252,2216,30.8,1766.6,14,2,1,5,7,5,1,1,0,0,15414,7.0,17676,190,52,-2252,-2216,24.2,1541.4
4814379090,0,12,2,0,6,3,4,0,0,0,0,16475,7.0,19045,207,48,-816,748,25.5,1647.5,13,1,1,3,6,3,1,1,0,0,17291,6.8,18297,211,76,816,-748,28.7,1729.1
4814335084,0,16,3,0,6,8,8,0,0,0,0,16495,6.8,17571,209,48,-1736,-1474,25.7,1649.5,14,1,1,8,6,13,1,1,0,0,18231,7.0,19045,212,64,1736,1474,27.6,1823.1
4814298987,0,10,1,0,10,8,7,0,0,0,0,18915,7.0,18339,187,52,2151,1684,23.9,1891.5,12,0,1,8,10,8,1,1,0,0,16764,6.6,16655,171,47,-2151,-1684,21.8,1676.4
4813000573,1,11,2,1,9,3,6,0,0,0,0,17837,6.8,18290,211,56,3065,2081,26.7,1783.7,15,1,0,3,9,2,1,1,0,0,14772,6.4,16209,189,60,-3065,-2081,24.9,1477.2
4812529576,0,8,0,0,3,2,2,0,0,0,0,15483,6.8,17743,214,44,-891,-336,25.8,1548.3,14,0,1,2,3,2,1,1,0,0,16374,7.0,18079,217,64,891,336,28.1,1637.4
4811857958,0,13,0,0,1,3,3,0,0,0,0,15048,7.0,18166,214,56,-232,790,27.0,1504.8,13,0,1,3,1,2,1,0,1,0,15280,6.6,17376,186,64,232,-790,25.0,1528.0
4811843818,1,14,5,0,5,4,6,0,0,0,0,17057,7.2,19201,180,61,1922,2034,24.1,1705.7,15,3,1,4,5,4,0,0,0,0,15135,6.8,17167,216,46,-1922,-2034,26.2,1513.5
4811824104,0,55,1,0,6,8,6,0,0,0,0,16477,7.0,17727,208,48,-1035,-44,25.6,1647.7,11,1,1,8,6,8,0,0,0,0,17512,7.0,17771,199,68,1035,44,26.7,1751.2
4811114964,0,13,1,0,1,7,0,0,0,0,0,15416,6.6,17105,227,56,-1579,-1237,28.3,1541.6,13,2,1,7,1,6,0,0,0,0,16995,7.2,18342,218,60,1579,1237,27.8,1699.5
4811073565,0,72,2,0,7,6,6,1,0,1,0,16771,6.6,17099,190,62,-2092,-1954,25.2,1677.1,14,3,1,6,7,6,1,1,0,0,18863,7.0,19053,217,61,2092,1954,27.8,1886.3
4811024800,1,9,4,1,7,2,13,2,1,1,0,17014,6.8,17763,192,60,2999,2228,25.2,1701.4,18,1,0,2,7,3,0,0,0,0,14015,6.6,15535,195,48,-2999,-2228,24.3,1401.5
4810990698,0,13,3,0,7,8,11,0,0,0,0,17917,7.0,18379,209,44,116,-650,25.3,1791.7,13,2,1,8,7,4,0,0,0,0,17801,7.2,19029,227,56,-116,650,28.3,1780.1
4810963875,1,34,2,0,1,3,0,0,0,0,0,14655,7.0,17894,203,53,-61,1206,25.6,1465.5,12,7,1,3,1,4,0,0,0,0,14716,6.4,16688,166,62,61,-1206,22.8,1471.6
4810933811,1,13,1,0,8,7,10,1,1,0,0,17757,6.6,16983,170,63,1599,2458,23.3,1775.7,18,1,1,7,8,7,0,0,0,0,16158,6.4,14525,150,44,-1599,-2458,19.4,1615.8
4790952713,0,18,0,0,4,2,2,0,0,0,0,17261,7.4,19878,214,64,2085,2391,27.8,1726.1,9,0,1,2,4,1,1,1,0,0,15176,6.8,17487,231,60,-2085,-2391,29.1,1517.6
4790947874,0,12,0,1,2,7,2,0,0,0,0,15485,7.0,17425,203,56,-4152,-2119,25.9,1548.5,12,2,0,7,2,4,0,0,0,0,19637,7.2,19544,236,60,4152,2119,29.6,1963.7
4790726367,0,11,8,1,5,7,3,0,0,0,0,14280,6.4,15401,154,40,-3159,-3660,19.4,1428.0,33,0,0,7,5,1,0,0,0,0,17439,7.2,19061,198,76,3159,3660,27.4,1743.9
4790689104,1,21,1,0,4,9,1,1,1,0,0,15817,6.8,17551,189,51,-1503,358,24.0,1581.7,14,1,1,9,4,7,0,0,0,0,17320,6.6,17193,170,63,1503,-358,23.3,1732.0
4790653318,0,16,0,1,5,9,0,0,0,0,0,14547,6.4,16366,188,44,-3564,-1974,23.2,1454.7,11,2,0,8,4,6,0,0,0,0,18111,7.2,18340,216,55,3564,1974,27.1,1811.1
4790593570,1,13,2,0,6,6,2,0,0,0,0,16228,6.8,18977,171,48,-108,1567,21.9,1622.8,14,3,1,6,6,4,0,0,0,0,16336,7.2,17410,198,40,108,-1567,23.8,1633.6
4790505113,0,19,2,0,3,3,1,1,1,0,0,15529,6.8,16797,196,51,-242,-940,24.7,1552.9,12,1,1,3,3,2,0,0,0,0,15771,7.0,17737,239,46,242,940,28.5,1577.1
4790474113,1,15,3,0,9,8,5,0,0,0,0,18155,7.0,18217,200,48,-73,2214,24.8,1815.5,12,2,1,8,9,8,0,0,0,0,18228,6.6,16003,178,44,73,-2214,22.2,1822.8
4788397330,0,15,0,0,4,6,4,0,0,0,0,15370,7.0,17984,205,60,-2159,-137,26.5,1537.0,15,3,1,6,4,5,1,1,0,0,17529,7.0,18121,224,56,2159,137,28.0,1752.9
4786603271,0,26,1,1,5,4,3,0,0,0,0,16223,6.6,17215,199,48,1335,716,24.7,1622.3,31,1,0,4,5,3,1,1,0,0,14888,6.6,16499,176,52,-1335,-716,22.8,1488.8
4786577387,0,9,3,0,5,3,8,1,1,0,0,16846,7.0,18417,212,56,2375,2488,26.8,1684.6,16,0,1,3,5,4,0,0,0,0,14471,6.6,15929,163,48,-2375,-2488,21.1,1447.1
4786137881,0,11,0,1,5,3,3,1,1,0,0,15724,6.8,17500,193,60,1347,759,25.3,1572.4,8,2,0,3,5,2,0,0,0,0,14377,6.4,16741,177,53,-1347,-759,23.0,1437.7
4786094888,1,11,3,1,6,6,9,0,0,0,0,15658,6.6,15892,157,44,-737,-1782,20.1,1565.8,11,1,0,6,6,6,0,0,0,0,16395,6.8,17674,187,55,737,1782,24.2,1639.5
4786049300,1,15,0,0,6,5,5,1,1,0,0,17139,6.6,17143,175,47,1370,-351,22.2,1713.9,7,1,1,5,6,2,1,0,1,0,15769,6.8,17494,189,52,-1370,351,24.1,1576.9
4785771300,1,11,0,1,4,3,6,0,0,0,0,16020,7.2,18818,217,46,789,704,26.3,1602.0,11,1,0,3,4,3,1,1,0,0,15231,7.0,18114,231,46,-789,-704,27.7,1523.1
4784876416,1,13,1,0,9,3,8,0,0,0,0,17779,7.0,18256,224,66,2635,536,29.0,1777.9,13,0,1,3,9,3,0,0,0,0,15144,6.8,17720,212,46,-2635,-536,25.8,1514.4
4784859337,0,15,1,1,5,6,11,0,0,0,0,18093,7.0,18420,197,64,360,81,26.1,1809.3,83,1,0,6,5,5,2,1,1,0,17733,7.0,18339,199,55,-360,-81,25.4,1773.3
4784404313,0,53,2,1,5,3,2,0,0,0,0,15724,6.8,17571,203,44,863,76,24.7,1572.4,19,1,0,3,5,3,0,0,0,0,14861,6.8,17495,197,56,-863,-76,25.3,1486.1
4784281661,0,6,2,0,5,8,4,1,0,1,0,16143,7.2,18447,197,64,-1724,864,26.1,1614.3,11,0,1,8,5,7,0,0,0,0,17867,6.8,17583,223,48,1724,-864,27.1,1786.7
4784248161,0,11,1,0,8,8,8,0,0,0,0,17308,6.6,17581,192,64,-189,-331,25.6,1730.8,65,1,1,8,8,3,0,0,0,0,17497,6.8,17912,188,68,189,331,25.6,1749.7
4858283039,0,8,0,0,3,3,4,0,0,0,0,15450,6.8,17766,219,52,-517,-693,27.1,1545.0,15,1,1,3,3,3,1,1,0,0,15967,7.0,18459,221,68,517,693,28.9,1596.7
4858251425,0,9,5,0,2,3,3,0,0,0,0,14721,7.0,17688,207,53,-1801,-1048,26.0,1472.1,27,0,1,3,2,4,0,0,0,0,16522,7.0,18736,217,64,1801,1048,28.1,1652.2
4858130535,1,0,0,0,24,28,55,0,0,0,2,37646,11.2,41211,109,0,-1851,724,10.9,3764.6,0,0,1,28,24,78,0,0,0,0,39497,11.0,40487,121,0,1851,-724,12.1,3949.7
4858063581,0,11,0,1,7,6,3,0,0,0,0,17211,6.8,17953,216,60,719,460,27.6,1721.1,11,0,0,6,7,5,0,0,0,0,16492,7.0,17493,211,52,-719,-460,26.3,1649.2
4858031780,1,14,0,1,6,5,3,0,0,0,0,17117,7.2,19198,196,68,61,1750,26.4,1711.7,9,0,0,5,6,2,0,0,0,0,17056,6.8,17448,210,48,-61,-1750,25.8,1705.6
4857152351,0,0,2,0,28,24,66,0,0,0,0,36793,11.0,41057,104,0,1415,1939,10.4,3679.3,105,0,1,24,28,57,0,0,0,0,35378,11.0,39118,99,0,-1415,-1939,9.9,3537.8
4857131013,1,72,0,1,20,13,34,0,0,0,0,35391,10.8,39780,110,0,1143,3540,11.0,3539.1,81,0,0,13,20,29,0,0,0,0,34248,10.6,36240,102,0,-1143,-3540,10.2,3424.8
4857101483,1,4,0,1,20,17,46,0,0,0,0,36025,11.0,39462,113,0,1004,655,11.3,3602.5,81,0,0,17,20,37,0,0,0,0,35021,10.8,38807,90,0,-1004,-655,9.0,3502.1
4857085648,1,1,0,0,23,21,55,0,0,0,1,37598,11.2,41324,112,0,2972,4642,11.2,3759.8,23,0,1,21,23,44,0,0,0,0,34626,10.4,36682,62,0,-2972,-4642,6.2,3462.6
4857070581,1,21,0,0,11,25,23,0,0,0,0,33748,10.2,35114,98,0,-2727,-3015,9.8,3374.8,0,0,1,25,11,76,0,0,0,0,36475,10.6,38129,102,0,2727,3015,10.2,3647.5
4857019317,1,17,4,1,17,21,41,0,0,0,0,37700,11.2,40504,109,0,1677,2407,10.9,3770.0,22,0,0,21,17,47,0,0,0,0,36023,10.8,38097,110,0,-1677,-2407,11.0,3602.3
4857003813,0,278,0,0,13,20,37,0,0,0,0,33636,10.4,36853,95,0,-2239,-244,9.5,3363.6,0,0,1,20,13,60,0,0,0,0,35875,10.6,37097,98,0,2239,244,9.8,3587.5
4856981423,1,17,0,0,13,11,37,0,0,0,0,33569,10.6,36799,110,0,32,2094,11.0,3356.9,0,4,1,11,13,32,0,0,0,0,33537,10.0,34705,77,0,-32,-2094,7.7,3353.7
4856937746,0,0,0,1,31,25,75,0,0,0,2,39236,11.6,42982,85,0,-21,803,8.5,3923.6,0,0,0,25,31,72,0,0,0,0,39257,11.4,42179,97,0,21,-803,9.7,3925.7
4856916029,1,145,2,1,14,18,23,0,0,0,0,34177,10.4,35590,116,0,-454,-2521,11.6,3417.7,23,0,0,18,14,45,0,0,0,0,34631,10.8,38111,93,0,454,2521,9.3,3463.1
4855338474,0,10,2,0,7,4,7,0,0,0,0,15917,6.6,16922,148,48,865,-116,19.6,1591.7,10,2,1,4,7,2,0,0,0,0,15052,6.6,17038,194,52,-865,116,24.6,1505.2
4855308806,0,11,1,1,26,20,64,0,0,0,0,36988,11.4,41474,97,0,696,2485,9.7,3698.8,10,0,0,20,26,37,0,0,0,0,36292,11.0,38989,79,0,-696,-2485,7.9,3629.2
4855278711,0,0,0,1,19,23,47,0,0,0,0,35819,10.4,36757,80,0,-1954,-5538,8.0,3581.9,0,0,0,23,19,54,0,0,0,0,37773,11.6,42295,100,0,1954,5538,10.0,3777.3
4855259614,0,0,0,0,22,35,37,0,0,0,2,35117,11.2,39842,68,0,-6134,-5455,6.8,3511.7,0,0,1,35,22,100,0,0,0,0,41251,11.8,45297,112,0,6134,5455,11.2,4125.1
4855233952,1,0,0,1,21,17,46,0,0,0,0,35347,11.0,39017,111,0,-79,546,11.1,3534.7,0,0,0,17,21,28,0,0,0,0,35426,11.0,38471,100,0,79,-546,10.0,3542.6
4858354021,0,50,0,0,3,3,3,0,0,0,0,15696,6.8,18251,205,52,-1796,-984,25.7,1569.6,13,0,1,3,3,2,0,0,0,0,17492,7.2,19235,236,47,1796,984,28.3,1749.2
4858309411,1,13,1,1,4,4,3,1,0,1,0,17819,7.2,19763,257,68,1732,1431,32.5,1781.9,20,2,0,4,4,10,0,0,0,0,16087,7.0,18332,237,63,-1732,-1431,30.0,1608.7
4858275433,1,0,0,1,26,20,68,0,0,0,2,40065,11.2,41421,115,0,3732,954,11.5,4006.5,0,0,0,20,26,36,0,0,0,0,36333,11.2,40467,112,0,-3732,-954,11.2,3633.3
4853767474,1,0,0,0,13,11,32,0,0,0,0,33957,10.8,37522,109,0,710,3609,10.9,3395.7,0,0,1,11,13,19,0,0,0,0,33247,10.0,33913,96,0,-710,-3609,9.6,3324.7
4852316783,1,38,0,1,29,20,64,0,0,0,1,39460,11.8,44008,112,0,3693,5035,11.2,3946.0,0,8,0,20,29,51,0,0,0,0,35767,11.0,38973,111,0,-3693,-5035,11.1,3576.7
4849768696,1,15,1,1,12,3,6,1,1,0,0,19580,7.6,20444,231,72,3065,2705,30.3,1958.0,11,2,0,3,12,4,0,0,0,0,16515,6.8,17739,212,56,-3065,-2705,26.8,1651.5
4849740465,0,41,2,0,8,5,4,0,0,0,0,17737,7.0,18906,236,60,-1793,-1217,29.6,1773.7,9,13,1,5,8,2,2,1,1,0,19530,7.4,20123,210,64,1793,1217,27.4,1953.0
4849469358,0,9,2,0,10,9,6,0,0,0,0,17128,7.0,18095,195,70,91,358,26.5,1712.8,13,2,1,8,9,4,0,0,0,0,17037,6.8,17737,221,45,-91,-358,26.6,1703.7
4845854995,0,10,1,0,6,6,2,0,0,0,0,16480,7.0,18443,224,60,1248,470,28.4,1648.0,11,1,1,6,6,4,0,0,0,0,15232,7.0,17973,207,52,-1248,-470,25.9,1523.2
4844154141,1,15,2,0,13,4,20,1,1,0,0,19875,7.0,19068,218,61,4140,1799,27.9,1987.5,12,4,1,4,13,9,0,0,0,0,15735,6.8,17269,206,54,-4140,-1799,26.0,1573.5
4844120847,1,11,2,1,7,4,3,1,0,1,0,18583,7.4,20365,247,68,3096,2340,31.5,1858.3,9,1,0,4,7,2,0,0,0,0,15487,7.2,18025,221,68,-3096,-2340,28.9,1548.7
4841901893,0,0,0,1,15,20,37,0,0,0,0,35297,10.6,37323,103,0,-344,-1751,10.3,3529.7,8,0,0,20,15,63,0,0,0,0,35641,10.8,39074,109,0,344,1751,10.9,3564.1
4840866183,0,18,1,0,4,11,2,0,0,0,0,15620,6.6,16210,193,52,-4221,-2192,24.5,1562.0,32,3,1,11,4,9,0,0,0,0,19841,7.0,18402,244,64,4221,2192,30.8,1984.1
4840837357,1,13,0,0,8,1,7,0,0,0,0,18330,7.2,19705,249,64,3472,1888,31.3,1833.0,14,1,1,1,8,1,0,0,0,0,14858,6.8,17817,225,68,-3472,-1888,29.3,1485.8
4838551394,0,0,2,1,35,28,86,0,0,0,1,38566,11.6,44029,94,0,-2767,-285,9.4,3856.6,14,0,0,28,35,56,0,0,0,0,41333,11.4,44314,104,0,2767,285,10.4,4133.3
4838549759,1,16,0,0,19,15,45,0,0,0,0,36185,11.2,40075,105,0,602,1478,10.5,3618.5,22,0,1,15,19,46,0,0,0,0,35583,11.0,38597,75,0,-602,-1478,7.5,3558.3
4838337271,1,0,0,1,28,19,73,0,0,0,0,37700,11.4,42812,101,0,2407,2422,10.1,3770.0,0,0,0,19,28,36,0,0,0,0,35293,11.0,40390,98,0,-2407,-2422,9.8,3529.3
4837363966,0,0,0,1,22,28,45,0,0,0,1,36919,11.6,43411,98,0,-1347,429,9.8,3691.9,0,0,0,28,22,64,0,0,0,0,38266,11.4,42982,110,0,1347,-429,11.0,3826.6
4837339542,0,12,0,0,20,32,42,0,0,0,0,35902,11.2,40238,98,0,-2762,-2573,9.8,3590.2,0,1,1,31,19,93,0,0,0,0,38664,11.6,42811,105,0,2762,2573,10.5,3866.4
4814654207,0,0,0,0,30,34,74,0,0,0,1,39855,11.8,44896,76,0,-2097,-2069,7.6,3985.5,0,0,1,34,30,98,0,0,0,0,41952,12.0,46965,112,0,2097,2069,11.2,4195.2
4814652861,1,0,0,1,32,25,85,0,0,0,0,38800,11.4,42761,100,0,1011,-613,10.0,3880.0,0,0,0,25,32,51,0,0,0,0,37789,11.6,43374,102,0,-1011,613,10.2,3778.9
4814642559,1,20,0,0,9,14,15,0,0,0,0,33121,10.6,35680,119,0,-2025,-2407,11.9,3312.1,0,5,1,14,9,31,0,0,0,0,35146,11.0,38087,96,0,2025,2407,9.6,3514.6
4813708566,1,41,2,0,5,8,5,0,0,0,0,16144,6.6,16407,168,56,-3227,-1979,22.4,1614.4,65,2,1,8,5,8,0,0,0,0,19371,7.0,18386,202,60,3227,1979,26.2,1937.1
4811731174,0,7,1,1,9,5,1,0,0,0,0,17638,7.0,18719,200,51,2201,2543,25.1,1763.8,14,0,0,5,9,4,0,0,0,0,15437,6.2,16176,185,49,-2201,-2543,23.4,1543.7
4811718052,1,11,1,1,2,6,4,0,0,0,0,14919,6.4,16182,196,44,-2557,-2091,24.0,1491.9,11,3,0,6,2,7,0,0,0,0,17476,7.0,18273,224,47,2557,2091,27.1,1747.6
4809708501,0,10,1,1,6,3,4,0,0,0,0,16040,6.8,16422,179,51,452,-769,23.0,1604.0,14,2,0,3,6,3,1,1,0,0,15588,6.6,17191,207,50,-452,769,25.7,1558.8
4808776086,0,1,0,0,29,29,66,0,0,0,0,36774,11.4,42706,105,0,-1419,-1809,10.5,3677.4,0,0,1,29,29,66,0,0,0,0,38193,11.6,44515,101,0,1419,1809,10.1,3819.3
4807370513,1,14,0,0,31,31,87,0,0,0,1,39336,11.6,42570,95,0,-85,-522,9.5,3933.6,0,0,1,31,31,87,0,0,0,0,39421,11.6,43092,95,0,85,522,9.5,3942.1
4807347339,1,0,0,0,24,24,75,0,0,0,1,38173,11.2,42301,96,0,1598,3324,9.6,3817.3,0,0,1,24,24,75,0,0,0,0,36575,11.0,38977,95,0,-1598,-3324,9.5,3657.5
4807324562,0,0,0,1,26,21,63,0,0,0,0,36158,11.0,40085,85,0,-738,-1287,8.5,3615.8,0,0,0,21,26,46,0,0,0,0,36896,11.2,41372,100,0,738,1287,10.0,3689.6
4806766261,1,6,2,0,2,2,2,0,0,0,0,15474,6.8,18516,237,53,1577,483,29.0,1547.4,12,0,1,2,2,0,0,0,0,0,13897,7.0,18033,201,52,-1577,-483,25.3,1389.7
4806178907,1,0,0,1,43,26,91,0,0,0,0,41902,12.2,46714,125,0,5174,5621,12.5,4190.2,0,0,0,26,43,55,0,0,0,0,36728,11.2,41093,86,0,-5174,-5621,8.6,3672.8
4806159117,1,25,0,0,32,21,89,0,0,0,0,38121,11.4,42291,80,0,2278,4385,8.0,3812.1,0,0,1,21,32,51,0,0,0,0,35843,10.8,37906,83,0,-2278,-4385,8.3,3584.3
4803653922,1,360,11,1,30,27,85,0,0,0,2,39567,11.8,44337,120,0,111,2849,12.0,3956.7,19,0,0,26,29,74,0,0,0,0,39456,11.4,41488,97,0,-111,-2849,9.7,3945.6
4803439604,0,0,0,1,15,14,29,0,0,0,1,32905,10.4,35498,93,0,-1899,-1001,9.3,3290.5,0,0,0,14,15,40,0,0,0,0,34804,10.4,36499,99,0,1899,1001,9.9,3480.4
4803354343,1,74,2,1,4,1,4,0,0,0,0,16486,6.8,18493,202,68,868,-71,27.0,1648.6,15,2,0,1,4,1,1,1,0,0,15618,7.0,18564,228,56,-868,71,28.4,1561.8
4802604186,1,16,3,0,11,5,5,0,0,0,0,17635,7.0,18943,218,52,1836,2384,27.0,1763.5,16,1,1,5,11,5,1,1,0,0,15799,6.6,16559,211,52,-1836,-2384,26.3,1579.9
4802087026,1,16,9,1,8,5,7,0,0,0,0,18551,7.0,18093,226,48,2342,2303,27.4,1855.1,83,4,0,5,8,3,1,1,0,0,16209,6.4,15790,194,60,-2342,-2303,25.4,1620.9
4856203978,0,12,2,0,5,8,9,0,0,0,0,15711,6.6,16575,198,52,-2784,-1965,25.0,1571.1,76,0,1,8,5,5,0,0,0,0,18495,7.0,18540,241,60,2784,1965,30.1,1849.5
4856162055,0,13,0,0,3,11,3,0,0,0,0,15002,7.0,17576,207,64,-5204,-1814,27.1,1500.2,12,2,1,11,3,11,0,0,0,0,20206,7.2,19390,251,44,5204,1814,29.5,2020.6
4855771310,1,0,0,1,12,16,15,0,0,0,0,44900,10.0,47500,0,0,16000,19000,0.0,4490.0,0,0,0,11,7,9,0,0,0,0,28900,6.0,28500,0,0,-16000,-19000,0.0,2890.0
4855744894,0,10,0,0,4,4,1,1,0,1,0,14712,7.0,17746,171,64,-820,1389,23.5,1471.2,11,1,1,4,4,3,1,1,0,0,15532,6.4,16357,208,63,820,-1389,27.1,1553.2
4855714511,0,9,1,0,4,4,5,0,0,0,0,15604,7.4,19005,198,60,-1323,56,25.8,1560.4,11,1,1,4,4,3,0,0,0,0,16927,7.2,18949,236,52,1323,-56,28.8,1692.7
4855687108,1,12,1,0,3,4,4,0,0,0,0,15909,7.0,17761,201,68,496,633,26.9,1590.9,8,0,1,4,3,3,0,0,0,0,15413,6.6,17128,216,40,-496,-633,25.6,1541.3
4855164410,1,0,0,1,22,15,20,0,0,0,0,65550,12.0,55000,0,0,29400,22000,0.0,6555.0,0,0,0,7,14,8,0,0,0,0,36150,7.2,33000,0,0,-29400,-22000,0.0,3615.0
4855136796,1,0,0,1,26,17,19,0,0,0,0,47350,10.0,47500,0,0,18800,19000,0.0,4735.0,0,0,0,8,17,16,0,0,0,0,28550,6.0,28500,0,0,-18800,-19000,0.0,2855.0
4855096559,1,316,0,1,16,14,17,0,0,0,0,45341,10.0,47500,1,0,17352,19000,0.1,4534.1,80,0,0,9,11,5,0,0,0,0,27989,6.0,28500,2,0,-17352,-19000,0.2,2798.9
4855074158,0,0,0,0,27,25,49,0,0,0,1,36381,11.4,42125,77,0,-1230,-288,7.7,3638.1,0,0,1,25,27,66,0,0,0,0,37611,11.2,42413,115,0,1230,288,11.5,3761.1
4855031651,1,0,1,1,25,24,68,0,0,0,2,38478,11.4,41930,111,0,814,2896,11.1,3847.8,36,0,0,24,25,64,0,0,0,0,37664,11.0,39034,95,0,-814,-2896,9.5,3766.4
4855016783,1,29,1,0,21,26,58,0,0,0,2,37065,10.8,38906,111,0,-985,341,11.1,3706.5,3,19,1,26,21,87,0,0,0,0,38050,10.8,38565,89,0,985,-341,8.9,3805.0
4854973112,0,0,0,1,22,30,48,0,0,0,2,36174,11.2,40748,89,0,-3051,-1328,8.9,3617.4,0,0,0,30,22,77,0,0,0,0,39225,11.2,42076,114,0,3051,1328,11.4,3922.5
4854883084,1,83,0,1,16,15,13,0,0,0,0,61846,12.0,55000,0,0,24646,22000,0.0,6184.6,0,0,0,9,10,10,0,0,0,0,37200,7.2,33000,0,0,-24646,-22000,0.0,3720.0
4854863441,1,0,0,0,18,16,17,0,0,0,0,62700,12.0,55000,0,0,26184,22000,0.0,6270.0,0,0,1,9,11,4,0,0,0,0,36516,7.2,33000,0,0,-26184,-22000,0.0,3651.6
4854834651,1,4,0,0,15,19,14,0,0,0,0,45250,10.0,47500,0,0,17400,19000,0.0,4525.0,0,0,1,10,6,10,0,0,0,0,27850,6.0,28500,0,0,-17400,-19000,0.0,2785.0
4854815688,1,8,7,0,19,15,14,0,0,0,0,46710,10.0,47500,7,0,15230,19000,0.7,4671.0,37,1,1,9,13,10,0,0,0,0,31480,6.0,28500,9,0,-15230,-19000,0.9,3148.0
4854798954,1,0,0,0,18,14,17,0,0,0,0,46350,10.0,47500,1,0,19550,19000,0.1,4635.0,0,0,1,8,12,7,0,0,0,0,26800,6.0,28500,0,0,-19550,-19000,0.0,2680.0
4854140194,0,198,0,0,18,37,30,0,0,0,1,36345,10.8,39944,109,0,-4431,-4578,10.9,3634.5,0,0,1,37,18,95,0,0,0,0,40776,11.8,44522,116,0,4431,4578,11.6,4077.6
4800756323,1,16,3,1,9,7,8,0,0,0,0,17423,7.0,17664,208,32,807,-518,24.0,1742.3,15,2,0,7,9,3,0,0,0,0,16616,6.8,18182,193,64,-807,518,25.7,1661.6
4800711856,0,11,1,0,6,4,4,0,0,0,0,16628,7.0,17875,257,44,764,753,30.1,1662.8,17,1,1,4,6,6,0,0,0,0,15864,6.6,17122,195,48,-764,-753,24.3,1586.4
4800671202,1,14,1,0,7,6,7,1,1,0,0,18035,7.0,18594,237,60,1292,560,29.7,1803.5,12,1,1,6,7,5,0,0,0,0,16743,7.0,18034,184,52,-1292,-560,23.6,1674.3
4800637336,0,12,2,0,2,6,2,0,0,0,0,16133,7.0,17796,225,48,-1157,-262,27.3,1613.3,28,1,1,6,2,7,1,1,0,0,17290,7.0,18058,222,52,1157,262,27.4,1729.0
4800615774,0,15,1,1,1,3,1,0,0,0,0,15559,6.8,17686,218,63,-1107,-2108,28.1,1555.9,10,1,0,3,1,1,1,1,0,0,16666,7.2,19794,236,64,1107,2108,30.0,1666.6
4800447170,0,23,1,1,6,6,8,0,0,0,0,17017,7.0,19144,195,60,-50,1730,25.5,1701.7,10,0,0,6,6,4,0,0,0,0,17067,6.8,17414,221,52,50,-1730,27.3,1706.7
4800403717,1,11,1,1,8,9,9,0,0,0,0,18861,7.0,18371,225,64,779,-18,28.9,1886.1,17,1,0,9,8,11,1,1,0,0,18082,7.0,18389,214,60,-779,18,27.4,1808.2
4800386223,1,35,1,0,7,8,7,0,0,0,0,17626,7.0,17593,206,56,-718,-903,26.2,1762.6,14,1,1,8,7,2,0,0,0,0,18344,7.2,18496,198,64,718,903,26.2,1834.4
4799398983,0,130,0,0,5,5,7,0,0,0,0,16593,6.4,17133,206,64,184,-1135,27.0,1659.3,16,1,1,5,5,2,0,0,0,0,16409,6.8,18268,239,56,-184,1135,29.5,1640.9
4798832003,1,30,0,0,6,8,3,0,0,0,0,17297,7.0,18651,216,48,472,890,26.4,1729.7,8,11,1,7,5,8,1,1,0,0,16825,6.8,17761,191,48,-472,-890,23.9,1682.5
4777945834,0,11,1,0,2,2,0,0,0,0,0,14779,6.8,16961,226,44,-1327,-2388,27.0,1477.9,29,0,1,2,2,3,0,0,0,0,16106,7.2,19349,215,64,1327,2388,27.9,1610.6
4777901703,1,29,2,1,4,3,4,1,1,0,0,15571,6.8,17275,178,64,-109,-1215,24.2,1557.1,34,0,0,3,4,1,0,0,0,0,15680,7.0,18490,247,48,109,1215,29.5,1568.0
4777864146,1,17,0,1,8,4,10,0,0,0,0,18487,7.2,18155,222,39,1904,956,26.1,1848.7,5,1,0,4,8,3,0,0,0,0,16583,6.8,17199,209,52,-1904,-956,26.1,1658.3
4748041170,0,0,0,1,23,36,56,0,0,0,1,38725,11.2,42318,95,0,-1477,-794,9.5,3872.5,0,0,0,36,23,108,0,0,0,0,40202,11.4,43112,114,0,1477,794,11.4,4020.2
4748034930,1,24,0,1,36,23,97,0,0,0,1,41598,12.0,46616,114,0,3041,6840,11.4,4159.8,4,0,0,23,36,59,0,0,0,0,38557,11.0,39776,100,0,-3041,-6840,10.0,3855.7
4748019765,1,0,1,0,22,29,66,0,0,0,1,37321,10.8,39015,122,0,-1338,-1212,12.2,3732.1,25,0,1,29,22,85,0,0,0,0,38659,11.0,40227,117,0,1338,1212,11.7,3865.9
4748004421,1,0,0,1,23,24,48,0,0,0,1,39413,11.4,40801,126,0,1677,-146,12.6,3941.3,0,0,0,24,23,66,0,0,0,0,37736,11.0,40947,107,0,-1677,146,10.7,3773.6
4739782924,1,14,2,1,6,5,5,1,1,0,0,16987,6.8,17961,215,60,989,-602,27.5,1698.7,22,3,0,5,6,2,0,0,0,0,15998,7.0,18563,216,56,-989,602,27.2,1599.8
4739731885,0,34,1,0,4,6,4,0,0,0,0,14972,6.8,17232,198,48,-3283,-2059,24.6,1497.2,30,13,1,6,4,7,1,1,0,0,18255,7.2,19291,253,61,3283,2059,31.4,1825.5
4738838355,1,13,1,0,6,7,9,0,0,0,0,15510,6.8,17270,195,8,-1657,-1913,20.3,1551.0,11,1,1,7,6,6,1,1,0,0,17167,7.2,19183,234,76,1657,1913,31.0,1716.7
4857544255,0,0,0,0,8,15,20,0,0,0,1,31720,10.0,33268,95,0,-2574,-3350,9.5,3172.0,0,0,1,15,8,46,0,0,0,0,34294,10.6,36618,113,0,2574,3350,11.3,3429.4
4857487730,1,74,1,1,5,7,2,1,1,0,0,16168,7.0,19115,209,64,-762,344,27.3,1616.8,8,1,0,7,5,5,1,0,1,0,16930,7.2,18771,184,51,762,-344,23.5,1693.0
4857463647,1,8,0,1,19,4,57,0,0,0,1,34710,10.6,37631,103,0,6332,6457,10.3,3471.0,0,2,0,4,19,7,0,0,0,0,28378,9.4,31174,84,0,-6332,-6457,8.4,2837.8
4857446094,1,0,0,1,19,13,18,0,0,0,0,47000,10.0,47500,0,0,20200,19000,0.0,4700.0,0,0,0,6,12,6,0,0,0,0,26800,6.0,28500,0,0,-20200,-19000,0.0,2680.0
4857416432,1,0,0,1,10,18,13,0,0,0,0,45250,10.0,47500,0,0,16000,19000,0.0,4525.0,0,0,0,14,6,9,0,0,0,0,29250,6.0,28500,0,0,-16000,-19000,0.0,2925.0
4857384374,1,18,0,1,17,20,38,0,0,0,0,35502,10.6,37251,107,0,-291,-3358,10.7,3550.2,0,2,0,20,17,54,0,0,0,0,35793,11.0,40609,96,0,291,3358,9.6,3579.3
4857335256,1,0,0,0,22,22,55,0,0,0,1,37625,11.0,40046,117,0,1733,2622,11.7,3762.5,0,0,1,22,22,46,0,0,0,0,35892,10.8,37424,85,0,-1733,-2622,8.5,3589.2
4857300648,1,0,5,1,17,15,46,0,0,0,1,34814,10.2,36571,121,0,1224,83,12.1,3481.4,6,0,0,15,17,31,0,0,0,0,33590,10.4,36488,105,0,-1224,-83,10.5,3359.0
4857279199,0,0,0,0,35,22,96,0,0,0,1,39667,11.4,43233,84,0,-569,454,8.4,3966.7,6,0,1,22,35,46,0,0,0,0,40236,11.6,42779,114,0,569,-454,11.4,4023.6
4856540924,1,12,0,1,20,24,42,0,0,0,0,35743,10.8,40179,102,0,-276,394,10.2,3574.3,0,2,0,24,20,48,0,0,0,0,36019,11.0,39785,93,0,276,-394,9.3,3601.9
4856528767,0,0,0,0,16,28,35,0,0,0,1,34556,10.6,37948,96,0,-3431,-2941,9.6,3455.6,0,0,1,28,16,87,0,0,0,0,37987,11.0,40889,119,0,3431,2941,11.9,3798.7
4856503928,1,0,0,1,17,21,39,0,0,0,0,35581,11.0,39732,97,0,929,1672,9.7,3558.1,0,0,0,21,17,51,0,0,0,0,34652,10.8,38060,106,0,-929,-1672,10.6,3465.2
4856477464,1,0,0,0,19,11,44,0,0,0,0,34522,10.8,37750,104,0,1574,4559,10.4,3452.2,25,0,1,11,19,23,0,0,0,0,32948,10.0,33191,98,0,-1574,-4559,9.8,3294.8
4856457620,1,0,0,1,33,27,65,0,0,0,0,40789,12.0,46015,109,0,2941,4791,10.9,4078.9,0,0,0,27,33,57,0,0,0,0,37848,11.2,41224,100,0,-2941,-4791,10.0,3784.8
4856434487,1,22,0,1,16,15,31,0,0,0,0,35018,10.8,37573,74,0,2257,2189,7.4,3501.8,0,7,0,15,16,36,0,0,0,0,32761,10.2,35384,89,0,-2257,-2189,8.9,3276.1
4856402784,1,3,0,1,20,22,44,0,0,0,1,36060,10.6,37661,118,0,-2096,-4265,11.8,3606.0,0,0,0,22,20,49,0,0,0,0,38156,11.4,41926,106,0,2096,4265,10.6,3815.6
4854279100,0,0,1,0,23,21,51,0,0,0,0,35852,11.0,38776,112,0,-1781,-2551,11.2,3585.2,5,0,1,21,23,53,0,0,0,0,37633,11.2,41327,122,0,1781,2551,12.2,3763.3
4854248103,1,11,1,1,5,3,1,1,1,0,0,15871,7.2,18345,184,60,-388,-1150,24.4,1587.1,13,1,0,3,5,1,1,0,1,0,16259,7.2,19495,219,55,388,1150,27.4,1625.9
4854190563,0,13,0,0,4,6,4,0,0,0,0,15820,6.6,17208,205,50,-470,-1449,25.5,1582.0,9,0,1,6,4,2,0,0,0,0,16290,7.0,18657,220,46,470,1449,26.6,1629.0
4836002864,1,10,1,1,3,8,2,0,0,0,0,14734,6.4,15654,179,48,-1497,-1005,22.7,1473.4,14,1,0,8,3,13,1,1,0,0,16231,6.6,16659,197,48,1497,1005,24.5,1623.1
4834141648,0,10,17,0,4,6,5,1,0,1,0,15817,6.8,17642,230,44,-3131,-2237,27.4,1581.7,37,1,1,6,4,5,1,1,0,0,18948,7.4,19879,247,68,3131,2237,31.5,1894.8
4834089498,1,13,0,0,2,4,5,0,0,0,0,15600,7.2,18703,204,52,-1512,-253,25.6,1560.0,15,2,1,4,2,3,1,1,0,0,17112,7.0,18956,251,72,1512,253,32.3,1711.2
4833849422,0,16,3,1,3,2,2,0,0,0,0,16362,7.2,18954,234,64,1086,1019,29.8,1636.2,16,3,0,2,3,3,1,1,0,0,15276,6.8,17935,230,56,-1086,-1019,28.6,1527.6
4832633601,1,12,0,0,3,4,1,1,1,0,0,16525,7.4,19440,241,56,612,862,29.7,1652.5,11,0,1,4,3,4,0,0,0,0,15913,7.2,18578,197,56,-612,-862,25.3,1591.3
4830607465,0,12,0,0,2,3,1,0,0,0,0,15221,6.8,17972,243,52,-529,53,29.5,1522.1,13,2,1,3,2,4,1,1,0,0,15750,6.6,17919,244,56,529,-53,30.0,1575.0
4830577898,1,17,1,1,11,2,11,1,1,0,0,19364,7.0,18749,222,61,4150,1270,28.3,1936.4,19,0,0,2,11,2,0,0,0,0,15214,7.0,17479,211,64,-4150,-1270,27.5,1521.4
4830431267,1,10,3,1,5,1,2,0,0,0,0,16824,7.0,19088,252,64,2395,1045,31.6,1682.4,15,0,0,1,5,1,0,0,0,0,14429,7.0,18043,210,60,-2395,-1045,27.0,1442.9
4830091362,0,8,2,1,10,3,10,1,1,0,0,18512,7.0,18060,239,60,2491,108,29.9,1851.2,11,0,0,3,10,2,0,0,0,0,16021,7.0,17952,230,52,-2491,-108,28.2,1602.1
4830079268,1,13,0,0,4,2,1,1,0,1,0,16451,7.2,19683,244,52,2360,2057,29.6,1645.1,12,1,1,2,4,2,1,1,0,0,14091,7.0,17626,207,60,-2360,-2057,26.7,1409.1
4830065334,1,12,1,1,10,2,15,0,0,0,0,19297,6.8,18027,193,52,4659,2535,24.5,1929.7,97,1,0,2,10,4,1,1,0,0,14638,6.2,15492,218,52,-4659,-2535,27.0,1463.8
4830054005,0,10,1,0,1,5,1,0,0,0,0,14314,6.8,18065,196,68,-3456,-1474,26.4,1431.4,13,1,1,5,1,6,1,0,1,0,17770,7.2,19539,250,60,3456,1474,31.0,1777.0
4829309703,0,197,1,0,4,6,2,0,0,0,0,16126,6.8,17469,209,46,-423,-1356,25.5,1612.6,14,0,1,6,4,3,1,1,0,0,16549,7.0,18825,207,52,423,1356,25.9,1654.9
4829286549,0,10,1,0,2,3,2,0,0,0,0,14818,6.8,17993,215,52,-697,146,26.7,1481.8,15,1,1,3,2,3,0,0,0,0,15515,7.0,17847,189,64,697,-146,25.3,1551.5
4826823685,0,14,0,1,6,3,7,1,1,0,0,16734,7.0,18293,214,42,1158,286,25.6,1673.4,17,0,0,3,6,4,0,0,0,0,15576,7.0,18007,237,51,-1158,-286,28.8,1557.6
4826785333,1,13,1,0,3,4,4,0,0,0,0,15446,7.0,17625,188,64,-2029,-1315,25.2,1544.6,65,0,1,4,3,5,1,1,0,0,17475,7.2,18940,244,74,2029,1315,31.8,1747.5
4826744812,1,18,0,1,6,2,4,1,1,0,0,16452,6.8,17715,227,58,1790,408,28.5,1645.2,14,0,0,2,6,2,0,0,0,0,14662,6.6,17307,188,49,-1790,-408,23.7,1466.2
4826432662,0,112,2,1,5,5,2,0,0,0,0,15954,7.0,18302,192,56,-594,-742,24.8,1595.4,9,4,0,5,5,3,1,1,0,0,16548,7.2,19044,239,55,594,742,29.4,1654.8
4826414873,1,8,0,1,7,5,4,1,1,0,0,16331,7.0,18255,191,48,-1597,-440,23.9,1633.1,15,0,0,5,7,3,0,0,0,0,17928,7.0,18695,200,60,1597,440,26.0,1792.8
4826243309,0,12,2,0,1,5,1,0,0,0,0,15082,6.8,17591,219,66,-1985,-1738,28.5,1508.2,10,0,1,5,1,5,0,0,0,0,17067,7.2,19329,221,50,1985,1738,27.1,1706.7
4857037577,1,1,0,1,34,30,70,0,0,0,1,41141,11.8,45736,114,0,2534,1645,11.4,4114.1,29,0,0,30,34,75,0,0,0,0,38607,11.6,44091,96,0,-2534,-1645,9.6,3860.7
4856991602,0,20,3,1,7,8,7,0,0,0,0,17906,6.8,17567,218,48,428,676,26.6,1790.6,12,2,0,8,7,6,0,0,0,0,17478,6.8,16891,203,52,-428,-676,25.5,1747.8
4856885266,1,70,1,1,10,13,11,0,0,0,0,19082,7.0,17228,178,52,-298,-167,23.0,1908.2,11,2,0,13,10,15,1,1,0,0,19380,6.8,17395,188,50,298,167,23.8,1938.0
4856200162,1,0,0,0,11,17,8,0,0,0,0,44900,10.0,47500,0,0,16000,19000,0.0,4490.0,0,0,1,10,4,12,0,0,0,0,28900,6.0,28500,0,0,-16000,-19000,0.0,2890.0
4856174760,1,31,0,1,10,17,18,0,0,0,0,45956,10.0,47500,1,0,17390,19000,0.1,4595.6,0,0,0,14,7,8,0,0,0,0,28566,6.0,28500,5,0,-17390,-19000,0.5,2856.6
4856144269,1,0,0,1,21,15,22,0,0,0,0,62214,12.2,56000,0,0,24254,23000,0.0,6221.4,1,0,0,11,17,11,0,0,0,0,37960,7.2,33000,0,0,-24254,-23000,0.0,3796.0
4855851816,1,2,0,1,17,12,17,0,0,0,0,32700,10.0,47500,0,0,14200,19000,0.0,3270.0,4,0,0,6,11,5,0,0,0,0,18500,6.0,28500,0,0,-14200,-19000,0.0,1850.0
4855833023,1,0,0,0,23,14,16,0,0,0,0,47810,12.0,55000,0,0,19505,22000,0.0,4781.0,0,0,1,4,13,12,0,0,0,0,28305,7.2,33000,3,0,-19505,-22000,0.3,2830.5
4855810475,1,20,1,0,18,21,19,0,0,0,0,47360,10.0,47500,1,0,17400,19000,0.1,4736.0,30,0,1,14,11,14,0,0,0,0,29960,6.0,28500,1,0,-17400,-19000,0.1,2996.0
4855797199,1,27,3,1,12,19,12,0,0,0,0,46128,10.0,47500,5,0,17543,19000,0.5,4612.8,306,3,0,14,7,10,0,0,0,0,28585,6.0,28500,0,0,-17543,-19000,0.0,2858.5
4855758488,1,8,0,0,20,16,17,0,0,0,0,48075,10.0,47500,1,0,20225,19000,0.1,4807.5,0,0,1,6,10,7,0,0,0,0,27850,6.0,28500,0,0,-20225,-19000,0.0,2785.0
4855740540,1,213,1,1,17,12,17,0,0,0,0,47599,10.0,47500,1,0,19729,18925,0.1,4759.9,176,4,0,8,13,8,0,0,0,0,27870,6.0,28575,0,0,-19729,-18925,0.0,2787.0
4855732193,0,39,0,0,4,4,1,1,1,0,0,15237,7.0,18478,207,69,-1904,-97,27.6,1523.7,8,14,1,4,4,5,0,0,0,0,17141,6.8,18575,237,54,1904,97,29.1,1714.1
4855706108,1,57,0,1,6,6,4,1,1,0,0,16202,6.6,16585,168,48,-373,-2138,21.6,1620.2,17,1,0,6,6,4,0,0,0,0,16575,7.2,18723,230,44,373,2138,27.4,1657.5
4855682938,0,8,0,1,3,4,2,0,0,0,0,16009,6.8,18072,207,52,904,108,25.9,1600.9,9,0,0,4,3,4,0,0,0,0,15105,7.0,17964,202,60,-904,-108,26.2,1510.5
4855664547,0,14,1,1,5,5,5,1,1,0,0,15516,6.6,17151,184,48,-2690,-532,23.2,1551.6,15,0,0,5,5,9,0,0,0,0,18206,6.8,17683,197,51,2690,532,24.8,1820.6
4854728553,0,9,1,0,2,5,3,0,0,0,0,14279,6.6,16855,203,52,-3644,-2564,25.5,1427.9,24,4,1,5,2,6,1,1,0,0,17923,7.2,19419,228,64,3644,2564,29.2,1792.3
4854699510,0,20,0,0,4,8,3,0,0,0,0,15968,6.6,17401,209,45,-3256,-660,25.4,1596.8,12,1,1,8,4,10,1,1,0,0,19224,7.0,18061,226,50,3256,660,27.6,1922.4
4854674805,0,10,0,0,2,7,2,0,0,0,0,14093,6.6,17245,187,60,-3158,-1152,24.7,1409.3,6,0,1,7,2,8,0,0,0,0,17251,7.0,18397,238,52,3158,1152,29.0,1725.1
4854642310,1,11,2,1,5,3,4,0,0,0,0,17106,7.0,18972,222,58,1057,1802,28.0,1710.6,9,0,0,3,5,1,0,0,0,0,16049,6.6,17170,214,51,-1057,-1802,26.5,1604.9
4847183912,1,13,2,1,4,4,1,0,0,0,0,16527,7.4,19268,245,68,626,469,31.3,1652.7,19,0,0,4,4,5,0,0,0,0,15901,6.8,18799,203,72,-626,-469,27.5,1590.1
4844151852,0,14,3,0,2,6,1,0,0,0,0,15510,7.0,18162,177,58,-2439,-766,23.5,1551.0,9,3,1,6,2,5,1,1,0,0,17949,7.0,18928,213,49,2439,766,26.2,1794.9
4844111032,1,13,1,0,6,7,6,1,1,0,0,16545,6.6,16904,208,50,268,1261,25.8,1654.5,10,1,1,7,6,10,0,0,0,0,16277,6.2,15643,173,45,-268,-1261,21.8,1627.7
4844054385,0,12,0,1,11,5,15,0,0,0,0,18029,7.0,17713,213,44,1452,-292,25.7,1802.9,13,1,0,5,11,3,0,0,0,0,16577,7.0,18005,203,60,-1452,292,26.3,1657.7
4843982317,1,13,1,1,6,5,6,0,0,0,0,17165,6.8,17867,220,47,1050,-68,26.7,1716.5,18,1,0,5,6,4,1,1,0,0,16115,6.8,17935,201,44,-1050,68,24.5,1611.5
4817966461,0,11,3,1,10,7,10,0,0,0,0,19597,7.0,18346,227,56,2428,1393,28.3,1959.7,13,1,0,7,10,8,1,1,0,0,17169,6.6,16953,189,56,-2428,-1393,24.5,1716.9
4806890757,0,11,1,0,5,7,3,0,0,0,0,15900,6.6,17253,239,40,-1682,-793,27.9,1590.0,11,1,1,7,5,9,1,1,0,0,17582,6.8,18046,221,60,1682,793,28.1,1758.2
4806869235,0,11,0,0,1,4,1,0,0,0,0,13724,6.6,16696,190,48,-2415,-1381,23.8,1372.4,7,1,1,4,1,4,0,0,0,0,16139,6.8,18077,205,50,2415,1381,25.5,1613.9
4775277922,0,16,0,0,3,3,1,0,0,0,0,16036,7.0,18550,209,72,-31,292,28.1,1603.6,14,2,1,3,3,2,1,1,0,0,16067,7.0,18258,210,56,31,-292,26.6,1606.7
4775221210,1,10,0,1,5,4,6,0,0,0,0,18108,7.2,19054,203,64,2941,828,26.7,1810.8,14,0,0,4,5,2,0,0,0,0,15167,6.8,18226,210,52,-2941,-828,26.2,1516.7
4775156104,0,22,2,0,2,3,3,0,0,0,0,16454,7.2,18447,205,56,610,537,26.1,1645.4,9,0,1,3,2,2,0,0,0,0,15844,7.0,17910,218,52,-610,-537,27.0,1584.4
4752045881,0,0,0,1,33,22,95,0,0,0,0,38547,11.6,43888,119,0,1019,3016,11.9,3854.7,0,0,0,22,33,59,0,0,0,0,37528,11.2,40872,108,0,-1019,-3016,10.8,3752.8
4752017478,1,0,4,0,22,22,51,0,0,0,0,37535,11.2,41560,102,0,929,2281,10.2,3753.5,17,0,1,22,22,63,0,0,0,0,36606,11.0,39279,116,0,-929,-2281,11.6,3660.6
4751987397,1,0,0,0,17,19,43,0,0,0,0,34917,10.8,36882,114,0,869,-181,11.4,3491.7,0,0,1,19,17,47,0,0,0,0,34048,10.4,37063,99,0,-869,181,9.9,3404.8
4719168531,1,13,0,1,4,2,5,1,1,0,0,17218,6.8,17934,253,53,2327,221,30.6,1721.8,11,0,0,2,4,2,0,0,0,0,14891,7.0,17713,208,40,-2327,-221,24.8,1489.1
4719117188,1,74,0,1,8,5,9,0,0,0,0,18605,7.0,18753,213,68,2756,1444,28.1,1860.5,119,0,0,4,7,4,1,1,0,0,15849,6.8,17309,230,44,-2756,-1444,27.4,1584.9
4719067608,0,13,1,0,2,10,2,0,0,0,0,15012,6.6,17474,209,47,-5058,-1249,25.6,1501.2,19,2,1,10,2,14,1,0,1,0,20070,7.0,18723,245,53,5058,1249,29.8,2007.0
4719011516,1,13,1,1,6,6,3,0,0,0,0,17150,7.0,18159,232,36,356,316,26.8,1715.0,19,2,0,6,6,4,0,0,0,0,16794,7.0,17843,213,52,-356,-316,26.5,1679.4
4701767485,1,14,1,1,5,3,5,0,0,0,0,18077,7.2,19413,241,64,3487,798,30.5,1807.7,12,0,0,3,5,3,0,0,0,0,14590,7.0,18615,189,63,-3487,-798,25.2,1459.0
4678578866,0,11,2,0,3,9,3,0,0,0,0,14860,6.6,16704,205,35,-3998,-2830,24.0,1486.0,22,1,1,9,3,9,1,1,0,0,18858,7.2,19534,219,51,3998,2830,27.0,1885.8
4856268436,0,0,0,0,27,27,77,0,0,0,2,41195,11.8,43352,115,0,2215,2455,11.5,4119.5,1,0,1,27,27,48,0,0,0,0,38980,11.0,40897,93,0,-2215,-2455,9.3,3898.0
4856237381,1,26,0,1,24,26,53,0,0,0,0,36018,10.8,39729,123,0,-2915,-2945,12.3,3601.8,0,25,0,26,24,79,0,0,0,0,38933,11.4,42674,111,0,2915,2945,11.1,3893.3
4856206078,0,0,0,1,24,23,59,0,0,0,1,37505,11.2,40831,111,0,-814,145,11.1,3750.5,0,0,0,23,24,38,0,0,0,0,38319,11.0,40686,129,0,814,-145,12.9,3831.9
4856168374,1,0,0,1,29,30,86,0,0,0,0,40480,11.8,44288,121,0,1954,1889,12.1,4048.0,0,0,0,30,29,70,0,0,0,0,38526,11.4,42399,108,0,-1954,-1889,10.8,3852.6
4856129975,1,16,2,1,9,9,14,0,0,0,0,17858,6.6,16589,183,47,-580,-815,23.0,1785.8,12,2,0,9,9,8,0,0,0,0,18438,7.0,17404,218,48,580,815,26.6,1843.8
4855908468,1,14,14,0,1,3,0,1,1,0,0,15810,6.8,18294,251,50,-73,-111,30.1,1581.0,36,0,1,3,1,2,0,0,0,0,15883,6.8,18405,235,54,73,111,28.9,1588.3
4855829190,0,12,1,0,3,2,5,0,0,0,0,15374,6.4,16492,184,39,414,-443,22.3,1537.4,13,0,1,2,3,0,0,0,0,0,14960,6.6,16935,214,64,-414,443,27.8,1496.0
4854902551,1,71,0,0,25,18,66,0,0,0,0,40957,11.2,42869,88,0,4229,2890,8.8,4095.7,0,0,1,18,25,51,0,0,0,0,36728,11.2,39979,115,0,-4229,-2890,11.5,3672.8
4853930591,0,0,0,0,19,23,42,0,0,0,1,37213,11.0,38393,113,0,411,-2263,11.3,3721.3,16,0,1,23,19,47,0,0,0,0,36802,11.0,40656,113,0,-411,2263,11.3,3680.2
4853907215,1,3,0,0,29,23,78,0,0,0,0,38903,12.0,44890,104,0,957,5035,10.4,3890.3,48,0,1,23,29,67,0,0,0,0,37946,11.2,39855,103,0,-957,-5035,10.3,3794.6
4853760005,1,0,0,0,18,18,20,0,0,0,0,63080,12.0,55000,0,0,24830,22000,0.0,6308.0,11,0,1,13,13,10,0,0,0,0,38250,7.2,33000,0,0,-24830,-22000,0.0,3825.0
4853704852,1,34,3,1,21,15,21,0,0,0,0,64443,12.0,55000,12,0,27902,22000,1.2,6444.3,0,1,0,8,14,7,0,0,0,0,36541,7.2,33000,0,0,-27902,-22000,0.0,3654.1
4853688231,1,0,0,1,18,21,19,0,0,0,0,62385,12.0,55000,0,0,24485,20000,0.0,6238.5,2,0,0,12,9,14,0,0,0,0,37900,7.6,35000,0,0,-24485,-20000,0.0,3790.0
4853657197,0,0,0,0,33,26,91,0,0,0,2,40467,11.8,45328,102,0,748,2008,10.2,4046.7,0,0,1,26,33,60,0,0,0,0,39719,11.6,43320,109,0,-748,-2008,10.9,3971.9
4853629700,1,0,6,0,18,21,51,0,0,0,2,36488,11.0,38683,121,0,258,-507,12.1,3648.8,15,0,1,21,18,55,0,0,0,0,36230,10.8,39190,113,0,-258,507,11.3,3623.0
4851949248,1,68,0,0,16,17,41,0,0,0,0,36873,10.8,39033,106,0,-271,365,10.6,3687.3,0,0,1,17,16,54,0,0,0,0,37144,10.8,38668,118,0,271,-365,11.8,3714.4
4851121986,0,15,0,0,17,23,57,0,0,0,1,35082,10.8,38287,92,0,-3454,-1328,9.2,3508.2,0,0,1,23,17,69,0,0,0,0,38536,11.0,39615,93,0,3454,1328,9.3,3853.6
4851107210,0,0,0,0,28,30,77,0,0,0,2,39599,11.4,42561,98,0,-677,-2873,9.8,3959.9,0,0,1,30,28,84,0,0,0,0,40276,11.8,45434,102,0,677,2873,10.2,4027.6
4851085535,1,0,0,1,23,19,56,0,0,0,0,38663,11.2,42034,116,0,2204,2227,11.6,3866.3,0,0,0,19,23,37,0,0,0,0,36459,10.8,39807,110,0,-2204,-2227,11.0,3645.9
4851068392,1,0,0,0,26,21,75,0,0,0,2,39078,11.0,40929,106,0,2244,1650,10.6,3907.8,0,0,1,21,26,45,0,0,0,0,36834,11.0,39279,107,0,-2244,-1650,10.7,3683.4
4844301120,1,0,0,0,22,18,63,0,0,0,0,36163,11.0,39835,105,0,1231,2239,10.5,3616.3,3,0,1,18,22,33,0,0,0,0,34932,10.6,37596,113,0,-1231,-2239,11.3,3493.2
4844271221,1,0,0,1,19,15,40,0,0,0,1,35018,11.0,37941,108,0,1273,1581,10.8,3501.8,0,0,0,15,19,28,0,0,0,0,33745,10.4,36360,114,0,-1273,-1581,11.4,3374.5
4844232185,1,12,1,0,7,2,4,0,0,0,0,15934,6.8,17504,187,57,707,673,24.4,1593.4,10,1,1,2,7,1,0,0,0,0,15227,6.6,16831,208,50,-707,-673,25.8,1522.7
4844181356,0,13,0,0,4,7,1,0,0,0,0,14931,6.8,16654,204,48,-2593,-1496,25.2,1493.1,13,2,1,7,4,5,0,0,0,0,17524,7.0,18150,195,56,2593,1496,25.1,1752.4
4844125268,0,13,2,0,1,3,0,1,0,1,0,14523,7.0,17722,221,52,-1385,-428,27.3,1452.3,14,1,1,3,1,4,1,1,0,0,15908,7.0,18150,219,55,1385,428,27.4,1590.8
4843875386,0,82,0,0,2,6,1,1,1,0,0,15136,6.8,16382,192,54,-1895,-1387,24.6,1513.6,12,2,1,6,2,5,0,0,0,0,17031,6.8,17769,205,58,1895,1387,26.3,1703.1
4843278279,0,5,1,1,7,8,8,0,0,0,0,17770,7.0,17841,206,56,1179,-330,26.2,1777.0,83,0,0,8,7,6,1,1,0,0,16591,7.0,18171,200,64,-1179,330,26.4,1659.1
4843244016,1,10,0,0,9,5,11,0,0,0,0,15976,6.4,16210,174,32,-1023,-1982,20.6,1597.6,34,0,1,5,9,1,0,0,0,0,16999,6.8,18192,192,55,1023,1982,24.7,1699.9
4843198060,1,14,4,0,5,2,6,0,0,0,0,15867,7.0,18742,204,64,814,1169,26.8,1586.7,72,5,1,2,5,3,0,0,0,0,15053,7.0,17573,223,72,-814,-1169,29.5,1505.3
4722093523,1,22,0,0,22,18,53,0,0,0,0,35779,11.2,39411,101,0,-627,1399,10.1,3577.9,0,1,1,18,22,43,0,0,0,0,36406,10.8,38012,105,0,627,-1399,10.5,3640.6
4722063219,0,7,0,1,13,12,40,0,0,0,0,32675,10.0,34936,91,0,-978,-2359,9.1,3267.5,0,3,0,12,13,35,0,0,0,0,33653,10.6,37295,102,0,978,2359,10.2,3365.3
4708282471,0,0,0,0,13,18,30,0,0,0,0,35786,10.6,37139,113,0,-321,-3218,11.3,3578.6,0,0,1,18,13,42,0,0,0,0,36107,11.0,40357,126,0,321,3218,12.6,3610.7
4708253608,1,160,1,1,11,12,18,0,0,0,1,33349,10.6,36392,98,0,665,294,9.8,3334.9,10,0,0,12,11,29,0,0,0,0,32684,10.2,36098,90,0,-665,-294,9.0,3268.4
4691606038,0,0,2,0,18,31,38,0,0,0,1,35415,10.8,38812,97,0,-4645,-4857,9.7,3541.5,15,0,1,31,18,81,0,0,0,0,40060,11.8,43669,113,0,4645,4857,11.3,4006.0
4688746907,0,85,0,0,19,20,50,0,0,0,1,36048,11.0,39066,101,0,74,1071,10.1,3604.8,0,0,1,19,18,47,0,0,0,0,35974,11.0,37995,101,0,-74,-1071,10.1,3597.4
4687675491,0,0,3,0,23,21,49,0,0,0,0,36277,11.2,41444,92,0,194,515,9.2,3627.7,34,0,1,21,23,59,0,0,0,0,36083,11.2,40929,108,0,-194,-515,10.8,3608.3
4687645014,0,14,3,1,4,3,4,1,1,0,0,16877,7.0,17810,245,52,-40,-835,29.7,1687.7,13,1,0,3,4,3,1,0,1,0,16917,7.0,18645,228,64,40,835,29.2,1691.7
4687607283,0,9,1,1,3,3,2,0,0,0,0,16213,6.8,17900,211,64,977,-191,27.5,1621.3,15,2,0,3,3,1,0,0,0,0,15236,7.0,18091,217,59,-977,191,27.6,1523.6
4687548655,0,9,0,1,3,3,2,0,0,0,0,15792,6.6,18423,226,56,87,1380,28.2,1579.2,12,2,0,3,3,3,0,0,0,0,15705,6.8,17043,211,60,-87,-1380,27.1,1570.5
4687526246,0,10,3,1,2,5,1,0,0,0,0,15629,6.6,17661,202,52,-1649,-1316,25.4,1562.9,10,0,0,5,2,5,1,0,1,0,17278,7.0,18977,231,52,1649,1316,28.3,1727.8
4857179463,1,84,0,0,33,24,89,0,0,0,2,41289,12.2,48000,111,0,1209,5673,11.1,4128.9,26,0,1,24,33,64,0,0,0,0,40080,11.4,42327,107,0,-1209,-5673,10.7,4008.0
4857163927,1,0,0,1,35,20,109,0,0,0,1,40872,12.0,44939,87,0,3555,5805,8.7,4087.2,0,0,0,20,35,56,0,0,0,0,37317,10.8,39134,87,0,-3555,-5805,8.7,3731.7
4857142815,1,270,0,0,19,18,55,0,0,0,1,36887,11.0,40050,112,0,2596,3213,11.2,3688.7,0,0,1,18,19,45,0,0,0,0,34291,10.6,36837,67,0,-2596,-3213,6.7,3429.1
4857112091,1,19,0,1,28,23,67,0,0,0,0,39424,11.6,42983,116,0,2436,2376,11.6,3942.4,0,17,0,23,28,54,0,0,0,0,36988,11.2,40607,90,0,-2436,-2376,9.0,3698.8
4855787992,0,0,0,1,24,22,57,0,0,0,1,35236,11.2,39486,100,0,-3115,-1145,10.0,3523.6,0,0,0,22,24,46,0,0,0,0,38351,11.0,40631,116,0,3115,1145,11.6,3835.1
4852959474,1,22,0,0,22,24,46,0,0,0,0,35946,11.0,39884,115,0,543,460,11.5,3594.6,1,30,1,23,21,45,0,0,0,0,35403,10.8,39424,107,0,-543,-460,10.7,3540.3
4852929345,0,49,0,1,16,11,40,0,0,0,1,34862,10.4,35929,97,0,1880,631,9.7,3486.2,34,6,0,11,16,36,0,0,0,0,32982,10.2,35298,100,0,-1880,-631,10.0,3298.2
4852907521,1,0,0,1,24,21,14,0,0,0,0,64142,13.8,66500,0,0,26210,29000,0.0,6414.2,6,0,0,8,11,15,0,0,0,0,37932,7.8,37500,0,0,-26210,-29000,0.0,3793.2
4849987262,1,15,0,1,22,27,36,0,0,0,1,37216,11.0,40800,113,0,276,750,11.3,3721.6,0,4,0,27,22,71,0,0,0,0,36940,11.2,40050,104,0,-276,-750,10.4,3694.0
4849964864,0,28,0,1,18,18,47,0,0,0,1,36376,11.0,38631,111,0,441,1074,11.1,3637.6,0,0,0,18,18,53,0,0,0,0,35935,10.8,37557,99,0,-441,-1074,9.9,3593.5
4849941951,1,74,0,1,34,36,86,0,0,0,0,41389,12.0,46529,103,0,1761,1311,10.3,4138.9,0,0,0,36,34,93,0,0,0,0,39628,11.8,45218,83,0,-1761,-1311,8.3,3962.8
4847615480,1,11,0,0,19,12,45,0,0,0,0,35501,10.8,37964,116,0,3040,2999,11.6,3550.1,0,1,1,12,19,37,0,0,0,0,32461,10.2,34965,78,0,-3040,-2999,7.8,3246.1
4845304888,1,0,0,1,30,26,72,0,0,0,0,40036,11.6,43067,114,0,2286,2629,11.4,4003.6,0,0,0,26,30,62,0,0,0,0,37750,11.2,40438,98,0,-2286,-2629,9.8,3775.0
4845278196,0,13,0,1,19,18,55,0,0,0,1,35743,11.2,40515,103,0,-44,1565,10.3,3574.3,0,0,0,18,19,42,0,0,0,0,35787,11.0,38950,88,0,44,-1565,8.8,3578.7
4844033758,0,0,0,0,16,26,29,0,0,0,1,34052,10.8,38203,94,0,-4557,-4388,9.4,3405.2,234,0,1,26,16,60,0,0,0,0,38609,11.6,42591,98,0,4557,4388,9.8,3860.9
4844011076,1,10,0,1,32,19,92,0,0,0,1,39399,11.4,41324,111,0,3174,4152,11.1,3939.9,14,1,0,19,32,45,0,0,0,0,36225,10.8,37172,92,0,-3174,-4152,9.2,3622.5
4842180402,0,31,0,1,6,4,8,0,0,0,0,16008,6.8,16679,161,49,-407,-2777,21.0,1600.8,10,1,0,4,6,2,0,0,0,0,16415,7.0,19456,207,74,407,2777,28.1,1641.5
4842157753,0,9,2,0,2,6,1,0,0,0,0,14627,6.8,17276,197,52,-1105,-556,24.9,1462.7,14,1,1,6,2,9,1,1,0,0,15732,7.0,17832,180,56,1105,556,23.6,1573.2
4841432594,1,13,4,1,6,4,7,0,0,0,0,16617,6.2,15148,153,48,1869,-1449,20.1,1661.7,15,1,0,4,6,1,0,0,0,0,14748,6.4,16597,203,55,-1869,1449,25.8,1474.8
4840325453,0,14,0,0,29,28,75,0,0,0,1,37148,11.0,40784,102,0,-2692,-170,10.2,3714.8,0,0,1,28,29,81,0,0,0,0,39840,11.2,40954,112,0,2692,170,11.2,3984.0
4857296268,1,77,1,0,3,3,2,0,0,0,0,15817,7.0,18362,218,52,84,1328,27.0,1581.7,13,1,1,3,3,4,0,0,0,0,15733,6.6,17034,215,44,-84,-1328,25.9,1573.3
4857253792,1,9,1,1,9,2,7,0,0,0,0,16996,6.6,17535,182,60,1706,273,24.2,1699.6,12,0,0,2,9,1,1,1,0,0,15290,6.6,17262,192,72,-1706,-273,26.4,1529.0
4857211836,0,112,0,0,24,17,53,0,0,0,1,38250,11.4,42181,122,0,2620,3030,12.2,3825.0,2,0,1,17,24,33,0,0,0,0,35630,10.8,39151,104,0,-2620,-3030,10.4,3563.0
4857152221,1,0,0,0,24,31,70,0,0,0,2,39943,11.2,41956,108,0,761,492,10.8,3994.3,3,0,1,31,24,90,0,0,0,0,39182,11.0,41464,103,0,-761,-492,10.3,3918.2
4856200648,1,23,0,0,35,34,79,0,0,0,1,42413,12.4,48064,113,0,3286,2091,11.3,4241.3,1,2,1,34,35,83,0,0,0,0,39127,12.0,45973,93,0,-3286,-2091,9.3,3912.7
4856167697,1,0,0,1,29,27,63,0,0,0,0,41515,11.8,44929,97,0,3523,3090,9.7,4151.5,0,0,0,27,29,75,0,0,0,0,37992,11.4,41839,113,0,-3523,-3090,11.3,3799.2
4856134384,1,0,0,0,28,25,76,0,0,0,1,38523,11.8,44359,120,0,2048,4282,12.0,3852.3,0,0,1,25,28,63,0,0,0,0,36475,11.2,40077,89,0,-2048,-4282,8.9,3647.5
4856102514,0,4,1,1,27,30,73,0,0,0,1,37714,11.6,42546,107,0,-1692,-253,10.7,3771.4,16,0,0,30,27,82,0,0,0,0,39406,11.6,42799,109,0,1692,253,10.9,3940.6
4855777013,0,16,0,1,22,31,43,0,0,0,2,37880,11.0,40092,82,0,-1615,-4354,8.2,3788.0,0,4,0,31,22,71,0,0,0,0,39495,11.8,44446,127,0,1615,4354,12.7,3949.5
4853998183,0,12,2,1,4,1,3,1,1,0,0,16042,7.0,18602,225,64,2337,2176,28.9,1604.2,17,2,0,1,4,2,0,0,0,0,13705,6.6,16426,189,56,-2337,-2176,24.5,1370.5
4853953416,0,147,1,0,2,6,2,0,0,0,0,13787,6.4,16532,165,60,-3527,-1713,22.5,1378.7,27,0,1,6,2,7,0,0,0,0,17314,7.0,18245,230,55,3527,1713,28.5,1731.4
4853898479,0,16,2,1,4,7,5,0,0,0,0,16078,6.8,17770,220,58,-239,1097,27.8,1607.8,50,3,0,7,4,7,0,0,0,0,16317,6.8,16673,191,52,239,-1097,24.3,1631.7
4853812313,1,0,0,1,19,17,55,0,0,0,1,37592,11.0,40486,110,0,2781,3694,11.0,3759.2,0,0,0,17,19,51,0,0,0,0,34811,10.6,36792,104,0,-2781,-3694,10.4,3481.1
4851807586,1,0,0,1,16,13,40,0,0,0,1,34444,10.2,35383,117,0,1053,670,11.7,3444.4,0,0,0,13,16,39,0,0,0,0,33391,10.0,34713,106,0,-1053,-670,10.6,3339.1
4849115614,0,55,3,0,7,5,8,0,0,0,0,16328,7.2,18626,202,56,-32,-512,25.8,1632.8,16,1,1,5,7,3,0,0,0,0,16360,7.4,19138,216,60,32,512,27.6,1636.0
4849078536,0,38,2,0,5,5,2,0,0,0,0,15433,6.8,17611,193,52,-1065,-259,24.5,1543.3,7,11,1,5,5,4,0,0,0,0,16498,6.8,17870,183,68,1065,259,25.1,1649.8
4849044577,1,13,0,1,3,0,4,0,0,0,0,14917,6.8,17397,200,52,1224,255,25.2,1491.7,14,0,0,0,3,0,0,0,0,0,13693,6.8,17142,193,44,-1224,-255,23.7,1369.3
4848991697,1,15,3,1,5,4,7,0,0,0,0,16921,7.0,18262,230,58,2025,1331,28.8,1692.1,14,2,0,4,5,3,0,0,0,0,14896,6.4,16931,198,34,-2025,-1331,23.2,1489.6
4848957170,1,17,1,0,1,2,1,1,1,0,0,15830,7.0,18581,204,60,1195,1132,26.4,1583.0,10,1,1,2,1,3,0,0,0,0,14635,6.8,17449,203,56,-1195,-1132,25.9,1463.5
4848906542,0,19,0,0,4,4,3,0,0,0,0,15105,7.0,17206,186,48,-2133,-1223,23.4,1510.5,15,0,1,4,4,3,0,0,0,0,17238,7.0,18429,218,59,2133,1223,27.7,1723.8
4857361580,0,71,1,0,1,5,1,1,1,0,0,13627,6.8,17010,181,52,-2371,-1481,23.3,1362.7,15,1,1,5,1,2,0,0,0,0,15998,7.0,18491,190,44,2371,1481,23.4,1599.8
4857315532,1,13,5,1,5,3,1,0,0,0,0,15096,6.8,17931,185,40,-975,-965,22.5,1509.6,90,0,0,3,5,1,1,1,0,0,16071,7.0,18896,220,72,975,965,29.2,1607.1
4857265341,1,0,0,1,29,16,76,0,0,0,1,38273,11.2,42145,112,0,2301,2937,11.2,3827.3,0,0,0,16,29,37,0,0,0,0,35972,10.8,39208,108,0,-2301,-2937,10.8,3597.2
4857244147,0,34,0,0,22,30,58,0,0,0,2,36045,11.0,39547,83,0,-5011,-5807,8.3,3604.5,34,0,1,30,22,71,0,0,0,0,41056,12.0,45354,112,0,5011,5807,11.2,4105.6
4856261318,0,10,3,0,28,21,75,0,0,0,0,36999,11.2,41785,115,0,-923,346,11.5,3699.9,18,0,1,21,28,49,0,0,0,0,37922,11.2,41439,110,0,923,-346,11.0,3792.2
4856216329,1,1,0,1,28,15,65,0,0,0,1,39902,11.4,42268,114,0,5068,5018,11.4,3990.2,0,0,0,15,28,44,0,0,0,0,34834,10.8,37250,104,0,-5068,-5018,10.4,3483.4
4856184814,1,0,0,0,31,24,73,0,0,0,0,39421,11.6,42853,109,0,2818,3307,10.9,3942.1,0,0,1,24,31,62,0,0,0,0,36603,11.0,39546,104,0,-2818,-3307,10.4,3660.3
4856040632,0,66,1,1,2,3,1,0,0,0,0,14360,6.8,17369,194,52,-1339,-1355,24.6,1436.0,14,3,0,3,2,0,0,0,0,0,15699,7.2,18724,236,60,1339,1355,29.6,1569.9
4855071391,1,0,0,0,23,18,61,0,0,0,0,39049,11.2,41315,103,0,3602,5161,10.3,3904.9,3,0,1,18,23,41,0,0,0,0,35447,10.2,36154,97,0,-3602,-5161,9.7,3544.7
4855037487,0,31,0,1,18,18,45,0,0,0,0,34891,10.6,37554,106,0,-884,-1069,10.6,3489.1,17,0,0,18,18,47,0,0,0,0,35775,10.8,38623,110,0,884,1069,11.0,3577.5
4855007439,1,11,0,1,32,18,104,0,0,0,2,40441,11.8,42445,117,0,6816,7292,11.7,4044.1,0,0,0,17,31,42,0,0,0,0,33625,10.2,35153,80,0,-6816,-7292,8.0,3362.5
4854896234,0,31,0,0,28,38,62,0,0,0,0,37461,11.2,41674,93,0,-5388,-7602,9.3,3746.1,0,1,1,38,28,105,0,0,0,0,42849,12.4,49276,110,0,5388,7602,11.0,4284.9
4854863340,0,0,0,0,25,36,71,0,0,0,1,39055,11.0,41518,97,0,-3951,-6174,9.7,3905.5,0,0,1,36,25,101,0,0,0,0,43006,12.4,47692,101,0,3951,6174,10.1,4300.6
4851805230,0,0,0,0,20,11,54,0,0,0,0,35251,10.8,39008,96,0,306,891,9.6,3525.1,78,0,1,11,20,29,0,0,0,0,34945,10.6,38117,117,0,-306,-891,11.7,3494.5
4851780379,0,20,0,1,36,31,98,0,0,0,1,42116,12.4,47079,100,0,1342,3362,10.0,4211.6,0,2,0,31,36,85,0,0,0,0,40774,11.6,43717,117,0,-1342,-3362,11.7,4077.4
4851756032,1,0,0,0,24,20,72,0,0,0,0,36495,11.0,39938,80,0,411,1494,8.0,3649.5,0,0,1,20,24,54,0,0,0,0,36084,10.8,38444,98,0,-411,-1494,9.8,3608.4
4851592857,0,7,1,0,2,4,2,0,0,0,0,14859,7.0,18092,210,48,-1656,-277,25.8,1485.9,13,0,1,4,2,3,0,0,0,0,16515,7.0,18369,220,60,1656,277,28.0,1651.5
4851561268,0,11,1,1,6,8,7,0,0,0,0,16400,6.8,16723,216,51,-890,-1414,26.7,1640.0,12,1,0,8,6,6,0,0,0,0,17290,7.0,18137,202,44,890,1414,24.6,1729.0
4851521991,0,10,1,1,4,5,3,1,0,1,0,15767,7.0,18443,193,60,-178,1017,25.3,1576.7,13,0,0,5,4,6,1,1,0,0,15945,6.8,17426,228,63,178,-1017,29.1,1594.5
4828882149,1,57,3,0,4,3,3,0,0,0,0,16475,7.0,17731,210,56,1124,15,26.6,1647.5,35,14,1,3,4,4,0,0,0,0,15351,6.8,17716,208,48,-1124,-15,25.6,1535.1
4828857797,0,17,1,1,6,3,2,0,0,0,0,15916,6.8,17514,199,51,19,-600,25.0,1591.6,10,2,0,3,6,3,2,1,1,0,15897,7.0,18114,235,68,-19,600,30.3,1589.7
4822721553,0,12,8,1,8,5,11,0,0,0,0,18388,7.2,18906,264,48,2133,-553,31.2,1838.8,43,2,0,5,8,3,1,0,1,0,16255,7.0,19459,214,84,-2133,553,29.8,1625.5
4815607772,1,13,1,1,8,6,6,0,0,0,0,17487,6.6,16825,214,56,667,629,27.0,1748.7,15,2,0,6,8,10,1,1,0,0,16820,6.6,16196,159,62,-667,-629,22.1,1682.0
4811753915,0,10,0,0,6,5,7,1,1,0,0,15874,6.6,17091,200,59,-1148,-1505,25.9,1587.4,12,0,1,5,6,1,0,0,0,0,17022,7.0,18596,214,44,1148,1505,25.8,1702.2
4811737904,1,74,1,1,7,3,5,1,0,1,0,16304,7.0,18373,191,52,1264,834,24.3,1630.4,9,0,0,3,7,3,0,0,0,0,15040,7.0,17539,217,55,-1264,-834,27.2,1504.0
4810873152,1,14,2,0,7,7,3,1,1,0,0,17149,7.0,18508,234,52,840,1416,28.6,1714.9,9,0,1,7,7,4,0,0,0,0,16309,6.6,17092,194,56,-840,-1416,25.0,1630.9
4810474032,0,19,0,0,3,5,0,0,0,0,0,15794,7.2,18407,203,76,-1524,-952,27.9,1579.4,8,0,1,5,3,3,0,0,0,0,17318,7.4,19359,248,47,1524,952,29.5,1731.8
4810327007,0,10,1,1,6,3,6,1,1,0,0,17946,7.4,18845,237,60,1768,1176,29.7,1794.6,9,0,0,3,6,2,0,0,0,0,16178,6.8,17669,218,72,-1768,-1176,29.0,1617.8
4810263724,0,17,8,1,5,6,9,0,0,0,0,16779,7.0,18012,185,67,1229,-175,25.2,1677.9,37,1,0,6,5,2,0,0,0,0,15550,6.8,18187,220,28,-1229,175,24.8,1555.0
4810162235,1,11,0,0,6,3,5,0,0,0,0,17062,6.6,17546,212,74,2369,1771,28.6,1706.2,16,0,1,3,6,3,0,0,0,0,14693,6.4,15775,203,44,-2369,-1771,24.7,1469.3
4810132976,1,9,2,1,6,3,1,0,0,0,0,17142,7.4,19936,228,73,1292,1849,30.1,1714.2,12,0,0,3,6,3,0,0,0,0,15850,7.2,18087,198,62,-1292,-1849,26.0,1585.0
4810099630,1,69,7,0,7,5,9,1,1,0,0,17019,6.8,17344,192,54,-1132,-881,24.6,1701.9,16,0,1,5,7,6,0,0,0,0,18151,6.8,18225,198,78,1132,881,27.6,1815.1
4809940279,1,12,1,0,6,6,5,1,1,0,0,15399,6.6,16817,187,56,-561,-742,24.3,1539.9,10,1,1,5,5,4,0,0,0,0,15960,7.0,17559,184,51,561,742,23.5,1596.0
4809905497,1,15,0,1,6,6,4,0,0,0,0,15526,6.8,16936,198,56,-835,-476,25.4,1552.6,14,1,0,6,6,2,0,0,0,0,16361,6.8,17412,239,52,835,476,29.1,1636.1
4809290477,1,9,0,1,12,6,11,0,0,0,0,18633,7.0,17709,197,55,1517,1979,25.2,1863.3,25,0,0,5,11,8,0,0,0,0,17116,6.4,15730,177,44,-1517,-1979,22.1,1711.6
4809243160,1,14,1,0,2,3,1,1,1,0,0,14981,7.0,17853,242,64,95,895,30.6,1498.1,99,1,1,3,2,5,0,0,0,0,14886,6.8,16958,181,64,-95,-895,24.5,1488.6
4807703097,0,17,1,1,8,5,10,0,0,0,0,16881,6.8,16496,168,43,13,-1958,21.1,1688.1,11,2,0,5,8,4,0,0,0,0,16868,7.2,18454,230,69,-13,1958,29.9,1686.8
4807671352,0,11,0,0,5,6,4,0,0,0,0,17265,7.0,17954,207,52,684,146,25.9,1726.5,13,0,1,6,5,4,0,0,0,0,16581,6.8,17808,214,64,-684,-146,27.8,1658.1
4807646985,1,14,1,0,4,10,1,0,0,0,0,14841,6.4,16890,183,64,-3122,-2954,24.7,1484.1,16,2,1,9,3,3,1,0,1,0,17963,7.2,19844,227,60,3122,2954,28.7,1796.3
4849255547,0,13,2,1,9,15,10,0,0,0,0,17471,6.2,15516,176,40,-2246,-2727,21.6,1747.1,13,0,0,14,8,11,0,0,0,0,19717,7.0,18243,215,48,2246,2727,26.3,1971.7
4849239801,0,14,1,0,1,3,0,0,0,0,0,15219,6.8,18164,214,59,-1783,252,27.3,1521.9,12,2,1,3,1,6,1,1,0,0,17002,6.8,17912,213,64,1783,-252,27.7,1700.2
4849207357,0,34,0,1,5,5,1,0,0,0,0,16414,7.0,18554,210,56,481,1567,26.6,1641.4,13,11,0,5,5,4,1,1,0,0,15933,6.6,16987,168,64,-481,-1567,23.2,1593.3
4849159723,0,17,1,1,6,4,3,0,0,0,0,16429,7.0,18498,216,56,18,415,27.2,1642.9,9,3,0,4,6,4,0,0,0,0,16411,6.8,18083,187,48,-18,-415,23.5,1641.1
4848972563,0,14,3,1,3,8,5,0,0,0,0,15401,6.8,17929,209,52,-2169,-370,26.1,1540.1,16,2,0,8,3,7,1,1,0,0,17570,7.2,18299,207,60,2169,370,26.7,1757.0
4848922197,1,14,0,1,6,3,4,1,1,0,0,16392,7.0,17976,194,64,1847,425,25.8,1639.2,13,1,0,3,6,3,0,0,0,0,14545,6.8,17551,196,60,-1847,-425,25.6,1454.5
4848771646,1,85,1,1,6,6,5,0,0,0,0,17276,7.2,19142,203,69,599,7,27.2,1727.6,14,1,0,6,6,5,0,0,0,0,16677,7.2,19135,221,62,-599,-7,28.3,1667.7
4848226005,1,11,4,1,4,2,8,1,1,0,0,16412,6.8,18415,224,47,1333,-586,27.1,1641.2,13,2,0,2,4,2,0,0,0,0,15079,7.0,19001,240,60,-1333,586,30.0,1507.9
4848195134,1,13,2,1,6,3,4,0,0,0,0,16185,7.0,18608,226,48,512,11,27.4,1618.5,16,3,0,3,6,2,2,1,1,0,15673,7.0,18597,205,52,-512,-11,25.7,1567.3
4848167619,1,17,2,1,9,4,2,1,1,0,0,16800,7.0,17531,180,63,1053,260,24.3,1680.0,19,3,0,4,9,5,0,0,0,0,15747,6.8,17271,194,48,-1053,-260,24.2,1574.7
4848130499,1,36,2,0,5,5,1,0,0,0,0,15998,7.2,19600,195,58,-135,2334,25.3,1599.8,15,17,1,5,5,7,2,1,1,0,16133,7.0,17266,184,54,135,-2334,23.8,1613.3
4842636014,1,87,2,0,5,2,6,1,1,0,0,16584,7.0,18057,206,52,2555,1870,25.8,1658.4,13,0,1,2,5,0,0,0,0,0,14029,6.6,16187,166,56,-2555,-1870,22.2,1402.9
4842612173,0,11,3,0,5,8,4,0,0,0,0,15226,6.8,17223,171,56,-2731,-1741,22.7,1522.6,20,2,1,8,5,7,1,1,0,0,17957,7.2,18964,197,63,2731,1741,26.0,1795.7
4838398774,1,15,3,0,6,6,5,0,0,0,0,16233,7.0,17456,199,52,-400,464,25.1,1623.3,13,2,1,6,6,8,0,0,0,0,16633,6.8,16992,200,48,400,-464,24.8,1663.3
4838339792,1,17,4,1,5,6,9,0,0,0,0,16863,6.6,17243,186,48,-544,-623,23.4,1686.3,13,4,0,6,5,5,0,0,0,0,17407,6.8,17866,201,54,544,623,25.5,1740.7
4836172347,0,50,1,0,0,5,0,0,0,0,0,13417,6.8,16871,197,47,-2263,-1479,24.4,1341.7,14,1,1,5,0,4,1,1,0,0,15680,7.0,18350,229,56,2263,1479,28.5,1568.0
4836130491,0,11,2,0,3,4,3,0,0,0,0,15489,7.0,18344,224,48,-874,170,27.2,1548.9,15,0,1,4,3,4,0,0,0,0,16363,7.0,18174,214,75,874,-170,28.9,1636.3
4857928756,0,9,1,0,3,7,1,0,0,0,0,15317,6.8,17423,234,63,-1359,422,29.7,1531.7,15,2,1,7,3,9,1,1,0,0,16676,6.6,17001,214,51,1359,-422,26.5,1667.6
4857905021,1,36,2,1,7,6,9,0,0,0,0,16672,6.4,16239,191,28,639,-2370,21.9,1667.2,12,1,0,6,7,2,0,0,0,0,16033,7.2,18609,191,71,-639,2370,26.2,1603.3
4857037245,1,18,1,0,3,4,1,0,0,0,0,14692,7.0,18619,218,56,-1283,-279,27.4,1469.2,16,1,1,4,3,4,0,0,0,0,15975,7.0,18898,237,56,1283,279,29.3,1597.5
4857005102,1,141,3,0,6,5,6,0,0,0,0,15507,6.6,16940,192,40,-945,-585,23.2,1550.7,15,1,1,5,6,2,1,0,1,0,16452,7.0,17525,219,60,945,585,27.9,1645.2
4855929347,1,10,1,1,2,1,2,0,0,0,0,14979,7.0,18499,218,56,133,395,27.4,1497.9,13,1,0,1,2,2,0,0,0,0,14846,6.8,18104,209,60,-133,-395,26.9,1484.6
4855907286,1,8,1,1,8,0,11,1,1,0,0,17691,7.2,18382,206,66,3670,1583,27.2,1769.1,11,0,0,0,8,0,0,0,0,0,14021,6.8,16799,203,56,-3670,-1583,25.9,1402.1
4855861177,0,15,4,1,3,4,5,0,0,0,0,15323,6.6,16287,184,43,-2593,-1893,22.7,1532.3,17,2,0,4,3,6,1,1,0,0,17916,7.0,18180,226,60,2593,1893,28.6,1791.6
4854721944,1,27,0,0,18,20,16,0,0,0,0,47365,10.0,47500,0,0,17345,19000,0.0,4736.5,0,1,1,13,11,15,0,0,0,0,30020,6.0,28500,3,0,-17345,-19000,0.3,3002.0
4854700471,1,36,0,1,16,17,14,0,0,0,0,47150,10.0,47500,6,0,18102,19000,0.6,4715.0,0,1,0,9,8,11,0,0,0,0,29048,6.0,28500,0,0,-18102,-19000,0.0,2904.8
4854687108,1,0,0,0,23,21,24,0,0,0,0,65925,13.0,62500,0,0,28025,25000,0.0,6592.5,0,0,1,12,14,14,0,0,0,0,37900,7.8,37500,0,0,-28025,-25000,0.0,3790.0
4854661874,1,33,2,1,18,15,18,0,0,0,0,61460,12.0,55000,6,0,24935,22000,0.6,6146.0,0,0,0,7,10,7,0,0,0,0,36525,7.2,33000,1,0,-24935,-22000,0.1,3652.5
4854639717,1,19,0,1,22,13,24,0,0,0,0,62748,12.0,55000,0,0,26299,22000,0.0,6274.8,0,0,0,7,16,5,0,0,0,0,36449,7.2,33000,0,0,-26299,-22000,0.0,3644.9
4852482129,0,17,1,1,3,7,1,0,0,0,0,13852,6.4,16570,159,44,-3438,226,20.3,1385.2,12,2,0,7,3,8,0,0,0,0,17290,6.6,16344,200,44,3438,-226,24.4,1729.0
4852452427,0,16,3,1,4,4,5,0,0,0,0,15638,6.6,17238,193,44,-363,-1460,23.7,1563.8,11,2,0,4,4,5,2,1,1,0,16001,7.0,18698,221,67,363,1460,28.8,1600.1
4852430635,1,9,13,1,5,2,4,0,0,0,0,17859,6.8,17358,188,44,2790,-389,23.2,1785.9,38,1,0,2,5,1,1,1,0,0,15069,6.8,17747,193,68,-2790,389,26.1,1506.9
4852413368,1,14,2,1,5,2,6,1,1,0,0,16241,6.6,16996,203,55,1797,436,25.8,1624.1,8,2,0,2,5,1,0,0,0,0,14444,6.6,16560,188,44,-1797,-436,23.2,1444.4
4852356753,1,14,1,1,7,1,9,0,0,0,0,17483,7.0,17363,247,44,3465,1250,29.1,1748.3,19,2,0,1,7,1,1,1,0,0,14018,6.6,16113,195,56,-3465,-1250,25.1,1401.8
4852338406,1,12,2,0,6,6,6,0,0,0,0,17305,7.0,17861,207,52,1638,-7,25.9,1730.5,14,0,1,6,6,2,0,0,0,0,15667,7.0,17868,183,68,-1638,7,25.1,1566.7
4852317203,0,21,1,0,5,9,5,0,0,0,0,16670,6.8,17355,209,60,-386,-632,26.9,1667.0,9,0,1,9,5,7,1,0,1,0,17056,6.8,17987,195,42,386,632,23.7,1705.6
4851253101,1,12,1,0,4,5,2,0,0,0,0,15303,6.8,17959,204,64,-707,303,26.8,1530.3,18,1,1,5,4,5,0,0,0,0,16010,6.8,17656,222,52,707,-303,27.4,1601.0
4858137503,0,16,0,0,1,2,2,0,0,0,0,14206,6.8,17876,219,48,-1227,-1759,26.7,1420.6,32,0,1,2,1,1,1,1,0,0,15433,7.2,19635,224,71,1227,1759,29.5,1543.3
4858090492,1,12,2,0,10,6,6,0,0,0,0,18172,7.2,18370,190,65,1817,552,25.5,1817.2,11,1,1,6,10,3,1,1,0,0,16355,6.8,17818,187,56,-1817,-552,24.3,1635.5
4856587165,1,0,0,1,34,25,96,0,0,0,0,39433,11.8,45107,104,0,1634,3760,10.4,3943.3,0,0,0,24,33,59,0,0,0,0,37799,11.2,41347,97,0,-1634,-3760,9.7,3779.9
4856571896,0,68,0,0,21,25,58,0,0,0,1,36396,11.4,41066,90,0,-2488,-828,9.0,3639.6,0,0,1,25,21,69,0,0,0,0,38884,11.2,41894,123,0,2488,828,12.3,3888.4
4856551251,1,0,0,0,17,16,52,0,0,0,1,35147,10.6,36457,120,0,347,288,12.0,3514.7,0,0,1,16,17,41,0,0,0,0,34800,10.2,36169,117,0,-347,-288,11.7,3480.0
4856295483,0,16,0,0,21,26,54,0,0,0,1,35248,10.6,37835,71,0,-3776,-4948,7.1,3524.8,0,8,1,26,21,65,0,0,0,0,39024,11.6,42783,132,0,3776,4948,13.2,3902.4
4856267060,1,0,0,0,26,24,50,0,0,0,2,38537,11.6,44000,108,0,1695,3229,10.8,3853.7,0,0,1,23,25,60,0,0,0,0,36842,11.2,40771,100,0,-1695,-3229,10.0,3684.2
4856219768,1,0,0,0,20,18,59,0,0,0,2,37662,10.8,39909,125,0,143,2261,12.5,3766.2,0,0,1,18,20,53,0,0,0,0,37519,10.8,37648,99,0,-143,-2261,9.9,3751.9
4855169630,0,0,0,0,24,24,74,0,0,0,1,39100,11.6,42657,79,0,1666,3547,7.9,3910.0,0,0,1,24,24,64,0,0,0,0,37434,11.2,39110,100,0,-1666,-3547,10.0,3743.4
4855133144,1,0,0,1,18,16,41,0,0,0,1,37589,11.2,40235,125,0,2215,1396,12.5,3758.9,88,0,0,16,18,38,0,0,0,0,35374,11.0,38839,118,0,-2215,-1396,11.8,3537.4
4855095918,1,18,0,1,26,22,71,0,0,0,0,39429,11.0,40826,116,0,3316,1280,11.6,3942.9,0,2,0,22,26,53,0,0,0,0,36113,11.0,39546,91,0,-3316,-1280,9.1,3611.3
4854297997,1,0,0,1,31,17,98,0,0,0,1,39030,11.6,43346,100,0,3701,5808,10.0,3903.0,13,0,0,17,31,41,0,0,0,0,35329,10.6,37538,95,0,-3701,-5808,9.5,3532.9
4854283926,0,6,2,1,15,26,35,0,0,0,0,34713,10.4,35527,103,0,-3749,-6802,10.3,3471.3,13,0,0,26,15,57,0,0,0,0,38462,11.4,42329,112,0,3749,6802,11.2,3846.2
4854263969,1,5,0,1,29,3,20,0,0,0,1,26795,7.4,20581,227,4,15342,8956,23.1,2679.5,0,0,0,3,29,2,0,0,0,0,11453,5.2,11625,75,0,-15342,-8956,7.5,1145.3
4853847440,0,8,0,0,13,29,29,0,0,0,0,33589,10.2,35684,117,0,-5256,-5714,11.7,3358.9,0,0,1,29,13,82,0,0,0,0,38845,11.2,41398,111,0,5256,5714,11.1,3884.5
4853819139,1,0,0,0,12,17,36,0,0,0,1,33663,10.0,35671,96,0,-1619,-7,9.6,3366.3,0,0,1,17,12,58,0,0,0,0,35282,10.2,35678,103,0,1619,7,10.3,3528.2
4853800863,1,18,0,1,23,10,49,0,0,0,0,36898,11.0,39147,125,0,4478,4975,12.5,3689.8,682,0,0,10,23,13,0,0,0,0,32420,10.0,34172,99,0,-4478,-4975,9.9,3242.0
4851541629,0,11,0,0,5,11,4,0,0,0,0,16318,6.6,16861,201,52,-2451,-1518,25.3,1631.8,15,0,1,11,5,12,0,0,0,0,18769,7.2,18379,214,59,2451,1518,27.3,1876.9
4851080757,0,0,0,0,29,33,77,0,0,0,2,41692,11.6,45019,119,0,1779,2897,11.9,4169.2,3,0,1,33,29,89,0,0,0,0,39913,11.4,42122,105,0,-1779,-2897,10.5,3991.3
4851054592,1,0,0,0,25,31,53,0,0,0,0,38270,11.4,42921,114,0,-315,-687,11.4,3827.0,0,0,1,31,25,80,0,0,0,0,38585,11.8,43608,107,0,315,687,10.7,3858.5
4821194651,1,7,2,1,3,4,3,0,0,0,0,15101,6.8,18236,197,60,-1273,-1042,25.7,1510.1,9,0,0,4,3,2,2,1,1,0,16374,7.4,19278,233,60,1273,1042,29.3,1637.4
4821172455,1,12,1,0,11,4,12,1,0,1,0,20328,7.2,19468,229,62,4954,1934,29.1,2032.8,260,0,1,4,11,1,1,1,0,0,15374,6.8,17534,205,60,-4954,-1934,26.5,1537.4
4821139513,0,15,0,0,2,4,2,1,1,0,0,14726,7.0,17953,213,60,-728,3,27.3,1472.6,14,1,1,4,2,2,0,0,0,0,15454,6.6,17950,200,56,728,-3,25.6,1545.4
4821100695,1,17,3,1,6,2,4,2,1,1,0,16813,7.0,19437,231,68,2154,893,29.9,1681.3,66,0,0,2,6,1,0,0,0,0,14659,7.0,18544,197,68,-2154,-893,26.5,1465.9
4814395850,1,13,2,0,4,8,5,1,1,0,0,17039,6.6,17303,223,48,-321,-1583,27.1,1703.9,12,0,1,8,4,7,0,0,0,0,17360,7.2,18886,199,68,321,1583,26.7,1736.0
4814352756,0,13,2,0,6,2,13,1,1,0,0,16260,6.6,16201,193,50,-703,-1678,24.3,1626.0,13,2,1,2,6,6,0,0,0,0,16963,6.6,17879,230,60,703,1678,29.0,1696.3
4812497008,0,18,1,1,5,4,2,1,1,0,0,16597,7.0,18911,241,64,807,1431,30.5,1659.7,15,3,0,4,5,4,0,0,0,0,15790,6.8,17480,218,52,-807,-1431,27.0,1579.0
4812464402,0,151,2,1,6,4,6,1,1,0,0,16314,6.8,16921,199,44,102,-96,24.3,1631.4,14,0,0,4,6,4,0,0,0,0,16212,6.8,17017,235,44,-102,96,27.9,1621.2
4812432682,1,15,0,1,7,3,6,0,0,0,0,17216,7.2,18811,218,52,1396,257,27.0,1721.6,14,2,0,3,7,2,1,1,0,0,15820,7.0,18554,238,59,-1396,-257,29.7,1582.0
4810500685,0,44,1,1,1,3,1,0,0,0,0,14280,6.8,17558,218,56,-1704,-1674,27.4,1428.0,11,20,0,3,1,2,1,1,0,0,15984,7.0,19232,245,60,1704,1674,30.5,1598.4
4810459640,1,10,0,1,7,7,10,1,1,0,0,15903,6.8,17607,171,47,-577,643,21.8,1590.3,19,0,0,7,7,4,0,0,0,0,16480,6.8,16964,158,52,577,-643,21.0,1648.0
4789793009,0,41,0,0,13,14,19,0,0,0,0,19992,6.8,17602,191,50,-909,641,24.1,1999.2,18,7,1,14,13,29,0,0,0,0,20901,6.8,16961,176,56,909,-641,23.2,2090.1
4789745097,0,13,1,0,4,5,4,0,0,0,0,14864,6.2,15763,168,36,-1785,-2096,20.4,1486.4,16,1,1,5,4,2,1,1,0,0,16649,6.8,17859,178,68,1785,2096,24.6,1664.9
4789479656,1,16,2,1,4,4,3,0,0,0,0,16189,7.0,17982,225,56,-425,-187,28.1,1618.9,13,2,0,4,4,5,2,1,1,0,16614,7.0,18169,193,60,425,187,25.3,1661.4
4789457477,0,184,1,0,7,5,5,1,1,0,0,17278,7.0,19021,230,50,1459,-547,28.0,1727.8,14,0,1,5,7,2,0,0,0,0,15819,7.6,19568,208,58,-1459,547,26.6,1581.9
4789442469,0,11,1,1,5,3,5,1,1,0,0,16548,6.8,17834,227,56,79,-1038,28.3,1654.8,14,1,0,3,5,1,0,0,0,0,16469,7.0,18872,253,62,-79,1038,31.5,1646.9
4789419175,0,12,2,1,4,5,6,0,0,0,0,15800,6.6,15901,188,40,155,-1005,22.8,1580.0,13,1,0,5,4,4,1,1,0,0,15645,6.8,16906,179,48,-155,1005,22.7,1564.5
4789066697,0,13,1,0,5,7,5,1,1,0,0,16618,6.8,17873,218,40,446,209,25.8,1661.8,13,1,1,7,5,6,0,0,0,0,16172,6.8,17664,188,52,-446,-209,24.0,1617.2
4789041207,1,13,3,1,3,3,5,1,1,0,0,15431,6.8,17449,212,56,-506,-1490,26.8,1543.1,13,0,0,3,3,2,1,0,1,0,15937,7.2,18939,208,60,506,1490,26.8,1593.7
4787995166,1,12,0,1,5,5,4,0,0,0,0,15229,6.6,16798,156,48,-1000,-1730,20.4,1522.9,11,0,0,5,5,2,1,1,0,0,16229,7.0,18528,226,60,1000,1730,28.6,1622.9
4858384176,1,30,0,1,8,7,8,0,0,0,0,17889,7.2,17979,197,56,1688,510,25.3,1788.9,71,11,0,7,8,7,1,1,0,0,16201,6.6,17469,196,52,-1688,-510,24.8,1620.1
4857857850,1,23,0,0,4,4,4,0,0,0,0,15224,6.8,17035,184,48,244,835,23.2,1522.4,119,1,1,4,4,3,1,0,1,0,14980,6.4,16200,173,56,-244,-835,22.9,1498.0
4857839855,0,11,1,1,5,5,5,1,1,0,0,16502,6.8,17520,189,64,823,-946,25.3,1650.2,13,1,0,5,5,1,0,0,0,0,15679,7.0,18466,197,60,-823,946,25.7,1567.9
4857822923,0,12,2,0,5,4,6,1,1,0,0,16679,7.4,19149,233,60,-663,1255,29.3,1667.9,11,0,1,4,5,4,0,0,0,0,17342,6.8,17894,235,52,663,-1255,28.7,1734.2
4856962234,1,11,0,1,6,2,3,1,0,1,0,15727,7.0,17876,188,48,482,883,23.6,1572.7,12,2,0,2,6,5,1,1,0,0,15245,6.6,16993,192,72,-482,-883,26.4,1524.5
4856931109,0,13,2,0,3,2,3,0,0,0,0,15271,6.8,17894,202,56,243,590,25.8,1527.1,11,0,1,2,3,3,0,0,0,0,15028,6.8,17304,227,48,-243,-590,27.5,1502.8
4856896289,0,9,1,0,7,2,5,0,0,0,0,16751,7.2,19011,219,64,2586,1862,28.3,1675.1,14,0,1,2,7,2,0,0,0,0,14165,6.8,17149,203,48,-2586,-1862,25.1,1416.5
4856844019,0,10,0,1,5,6,4,0,0,0,0,15602,6.6,16868,199,48,-671,20,24.7,1560.2,11,0,0,6,5,6,0,0,0,0,16273,6.8,16848,196,50,671,-20,24.6,1627.3
4856803799,1,31,2,0,7,4,6,0,0,0,0,16485,7.0,18005,191,60,618,-367,25.1,1648.5,33,0,1,4,7,3,1,1,0,0,15867,7.0,18372,210,68,-618,367,27.8,1586.7
4856785172,1,12,0,0,1,4,1,0,0,0,0,15039,7.0,18428,222,64,-197,373,28.6,1503.9,14,0,1,4,1,2,1,1,0,0,15236,7.2,18055,203,52,197,-373,25.5,1523.6
4856767074,1,11,3,1,6,1,6,0,0,0,0,17446,7.2,19948,235,48,2414,2488,28.3,1744.6,81,0,0,1,6,1,0,0,0,0,15032,6.8,17460,220,56,-2414,-2488,27.6,1503.2
4856757220,1,65,2,0,8,3,8,1,1,0,0,18111,7.0,18896,229,44,2741,1588,27.3,1811.1,25,2,1,3,8,3,0,0,0,0,15370,6.6,17308,227,60,-2741,-1588,28.7,1537.0
4856131999,1,10,0,0,4,7,4,0,0,0,0,15611,6.8,16448,198,48,-1289,-570,24.6,1561.1,10,1,1,7,4,10,0,0,0,0,16900,6.8,17018,191,52,1289,570,24.3,1690.0
4856050363,0,82,1,0,1,6,1,1,1,0,0,14668,7.0,17812,199,56,-2850,-2321,25.5,1466.8,14,0,1,6,1,2,0,0,0,0,17518,7.4,20133,229,56,2850,2321,28.5,1751.8
4853535141,1,32,2,0,5,7,1,0,0,0,0,15591,7.0,17430,191,63,-1748,-133,25.4,1559.1,70,0,1,7,5,12,1,1,0,0,17339,7.0,17563,190,48,1748,133,23.8,1733.9
4853506115,0,11,0,1,11,9,13,0,0,0,0,19323,6.4,17014,182,36,1571,155,21.8,1932.3,13,0,0,8,10,7,0,0,0,0,17752,6.8,16859,188,48,-1571,-155,23.6,1775.2
4853423036,1,16,2,0,10,6,7,0,0,0,0,17551,6.8,17494,202,45,1772,1253,24.7,1755.1,12,1,1,6,10,9,1,1,0,0,15779,6.6,16241,189,53,-1772,-1253,24.2,1577.9
4853393276,0,33,3,0,0,3,0,0,0,0,0,13287,6.8,17214,196,56,-2712,-1332,25.2,1328.7,12,20,1,3,0,2,1,0,1,0,15999,7.0,18546,203,56,2712,1332,25.9,1599.9
4853370377,1,15,0,0,8,8,8,1,1,0,0,18682,7.2,18503,212,52,1614,1452,26.4,1868.2,16,1,1,8,8,8,0,0,0,0,17068,6.6,17051,183,58,-1614,-1452,24.1,1706.8
4852551176,0,18,1,0,2,3,2,1,1,0,0,16310,7.0,18807,253,64,661,1063,31.7,1631.0,14,1,1,3,2,2,0,0,0,0,15649,6.8,17744,221,52,-661,-1063,27.3,1564.9
4858093595,1,0,0,0,22,25,63,0,0,0,1,36043,11.0,37836,99,0,-4357,-5303,9.9,3604.3,342,0,1,25,22,74,0,0,0,0,40400,11.8,43139,108,0,4357,5303,10.8,4040.0
4858073935,0,0,0,1,22,23,53,0,0,0,0,36078,11.0,39418,106,0,-282,-1667,10.6,3607.8,0,0,0,23,22,45,0,0,0,0,36360,11.2,41085,108,0,282,1667,10.8,3636.0
4858055126,1,0,0,1,37,25,108,0,0,0,2,42107,12.2,47662,114,0,3715,5894,11.4,4210.7,0,0,0,24,36,69,0,0,0,0,38392,11.4,41768,117,0,-3715,-5894,11.7,3839.2
4858041009,1,0,0,1,23,21,51,0,0,0,1,39176,11.4,41826,112,0,3890,4263,11.2,3917.6,0,0,0,21,23,58,0,0,0,0,35286,10.8,37563,84,0,-3890,-4263,8.4,3528.6
4858018597,1,0,0,1,18,23,48,0,0,0,0,37700,10.6,38065,108,0,920,-3765,10.8,3770.0,0,0,0,23,18,78,0,0,0,0,36780,11.2,41830,104,0,-920,3765,10.4,3678.0
4857994957,1,14,2,0,5,6,6,1,1,0,0,17115,7.0,18499,222,64,369,-159,28.6,1711.5,12,0,1,6,5,6,0,0,0,0,16746,7.0,18658,222,67,-369,159,28.9,1674.6
4857961843,1,10,11,0,6,4,2,0,0,0,0,16158,7.2,18643,221,40,550,73,26.1,1615.8,37,2,1,4,6,4,0,0,0,0,15608,7.2,18570,216,76,-550,-73,29.2,1560.8
4857926051,0,13,3,1,5,5,4,0,0,0,0,15579,7.2,18003,211,27,-1232,-706,23.8,1557.9,12,1,0,5,5,3,0,0,0,0,16811,7.2,18709,225,64,1232,706,28.9,1681.1
4857318744,0,0,0,1,34,21,86,0,0,0,0,39780,11.8,44977,106,0,2728,3535,10.6,3978.0,2,0,0,21,34,44,0,0,0,0,37052,11.4,41442,102,0,-2728,-3535,10.2,3705.2
4857288371,0,0,0,1,19,28,36,0,0,0,1,36136,10.8,38273,110,0,-3485,-4500,11.0,3613.6,0,0,0,28,19,78,0,0,0,0,39621,11.4,42773,110,0,3485,4500,11.0,3962.1
4857249595,0,0,0,1,32,28,83,0,0,0,0,40271,11.6,44747,106,0,1432,1013,10.6,4027.1,0,0,0,28,32,76,0,0,0,0,38839,11.8,43734,106,0,-1432,-1013,10.6,3883.9
4857211150,1,15,3,0,5,3,4,0,0,0,0,16647,6.8,17829,250,51,1782,628,30.1,1664.7,15,2,1,3,5,3,2,1,1,0,14865,6.6,17201,200,57,-1782,-628,25.7,1486.5
4857166632,0,10,0,1,5,2,5,0,0,0,0,17167,7.2,18777,224,64,1885,479,28.8,1716.7,15,3,0,2,5,1,0,0,0,0,15282,7.0,18298,219,67,-1885,-479,28.6,1528.2
4853035090,0,0,0,0,19,24,60,0,0,0,0,36202,11.0,37744,124,0,-2645,-3805,12.4,3620.2,0,0,1,24,19,71,0,0,0,0,38847,11.2,41549,103,0,2645,3805,10.3,3884.7
4852998619,0,0,0,0,12,19,29,0,0,0,1,33473,10.4,36141,106,0,-3634,-982,10.6,3347.3,0,0,1,19,12,49,0,0,0,0,37107,10.6,37123,129,0,3634,982,12.9,3710.7
4852973289,0,0,0,1,26,15,86,0,0,0,1,36406,11.0,39855,110,0,2298,3108,11.0,3640.6,6,0,0,15,26,38,0,0,0,0,34108,10.6,36747,74,0,-2298,-3108,7.4,3410.8
4852938685,0,13,0,0,19,20,28,0,0,0,0,34730,10.8,38134,112,0,-2202,-2311,11.2,3473.0,0,6,1,20,19,52,0,0,0,0,36932,10.8,40445,134,0,2202,2311,13.4,3693.2
4852910692,1,34,0,0,28,26,59,0,0,0,1,38892,11.6,43545,114,0,1069,2574,11.4,3889.2,34,0,1,26,28,73,0,0,0,0,37823,11.2,40971,93,0,-1069,-2574,9.3,3782.3
4852883693,1,0,0,1,30,28,69,0,0,0,0,39658,12.0,45784,100,0,366,2330,10.0,3965.8,12,0,0,28,30,56,0,0,0,0,39292,11.6,43454,106,0,-366,-2330,10.6,3929.2
4852846093,1,0,0,1,32,34,78,0,0,0,1,40991,12.0,47282,106,0,2127,2127,10.6,4099.1,0,0,0,34,32,90,0,0,0,0,38864,11.8,45155,90,0,-2127,-2127,9.0,3886.4
4858488153,1,202,1,1,22,13,17,0,0,0,0,63982,12.4,57000,7,0,26359,24000,0.7,6398.2,192,1,0,8,17,7,0,0,0,0,37623,7.2,33000,0,0,-26359,-24000,0.0,3762.3
4858464726,1,26,2,1,18,18,20,0,0,0,0,63191,12.8,59000,3,0,26221,26000,0.3,6319.1,0,0,0,10,10,7,0,0,0,0,36970,7.2,33000,3,0,-26221,-26000,0.3,3697.0
4858447952,1,5,0,0,14,17,11,0,0,0,0,44550,10.0,47500,0,0,16700,19000,0.0,4455.0,0,0,1,9,6,9,0,0,0,0,27850,6.0,28500,0,0,-16700,-19000,0.0,2785.0
4858339738,1,0,0,1,12,23,8,0,0,0,0,45950,10.0,47500,0,0,16000,19000,0.0,4595.0,0,0,0,14,3,15,0,0,0,0,29950,6.0,28500,0,0,-16000,-19000,0.0,2995.0
4858318241,1,0,0,0,19,23,18,0,0,0,0,62417,12.0,55000,0,0,23817,22000,0.0,6241.7,0,0,1,13,9,14,0,0,0,0,38600,7.2,33000,0,0,-23817,-22000,0.0,3860.0
4858270375,1,237,0,0,16,18,18,0,0,0,0,47045,10.4,49000,1,0,18819,20500,0.1,4704.5,0,0,1,10,8,10,0,0,0,0,28226,6.0,28500,0,0,-18819,-20500,0.0,2822.6
4858126359,1,0,0,1,19,11,23,0,0,0,0,48050,10.0,47500,0,0,21600,19000,0.0,4805.0,0,0,0,7,15,1,0,0,0,0,26450,6.0,28500,0,0,-21600,-19000,0.0,2645.0
4858109754,1,0,0,0,14,16,24,0,0,0,0,61069,12.0,55000,1,0,23169,22000,0.1,6106.9,0,0,1,15,13,5,0,0,0,0,37900,7.2,33000,0,0,-23169,-22000,0.0,3790.0
4857954284,1,0,0,0,20,15,19,0,0,0,0,47957,10.0,47500,0,0,20747,19000,0.0,4795.7,0,0,1,8,13,9,0,0,0,0,27210,6.0,28500,0,0,-20747,-19000,0.0,2721.0
4856894568,1,8,0,1,17,23,23,0,0,0,0,62350,13.2,63500,0,0,22700,26000,0.0,6235.0,0,0,0,16,10,14,0,0,0,0,39650,7.8,37500,0,0,-22700,-26000,0.0,3965.0
4856884939,1,1,0,1,20,16,22,0,0,0,0,46651,10.0,47500,0,0,18801,19000,0.0,4665.1,6,0,0,9,13,6,0,0,0,0,27850,6.0,28500,0,0,-18801,-19000,0.0,2785.0
4856570022,1,0,0,1,18,20,18,0,0,0,0,55500,12.0,55000,4,0,21850,22000,0.4,5550.0,15,0,0,10,8,13,0,0,0,0,33650,7.2,33000,1,0,-21850,-22000,0.1,3365.0
4856558290,1,8,0,0,26,18,21,0,0,0,0,65150,12.0,55000,0,0,28300,22000,0.0,6515.0,0,0,1,8,16,11,0,0,0,0,36850,7.2,33000,0,0,-28300,-22000,0.0,3685.0
4856544302,1,15,0,1,16,12,22,0,0,0,0,62000,12.0,55000,0,0,26200,22000,0.0,6200.0,0,0,0,8,12,6,0,0,0,0,35800,7.2,33000,0,0,-26200,-22000,0.0,3580.0
4856531314,1,0,6,1,20,16,21,0,0,0,0,62760,12.0,55000,6,0,26260,22000,0.6,6276.0,41,0,0,7,11,6,0,0,0,0,36500,7.2,33000,0,0,-26260,-22000,0.0,3650.0
4856521793,1,8,0,1,11,21,23,0,0,0,0,61650,13.0,62500,8,0,22700,25000,0.8,6165.0,0,0,0,22,12,10,0,0,0,0,38950,7.8,37500,1,0,-22700,-25000,0.1,3895.0
4856504068,1,180,0,0,16,22,14,0,0,0,0,47043,10.0,47500,0,0,17421,19000,0.0,4704.3,81,0,1,14,8,15,0,0,0,0,29622,6.0,28500,0,0,-17421,-19000,0.0,2962.2
4856480686,1,0,0,1,23,20,20,0,0,0,0,63550,12.0,55000,3,0,24950,22000,0.3,6355.0,0,0,0,11,14,13,0,0,0,0,38600,7.2,33000,0,0,-24950,-22000,0.0,3860.0
4856460047,1,1,0,1,16,21,13,0,0,0,0,60950,13.0,62500,0,0,22000,25000,0.0,6095.0,46,0,0,13,8,13,0,0,0,0,38950,7.8,37500,0,0,-22000,-25000,0.0,3895.0
4856349356,1,16,2,0,6,9,6,1,0,1,0,16454,6.8,17920,214,51,-2276,-1063,26.5,1645.4,22,3,1,9,6,12,1,1,0,0,18730,7.4,18983,218,80,2276,1063,29.8,1873.0
4858362602,0,8,14,0,5,4,7,0,0,0,0,17174,7.0,18520,213,63,74,-626,27.6,1717.4,48,2,1,4,5,4,1,1,0,0,17100,7.0,19146,215,68,-74,626,28.3,1710.0
4857559651,0,14,2,0,4,12,5,0,0,0,0,15370,6.8,17614,199,48,-4582,-1297,24.7,1537.0,16,3,1,12,4,15,1,1,0,0,19952,7.0,18911,211,64,4582,1297,27.5,1995.2
4857517510,1,14,1,0,4,3,4,0,0,0,0,16018,7.0,18410,210,64,-86,358,27.4,1601.8,19,1,1,3,4,3,1,1,0,0,16104,7.0,18052,227,52,86,-358,27.9,1610.4
4857483238,0,14,1,1,5,2,9,0,0,0,0,16731,6.8,17755,203,52,2862,996,25.5,1673.1,11,2,0,2,5,2,0,0,0,0,13869,6.8,16759,189,56,-2862,-996,24.5,1386.9
4857433718,0,14,2,0,4,7,2,0,0,0,0,16776,6.8,18001,216,50,-1224,1079,26.6,1677.6,12,1,1,7,4,8,0,0,0,0,18000,6.8,16922,183,48,1224,-1079,23.1,1800.0
4857139030,1,11,13,1,5,0,3,1,1,0,0,16208,7.2,18463,224,52,2432,1129,27.6,1620.8,29,1,0,0,5,0,0,0,0,0,13776,6.8,17334,203,60,-2432,-1129,26.3,1377.6
4856864997,1,9,0,1,28,20,48,0,0,0,1,38359,11.8,43562,111,0,2455,2531,11.1,3835.9,5,0,0,20,28,24,0,0,0,0,35904,11.2,41031,101,0,-2455,-2531,10.1,3590.4
4856845724,1,15,0,1,31,34,65,0,0,0,1,42049,12.2,47448,92,0,2736,3983,9.2,4204.9,15,2,0,34,31,96,0,0,0,0,39313,11.6,43465,82,0,-2736,-3983,8.2,3931.3
4856833257,0,0,0,1,26,29,74,0,0,0,2,40204,11.6,43317,121,0,676,1922,12.1,4020.4,13,0,0,29,26,73,0,0,0,0,39528,11.0,41395,95,0,-676,-1922,9.5,3952.8
4855832172,0,36,1,0,5,7,10,0,0,0,0,15459,6.4,16409,179,56,-3110,-1685,23.5,1545.9,120,12,1,7,5,11,2,1,1,0,18569,7.2,18094,226,56,3110,1685,28.2,1856.9
4855815815,1,33,1,1,8,4,9,1,1,0,0,18195,7.2,19032,216,60,3189,1218,27.6,1819.5,11,6,0,4,8,2,0,0,0,0,15006,7.0,17814,203,51,-3189,-1218,25.4,1500.6
4855779789,1,12,1,0,2,1,2,1,1,0,0,14349,6.6,17484,211,62,53,-185,27.3,1434.9,12,0,1,1,2,1,0,0,0,0,14296,6.8,17669,221,58,-53,185,27.9,1429.6
4855484892,0,2,0,1,36,36,72,0,0,0,1,41789,12.2,46712,87,0,818,240,8.7,4178.9,2,0,0,36,36,90,0,0,0,0,40971,12.0,46472,90,0,-818,-240,9.0,4097.1
4855473069,1,0,0,1,27,19,67,0,0,0,0,36857,11.2,41451,95,0,35,697,9.5,3685.7,3,0,0,19,27,38,0,0,0,0,36822,11.2,40754,109,0,-35,-697,10.9,3682.2
4855440229,1,11,0,0,4,10,4,0,0,0,0,16718,6.6,17716,206,52,-1491,118,25.8,1671.8,12,3,1,10,4,11,0,0,0,0,18209,7.0,17598,203,56,1491,-118,25.9,1820.9
4855397607,0,9,0,1,3,3,0,0,0,0,0,15560,7.0,19197,216,60,-78,-156,27.6,1556.0,10,1,0,3,3,3,0,0,0,0,15638,7.2,19353,221,72,78,156,29.3,1563.8
4854910035,1,0,0,0,21,23,49,0,0,0,1,37370,11.0,41782,91,0,1738,3626,9.1,3737.0,0,0,1,23,21,67,0,0,0,0,35632,10.8,38156,104,0,-1738,-3626,10.4,3563.2
4854879273,0,11,0,1,24,23,47,0,0,0,0,38006,11.2,40601,103,0,1055,16,10.3,3800.6,0,0,0,23,24,66,0,0,0,0,36951,11.0,40585,89,0,-1055,-16,8.9,3695.1
4854796243,0,22,3,1,10,7,5,0,0,0,0,17518,7.0,18585,218,68,1334,1512,28.6,1751.8,11,5,0,7,10,4,0,0,0,0,16184,6.8,17073,187,60,-1334,-1512,24.7,1618.4
4818923292,0,8,5,1,3,6,1,0,0,0,0,15476,7.4,19367,227,60,-417,1373,28.7,1547.6,10,1,0,6,3,4,1,1,0,0,15893,7.0,17994,208,56,417,-1373,26.4,1589.3
4818892477,0,8,1,0,1,7,1,0,0,0,0,13888,6.4,16834,171,51,-4863,-1976,22.2,1388.8,75,0,1,7,1,10,1,1,0,0,18751,7.0,18810,222,48,4863,1976,27.0,1875.1
4818806572,0,13,0,0,10,8,11,0,0,0,0,17639,6.8,18012,203,50,-258,262,25.3,1763.9,11,2,1,8,10,7,0,0,0,0,17897,6.8,17750,196,66,258,-262,26.2,1789.7
4816774253,0,13,1,1,7,4,6,0,0,0,0,18332,7.2,18881,200,59,2365,1281,25.9,1833.2,9,0,0,4,7,4,1,1,0,0,15967,6.6,17600,210,56,-2365,-1281,26.6,1596.7
4816759735,1,11,0,0,2,6,4,0,0,0,0,15074,6.8,16736,219,52,-884,-1285,27.1,1507.4,13,1,1,6,2,2,1,1,0,0,15958,6.8,18021,214,48,884,1285,26.2,1595.8
4816725665,1,14,0,1,3,3,2,1,1,0,0,16044,7.0,18572,244,67,567,666,31.1,1604.4,13,4,0,3,3,3,0,0,0,0,15477,6.8,17906,193,56,-567,-666,24.9,1547.7
4816276183,1,15,2,1,4,3,2,0,0,0,0,17568,7.4,20130,234,74,2006,2804,30.8,1756.8,9,0,0,3,4,3,0,0,0,0,15562,6.6,17326,200,44,-2006,-2804,24.4,1556.2
4816224398,1,64,0,1,6,7,5,1,0,1,0,16747,7.0,18547,210,52,-1025,82,26.2,1674.7,10,1,0,7,6,4,1,1,0,0,17772,7.0,18465,201,56,1025,-82,25.7,1777.2
4816001128,0,153,0,0,3,5,2,0,0,0,0,15121,6.8,17705,218,48,-549,-461,26.6,1512.1,11,0,1,5,3,5,2,1,1,0,15670,6.8,18166,219,60,549,461,27.9,1567.0
4815860683,0,14,2,0,2,9,2,0,0,0,0,14583,6.8,17120,178,67,-3431,-980,24.5,1458.3,13,1,1,9,2,8,1,1,0,0,18014,7.0,18100,214,60,3431,980,27.4,1801.4
4815841718,1,13,1,1,3,0,2,0,0,0,0,16807,7.2,19242,229,62,3713,1751,29.1,1680.7,14,0,0,0,3,0,0,0,0,0,13094,7.0,17491,198,44,-3713,-1751,24.2,1309.4
4815444961,0,15,2,1,3,7,2,0,0,0,0,14834,6.6,17062,217,48,-2931,-2070,26.5,1483.4,18,3,0,7,3,11,1,1,0,0,17765,7.2,19132,235,76,2931,2070,31.1,1776.5
4814194044,1,12,0,0,6,3,5,1,1,0,0,16406,6.8,17002,183,56,1628,1002,23.9,1640.6,10,1,1,3,6,3,0,0,0,0,14778,6.4,16000,181,51,-1628,-1002,23.2,1477.8
4814157148,1,14,1,0,5,1,4,0,0,0,0,16617,7.0,18651,217,55,1870,227,27.2,1661.7,14,1,1,1,5,0,0,0,0,0,14747,7.0,18424,205,72,-1870,-227,27.7,1474.7
4814027000,1,11,0,0,7,6,4,0,0,0,0,17377,6.8,17881,188,57,1043,1625,24.5,1737.7,10,0,1,6,7,10,0,0,0,0,16334,6.4,16256,184,40,-1043,-1625,22.4,1633.4
4812951375,1,13,0,0,14,10,25,0,0,0,0,30689,10.6,37077,93,51,2721,2893,14.4,3068.9,24,0,1,10,14,18,0,0,0,0,27968,10.4,34184,77,47,-2721,-2893,12.4,2796.8
4812918709,1,13,2,0,6,4,7,0,0,0,0,16942,7.0,18495,227,56,1464,992,28.3,1694.2,15,1,1,4,6,4,0,0,0,0,15478,6.6,17503,206,56,-1464,-992,26.2,1547.8
4812826240,0,15,2,0,3,5,5,0,0,0,0,15415,6.6,17557,207,56,-1011,-1137,26.3,1541.5,10,3,1,5,3,5,0,0,0,0,16426,7.2,18694,215,48,1011,1137,26.3,1642.6
4812801382,0,14,2,0,5,5,4,1,1,0,0,16064,7.2,18161,208,52,-1741,-679,26.0,1606.4,12,2,1,5,5,6,0,0,0,0,17805,7.0,18840,241,52,1741,679,29.3,1780.5
4852934969,0,10,0,0,3,1,2,0,0,0,0,15214,6.8,18052,236,47,72,848,28.3,1521.4,12,0,1,1,3,0,1,1,0,0,15142,6.6,17204,233,58,-72,-848,29.1,1514.2
4852867986,1,10,1,1,6,4,6,1,1,0,0,17148,6.6,17370,202,60,1537,-1065,26.2,1714.8,15,0,0,4,6,2,0,0,0,0,15611,7.0,18435,191,68,-1537,1065,25.9,1561.1
4852815471,1,12,1,1,4,2,2,0,0,0,0,15976,6.6,17277,208,56,1328,-577,26.4,1597.6,13,2,0,2,4,2,1,1,0,0,14648,6.8,17854,204,68,-1328,577,27.2,1464.8
4852746606,1,252,0,1,18,19,61,0,0,0,0,35907,10.8,38216,116,0,-1147,-1623,11.6,3590.7,0,0,0,19,18,58,0,0,0,0,37054,10.8,39839,108,0,1147,1623,10.8,3705.4
4851772854,1,177,0,0,24,26,51,0,0,0,1,38960,11.4,41921,114,0,2017,799,11.4,3896.0,0,0,1,26,24,72,0,0,0,0,36943,11.0,41122,81,0,-2017,-799,8.1,3694.3
4847949242,1,12,1,0,7,7,5,0,0,0,0,18365,6.8,17807,197,44,1448,84,24.1,1836.5,8,2,1,7,7,6,0,0,0,0,16917,7.0,17723,204,64,-1448,-84,26.8,1691.7
4845284877,1,8,1,0,2,7,1,0,0,0,0,14613,7.0,17815,194,68,-3460,-1881,26.2,1461.3,9,1,1,7,2,4,0,0,0,0,18073,7.2,19696,224,66,3460,1881,29.0,1807.3
4845268838,0,0,0,1,31,25,82,0,0,0,2,39039,11.2,41321,85,0,-3488,-3560,8.5,3903.9,10,0,0,25,31,73,0,0,0,0,42527,12.0,44881,110,0,3488,3560,11.0,4252.7
4843513817,0,0,0,1,26,24,59,0,0,0,1,38027,11.2,41769,108,0,675,2790,10.8,3802.7,0,0,0,24,26,60,0,0,0,0,37352,10.8,38979,109,0,-675,-2790,10.9,3735.2
4841356255,0,15,0,0,5,5,4,0,0,0,0,16192,7.2,18308,213,64,-58,820,27.7,1619.2,11,1,1,5,5,7,1,1,0,0,16250,7.0,17488,175,59,58,-820,23.4,1625.0
4841236128,0,15,0,0,20,28,51,0,0,0,1,37652,11.2,40449,92,0,-186,-779,9.2,3765.2,0,3,1,28,20,72,0,0,0,0,37838,11.4,41228,114,0,186,779,11.4,3783.8
4840454026,0,16,1,1,5,4,4,0,0,0,0,15815,7.2,17779,185,56,31,8,24.1,1581.5,12,2,0,4,5,3,1,1,0,0,15784,7.0,17771,199,51,-31,-8,25.0,1578.4
4840417362,0,10,2,1,4,10,3,1,0,1,0,14765,6.8,16802,173,54,-3284,-2603,22.7,1476.5,91,0,0,10,4,9,0,0,0,0,18049,7.2,19405,210,44,3284,2603,25.4,1804.9
4840390144,0,0,0,1,36,22,93,0,0,0,1,40224,11.8,44820,108,0,4115,3072,10.8,4022.4,0,0,0,21,35,55,0,0,0,0,36109,11.4,41748,78,0,-4115,-3072,7.8,3610.9
4831251830,0,68,0,0,21,29,58,0,0,0,1,37149,11.4,42829,82,0,-3018,-1851,8.2,3714.9,179,0,1,29,21,76,0,0,0,0,40167,12.0,44680,113,0,3018,1851,11.3,4016.7
4831226922,0,23,0,1,24,22,70,0,0,0,0,36890,11.2,40723,120,0,-715,1665,12.0,3689.0,0,24,0,22,24,62,0,0,0,0,37605,10.8,39058,112,0,715,-1665,11.2,3760.5
4831205811,1,0,0,1,25,21,66,0,0,0,1,37846,11.0,41503,113,0,1438,1497,11.3,3784.6,0,0,0,21,25,54,0,0,0,0,36408,11.0,40006,96,0,-1438,-1497,9.6,3640.8
4829393553,1,9,1,1,8,2,6,0,0,0,0,17227,7.2,18656,214,52,3156,779,26.6,1722.7,8,0,0,2,8,1,0,0,0,0,14071,6.8,17877,200,56,-3156,-779,25.6,1407.1
4829233176,0,27,1,1,3,5,3,0,0,0,0,15444,6.8,17803,207,44,-836,2,25.1,1544.4,12,0,0,5,3,6,0,0,0,0,16280,6.8,17801,209,56,836,-2,26.5,1628.0
4858011187,1,14,2,0,7,10,3,0,0,0,0,16483,6.6,16831,179,48,-2116,157,22.7,1648.3,14,4,1,10,7,11,1,1,0,0,18599,6.6,16674,197,56,2116,-157,25.3,1859.9
4857975705,0,27,1,0,9,3,9,1,0,1,0,19231,7.6,20609,229,68,3928,3606,29.7,1923.1,13,2,1,3,9,2,1,1,0,0,15303,6.6,17003,186,56,-3928,-3606,24.2,1530.3
4856427683,1,0,0,0,21,15,19,0,0,0,0,63056,12.8,60500,0,0,26203,23000,0.0,6305.6,0,0,1,7,13,11,0,0,0,0,36853,7.8,37500,0,0,-26203,-23000,0.0,3685.3
4856413873,1,30,1,1,18,17,20,0,0,0,0,48110,10.0,47500,2,0,19515,19000,0.2,4811.0,0,4,0,13,14,8,0,0,0,0,28595,6.0,28500,1,0,-19515,-19000,0.1,2859.5
4856380725,1,234,1,1,19,17,17,0,0,0,0,47067,10.0,47500,1,0,18691,19000,0.1,4706.7,28,0,0,8,10,13,0,0,0,0,28376,6.0,28500,6,0,-18691,-19000,0.6,2837.6
4856361236,1,176,0,1,17,12,11,0,0,0,0,46130,10.2,48680,3,0,19635,20055,0.3,4613.0,176,0,0,5,10,10,0,0,0,0,26495,6.0,28625,1,0,-19635,-20055,0.1,2649.5
4856325948,1,0,0,1,15,11,45,0,0,0,1,35407,10.6,36385,111,0,2851,1823,11.1,3540.7,0,0,0,11,15,23,0,0,0,0,32556,10.4,34562,87,0,-2851,-1823,8.7,3255.6
4856292862,1,0,5,1,16,12,35,0,0,0,1,34348,10.2,35882,115,0,1292,2007,11.5,3434.8,23,0,0,12,16,25,0,0,0,0,33056,10.0,33875,94,0,-1292,-2007,9.4,3305.6
4856254149,0,0,0,1,23,21,51,0,0,0,0,37918,11.4,40841,118,0,81,-624,11.8,3791.8,3,0,0,21,23,54,0,0,0,0,37837,11.2,41465,93,0,-81,624,9.3,3783.7
4855927780,1,0,0,0,20,17,22,0,0,0,0,49854,10.2,48680,0,0,18809,20180,0.0,4985.4,13,0,1,11,14,13,0,0,0,0,31045,6.0,28500,0,0,-18809,-20180,0.0,3104.5
4855903693,1,8,0,0,10,21,18,0,0,0,0,46400,10.0,47500,2,0,18200,19000,0.2,4640.0,0,0,1,16,5,9,0,0,0,0,28200,6.0,28500,0,0,-18200,-19000,0.0,2820.0
4855896062,1,5,1,1,23,15,24,0,0,0,0,66360,12.0,55000,1,0,29510,22000,0.1,6636.0,17,0,0,8,16,9,0,0,0,0,36850,7.2,33000,0,0,-29510,-22000,0.0,3685.0
4855878614,1,9,4,0,16,23,22,0,0,0,0,63795,12.0,55000,1,0,25415,22000,0.1,6379.5,27,1,1,16,9,8,0,0,0,0,38380,7.2,33000,5,0,-25415,-22000,0.5,3838.0
4855269491,1,0,0,1,13,15,12,0,0,0,0,45400,10.0,47500,1,0,16718,19000,0.1,4540.0,6,0,0,10,8,10,0,0,0,0,28682,6.0,28500,2,0,-16718,-19000,0.2,2868.2
4855252271,1,0,0,1,26,15,26,0,0,0,0,63800,12.2,56000,1,0,26928,22962,0.1,6380.0,87,0,0,7,18,10,0,0,0,0,36872,7.2,33038,2,1,-26928,-22962,0.3,3687.2
4855223599,1,326,0,0,20,19,21,0,0,0,0,52034,12.8,59000,0,0,13962,25000,0.0,5203.4,0,0,1,11,12,13,0,0,0,0,38072,7.4,34000,3,0,-13962,-25000,0.3,3807.2
4855201286,1,0,0,0,13,20,13,0,0,0,0,61820,12.0,55000,2,0,22795,22000,0.2,6182.0,0,0,1,14,7,13,0,0,0,0,39025,7.2,33000,1,0,-22795,-22000,0.1,3902.5
4855184856,1,0,0,1,21,11,17,0,0,0,0,62700,12.0,55000,2,0,26900,22000,0.2,6270.0,4,0,0,3,13,7,0,0,0,0,35800,7.2,33000,0,0,-26900,-22000,0.0,3580.0
4854960468,1,43,0,0,11,18,8,0,0,0,0,44900,10.0,47500,0,0,16700,19000,0.0,4490.0,5,0,1,11,4,13,0,0,0,0,28200,6.0,28500,0,0,-16700,-19000,0.0,2820.0
4854936682,1,56,3,0,21,18,21,0,0,0,0,64140,12.0,55000,1,0,26240,22000,0.1,6414.0,0,0,1,12,15,11,0,0,0,0,37900,7.2,33000,0,0,-26240,-22000,0.0,3790.0
