gameId,blueWins,blueWardsPlaced,blueWardsDestroyed,blueFirstBlood,blueKills,blueDeaths,blueAssists,blueEliteMonsters,blueDragons,blueHeralds,blueTowersDestroyed,blueTotalGold,blueAvgLevel,blueTotalExperience,blueTotalMinionsKilled,blueTotalJungleMinionsKilled,blueGoldDiff,blueExperienceDiff,blueCSPerMin,blueGoldPerMin,redWardsPlaced,redWardsDestroyed,redFirstBlood,redKills,redDeaths,redAssists,redEliteMonsters,redDragons,redHeralds,redTowersDestroyed,redTotalGold,redAvgLevel,redTotalExperience,redTotalMinionsKilled,redTotalJungleMinionsKilled,redGoldDiff,redExperienceDiff,redCSPerMin,redGoldPerMin
4763481377,0,18,1,0,5,4,4,0,0,0,0,16058,7.2,18042,229,48,681,412,27.7,1605.8,13,4,1,4,5,2,1,1,0,0,15377,6.8,17630,215,59,-681,-412,27.4,1537.7
4763458058,1,23,2,1,12,3,12,1,1,0,0,20112,6.8,18245,220,36,4704,2740,25.6,2011.2,10,0,0,3,12,2,1,0,1,0,15408,6.2,15505,167,58,-4704,-2740,22.5,1540.8
4760478999,0,12,1,1,2,3,0,0,0,0,0,15152,6.8,17154,247,56,-1886,-604,30.3,1515.2,14,2,0,3,2,6,0,0,0,0,17038,6.8,17758,204,61,1886,604,26.5,1703.8
4759685038,0,10,2,0,4,5,4,0,0,0,0,17484,7.0,18880,240,73,1907,986,31.3,1748.4,14,2,1,5,4,9,0,0,0,0,15577,6.6,17894,213,54,-1907,-986,26.7,1557.7
4759645009,0,15,0,1,9,3,10,0,0,0,0,18581,7.0,18274,239,40,3942,1814,27.9,1858.1,11,3,0,3,9,3,1,1,0,0,14639,6.6,16460,208,62,-3942,-1814,27.0,1463.9
4759014068,1,11,0,0,6,5,6,1,1,0,0,16994,6.8,18359,225,60,-7,857,28.5,1699.4,10,0,1,5,6,7,0,0,0,0,17001,7.0,17502,232,52,7,-857,28.4,1700.1
4750082621,1,9,1,0,7,5,4,1,1,0,0,17226,7.2,18830,226,68,56,-374,29.4,1722.6,11,0,1,5,7,4,0,0,0,0,17170,7.0,19204,245,60,-56,374,30.5,1717.0
4750046042,1,10,2,1,7,3,12,1,1,0,0,17516,7.0,18274,218,59,2796,124,27.7,1751.6,225,1,0,3,7,0,1,0,1,0,14720,7.0,18150,216,60,-2796,-124,27.6,1472.0
4750004644,0,15,0,1,7,4,7,0,0,0,0,16747,6.8,17322,202,57,894,-752,25.9,1674.7,12,3,0,4,7,5,1,1,0,0,15853,7.0,18074,226,64,-894,752,29.0,1585.3
4749984799,0,16,2,0,2,8,2,0,0,0,0,15146,6.6,17702,227,52,-2613,-928,27.9,1514.6,12,5,1,8,2,11,1,1,0,0,17759,7.0,18630,218,52,2613,928,27.0,1775.9
4748305445,0,13,2,1,3,6,3,0,0,0,0,15359,6.8,17085,239,52,-2247,-1374,29.1,1535.9,15,4,0,6,3,8,1,1,0,0,17606,7.2,18459,212,71,2247,1374,28.3,1760.6
4748262730,0,34,3,1,5,7,6,0,0,0,0,15213,6.6,16601,202,55,-1975,-1897,25.7,1521.3,12,3,0,7,5,3,0,0,0,0,17188,7.2,18498,224,58,1975,1897,28.2,1718.8
4747406887,0,48,1,0,4,4,3,0,0,0,0,15217,7.2,18701,224,48,-1836,325,27.2,1521.7,9,1,1,4,4,4,1,0,1,0,17053,7.0,18376,229,60,1836,-325,28.9,1705.3
4747358079,1,21,1,1,11,5,14,2,1,1,0,19815,6.8,18674,243,56,2784,3135,29.9,1981.5,31,0,0,5,11,10,0,0,0,0,17031,6.6,15539,174,52,-2784,-3135,22.6,1703.1
4745838506,0,10,1,0,3,7,2,0,0,0,0,16138,7.0,17763,211,40,-1767,-2249,25.1,1613.8,8,2,1,7,3,4,1,1,0,0,17905,7.4,20012,236,74,1767,2249,31.0,1790.5
4745832790,0,48,0,0,6,13,6,0,0,0,0,16358,6.6,16323,189,47,-3756,-2584,23.6,1635.8,11,2,1,13,6,13,1,1,0,0,20114,7.2,18907,228,56,3756,2584,28.4,2011.4
4745795599,1,95,2,1,7,6,9,0,0,0,0,17542,6.6,16772,187,60,1310,-353,24.7,1754.2,16,1,0,6,7,2,0,0,0,0,16232,6.8,17125,221,52,-1310,353,27.3,1623.2
4745771680,1,10,1,0,2,1,1,1,1,0,0,15731,7.2,19387,253,68,2266,2517,32.1,1573.1,12,1,1,1,2,1,0,0,0,0,13465,6.6,16870,201,52,-2266,-2517,25.3,1346.5
4745752339,1,16,0,1,9,2,8,1,1,0,0,17293,7.0,18231,201,60,2534,1388,26.1,1729.3,12,0,0,2,9,1,0,0,0,0,14759,6.8,16843,212,60,-2534,-1388,27.2,1475.9
4858106455,1,0,0,0,24,23,56,0,0,0,0,35825,11.0,40230,95,0,-1067,609,9.5,3582.5,0,0,1,23,24,54,0,0,0,0,36892,11.0,39621,117,0,1067,-609,11.7,3689.2
4858095999,1,0,0,0,21,25,46,0,0,0,0,38977,11.6,43806,97,0,1626,1393,9.7,3897.7,0,0,1,25,21,67,0,0,0,0,37351,11.4,42413,109,0,-1626,-1393,10.9,3735.1
4858071499,1,21,0,1,33,19,91,0,0,0,0,40098,11.8,43923,112,0,2889,1482,11.2,4009.8,0,2,0,19,33,32,0,0,0,0,37209,11.4,42441,112,0,-2889,-1482,11.2,3720.9
4858052477,0,0,0,0,25,29,58,0,0,0,1,39865,11.6,43143,117,0,-286,715,11.7,3986.5,20,0,1,29,25,91,0,0,0,0,40151,11.4,42428,124,0,286,-715,12.4,4015.1
4858034292,1,0,0,1,34,17,83,0,0,0,0,41139,11.8,44601,118,0,4207,2529,11.8,4113.9,2,0,0,17,34,37,0,0,0,0,36932,11.4,42072,110,0,-4207,-2529,11.0,3693.2
4858002619,1,0,0,1,26,16,59,0,0,0,1,38468,11.0,39535,116,0,4016,3286,11.6,3846.8,0,0,0,16,26,33,0,0,0,0,34452,10.4,36249,98,0,-4016,-3286,9.8,3445.2
4857981248,0,0,0,0,22,34,69,0,0,0,1,37052,11.0,38422,103,0,-4328,-7572,10.3,3705.2,0,0,1,34,22,100,0,0,0,0,41380,12.0,45994,116,0,4328,7572,11.6,4138.0
4857302186,1,0,0,1,32,27,96,0,0,0,1,40335,11.6,44014,111,0,591,1082,11.1,4033.5,2,0,0,27,32,64,0,0,0,0,39744,11.6,42932,99,0,-591,-1082,9.9,3974.4
4857279817,1,21,0,0,33,24,76,0,0,0,1,40724,11.8,45578,110,0,3041,3978,11.0,4072.4,0,5,1,24,33,59,0,0,0,0,37683,11.2,41600,120,0,-3041,-3978,12.0,3768.3
4857244496,1,6,0,1,37,20,104,0,0,0,1,42066,11.8,44940,109,0,3220,2187,10.9,4206.6,2,0,0,20,37,54,0,0,0,0,38846,11.6,42753,94,0,-3220,-2187,9.4,3884.6
4857216526,0,0,0,0,24,33,60,0,0,0,1,36240,11.0,40415,88,0,-5690,-6743,8.8,3624.0,2,0,1,33,24,81,0,0,0,0,41930,12.2,47158,118,0,5690,6743,11.8,4193.0
4857195167,0,0,0,0,15,21,33,0,0,0,1,34317,10.4,36036,106,0,-2204,-2110,10.6,3431.7,0,0,1,21,15,46,0,0,0,0,36521,10.8,38146,116,0,2204,2110,11.6,3652.1
4857168449,1,0,0,0,21,35,40,0,0,0,0,37907,11.2,41969,98,0,-1414,-3993,9.8,3790.7,82,0,1,35,21,99,0,0,0,0,39321,11.8,45962,111,0,1414,3993,11.1,3932.1
4856500059,1,0,0,1,29,24,68,0,0,0,2,39387,11.2,41762,109,0,3347,-341,10.9,3938.7,11,0,0,24,29,56,0,0,0,0,36040,11.2,42103,80,0,-3347,341,8.0,3604.0
4856476859,0,0,0,0,23,30,53,0,0,0,0,37055,11.2,40204,107,0,-2239,-3247,10.7,3705.5,0,0,1,30,23,81,0,0,0,0,39294,11.6,43451,118,0,2239,3247,11.8,3929.4
4856449889,1,33,2,0,14,22,19,0,0,0,0,60785,12.0,55000,7,0,22875,22000,0.7,6078.5,26,2,1,17,9,11,0,0,0,0,37910,7.2,33000,0,0,-22875,-22000,0.0,3791.0
4856432105,1,0,0,1,20,16,14,0,0,0,0,50500,10.0,47500,0,0,22300,19000,0.0,5050.0,1,0,0,9,13,8,0,0,0,0,28200,6.0,28500,0,0,-22300,-19000,0.0,2820.0
4856416998,1,20,0,1,21,12,19,0,0,0,0,47724,10.0,47500,0,0,21624,19000,0.0,4772.4,0,0,0,6,15,4,0,0,0,0,26100,6.0,28500,0,0,-21624,-19000,0.0,2610.0
4856388351,1,0,0,1,18,21,17,0,0,0,0,48400,10.0,47500,0,0,18800,19000,0.0,4840.0,0,0,0,12,9,13,0,0,0,0,29600,6.0,28500,0,0,-18800,-19000,0.0,2960.0
4856362263,1,22,0,1,17,19,20,0,0,0,0,48400,10.0,47500,0,0,20200,19000,0.0,4840.0,0,0,0,11,9,9,0,0,0,0,28200,6.0,28500,0,0,-20200,-19000,0.0,2820.0
4763481377,0,18,1,0,5,4,4,0,0,0,0,16058,7.2,18042,229,48,681,412,27.7,1605.8,13,4,1,4,5,2,1,1,0,0,15377,6.8,17630,215,59,-681,-412,27.4,1537.7
4763458058,1,23,2,1,12,3,12,1,1,0,0,20112,6.8,18245,220,36,4704,2740,25.6,2011.2,10,0,0,3,12,2,1,0,1,0,15408,6.2,15505,167,58,-4704,-2740,22.5,1540.8
4760478999,0,12,1,1,2,3,0,0,0,0,0,15152,6.8,17154,247,56,-1886,-604,30.3,1515.2,14,2,0,3,2,6,0,0,0,0,17038,6.8,17758,204,61,1886,604,26.5,1703.8
4759685038,0,10,2,0,4,5,4,0,0,0,0,17484,7.0,18880,240,73,1907,986,31.3,1748.4,14,2,1,5,4,9,0,0,0,0,15577,6.6,17894,213,54,-1907,-986,26.7,1557.7
4759645009,0,15,0,1,9,3,10,0,0,0,0,18581,7.0,18274,239,40,3942,1814,27.9,1858.1,11,3,0,3,9,3,1,1,0,0,14639,6.6,16460,208,62,-3942,-1814,27.0,1463.9
4759014068,1,11,0,0,6,5,6,1,1,0,0,16994,6.8,18359,225,60,-7,857,28.5,1699.4,10,0,1,5,6,7,0,0,0,0,17001,7.0,17502,232,52,7,-857,28.4,1700.1
4750082621,1,9,1,0,7,5,4,1,1,0,0,17226,7.2,18830,226,68,56,-374,29.4,1722.6,11,0,1,5,7,4,0,0,0,0,17170,7.0,19204,245,60,-56,374,30.5,1717.0
4750046042,1,10,2,1,7,3,12,1,1,0,0,17516,7.0,18274,218,59,2796,124,27.7,1751.6,225,1,0,3,7,0,1,0,1,0,14720,7.0,18150,216,60,-2796,-124,27.6,1472.0
4750004644,0,15,0,1,7,4,7,0,0,0,0,16747,6.8,17322,202,57,894,-752,25.9,1674.7,12,3,0,4,7,5,1,1,0,0,15853,7.0,18074,226,64,-894,752,29.0,1585.3
4749984799,0,16,2,0,2,8,2,0,0,0,0,15146,6.6,17702,227,52,-2613,-928,27.9,1514.6,12,5,1,8,2,11,1,1,0,0,17759,7.0,18630,218,52,2613,928,27.0,1775.9
4748305445,0,13,2,1,3,6,3,0,0,0,0,15359,6.8,17085,239,52,-2247,-1374,29.1,1535.9,15,4,0,6,3,8,1,1,0,0,17606,7.2,18459,212,71,2247,1374,28.3,1760.6
4748262730,0,34,3,1,5,7,6,0,0,0,0,15213,6.6,16601,202,55,-1975,-1897,25.7,1521.3,12,3,0,7,5,3,0,0,0,0,17188,7.2,18498,224,58,1975,1897,28.2,1718.8
4747406887,0,48,1,0,4,4,3,0,0,0,0,15217,7.2,18701,224,48,-1836,325,27.2,1521.7,9,1,1,4,4,4,1,0,1,0,17053,7.0,18376,229,60,1836,-325,28.9,1705.3
4747358079,1,21,1,1,11,5,14,2,1,1,0,19815,6.8,18674,243,56,2784,3135,29.9,1981.5,31,0,0,5,11,10,0,0,0,0,17031,6.6,15539,174,52,-2784,-3135,22.6,1703.1
4745838506,0,10,1,0,3,7,2,0,0,0,0,16138,7.0,17763,211,40,-1767,-2249,25.1,1613.8,8,2,1,7,3,4,1,1,0,0,17905,7.4,20012,236,74,1767,2249,31.0,1790.5
4745832790,0,48,0,0,6,13,6,0,0,0,0,16358,6.6,16323,189,47,-3756,-2584,23.6,1635.8,11,2,1,13,6,13,1,1,0,0,20114,7.2,18907,228,56,3756,2584,28.4,2011.4
4745795599,1,95,2,1,7,6,9,0,0,0,0,17542,6.6,16772,187,60,1310,-353,24.7,1754.2,16,1,0,6,7,2,0,0,0,0,16232,6.8,17125,221,52,-1310,353,27.3,1623.2
4745771680,1,10,1,0,2,1,1,1,1,0,0,15731,7.2,19387,253,68,2266,2517,32.1,1573.1,12,1,1,1,2,1,0,0,0,0,13465,6.6,16870,201,52,-2266,-2517,25.3,1346.5
4745752339,1,16,0,1,9,2,8,1,1,0,0,17293,7.0,18231,201,60,2534,1388,26.1,1729.3,12,0,0,2,9,1,0,0,0,0,14759,6.8,16843,212,60,-2534,-1388,27.2,1475.9
4724612369,1,10,1,1,9,6,9,1,0,1,0,19841,7.4,20630,254,68,3027,3012,32.2,1984.1,13,1,0,6,9,7,1,1,0,0,16814,7.0,17618,217,60,-3027,-3012,27.7,1681.4
4721749724,1,13,3,0,9,2,10,1,1,0,0,18956,7.2,19766,216,68,4257,3547,28.4,1895.6,16,1,1,2,9,4,0,0,0,0,14699,6.8,16219,197,60,-4257,-3547,25.7,1469.9
4717514048,0,15,4,0,1,3,2,0,0,0,0,13631,6.4,16202,211,52,-4203,-4161,26.3,1363.1,11,2,1,3,1,2,1,1,0,0,17834,7.6,20363,261,76,4203,4161,33.7,1783.4
4717488434,0,11,4,0,2,7,3,0,0,0,0,14667,6.6,16236,219,60,-2566,-2600,27.9,1466.7,16,0,1,7,2,5,0,0,0,0,17233,7.2,18836,214,68,2566,2600,28.2,1723.3
4717452489,1,12,1,0,4,8,4,1,1,0,0,17967,6.6,17134,203,44,216,-67,24.7,1796.7,29,3,1,8,4,10,0,0,0,0,17751,6.8,17201,177,43,-216,67,22.0,1775.1
4717431840,0,8,2,1,8,4,10,0,0,0,0,17693,7.0,17987,212,58,2164,-288,27.0,1769.3,17,0,0,4,8,1,0,0,0,0,15529,7.0,18275,224,66,-2164,288,29.0,1552.9
4717396163,0,104,2,0,5,6,2,1,1,0,0,16172,6.6,17152,194,46,-160,-429,24.0,1617.2,14,1,1,6,5,5,0,0,0,0,16332,6.8,17581,183,59,160,429,24.2,1633.2
4716983339,1,16,1,1,10,4,10,2,1,1,0,18066,7.2,19303,203,64,2434,2326,26.7,1806.6,12,1,0,4,10,3,0,0,0,0,15632,6.6,16977,203,52,-2434,-2326,25.5,1563.2
4716934764,1,15,3,1,6,4,4,1,1,0,0,17632,7.2,18580,212,76,2564,734,28.8,1763.2,16,0,0,4,6,4,0,0,0,0,15068,7.0,17846,194,60,-2564,-734,25.4,1506.8
4716895816,0,46,1,0,5,5,3,1,0,1,0,18122,7.0,18850,221,48,1720,-11,26.9,1812.2,6,1,1,5,5,3,0,0,0,0,16402,7.0,18861,232,52,-1720,11,28.4,1640.2
4716668106,1,12,0,0,7,5,5,0,0,0,0,16685,7.0,17837,204,60,429,654,26.4,1668.5,28,0,1,5,7,9,0,0,0,0,16256,6.6,17183,207,39,-429,-654,24.6,1625.6
4716625243,0,100,0,0,6,9,4,0,0,0,0,15882,6.4,16037,181,48,-4226,-2581,22.9,1588.2,8,2,1,9,6,8,0,0,0,0,20108,7.2,18618,219,48,4226,2581,26.7,2010.8
4716590231,1,181,0,1,2,4,1,0,0,0,0,14261,6.8,16846,190,48,-2010,-1560,23.8,1426.1,14,20,0,4,2,1,1,1,0,0,16271,7.0,18406,221,58,2010,1560,27.9,1627.1
4704204021,0,66,2,1,5,2,7,1,1,0,0,16572,6.8,17502,226,54,903,-727,28.0,1657.2,14,4,0,2,5,2,0,0,0,0,15669,7.0,18229,221,60,-903,727,28.1,1566.9
4704006344,1,83,2,1,6,6,1,2,1,1,0,17968,7.2,19602,223,60,993,715,28.3,1796.8,27,3,0,6,6,8,0,0,0,0,16975,7.0,18887,215,68,-993,-715,28.3,1697.5
4703992163,1,7,2,1,9,4,8,0,0,0,0,19149,7.4,19396,238,59,3261,2782,29.7,1914.9,14,1,0,4,9,3,0,0,0,0,15888,6.6,16614,201,52,-3261,-2782,25.3,1588.8
4703979008,1,13,2,1,12,4,8,0,0,0,0,18927,7.0,18745,227,56,3846,2690,28.3,1892.7,85,3,0,4,12,6,0,0,0,0,15081,6.6,16055,189,46,-3846,-2690,23.5,1508.1
4703960010,0,16,2,1,6,7,5,1,1,0,0,16838,7.2,18385,206,49,-1080,-1334,25.5,1683.8,15,1,0,7,6,4,0,0,0,0,17918,7.4,19719,240,62,1080,1334,30.2,1791.8
4703919539,1,14,3,1,7,5,12,0,0,0,0,18299,6.8,18200,217,56,508,540,27.3,1829.9,12,1,0,5,7,8,0,0,0,0,17791,7.0,17660,233,48,-508,-540,28.1,1779.1
4856325842,0,27,0,0,24,40,51,0,0,0,1,40013,11.4,42649,115,0,-2647,-5728,11.5,4001.3,0,24,1,40,24,112,0,0,0,0,42660,12.2,48377,112,0,2647,5728,11.2,4266.0
4856283678,1,0,0,1,20,16,55,0,0,0,1,38231,11.0,40626,124,0,5192,4524,12.4,3823.1,19,0,0,16,20,35,0,0,0,0,33039,10.2,36102,95,0,-5192,-4524,9.5,3303.9
4856256438,0,0,0,0,22,25,60,0,0,0,2,37066,11.0,38704,118,0,-1848,-3306,11.8,3706.6,0,0,1,25,22,66,0,0,0,0,38914,11.4,42010,120,0,1848,3306,12.0,3891.4
4856204280,1,0,0,1,23,22,60,0,0,0,1,36982,11.4,41614,115,0,-942,399,11.5,3698.2,0,0,0,22,23,63,0,0,0,0,37924,11.2,41215,104,0,942,-399,10.4,3792.4
4853216831,1,0,0,1,19,16,49,0,0,0,1,37440,11.2,40222,115,0,3214,3336,11.5,3744.0,0,0,0,16,19,30,0,0,0,0,34226,10.6,36886,104,0,-3214,-3336,10.4,3422.6
4853199666,1,155,0,1,26,17,65,0,0,0,0,38200,11.6,43241,83,0,2993,5731,8.3,3820.0,0,0,0,17,26,45,0,0,0,0,35207,10.6,37510,99,0,-2993,-5731,9.9,3520.7
4853193919,0,0,0,1,21,22,54,0,0,0,0,36448,11.0,38825,96,0,-1518,-2240,9.6,3644.8,0,0,0,22,21,61,0,0,0,0,37966,11.0,41065,117,0,1518,2240,11.7,3796.6
4853181031,1,17,0,0,34,24,94,0,0,0,1,40350,12.0,45652,105,0,2047,3419,10.5,4035.0,0,0,1,24,34,64,0,0,0,0,38303,11.6,42233,111,0,-2047,-3419,11.1,3830.3
4853159432,0,0,0,0,24,25,65,0,0,0,1,37574,11.0,41097,97,0,49,-141,9.7,3757.4,0,0,1,25,24,67,0,0,0,0,37525,11.2,41238,88,0,-49,141,8.8,3752.5
4853147895,1,0,0,0,24,18,64,0,0,0,0,38481,11.2,41688,119,0,3510,2817,11.9,3848.1,0,0,1,18,24,46,0,0,0,0,34971,11.0,38871,107,0,-3510,-2817,10.7,3497.1
4853128342,0,4,7,0,20,29,47,0,0,0,1,35560,10.6,37998,92,0,-3615,-4794,9.2,3556.0,47,0,1,29,20,84,0,0,0,0,39175,11.2,42792,115,0,3615,4794,11.5,3917.5
4853017397,1,10,0,0,13,22,38,0,0,0,0,32684,10.0,32948,94,0,-3596,-5147,9.4,3268.4,17,0,1,22,13,62,0,0,0,0,36280,10.8,38095,97,0,3596,5147,9.7,3628.0
4853003760,0,0,0,0,18,30,36,0,0,0,2,34674,10.8,37307,91,0,-6001,-3562,9.1,3467.4,0,0,1,30,18,72,0,0,0,0,40675,11.2,40869,119,0,6001,3562,11.9,4067.5
4852961027,1,0,0,0,16,19,46,0,0,0,1,33968,10.4,36118,105,0,-1347,-1557,10.5,3396.8,12,0,1,19,16,46,0,0,0,0,35315,10.6,37675,111,0,1347,1557,11.1,3531.5
4852926938,1,21,20,1,25,18,72,0,0,0,0,39419,11.2,40844,109,0,2774,2426,10.9,3941.9,27,2,0,17,24,41,0,0,0,0,36645,11.0,38418,109,0,-2774,-2426,10.9,3664.5
4852891471,1,9,0,1,18,22,17,0,0,0,0,61300,12.4,57000,0,0,22700,24000,0.0,6130.0,0,0,0,14,10,16,0,0,0,0,38600,7.2,33000,0,0,-22700,-24000,0.0,3860.0
4852176274,1,0,0,0,18,22,52,0,0,0,0,34211,11.0,37818,96,0,-2094,-1473,9.6,3421.1,0,0,1,22,18,56,0,0,0,0,36305,11.0,39291,121,0,2094,1473,12.1,3630.5
4852168979,1,0,0,0,27,42,54,0,0,0,2,39807,11.8,43510,117,0,-1481,-3934,11.7,3980.7,0,0,1,42,27,111,0,0,0,0,41288,12.2,47444,123,0,1481,3934,12.3,4128.8
4852164013,0,0,0,0,24,24,68,0,0,0,1,36156,11.0,40082,111,0,-2433,-3358,11.1,3615.6,0,0,1,24,24,59,0,0,0,0,38589,11.6,43440,120,0,2433,3358,12.0,3858.9
4852155476,1,33,7,0,37,23,123,0,0,0,1,40880,12.0,45801,108,0,2515,3836,10.8,4088.0,22,15,1,23,37,62,0,0,0,0,38365,11.2,41965,97,0,-2515,-3836,9.7,3836.5
4849483456,0,13,3,1,2,1,2,0,0,0,0,14748,6.8,17918,215,52,-179,-677,26.7,1474.8,12,1,0,1,2,0,0,0,0,0,14927,7.2,18595,235,72,179,677,30.7,1492.7
4849460496,0,15,2,0,7,4,10,0,0,0,0,16608,7.0,17657,218,63,165,-586,28.1,1660.8,21,0,1,4,7,5,1,1,0,0,16443,7.0,18243,197,53,-165,586,25.0,1644.3
4849442201,0,12,3,0,6,9,9,1,1,0,0,16399,6.2,15492,180,52,-2159,-1862,23.2,1639.9,15,2,1,9,6,7,0,0,0,0,18558,6.8,17354,234,41,2159,1862,27.5,1855.8
4848424614,0,13,0,0,3,5,3,0,0,0,0,16486,7.2,18911,226,60,-901,656,28.6,1648.6,12,4,1,5,3,4,1,1,0,0,17387,6.8,18255,255,56,901,-656,31.1,1738.7
4848131871,1,12,2,0,10,2,6,0,0,0,0,17893,7.0,18409,206,48,2906,1698,25.4,1789.3,15,0,1,2,10,3,0,0,0,0,14987,6.6,16711,206,56,-2906,-1698,26.2,1498.7
4848089937,0,15,14,0,0,4,0,0,0,0,0,14053,6.6,17553,222,60,-2814,-2431,28.2,1405.3,38,3,1,4,0,2,0,0,0,0,16867,7.4,19984,240,56,2814,2431,29.6,1686.7
4847664606,0,13,9,0,10,5,10,0,0,0,0,18007,7.0,18032,202,55,-365,-148,25.7,1800.7,30,4,1,5,10,5,0,0,0,0,18372,7.0,18180,234,64,365,148,29.8,1837.2
4847103869,1,12,0,1,8,2,7,1,1,0,0,17465,7.2,18652,233,52,1918,872,28.5,1746.5,11,0,0,2,8,2,0,0,0,0,15547,7.2,17780,212,55,-1918,-872,26.7,1554.7
4847066000,1,38,2,0,3,3,1,1,1,0,0,15562,7.2,19150,229,60,495,857,28.9,1556.2,11,7,1,3,3,2,0,0,0,0,15067,6.8,18293,199,54,-495,-857,25.3,1506.7
4847022998,1,123,0,1,7,5,7,0,0,0,0,16886,6.8,17949,204,52,-577,-1213,25.6,1688.6,12,2,0,5,7,3,0,0,0,0,17463,7.2,19162,215,68,577,1213,28.3,1746.3
4846961995,1,8,2,1,4,5,2,0,0,0,0,15618,7.0,18277,234,64,-456,-403,29.8,1561.8,16,0,0,5,4,4,0,0,0,0,16074,7.2,18680,202,60,456,403,26.2,1607.4
4846415308,1,14,1,0,4,3,4,0,0,0,0,15321,6.4,16175,190,44,-1669,-1303,23.4,1532.1,11,2,1,3,4,4,0,0,0,0,16990,6.8,17478,213,60,1669,1303,27.3,1699.0
4845582568,0,15,15,1,4,4,5,1,1,0,0,15125,7.0,18060,176,60,-1344,-676,23.6,1512.5,34,1,0,4,4,2,0,0,0,0,16469,7.0,18736,235,52,1344,676,28.7,1646.9
4845566754,0,11,0,0,5,5,4,0,0,0,0,16461,6.8,18118,198,52,-320,1198,25.0,1646.1,9,1,1,5,5,7,0,0,0,0,16781,6.8,16920,212,60,320,-1198,27.2,1678.1
4844658606,1,36,0,1,4,1,2,0,0,0,0,16808,7.0,19012,236,70,1260,90,30.6,1680.8,10,16,0,1,4,1,0,0,0,0,15548,7.4,18922,218,54,-1260,-90,27.2,1554.8
4844643697,0,10,0,0,4,10,2,0,0,0,0,14286,6.8,17328,190,56,-5143,-1710,24.6,1428.6,2,2,1,10,4,10,1,1,0,0,19429,7.2,19038,231,60,5143,1710,29.1,1942.9
4843728725,0,14,2,1,8,4,7,0,0,0,0,16672,7.0,18430,203,60,2839,2288,26.3,1667.2,14,0,0,4,8,0,0,0,0,0,13833,6.6,16142,156,60,-2839,-2288,21.6,1383.3
4842858759,1,105,5,1,6,2,7,1,0,1,0,17424,7.2,19081,231,76,1238,969,30.7,1742.4,14,2,0,2,6,2,0,0,0,0,16186,7.0,18112,209,64,-1238,-969,27.3,1618.6
4821312784,1,14,0,0,4,5,2,0,0,0,0,17114,7.2,19597,240,60,1019,1667,30.0,1711.4,75,0,1,5,4,2,1,1,0,0,16095,7.0,17930,220,62,-1019,-1667,28.2,1609.5
4818539701,1,12,1,0,4,6,2,0,0,0,0,16719,7.0,18856,230,56,437,502,28.6,1671.9,42,1,1,6,4,5,0,0,0,0,16282,6.8,18354,198,68,-437,-502,26.6,1628.2
4818529569,1,9,0,0,4,4,3,1,0,1,0,17334,7.4,19302,229,59,2572,1611,28.8,1733.4,17,1,1,4,4,3,0,0,0,0,14762,6.8,17691,194,56,-2572,-1611,25.0,1476.2
4818492824,0,14,0,1,5,6,7,0,0,0,0,16431,6.8,17027,162,44,-1128,-2126,20.6,1643.1,13,0,0,6,5,5,0,0,0,0,17559,7.0,19153,211,76,1128,2126,28.7,1755.9
4817813530,1,14,1,1,7,3,5,0,0,0,0,17897,7.2,19421,237,60,1481,1033,29.7,1789.7,12,1,0,3,7,2,0,0,0,0,16416,6.8,18388,193,64,-1481,-1033,25.7,1641.6
4817788518,1,12,0,0,8,8,4,0,0,0,0,17989,7.4,19504,226,62,1972,1877,28.8,1798.9,21,1,1,8,8,4,0,0,0,0,16017,7.0,17627,202,50,-1972,-1877,25.2,1601.7
4817774043,0,11,0,1,7,6,3,0,0,0,0,17262,7.0,18055,211,56,-301,1188,26.7,1726.2,18,0,0,6,7,9,0,0,0,0,17563,6.8,16867,187,60,301,-1188,24.7,1756.3
4817437270,1,10,0,1,5,3,4,0,0,0,0,17197,7.2,18540,194,64,1759,821,25.8,1719.7,15,0,0,3,5,2,0,0,0,0,15438,6.8,17719,218,44,-1759,-821,26.2,1543.8
4814645829,1,12,2,1,11,3,10,1,0,1,0,20986,7.6,20553,234,80,6707,4662,31.4,2098.6,11,1,0,3,11,3,0,0,0,0,14279,6.4,15891,148,44,-6707,-4662,19.2,1427.9
4808329277,0,13,2,0,2,2,3,0,0,0,0,15820,7.2,18713,266,60,494,-180,32.6,1582.0,17,1,1,2,2,1,1,0,1,0,15326,7.0,18893,217,76,-494,180,29.3,1532.6
4808275928,1,55,1,0,6,3,4,0,0,0,0,16178,6.8,17762,225,58,554,1950,28.3,1617.8,14,0,1,3,6,4,0,0,0,0,15624,6.4,15812,221,11,-554,-1950,23.2,1562.4
4808191037,0,13,3,1,3,2,3,0,0,0,0,15647,6.8,18133,245,56,107,-297,30.1,1564.7,16,2,0,1,2,1,0,0,0,0,15540,7.2,18430,241,64,-107,297,30.5,1554.0
4807732226,0,16,0,0,8,5,12,0,0,0,0,16072,6.8,17042,196,44,433,-605,24.0,1607.2,15,1,1,5,8,2,0,0,0,0,15639,7.0,17647,208,52,-433,605,26.0,1563.9
4806747293,1,10,0,1,6,5,6,0,0,0,0,17718,7.2,19261,247,56,1672,905,30.3,1771.8,7,1,0,5,6,6,0,0,0,0,16046,7.0,18356,242,64,-1672,-905,30.6,1604.6
4777156158,1,12,1,1,12,5,10,0,0,0,0,18644,6.8,17314,184,60,1449,-312,24.4,1864.4,9,1,0,5,12,1,1,0,1,0,17195,7.0,17626,198,52,-1449,312,25.0,1719.5
4759360480,1,13,0,0,7,2,9,1,1,0,0,18982,7.4,19682,247,64,3562,2875,31.1,1898.2,11,1,1,2,7,3,0,0,0,0,15420,6.8,16807,216,60,-3562,-2875,27.6,1542.0
4759345006,0,14,1,0,1,6,1,0,0,0,0,14924,7.0,18329,224,45,-3577,-1825,26.9,1492.4,11,1,1,6,1,5,1,1,0,0,18501,7.6,20154,272,72,3577,1825,34.4,1850.1
4759326414,1,17,1,1,4,4,4,0,0,0,0,17036,7.0,18684,245,52,518,1059,29.7,1703.6,73,3,0,4,4,8,0,0,0,0,16518,7.0,17625,209,63,-518,-1059,27.2,1651.8
4735208606,1,0,0,1,14,18,13,0,0,0,0,62727,12.2,56000,0,0,24097,23000,0.0,6272.7,82,0,0,12,8,7,0,0,0,0,38630,7.2,33000,0,0,-24097,-23000,0.0,3863.0
4734295558,1,86,5,0,14,15,17,0,0,0,0,47889,10.0,47500,0,0,18681,19000,0.0,4788.9,26,0,1,10,9,6,0,0,0,0,29208,6.0,28500,11,0,-18681,-19000,1.1,2920.8
4812875806,1,11,0,0,2,9,2,0,0,0,0,14896,7.0,18266,223,52,-4040,-1206,27.5,1489.6,12,3,1,9,2,8,1,0,1,0,18936,7.2,19472,236,56,4040,1206,29.2,1893.6
4811530925,0,14,2,0,2,4,1,0,0,0,0,16057,7.0,18564,235,68,-230,1013,30.3,1605.7,14,2,1,4,2,5,1,1,0,0,16287,6.6,17551,225,48,230,-1013,27.3,1628.7
4811490054,1,11,1,0,6,7,6,1,1,0,0,19159,7.2,18697,226,44,1648,1556,27.0,1915.9,13,1,1,7,6,9,0,0,0,0,17511,6.8,17141,220,51,-1648,-1556,27.1,1751.1
4811462097,1,15,1,1,6,7,6,1,1,0,0,18782,7.2,18844,260,62,859,312,32.2,1878.2,9,2,0,7,6,8,1,0,1,0,17923,7.0,18532,236,62,-859,-312,29.8,1792.3
4811410660,1,12,8,1,7,3,6,1,1,0,0,18223,7.0,18414,223,56,2375,1281,27.9,1822.3,15,3,0,3,7,3,0,0,0,0,15848,6.8,17133,229,60,-2375,-1281,28.9,1584.8
4810805191,1,11,1,1,4,8,9,0,0,0,0,16095,6.4,16058,223,47,-2974,-2077,27.0,1609.5,14,3,0,8,4,8,1,1,0,0,19069,7.0,18135,209,44,2974,2077,25.3,1906.9
4810799867,1,7,1,0,4,5,3,1,1,0,0,17897,7.4,19677,258,56,1257,2939,31.4,1789.7,25,1,1,5,4,3,1,0,1,0,16640,6.8,16738,218,48,-1257,-2939,26.6,1664.0
4810126265,0,20,1,1,2,8,2,1,1,0,0,13420,6.4,15392,165,58,-4621,-2505,22.3,1342.0,15,1,0,8,2,12,0,0,0,0,18041,7.0,17897,238,40,4621,2505,27.8,1804.1
4810101315,0,8,2,0,5,6,2,0,0,0,0,16227,6.6,16814,193,57,555,-635,25.0,1622.7,10,0,1,6,5,3,0,0,0,0,15672,6.8,17449,194,50,-555,635,24.4,1567.2
4809144102,0,14,1,0,1,2,1,1,1,0,0,15233,7.2,18528,255,72,-534,118,32.7,1523.3,11,1,1,2,1,1,0,0,0,0,15767,7.2,18410,242,64,534,-118,30.6,1576.7
4809011589,0,12,2,1,5,3,5,0,0,0,0,15958,6.8,16790,200,64,684,-1485,26.4,1595.8,12,1,0,3,5,4,0,0,0,0,15274,7.0,18275,173,72,-684,1485,24.5,1527.4
4793702129,1,78,1,1,6,7,7,1,1,0,0,18153,7.2,19098,225,68,313,2197,29.3,1815.3,10,0,0,7,6,11,0,0,0,0,17840,6.6,16901,204,47,-313,-2197,25.1,1784.0
4793679014,0,13,2,0,2,5,0,0,0,0,0,15480,7.2,18686,242,69,-1905,-268,31.1,1548.0,13,1,1,5,2,4,2,1,1,0,17385,7.0,18954,230,62,1905,268,29.2,1738.5
4793659074,1,53,0,0,5,9,7,0,0,0,0,18843,6.8,17510,199,43,1090,-282,24.2,1884.3,6,1,1,9,5,7,0,0,0,0,17753,6.8,17792,214,44,-1090,282,25.8,1775.3
4793640216,1,31,2,1,5,1,5,0,0,0,0,17896,7.4,19327,255,60,3386,1855,31.5,1789.6,19,16,0,1,5,2,0,0,0,0,14510,6.8,17472,229,53,-3386,-1855,28.2,1451.0
4787505722,1,25,2,1,7,7,9,0,0,0,0,18580,6.8,18550,202,68,824,385,27.0,1858.0,15,0,0,7,7,7,1,1,0,0,17756,7.0,18165,258,60,-824,-385,31.8,1775.6
4787485245,1,18,2,0,2,5,1,0,0,0,0,16219,7.0,19029,217,68,-186,-2,28.5,1621.9,14,3,1,5,2,5,0,0,0,0,16405,7.0,19031,229,64,186,2,29.3,1640.5
4787471830,1,15,1,0,6,4,7,1,0,1,0,18284,7.0,18614,214,48,2700,2034,26.2,1828.4,12,3,1,4,6,4,1,1,0,0,15584,6.6,16580,225,52,-2700,-2034,27.7,1558.4
4771785990,1,10,2,1,8,4,8,0,0,0,0,17748,7.0,19392,202,67,952,904,26.9,1774.8,249,2,0,4,8,1,0,0,0,0,16796,7.0,18488,250,63,-952,-904,31.3,1679.6
4769488316,0,12,2,0,9,10,6,1,0,1,0,19201,7.2,18316,223,60,199,1104,28.3,1920.1,14,1,1,9,8,10,0,0,0,0,19002,6.8,17212,226,48,-199,-1104,27.4,1900.2
4760381356,0,12,0,1,4,7,2,0,0,0,0,16595,6.8,17436,239,66,-1758,-1517,30.5,1659.5,12,0,0,6,3,6,1,1,0,0,18353,7.2,18953,245,57,1758,1517,30.2,1835.3
4728898830,1,11,1,0,9,6,11,0,0,0,0,18947,6.6,16701,213,42,2762,579,25.5,1894.7,11,2,1,6,9,6,1,0,1,0,16185,6.4,16122,192,64,-2762,-579,25.6,1618.5
4728863179,1,15,0,1,9,5,9,0,0,0,0,17173,7.0,17967,180,56,-2,-502,23.6,1717.3,10,2,0,5,9,7,1,1,0,0,17175,7.2,18469,232,64,2,502,29.6,1717.5
4728829888,0,12,0,0,4,8,5,0,0,0,0,15460,6.8,16693,207,38,-2049,-1112,24.5,1546.0,12,0,1,8,4,5,1,0,1,0,17509,6.8,17805,211,69,2049,1112,28.0,1750.9
4728793258,0,14,0,0,6,7,3,0,0,0,0,17821,6.8,17957,222,54,-242,787,27.6,1782.1,11,3,1,7,6,10,0,0,0,0,18063,6.6,17170,225,60,242,-787,28.5,1806.3
4725831521,0,14,1,1,6,6,12,0,0,0,0,18058,6.6,16505,211,40,955,-413,25.1,1805.8,10,3,0,6,6,9,0,0,0,0,17103,6.8,16918,216,55,-955,413,27.1,1710.3
4725779006,1,11,1,1,5,3,5,1,1,0,0,17767,7.2,19188,230,54,1776,327,28.4,1776.7,9,1,0,3,5,3,0,0,0,0,15991,7.2,18861,233,57,-1776,-327,29.0,1599.1
4725707054,0,14,0,1,6,8,4,0,0,0,0,17145,6.6,16405,205,43,-45,-119,24.8,1714.5,21,1,0,8,6,11,0,0,0,0,17190,6.6,16524,230,49,45,119,27.9,1719.0
4725668915,1,83,1,1,4,4,1,1,0,1,0,17006,7.4,19088,229,57,1364,-228,28.6,1700.6,10,5,0,3,3,0,1,1,0,0,15642,7.2,19316,232,60,-1364,228,29.2,1564.2
4725622995,0,15,2,1,8,1,7,1,1,0,0,19760,7.0,18176,245,55,6162,2530,30.0,1976.0,11,2,0,1,8,0,0,0,0,0,13598,6.2,15646,196,47,-6162,-2530,24.3,1359.8
4725590267,1,16,1,0,11,2,10,0,0,0,0,19793,7.4,19125,236,76,5379,3662,31.2,1979.3,12,0,1,2,11,2,0,0,0,0,14414,6.4,15463,223,36,-5379,-3662,25.9,1441.4
4724674229,1,13,1,1,8,3,11,1,1,0,0,18187,6.4,16367,208,56,1380,-678,26.4,1818.7,11,1,0,3,8,4,0,0,0,0,16807,6.8,17045,197,51,-1380,678,24.8,1680.7
4724617450,0,10,1,1,6,10,6,1,1,0,0,16869,6.6,16413,209,54,-2317,-2170,26.3,1686.9,15,1,0,10,6,9,0,0,0,0,19186,7.0,18583,216,58,2317,2170,27.4,1918.6
4724548322,0,24,0,0,14,13,15,0,0,0,0,21788,7.0,18672,202,52,1014,775,25.4,2178.8,5,1,1,12,13,10,0,0,0,0,20774,7.2,17897,212,49,-1014,-775,26.1,2077.4
4723454080,0,11,1,0,6,11,5,0,0,0,0,15877,6.6,15828,200,46,-2942,-2868,24.6,1587.7,33,0,1,11,6,8,0,0,0,0,18819,7.2,18696,192,58,2942,2868,25.0,1881.9
4723410937,1,31,2,1,2,4,3,0,0,0,0,15805,6.8,17845,216,63,-903,-785,27.9,1580.5,40,2,0,4,2,4,0,0,0,0,16708,7.2,18630,238,58,903,785,29.6,1670.8
4723371788,1,16,5,1,12,10,16,2,1,1,0,21652,6.8,17488,231,44,4348,943,27.5,2165.2,18,1,0,10,12,10,0,0,0,0,17304,6.4,16545,164,43,-4348,-943,20.7,1730.4
4723314678,0,9,0,0,3,10,3,0,0,0,0,17821,6.8,17462,230,67,-2264,-1944,29.7,1782.1,24,0,1,10,3,14,2,1,1,0,20085,7.0,19406,228,56,2264,1944,28.4,2008.5
4723277575,1,14,3,1,6,2,8,1,0,1,0,17127,7.0,18061,221,42,2737,49,26.3,1712.7,26,1,0,2,6,3,0,0,0,0,14390,7.0,18012,196,56,-2737,-49,25.2,1439.0
4723230293,0,17,1,1,6,4,6,0,0,0,0,15875,7.0,17578,209,56,86,-904,26.5,1587.5,11,0,0,4,6,1,1,1,0,0,15789,7.0,18482,217,68,-86,904,28.5,1578.9
4847786456,0,11,2,0,1,5,1,0,0,0,0,14459,6.8,17510,216,56,-1160,-1019,27.2,1445.9,14,2,1,5,1,0,0,0,0,0,15619,7.0,18529,233,68,1160,1019,30.1,1561.9
4830238310,1,0,0,1,18,20,47,0,0,0,0,36152,11.0,40077,99,0,1947,2534,9.9,3615.2,0,0,0,20,18,41,0,0,0,0,34205,10.6,37543,95,0,-1947,-2534,9.5,3420.5
4819690870,1,11,1,1,3,2,2,0,0,0,0,16263,7.2,18435,213,64,1667,1939,27.7,1626.3,11,2,0,2,3,2,0,0,0,0,14596,6.8,16496,204,40,-1667,-1939,24.4,1459.6
4819663970,1,9,1,1,6,6,4,0,0,0,0,16393,7.0,18662,215,64,653,441,27.9,1639.3,17,1,0,6,6,4,1,1,0,0,15740,7.0,18221,200,56,-653,-441,25.6,1574.0
4819639193,0,11,0,0,4,5,3,0,0,0,0,15663,7.0,18540,216,68,101,1382,28.4,1566.3,13,1,1,5,4,2,1,1,0,0,15562,6.8,17158,186,60,-101,-1382,24.6,1556.2
4819616070,0,14,0,0,2,10,2,0,0,0,0,14110,6.4,16389,210,46,-4259,-2116,25.6,1411.0,43,2,1,10,2,8,0,0,0,0,18369,7.0,18505,235,59,4259,2116,29.4,1836.9
4816729082,0,131,0,1,3,8,2,0,0,0,0,14834,6.8,16996,219,50,-2346,-2356,26.9,1483.4,13,0,0,8,3,3,1,1,0,0,17180,7.4,19352,236,64,2346,2356,30.0,1718.0
4812425914,0,12,0,1,4,1,4,0,0,0,0,16680,6.8,18314,218,44,1096,-576,26.2,1668.0,11,1,0,1,4,0,1,1,0,0,15584,7.0,18890,232,72,-1096,576,30.4,1558.4
4812393351,1,12,2,1,8,6,5,0,0,0,0,18860,7.0,19356,217,64,2453,1564,28.1,1886.0,11,0,0,6,8,7,1,1,0,0,16407,6.8,17792,213,60,-2453,-1564,27.3,1640.7
4812347142,0,24,1,0,4,8,6,1,1,0,0,16585,6.8,16088,200,48,-2020,-1853,24.8,1658.5,50,1,1,8,4,6,0,0,0,0,18605,7.2,17941,204,52,2020,1853,25.6,1860.5
4808436887,0,16,0,0,3,4,4,1,1,0,0,15316,6.6,16848,225,60,-2487,-1039,28.5,1531.6,107,0,1,4,3,0,0,0,0,0,17803,6.6,17887,245,56,2487,1039,30.1,1780.3
4808391014,0,12,2,0,8,6,6,1,0,1,0,17130,7.0,18281,215,68,325,1486,28.3,1713.0,10,1,1,6,8,10,0,0,0,0,16805,6.8,16795,178,48,-325,-1486,22.6,1680.5
4808327701,1,13,1,1,3,2,3,0,0,0,0,15771,6.6,16961,225,48,434,288,27.3,1577.1,16,1,0,2,3,2,0,0,0,0,15337,6.4,16673,212,44,-434,-288,25.6,1533.7
4802566389,1,12,1,1,9,7,11,0,0,0,0,18501,6.8,17511,220,44,1688,-600,26.4,1850.1,7,3,0,7,9,4,0,0,0,0,16813,7.0,18111,204,48,-1688,600,25.2,1681.3
4802529212,1,51,3,0,4,4,5,0,0,0,0,15561,7.0,17633,181,60,-2255,-5,24.1,1556.1,11,1,1,4,4,6,0,0,0,0,17816,7.0,17638,221,48,2255,5,26.9,1781.6
4802496595,1,15,2,1,2,1,3,2,1,1,0,16575,6.8,18387,237,52,1889,2093,28.9,1657.5,12,1,0,1,2,1,0,0,0,0,14686,6.6,16294,219,64,-1889,-2093,28.3,1468.6
4802472307,1,7,2,0,3,8,3,0,0,0,0,15314,6.6,17464,218,64,-2950,-1734,28.2,1531.4,12,0,1,8,3,7,1,1,0,0,18264,7.4,19198,194,52,2950,1734,24.6,1826.4
4800883761,0,12,0,0,7,4,8,1,1,0,0,16987,6.8,18682,192,60,1991,1886,25.2,1698.7,13,0,1,4,7,2,0,0,0,0,14996,6.6,16796,205,43,-1991,-1886,24.8,1499.6
4800829491,0,12,17,1,5,6,2,0,0,0,0,15269,6.6,17322,185,50,-942,-167,23.5,1526.9,38,2,0,6,5,6,2,1,1,0,16211,7.0,17489,209,52,942,167,26.1,1621.1
4858119257,1,352,0,1,13,21,12,0,0,0,0,61063,12.0,55000,0,0,23163,22000,0.0,6106.3,0,0,0,14,6,15,0,0,0,0,37900,7.2,33000,0,0,-23163,-22000,0.0,3790.0
4858093031,1,67,0,1,18,18,13,0,0,0,0,44938,10.0,47500,0,0,17414,19000,0.0,4493.8,42,0,0,7,7,12,0,0,0,0,27524,6.0,28500,0,0,-17414,-19000,0.0,2752.4
4858078848,1,20,0,1,19,13,26,0,0,0,0,64800,12.0,55000,0,0,29350,22000,0.0,6480.0,0,0,0,6,12,3,0,0,0,0,35450,7.2,33000,0,0,-29350,-22000,0.0,3545.0
4858061880,1,0,0,0,13,14,11,0,0,0,0,45950,10.4,49000,0,0,18800,20500,0.0,4595.0,0,0,1,9,8,10,0,0,0,0,27150,6.0,28500,0,0,-18800,-20500,0.0,2715.0
4858043457,1,7,2,1,22,16,19,0,0,0,0,47426,10.0,47500,0,0,18490,19000,0.0,4742.6,33,5,0,7,13,10,0,0,0,0,28936,6.0,28500,13,0,-18490,-19000,1.3,2893.6
4858028910,1,0,0,0,14,17,15,0,0,0,0,45802,10.0,47500,0,0,17107,19000,0.0,4580.2,30,0,1,12,9,11,0,0,0,0,28695,6.0,28500,1,0,-17107,-19000,0.1,2869.5
4858014847,1,0,0,1,15,15,17,0,0,0,0,60950,12.0,55000,0,0,24100,22000,0.0,6095.0,13,0,0,10,10,10,0,0,0,0,36850,7.2,33000,0,0,-24100,-22000,0.0,3685.0
4858001786,1,0,0,1,23,19,22,0,0,0,0,49965,10.0,47500,3,0,21690,19000,0.3,4996.5,0,0,0,9,13,13,0,0,0,0,28275,6.0,28500,1,0,-21690,-19000,0.1,2827.5
4857975628,1,0,0,0,17,21,16,0,0,0,0,47000,10.0,47500,3,0,18100,19000,0.3,4700.0,0,0,1,14,10,11,0,0,0,0,28900,6.0,28500,9,0,-18100,-19000,0.9,2890.0
4857885294,1,4,0,1,19,20,15,0,0,0,0,63448,12.6,59500,0,0,24133,19500,0.0,6344.8,0,0,0,13,12,15,0,0,0,0,39315,8.4,40000,0,0,-24133,-19500,0.0,3931.5
4857873149,1,0,0,1,24,16,20,0,0,0,0,63850,12.0,55000,1,0,25600,18000,0.1,6385.0,234,0,0,8,16,13,0,0,0,0,38250,8.0,37000,0,0,-25600,-18000,0.0,3825.0
4857865988,1,23,0,1,23,15,22,0,0,0,0,47700,10.0,47500,0,0,19500,19000,0.0,4770.0,0,0,0,6,14,8,0,0,0,0,28200,6.0,28500,0,0,-19500,-19000,0.0,2820.0
4857514226,1,39,0,1,13,20,19,0,0,0,0,62006,12.0,55000,2,0,23406,22000,0.2,6200.6,9,0,0,15,8,10,0,0,0,0,38600,7.2,33000,0,0,-23406,-22000,0.0,3860.0
4857496104,1,0,0,1,22,16,21,0,0,0,0,48400,12.0,55000,0,0,21973,22000,0.0,4840.0,0,0,0,6,12,7,0,0,0,0,26427,7.2,33000,0,0,-21973,-22000,0.0,2642.7
4857478165,1,2,0,1,9,18,15,0,0,0,0,43850,10.0,47500,0,0,13900,19000,0.0,4385.0,0,0,0,15,6,11,0,0,0,0,29950,6.0,28500,0,0,-13900,-19000,0.0,2995.0
4857375386,1,0,0,0,16,18,21,0,0,0,0,63550,12.0,55000,0,0,26691,22000,0.0,6355.0,74,0,1,11,9,7,0,0,0,0,36859,7.2,33000,0,0,-26691,-22000,0.0,3685.9
4857070883,0,0,0,1,31,31,79,0,0,0,0,39125,11.4,42590,98,0,-502,-3106,9.8,3912.5,0,0,0,31,31,62,0,0,0,0,39627,12.0,45696,84,0,502,3106,8.4,3962.7
4857051866,1,0,0,1,30,29,70,0,0,0,0,37752,11.2,42336,97,0,-1553,-2899,9.7,3775.2,0,0,0,29,30,56,0,0,0,0,39305,12.0,45235,105,0,1553,2899,10.5,3930.5
4857029714,1,0,0,0,20,18,19,0,0,0,0,63086,12.0,55000,0,0,26224,22000,0.0,6308.6,95,0,1,10,12,10,0,0,0,0,36862,7.2,33000,0,0,-26224,-22000,0.0,3686.2
4857013456,1,0,0,0,17,21,17,0,0,0,0,68403,12.0,55000,0,0,30126,22000,0.0,6840.3,0,0,1,16,12,13,0,0,0,0,38277,7.2,33000,0,0,-30126,-22000,0.0,3827.7
4858064835,0,15,3,0,3,6,2,0,0,0,0,15070,6.6,17020,216,44,-1721,-475,26.0,1507.0,154,2,1,6,3,9,1,1,0,0,16791,6.8,17495,219,64,1721,475,28.3,1679.1
4858037797,1,14,0,1,6,0,4,0,0,0,0,18286,6.8,17697,172,64,5097,2000,23.6,1828.6,10,0,0,0,6,0,0,0,0,0,13189,6.4,15697,185,52,-5097,-2000,23.7,1318.9
4858008634,0,13,1,0,3,8,3,0,0,0,0,14478,6.6,15683,167,44,-3740,-2901,21.1,1447.8,11,1,1,8,3,5,0,0,0,0,18218,6.8,18584,212,52,3740,2901,26.4,1821.8
4857983850,1,88,2,1,26,14,27,0,0,0,0,48800,10.0,47500,2,0,22326,19000,0.2,4880.0,20,0,0,4,16,5,0,0,0,0,26474,6.0,28500,0,0,-22326,-19000,0.0,2647.4
4857965199,1,0,0,1,23,10,17,0,0,0,0,47700,10.0,47500,0,0,22300,19000,0.0,4770.0,6,0,0,1,14,7,0,0,0,0,25400,6.0,28500,0,0,-22300,-19000,0.0,2540.0
4857943643,1,0,0,1,16,24,17,0,0,0,0,49000,10.0,47500,0,0,20100,17820,0.0,4900.0,0,0,0,15,7,10,0,0,0,0,28900,6.2,29680,0,0,-20100,-17820,0.0,2890.0
4857934217,1,11,3,1,17,17,17,0,0,0,0,50869,12.0,55000,1,0,20485,22000,0.1,5086.9,135,0,0,10,10,10,0,0,0,0,30384,7.2,33000,14,0,-20485,-22000,1.4,3038.4
4857845852,0,27,0,0,5,11,5,0,0,0,0,15173,6.0,14198,139,52,-5585,-5151,19.1,1517.3,34,1,1,11,5,8,1,1,0,0,20758,7.2,19349,222,56,5585,5151,27.8,2075.8
4857826741,1,9,0,1,3,4,4,0,0,0,0,15023,7.0,17738,190,44,-557,100,23.4,1502.3,81,1,0,4,3,3,0,0,0,0,15580,7.0,17638,212,56,557,-100,26.8,1558.0
4857431758,1,27,0,0,19,14,18,0,0,0,0,46660,10.0,47500,1,0,16710,19000,0.1,4666.0,0,0,1,7,12,7,0,0,0,0,29950,6.0,28500,0,0,-16710,-19000,0.0,2995.0
4857381493,1,11,0,0,6,9,6,0,0,0,0,17378,7.0,17728,210,54,-1628,-815,26.4,1737.8,12,0,1,9,6,7,0,0,0,0,19006,7.2,18543,219,56,1628,815,27.5,1900.6
4857343796,0,9,0,0,3,5,4,0,0,0,0,15203,6.8,17906,237,52,-1490,-472,28.9,1520.3,10,1,1,5,3,10,1,1,0,0,16693,6.8,18378,237,56,1490,472,29.3,1669.3
4857309097,0,11,1,1,4,11,2,0,0,0,0,15548,7.0,17924,228,60,-3448,-2600,28.8,1554.8,14,1,0,10,3,10,0,0,0,0,18996,7.4,20524,227,68,3448,2600,29.5,1899.6
4857224654,0,12,1,1,3,7,2,0,0,0,0,15395,6.8,17981,209,68,-2460,-1337,27.7,1539.5,12,2,0,7,3,7,0,0,0,0,17855,7.2,19318,220,68,2460,1337,28.8,1785.5
4857146335,1,10,0,1,2,5,1,1,1,0,0,15613,7.0,18710,224,68,-252,1209,29.2,1561.3,12,0,0,5,2,6,0,0,0,0,15865,6.8,17501,192,48,252,-1209,24.0,1586.5
4857115565,1,11,2,1,8,3,5,0,0,0,0,18018,7.0,18875,238,48,2754,1824,28.6,1801.8,15,0,0,3,8,2,0,0,0,0,15264,6.6,17051,146,64,-2754,-1824,21.0,1526.4
4856939174,1,3,0,0,15,21,13,0,0,0,0,46712,10.0,47500,0,0,18162,19000,0.0,4671.2,0,0,1,12,6,11,0,0,0,0,28550,6.0,28500,0,0,-18162,-19000,0.0,2855.0
4856924753,1,16,1,1,15,19,24,0,0,0,0,43330,10.6,50500,1,0,15824,22000,0.1,4333.0,0,0,0,14,10,5,0,0,0,0,27506,6.0,28500,0,0,-15824,-22000,0.0,2750.6
4856909505,1,0,0,1,20,20,19,0,0,0,0,61650,12.2,56000,0,0,23400,23000,0.0,6165.0,0,0,0,9,9,15,0,0,0,0,38250,7.2,33000,0,0,-23400,-23000,0.0,3825.0
4825289399,0,16,4,0,4,4,7,0,0,0,0,16726,7.0,18771,247,70,474,-227,31.7,1672.6,14,2,1,4,4,4,2,1,1,0,16252,7.2,18998,225,72,-474,227,29.7,1625.2
4825267656,0,17,0,0,2,6,0,0,0,0,0,14287,6.4,16138,221,45,-2981,-1670,26.6,1428.7,11,1,1,6,2,7,0,0,0,0,17268,7.0,17808,198,55,2981,1670,25.3,1726.8
4816621369,0,11,1,0,2,3,0,0,0,0,0,14503,6.6,18233,209,60,-724,54,26.9,1450.3,12,0,1,3,2,2,1,0,1,0,15227,7.0,18179,209,60,724,-54,26.9,1522.7
4816230720,0,13,3,0,5,10,5,1,0,1,0,19012,6.8,17722,195,60,136,-802,25.5,1901.2,23,4,1,10,5,12,1,1,0,0,18876,7.0,18524,223,52,-136,802,27.5,1887.6
4816166267,0,10,2,0,3,3,4,0,0,0,0,15965,7.0,18106,221,64,-129,350,28.5,1596.5,14,1,1,3,3,3,0,0,0,0,16094,6.8,17756,234,59,129,-350,29.3,1609.4
4816076503,1,13,1,1,6,3,5,0,0,0,0,16481,7.0,17762,230,44,1381,-314,27.4,1648.1,10,1,0,3,6,1,1,1,0,0,15100,7.0,18076,235,56,-1381,314,29.1,1510.0
4816047297,1,13,1,0,6,4,5,1,1,0,0,17149,6.8,18760,223,60,1302,2482,28.3,1714.9,11,0,1,4,6,4,0,0,0,0,15847,6.6,16278,232,48,-1302,-2482,28.0,1584.7
4813848917,1,12,0,1,5,5,5,0,0,0,0,17443,6.8,17769,201,58,440,84,25.9,1744.3,12,1,0,5,5,3,1,1,0,0,17003,6.6,17685,209,56,-440,-84,26.5,1700.3
4813823316,1,13,0,1,4,5,2,0,0,0,0,15739,6.6,17260,207,59,-329,-192,26.6,1573.9,11,1,0,5,4,4,0,0,0,0,16068,7.0,17452,219,56,329,192,27.5,1606.8
4813804210,0,13,0,0,1,7,1,0,0,0,0,14103,6.4,15498,192,46,-4351,-2998,23.8,1410.3,15,0,1,7,1,6,0,0,0,0,18454,7.0,18496,229,50,4351,2998,27.9,1845.4
4812847058,1,16,3,0,6,3,3,1,1,0,0,17027,6.8,18151,211,60,1507,1500,27.1,1702.7,8,3,1,3,6,2,0,0,0,0,15520,6.6,16651,205,44,-1507,-1500,24.9,1552.0
4812820642,1,12,0,1,5,4,5,0,0,0,0,16608,6.8,18178,212,68,919,-533,28.0,1660.8,12,1,0,4,5,5,1,1,0,0,15689,7.0,18711,206,59,-919,533,26.5,1568.9
4812804149,0,12,1,0,3,6,3,1,0,1,0,15785,6.8,17816,201,52,-1513,381,25.3,1578.5,13,0,1,6,3,7,1,1,0,0,17298,6.8,17435,190,72,1513,-381,26.2,1729.8
4812792745,0,14,1,0,6,6,9,0,0,0,0,16086,6.8,16161,195,47,-934,-2683,24.2,1608.6,12,2,1,6,6,3,0,0,0,0,17020,7.2,18844,219,72,934,2683,29.1,1702.0
4811975809,0,12,0,0,2,3,2,0,0,0,0,15505,6.8,17485,203,56,32,-38,25.9,1550.5,13,0,1,3,2,4,1,1,0,0,15473,6.8,17523,223,56,-32,38,27.9,1547.3
4811948280,0,12,2,0,3,5,0,1,1,0,0,15735,7.2,18112,228,56,-1052,-38,28.4,1573.5,12,3,1,5,3,5,0,0,0,0,16787,6.8,18150,215,64,1052,38,27.9,1678.7
4811932827,1,19,0,1,6,3,5,0,0,0,0,17489,7.0,18321,217,64,1921,228,28.1,1748.9,13,1,0,3,6,3,0,0,0,0,15568,6.8,18093,230,56,-1921,-228,28.6,1556.8
4811902899,0,17,1,1,4,4,1,1,1,0,0,16302,7.0,18626,201,80,214,1056,28.1,1630.2,14,0,0,4,4,4,1,0,1,0,16088,6.8,17570,221,52,-214,-1056,27.3,1608.8
4811463202,0,75,0,1,4,7,5,0,0,0,0,16490,7.0,18473,221,60,-427,-469,28.1,1649.0,13,0,0,7,4,6,0,0,0,0,16917,7.0,18942,206,64,427,469,27.0,1691.7
4811407676,1,14,1,1,10,9,4,0,0,0,0,18240,6.8,17322,192,50,346,1310,24.2,1824.0,15,2,0,9,10,9,0,0,0,0,17894,6.4,16012,153,66,-346,-1310,21.9,1789.4
4826311374,1,21,16,1,11,5,8,1,1,0,0,19181,7.4,19712,214,64,2330,1863,27.8,1918.1,36,1,0,5,11,4,0,0,0,0,16851,6.8,17849,221,66,-2330,-1863,28.7,1685.1
4826282131,1,11,1,0,9,6,15,0,0,0,0,19758,7.0,18689,233,63,3693,2003,29.6,1975.8,12,1,1,6,9,6,0,0,0,0,16065,6.6,16686,211,56,-3693,-2003,26.7,1606.5
4820610133,1,144,1,0,7,13,8,1,0,1,0,18060,6.6,17158,185,47,-1926,-637,23.2,1806.0,27,4,1,13,7,15,0,0,0,0,19986,6.8,17795,229,42,1926,637,27.1,1998.6
4820582367,1,14,2,0,9,7,5,1,1,0,0,17910,6.6,17053,155,55,782,1457,21.0,1791.0,12,0,1,7,9,10,0,0,0,0,17128,6.4,15596,204,40,-782,-1457,24.4,1712.8
4820553039,0,11,0,0,4,7,6,0,0,0,1,15939,6.2,15544,195,52,-2637,-2345,24.7,1593.9,12,3,1,7,4,7,1,1,0,0,18576,6.8,17889,244,56,2637,2345,30.0,1857.6
4820504151,0,15,3,0,4,3,8,0,0,0,0,16609,7.0,18205,244,67,1721,494,31.1,1660.9,12,1,1,3,4,3,1,1,0,0,14888,7.0,17711,201,60,-1721,-494,26.1,1488.8
4820069327,1,17,3,1,6,4,10,0,0,0,0,18142,7.0,18439,232,56,1712,766,28.8,1814.2,25,2,0,4,6,7,1,1,0,0,16430,7.0,17673,217,68,-1712,-766,28.5,1643.0
4820025096,1,11,2,0,3,5,4,0,0,0,0,15558,7.0,18418,217,70,-40,955,28.7,1555.8,29,0,1,5,3,7,1,1,0,0,15598,6.6,17463,200,56,40,-955,25.6,1559.8
4819958908,0,14,1,0,6,12,4,1,0,1,0,16184,6.2,15572,169,50,-5044,-3221,21.9,1618.4,14,2,1,12,6,12,0,0,0,0,21228,7.2,18793,244,47,5044,3221,29.1,2122.8
4819933406,1,7,2,0,6,8,8,1,1,0,0,18478,6.8,17921,222,56,2154,284,27.8,1847.8,8,1,1,8,6,2,0,0,0,0,16324,7.0,17637,190,48,-2154,-284,23.8,1632.4
4819894672,0,7,2,1,14,5,19,1,1,0,0,20764,7.0,17485,205,60,4375,962,26.5,2076.4,9,0,0,4,13,5,0,0,0,0,16389,6.4,16523,191,43,-4375,-962,23.4,1638.9
4819857046,1,12,1,1,10,5,7,1,0,1,0,20210,7.4,19257,231,60,1989,1664,29.1,2021.0,20,4,0,5,10,5,0,0,0,0,18221,6.8,17593,197,60,-1989,-1664,25.7,1822.1
4819445859,0,48,0,1,4,3,4,0,0,0,0,15280,6.8,17720,217,67,-2293,-1314,28.4,1528.0,13,1,0,3,4,3,1,1,0,0,17573,7.2,19034,222,72,2293,1314,29.4,1757.3
4817872091,1,11,4,1,9,6,8,1,1,0,0,17561,6.8,18005,205,54,106,396,25.9,1756.1,11,0,0,6,9,6,0,0,0,0,17455,6.8,17609,225,61,-106,-396,28.6,1745.5
4817833051,0,11,2,0,2,7,2,0,0,0,0,14657,6.8,17426,199,53,-3358,-2258,25.2,1465.7,13,1,1,7,2,7,0,0,0,0,18015,7.4,19684,257,69,3358,2258,32.6,1801.5
4817805248,1,16,4,0,10,8,7,0,0,0,0,18252,6.8,18067,222,44,-186,348,26.6,1825.2,11,5,1,8,10,4,0,0,0,0,18438,7.0,17719,210,59,186,-348,26.9,1843.8
4817383077,0,17,2,0,5,6,6,0,0,0,0,16852,6.8,17516,228,50,1202,1333,27.8,1685.2,52,1,1,6,5,9,0,0,0,0,15650,6.4,16183,195,43,-1202,-1333,23.8,1565.0
4817367401,0,12,1,0,3,6,1,0,0,0,0,14663,6.6,16785,207,56,-3436,-2130,26.3,1466.3,9,1,1,6,3,12,1,1,0,0,18099,7.2,18915,241,59,3436,2130,30.0,1809.9
4817334647,1,12,0,0,6,5,9,0,0,0,0,17873,6.8,18356,232,64,889,-449,29.6,1787.3,15,1,1,5,6,3,1,1,0,0,16984,7.2,18805,244,64,-889,449,30.8,1698.4
4817308430,1,34,0,1,5,8,5,0,0,0,0,15488,6.4,15947,194,51,-996,-616,24.5,1548.8,21,9,0,8,5,5,0,0,0,0,16484,6.6,16563,181,52,996,616,23.3,1648.4
4856499493,1,13,0,0,6,5,6,1,1,0,0,16306,6.6,17503,230,52,-2188,-1512,28.2,1630.6,18,1,1,5,6,5,0,0,0,0,18494,7.2,19015,249,64,2188,1512,31.3,1849.4
4851845437,0,14,1,1,5,4,7,1,1,0,0,17712,7.0,17979,225,44,1568,-1353,26.9,1771.2,119,2,0,4,5,3,0,0,0,0,16144,7.0,19332,217,64,-1568,1353,28.1,1614.4
4849045676,0,78,3,0,5,9,8,0,0,0,0,17116,6.6,17328,207,64,-1275,395,27.1,1711.6,16,3,1,9,5,10,1,1,0,0,18391,6.6,16933,217,36,1275,-395,25.3,1839.1
4849008744,0,14,0,1,8,8,10,0,0,0,0,17834,7.0,18443,220,59,1446,820,27.9,1783.4,16,1,0,8,8,7,0,0,0,0,16388,6.8,17623,210,44,-1446,-820,25.4,1638.8
4848960827,1,19,0,0,2,5,1,1,1,0,0,15661,7.2,18465,225,84,-1019,120,30.9,1566.1,17,1,1,5,2,7,0,0,0,0,16680,7.0,18345,235,56,1019,-120,29.1,1668.0
4848178397,1,12,0,0,4,1,5,0,0,0,0,16623,7.4,19456,253,58,1717,1403,31.1,1662.3,9,2,1,1,4,2,0,0,0,0,14906,7.0,18053,254,53,-1717,-1403,30.7,1490.6
4848151942,1,14,0,0,26,28,49,0,0,0,0,37349,11.4,41676,104,0,899,74,10.4,3734.9,0,0,1,28,26,74,0,0,0,0,36450,11.4,41602,104,0,-899,-74,10.4,3645.0
4848128996,1,0,0,0,19,23,28,0,0,0,0,37018,11.2,40316,99,0,-229,-841,9.9,3701.8,0,0,1,23,19,47,0,0,0,0,37247,11.2,41157,110,0,229,841,11.0,3724.7
4847968225,1,22,0,1,8,10,8,0,0,0,0,19002,6.8,18529,240,52,854,1348,29.2,1900.2,20,1,0,10,8,13,0,0,0,0,18148,6.8,17181,198,53,-854,-1348,25.1,1814.8
4847926860,0,13,2,0,4,10,6,0,0,0,0,17128,7.0,18086,211,39,-1644,-1405,25.0,1712.8,23,1,1,10,4,7,0,0,0,0,18772,7.4,19491,237,60,1644,1405,29.7,1877.2
4847151529,0,93,0,1,2,8,1,1,1,0,0,14840,7.2,17943,214,68,-3225,-804,28.2,1484.0,15,0,0,8,2,7,1,0,1,0,18065,7.0,18747,218,56,3225,804,27.4,1806.5
4847120179,0,13,1,0,1,3,1,1,0,1,0,15509,7.0,18761,215,72,131,1450,28.7,1550.9,24,2,1,3,1,2,1,1,0,0,15378,6.8,17311,228,56,-131,-1450,28.4,1537.8
4822055979,1,17,1,0,8,3,8,0,0,0,0,18877,7.2,19959,224,56,3641,2651,28.0,1887.7,15,1,1,3,8,3,0,0,0,0,15236,6.8,17308,210,60,-3641,-2651,27.0,1523.6
4810638863,0,15,3,0,4,5,4,1,1,0,0,15373,6.8,17105,165,44,-101,-147,20.9,1537.3,16,2,1,5,4,2,0,0,0,0,15474,6.6,17252,186,48,101,147,23.4,1547.4
4809419635,0,22,5,1,6,5,4,0,0,0,0,16774,6.8,16808,225,44,709,-701,26.9,1677.4,19,3,0,5,6,3,1,1,0,0,16065,7.0,17509,216,56,-709,701,27.2,1606.5
4808165593,1,14,1,0,9,4,9,0,0,0,0,19618,7.2,19892,251,60,4457,3431,31.1,1961.8,16,0,1,4,9,5,0,0,0,0,15161,6.8,16461,209,36,-4457,-3431,24.5,1516.1
4808138972,0,12,1,0,1,5,0,0,0,0,0,15776,6.8,18409,233,76,-1479,-1237,30.9,1577.6,12,2,1,5,1,5,1,1,0,0,17255,7.2,19646,220,68,1479,1237,28.8,1725.5
4808110352,0,13,1,0,6,11,8,0,0,0,0,16650,6.8,17653,206,52,-1941,-278,25.8,1665.0,24,0,1,11,6,15,0,0,0,0,18591,7.0,17931,208,64,1941,278,27.2,1859.1
4802106368,0,11,2,0,8,6,6,0,0,0,0,17170,6.8,17347,208,43,180,-657,25.1,1717.0,25,1,1,6,8,5,0,0,0,0,16990,7.0,18004,200,60,-180,657,26.0,1699.0
4801081352,0,21,2,0,5,6,6,0,0,0,0,17856,7.0,17906,223,56,1251,422,27.9,1785.6,10,0,1,6,5,6,1,1,0,0,16605,7.0,17484,244,48,-1251,-422,29.2,1660.5
4851533686,0,15,2,0,7,9,7,0,0,0,0,17389,6.4,16151,224,34,-274,-1083,25.8,1738.9,15,0,1,9,7,15,0,0,0,0,17663,6.8,17234,199,61,274,1083,26.0,1766.3
4851509431,1,14,0,1,8,7,4,1,1,0,0,17059,7.2,18835,208,60,-66,1967,26.8,1705.9,29,5,0,7,8,5,0,0,0,0,17125,6.6,16868,187,52,66,-1967,23.9,1712.5
4851486281,1,14,3,0,7,4,4,0,0,0,0,16544,6.6,16712,193,62,-1114,-904,25.5,1654.4,14,2,1,4,7,5,0,0,0,0,17658,7.0,17616,237,30,1114,904,26.7,1765.8
4850541781,1,10,0,1,5,2,4,0,0,0,0,15636,7.0,18106,193,68,441,1259,26.1,1563.6,19,0,0,2,5,0,0,0,0,0,15195,6.6,16847,231,52,-441,-1259,28.3,1519.5
4848272118,1,38,1,0,6,6,4,0,0,0,0,16604,7.0,17512,217,60,394,-434,27.7,1660.4,271,0,1,6,6,3,0,0,0,0,16210,7.0,17946,187,60,-394,434,24.7,1621.0
4848254092,0,16,1,0,3,6,1,0,0,0,0,14662,6.4,16412,193,52,-2219,-1170,24.5,1466.2,14,2,1,6,3,3,1,1,0,0,16881,6.6,17582,205,51,2219,1170,25.6,1688.1
4848222683,0,17,1,1,6,1,7,0,0,0,0,17390,7.0,18799,245,46,2125,1459,29.1,1739.0,15,1,0,1,6,2,0,0,0,0,15265,6.8,17340,214,60,-2125,-1459,27.4,1526.5
4837473022,0,12,0,1,6,10,4,0,0,0,0,16295,6.4,15261,189,26,-1659,-1695,21.5,1629.5,13,2,0,10,6,13,0,0,0,0,17954,6.6,16956,165,52,1659,1695,21.7,1795.4
4837448702,1,14,1,1,9,11,7,1,1,0,0,18302,6.8,17545,196,48,-524,-607,24.4,1830.2,69,2,0,11,9,9,0,0,0,0,18826,6.8,18152,224,52,524,607,27.6,1882.6
4837438890,1,12,0,1,16,13,6,0,0,0,0,20574,7.0,18705,161,56,1109,418,21.7,2057.4,10,1,0,13,16,7,0,0,0,0,19465,6.8,18287,202,52,-1109,-418,25.4,1946.5
4830988542,1,11,1,1,4,4,2,1,1,0,0,16026,7.0,18495,222,76,-1059,-419,29.8,1602.6,15,0,0,4,4,4,0,0,0,0,17085,7.4,18914,243,72,1059,419,31.5,1708.5
4825072757,1,34,5,1,9,4,11,0,0,0,0,18183,7.0,18422,207,64,2255,-411,27.1,1818.3,36,1,0,4,9,3,0,0,0,0,15928,7.2,18833,213,60,-2255,411,27.3,1592.8
4821194741,0,12,0,1,10,12,10,0,0,0,0,18187,6.2,15645,163,40,-1475,-713,20.3,1818.7,12,0,0,12,10,12,0,0,0,0,19662,6.4,16358,174,23,1475,713,19.7,1966.2
4821150798,1,11,0,1,9,3,7,0,0,0,0,18342,6.8,18115,209,43,1965,172,25.2,1834.2,14,1,0,3,9,4,0,0,0,0,16377,6.8,17943,214,72,-1965,-172,28.6,1637.7
4820989304,1,55,3,1,10,2,16,0,0,0,0,18406,6.8,17880,221,40,3649,780,26.1,1840.6,10,5,0,2,10,0,0,0,0,0,14757,6.6,17100,201,56,-3649,-780,25.7,1475.7
4817294302,1,12,0,1,8,7,6,0,0,0,0,17718,7.4,19326,219,68,1227,686,28.7,1771.8,13,0,0,7,8,5,1,1,0,0,16491,7.0,18640,190,64,-1227,-686,25.4,1649.1
4817262028,1,6,1,0,2,7,1,0,0,0,0,16619,7.0,18084,215,58,-6,-217,27.3,1661.9,15,0,1,7,2,2,0,0,0,0,16625,7.2,18301,239,45,6,217,28.4,1662.5
4817209986,1,18,0,1,7,8,4,0,0,0,2,20426,7.2,18567,215,44,972,1922,25.9,2042.6,8,0,0,8,7,11,0,0,0,0,19454,6.8,16645,155,67,-972,-1922,22.2,1945.4
4817170639,0,23,1,0,14,13,11,0,0,0,0,20914,7.0,18426,164,51,780,363,21.5,2091.4,11,2,1,13,14,11,0,0,0,0,20134,6.8,18063,196,56,-780,-363,25.2,2013.4
4814836937,0,13,2,1,6,4,5,0,0,0,0,17092,7.2,19277,211,60,699,-467,27.1,1709.2,13,0,0,4,6,3,0,0,0,0,16393,7.4,19744,203,64,-699,467,26.7,1639.3
4852013176,1,17,1,1,10,6,7,1,1,0,0,17953,7.0,18212,208,48,2752,1739,25.6,1795.3,11,2,0,6,10,3,0,0,0,0,15201,6.6,16473,156,55,-2752,-1739,21.1,1520.1
4851992734,0,9,1,0,3,10,3,0,0,0,0,14526,6.6,16048,157,56,-4102,-3589,21.3,1452.6,8,0,1,10,3,3,0,0,0,0,18628,7.2,19637,228,76,4102,3589,30.4,1862.8
4851975146,1,14,1,0,6,1,3,0,0,0,0,17709,7.0,17852,192,48,3706,728,24.0,1770.9,13,1,1,1,6,0,0,0,0,0,14003,6.6,17124,179,54,-3706,-728,23.3,1400.3
4851949660,0,9,1,0,1,4,0,0,0,0,0,13690,6.8,17739,206,60,-2075,-551,26.6,1369.0,10,0,1,4,1,6,1,1,0,0,15765,6.8,18290,209,60,2075,551,26.9,1576.5
4839996903,1,12,0,1,6,6,3,0,0,0,0,18103,7.2,19103,237,64,240,961,30.1,1810.3,11,1,0,6,6,8,0,0,0,0,17863,7.0,18142,194,56,-240,-961,25.0,1786.3
4839969626,1,12,0,0,8,5,4,1,1,0,0,17967,7.0,18264,228,57,865,-27,28.5,1796.7,14,0,1,5,8,7,1,0,1,0,17102,7.0,18291,197,47,-865,27,24.4,1710.2
4792640253,1,221,0,1,13,7,8,1,1,0,0,21098,7.2,19157,182,55,5093,3739,23.7,2109.8,3,1,0,7,13,5,0,0,0,0,16005,6.2,15418,176,16,-5093,-3739,19.2,1600.5
4791642344,1,14,2,1,4,8,3,0,0,0,0,15242,6.6,16605,181,52,-624,-1505,23.3,1524.2,19,1,0,8,4,3,1,1,0,0,15866,7.2,18110,184,64,624,1505,24.8,1586.6
4791631933,1,13,0,1,7,4,6,0,0,0,0,17428,6.6,16392,162,51,2379,513,21.3,1742.8,11,0,0,4,7,3,0,0,0,0,15049,6.6,15879,208,40,-2379,-513,24.8,1504.9
4791608195,0,34,2,1,8,5,4,0,0,0,0,18001,6.8,17708,198,60,1049,1267,25.8,1800.1,34,1,0,5,8,2,0,0,0,0,16952,6.4,16441,173,56,-1049,-1267,22.9,1695.2
4790484614,0,10,2,0,6,9,4,0,0,0,0,16205,6.8,16937,194,68,-1891,-466,26.2,1620.5,13,1,1,9,6,12,2,1,1,0,18096,6.8,17403,167,58,1891,466,22.5,1809.6
4790063923,0,12,1,0,6,5,3,1,1,0,0,16297,7.0,17697,172,52,412,-921,22.4,1629.7,5,0,1,5,6,2,0,0,0,0,15885,7.0,18618,161,68,-412,921,22.9,1588.5
4790050236,0,12,0,0,3,6,1,0,0,0,1,16496,6.6,16469,180,44,910,3994,22.4,1649.6,23,0,1,6,3,11,0,0,0,0,15586,5.6,12475,115,44,-910,-3994,15.9,1558.6
4783775533,0,8,0,0,10,7,6,0,0,0,0,18712,7.2,18674,212,55,2494,1887,26.7,1871.2,6,1,1,7,10,4,0,0,0,0,16218,6.8,16787,145,48,-2494,-1887,19.3,1621.8
4783758189,0,14,2,0,4,8,1,0,0,0,0,16426,7.2,18060,220,50,-925,-551,27.0,1642.6,14,0,1,8,4,5,0,0,0,0,17351,7.0,18611,197,60,925,551,25.7,1735.1
4783731425,0,14,0,0,6,7,10,0,0,0,0,16672,6.8,17449,194,49,-1620,-2381,24.3,1667.2,32,1,1,7,6,3,0,0,0,0,18292,7.4,19830,232,70,1620,2381,30.2,1829.2
4782926152,1,10,0,0,6,6,5,0,0,0,0,15956,6.4,15775,179,48,-1630,-1017,22.7,1595.6,12,0,1,6,6,7,0,0,0,0,17586,6.6,16792,198,64,1630,1017,26.2,1758.6
4778972870,1,12,0,1,8,2,8,1,0,1,0,17705,6.8,17945,222,44,3159,833,26.6,1770.5,7,0,0,2,8,2,0,0,0,0,14546,6.8,17112,192,56,-3159,-833,24.8,1454.6
4778951899,0,44,0,0,6,7,4,0,0,0,0,15252,6.4,14911,146,52,-4158,-2720,19.8,1525.2,16,2,1,7,6,5,1,1,0,0,19410,6.8,17631,209,63,4158,2720,27.2,1941.0
4857628720,1,19,2,1,5,1,3,0,0,0,0,17124,6.8,18195,221,55,3130,1161,27.6,1712.4,8,0,0,1,5,1,1,1,0,0,13994,6.6,17034,168,51,-3130,-1161,21.9,1399.4
4857596843,1,23,2,1,4,9,5,0,0,0,0,15895,6.8,17611,224,53,-1439,-779,27.7,1589.5,12,5,0,8,3,7,1,1,0,0,17334,6.8,18390,240,52,1439,779,29.2,1733.4
4857565283,0,20,2,0,8,5,8,0,0,0,0,18112,7.0,18228,220,56,696,-40,27.6,1811.2,12,4,1,5,8,5,0,0,0,0,17416,7.2,18268,225,55,-696,40,28.0,1741.6
4857531571,0,12,0,0,1,6,2,0,0,0,0,15367,6.8,17554,234,55,-1732,-875,28.9,1536.7,9,1,1,6,1,4,0,0,0,0,17099,7.2,18429,244,61,1732,875,30.5,1709.9
4857224167,1,0,0,1,19,18,18,0,0,0,0,48050,10.0,47500,0,0,19500,19000,0.0,4805.0,0,0,0,10,11,9,0,0,0,0,28550,6.0,28500,0,0,-19500,-19000,0.0,2855.0
4857051749,1,0,0,1,30,23,80,0,0,0,2,40009,11.6,42808,117,0,2238,3412,11.7,4000.9,0,0,0,23,30,68,0,0,0,0,37771,10.8,39396,106,0,-2238,-3412,10.6,3777.1
4857028936,1,5,0,1,16,17,37,0,0,0,1,34509,10.6,36496,102,0,17,-690,10.2,3450.9,0,2,0,17,16,40,0,0,0,0,34492,10.6,37186,116,0,-17,690,11.6,3449.2
4857009905,1,0,0,1,33,26,95,0,0,0,1,39421,11.4,42894,120,0,324,-195,12.0,3942.1,0,0,0,26,33,69,0,0,0,0,39097,11.4,43089,93,0,-324,195,9.3,3909.7
4856974070,1,10,1,1,7,7,7,2,1,1,0,18688,7.2,18771,228,59,2262,280,28.7,1868.8,11,0,0,7,7,1,0,0,0,0,16426,7.0,18491,205,48,-2262,-280,25.3,1642.6
4856938624,1,16,1,1,7,6,6,0,0,0,0,16783,6.8,17396,212,43,-36,330,25.5,1678.3,15,0,0,6,7,4,0,0,0,0,16819,6.8,17066,206,48,36,-330,25.4,1681.9
4854141178,0,1,0,1,23,21,56,0,0,0,0,37382,11.2,40187,93,0,2671,1441,9.3,3738.2,41,0,0,21,23,51,0,0,0,0,34711,11.0,38746,84,0,-2671,-1441,8.4,3471.1
4854110430,0,0,2,1,31,26,75,0,0,0,1,40452,11.6,43911,118,0,2715,2246,11.8,4045.2,4,0,0,26,31,72,0,0,0,0,37737,11.4,41665,99,0,-2715,-2246,9.9,3773.7
4854084715,0,0,0,0,23,19,50,0,0,0,1,36316,11.2,40392,96,0,-1602,1162,9.6,3631.6,0,0,1,19,23,44,0,0,0,0,37918,10.8,39230,104,0,1602,-1162,10.4,3791.8
4854052352,1,14,0,1,31,28,75,0,0,0,0,40606,12.0,46511,104,0,1726,4404,10.4,4060.6,12,1,0,28,31,60,0,0,0,0,38880,11.4,42107,97,0,-1726,-4404,9.7,3888.0
4853579794,1,63,0,0,39,30,124,0,0,0,1,41863,12.0,46325,104,0,2199,1692,10.4,4186.3,133,1,1,30,39,82,0,0,0,0,39664,11.8,44633,95,0,-2199,-1692,9.5,3966.4
4853557185,0,0,0,0,21,26,61,0,0,0,1,36856,11.2,40852,107,0,-1259,-489,10.7,3685.6,0,0,1,26,21,62,0,0,0,0,38115,11.2,41341,111,0,1259,489,11.1,3811.5
4853442209,0,12,2,0,6,11,6,0,0,0,0,16183,6.6,16609,208,52,-3143,-2701,26.0,1618.3,11,1,1,11,6,10,1,1,0,0,19326,7.2,19310,233,60,3143,2701,29.3,1932.6
4853358396,0,14,1,0,3,5,2,1,1,0,0,15338,7.0,17278,189,60,-2033,-1316,24.9,1533.8,175,2,1,5,3,2,0,0,0,0,17371,7.2,18594,216,52,2033,1316,26.8,1737.1
4853338111,1,38,4,1,8,3,8,0,0,0,0,17864,7.0,18359,225,60,3452,2245,28.5,1786.4,19,14,0,3,8,2,0,0,0,0,14412,6.8,16114,180,44,-3452,-2245,22.4,1441.2
4853322133,0,94,3,0,5,5,5,1,1,0,0,16018,7.2,18119,217,64,-732,-258,28.1,1601.8,16,7,1,4,4,6,0,0,0,0,16750,7.0,18377,235,52,732,258,28.7,1675.0
4858138295,0,0,0,1,27,31,73,0,0,0,2,38517,11.4,40556,87,0,-2711,-4951,8.7,3851.7,3,0,0,31,27,91,0,0,0,0,41228,12.0,45507,112,0,2711,4951,11.2,4122.8
4858121814,1,3,1,0,28,29,81,0,0,0,1,40146,11.8,43302,119,0,2673,1286,11.9,4014.6,13,0,1,29,28,82,0,0,0,0,37473,11.4,42016,89,0,-2673,-1286,8.9,3747.3
4858106777,1,0,0,0,19,21,49,0,0,0,1,37547,11.0,39964,102,0,995,-690,10.2,3754.7,0,0,1,21,19,53,0,0,0,0,36552,11.0,40654,105,0,-995,690,10.5,3655.2
4857937629,1,6,0,0,18,13,12,0,0,0,0,46650,10.0,47500,0,0,18800,19000,0.0,4665.0,0,0,1,4,9,9,0,0,0,0,27850,6.0,28500,0,0,-18800,-19000,0.0,2785.0
4857187045,1,0,0,0,12,16,11,0,0,0,0,44200,10.4,49000,0,1,15300,20500,0.1,4420.0,0,0,1,11,7,11,0,0,0,0,28900,6.0,28500,0,0,-15300,-20500,0.0,2890.0
4857163052,1,0,0,1,14,19,14,0,0,0,0,45252,10.6,50500,0,0,16002,22000,0.0,4525.2,0,0,0,12,7,13,0,0,0,0,29250,6.0,28500,0,0,-16002,-22000,0.0,2925.0
4856837649,1,4,0,1,12,11,12,0,0,0,0,31300,9.0,40000,0,0,12775,16000,0.0,3130.0,20,0,0,8,9,5,0,0,0,0,18525,5.4,24000,1,0,-12775,-16000,0.1,1852.5
4856825453,1,5,0,1,15,12,24,0,0,0,0,46650,10.0,47500,0,0,20900,19000,0.0,4665.0,0,0,0,8,11,2,0,0,0,0,25750,6.0,28500,0,0,-20900,-19000,0.0,2575.0
4856818303,1,331,0,1,13,14,14,0,0,0,0,44808,10.0,47500,4,0,17644,19000,0.4,4480.8,8,0,0,10,9,8,0,0,0,0,27164,6.0,28500,0,0,-17644,-19000,0.0,2716.4
4856813831,1,0,0,1,10,18,13,0,0,0,0,59200,12.4,57000,0,0,21300,24000,0.0,5920.0,0,0,0,13,5,10,0,0,0,0,37900,7.2,33000,0,0,-21300,-24000,0.0,3790.0
4856541189,0,14,0,1,29,22,65,0,0,0,0,37677,11.4,40940,97,0,430,335,9.7,3767.7,15,1,0,21,28,65,0,0,0,0,37247,11.0,40605,75,0,-430,-335,7.5,3724.7
4856525386,1,0,0,1,45,27,130,0,0,0,1,42633,12.2,48372,118,0,4055,5089,11.8,4263.3,7,0,0,26,44,57,0,0,0,0,38578,11.4,43283,98,0,-4055,-5089,9.8,3857.8
4856507075,1,0,0,0,25,26,61,0,0,0,0,37654,11.4,41877,97,0,549,623,9.7,3765.4,0,0,1,26,25,77,0,0,0,0,37105,11.2,41254,100,0,-549,-623,10.0,3710.5
4856483284,1,0,0,1,12,18,39,0,0,0,0,33734,10.4,36030,93,0,-1219,-414,9.3,3373.4,2,0,0,18,12,47,0,0,0,0,34953,10.6,36444,99,0,1219,414,9.9,3495.3
4856463046,1,0,0,0,22,27,50,0,0,0,1,37049,11.0,39167,102,0,-2473,-4987,10.2,3704.9,0,0,1,27,22,83,0,0,0,0,39522,11.6,44154,101,0,2473,4987,10.1,3952.2
4856425888,0,9,1,0,5,3,4,0,0,0,0,16544,6.8,17533,200,56,913,-222,25.6,1654.4,10,2,1,3,5,2,1,1,0,0,15631,7.0,17755,210,64,-913,222,27.4,1563.1
4856392015,1,13,0,0,3,7,0,0,0,0,0,14373,6.6,16987,195,51,-2459,183,24.6,1437.3,12,0,1,7,3,9,0,0,0,0,16832,6.6,16804,198,52,2459,-183,25.0,1683.2
4856355600,1,12,3,1,7,1,7,0,0,0,0,16999,7.0,17948,218,49,2822,448,26.7,1699.9,13,1,0,1,7,0,0,0,0,0,14177,6.8,17500,205,62,-2822,-448,26.7,1417.7
4856304077,1,12,0,0,2,10,2,0,0,0,0,14863,6.8,17247,201,58,-3454,-2522,25.9,1486.3,8,0,1,10,2,8,0,0,0,0,18317,7.4,19769,221,64,3454,2522,28.5,1831.7
4856228034,1,17,1,0,9,2,5,0,0,0,0,18550,7.2,19377,231,56,4364,3291,28.7,1855.0,12,1,1,2,9,2,0,0,0,0,14186,6.6,16086,179,44,-4364,-3291,22.3,1418.6
4794905997,0,13,3,0,2,5,3,0,0,0,0,15398,6.8,17446,223,42,-2264,-1559,26.5,1539.8,14,5,1,5,2,6,1,1,0,0,17662,7.2,19005,219,68,2264,1559,28.7,1766.2
4769625326,1,32,1,1,7,7,8,0,0,0,0,17263,6.4,15655,204,40,45,-1757,24.4,1726.3,15,1,0,7,7,8,1,1,0,0,17218,6.8,17412,220,67,-45,1757,28.7,1721.8
4769594557,1,10,3,0,6,7,7,1,1,0,0,16004,6.8,17371,230,40,-1440,-582,27.0,1600.4,20,2,1,7,6,5,1,0,1,0,17444,7.0,17953,231,64,1440,582,29.5,1744.4
4769507168,1,13,1,0,3,4,2,1,0,1,0,17266,7.0,18848,216,72,-312,795,28.8,1726.6,10,2,1,4,3,4,0,0,0,0,17578,6.8,18053,259,51,312,-795,31.0,1757.8
4762014057,1,39,2,0,8,2,10,0,0,0,0,17987,6.8,18472,251,56,2262,356,30.7,1798.7,33,2,1,2,8,2,1,1,0,0,15725,7.0,18116,205,52,-2262,-356,25.7,1572.5
4761989096,0,11,2,1,5,5,6,1,1,0,0,15987,6.6,16803,206,60,-100,-1156,26.6,1598.7,32,1,0,5,5,2,0,0,0,0,16087,6.8,17959,237,48,100,1156,28.5,1608.7
4761951369,1,11,2,1,2,4,3,0,0,0,0,15529,6.6,17042,235,40,-930,-1514,27.5,1552.9,14,0,0,4,2,4,0,0,0,0,16459,7.0,18556,248,64,930,1514,31.2,1645.9
4758164433,1,13,0,1,10,4,8,0,0,0,0,19842,7.4,19521,232,59,2391,146,29.1,1984.2,10,3,0,4,10,3,1,1,0,0,17451,7.2,19375,256,60,-2391,-146,31.6,1745.1
4758141930,1,32,2,0,4,2,8,0,0,0,0,16950,7.2,19076,230,80,1940,1230,31.0,1695.0,31,1,1,2,4,3,0,0,0,0,15010,6.8,17846,200,64,-1940,-1230,26.4,1501.0
4757782481,0,18,2,1,7,3,4,1,1,0,0,17317,7.0,18167,202,55,1920,1680,25.7,1731.7,12,3,0,3,7,1,0,0,0,0,15397,6.6,16487,197,57,-1920,-1680,25.4,1539.7
4756742771,0,11,0,0,2,12,0,0,0,0,0,14731,6.8,17806,202,56,-5336,-2701,25.8,1473.1,11,0,1,12,2,11,1,1,0,0,20067,7.4,20507,232,60,5336,2701,29.2,2006.7
4756407850,1,65,1,0,3,6,2,0,0,0,0,16020,7.0,18219,224,55,-433,279,27.9,1602.0,14,0,1,6,3,7,0,0,0,0,16453,7.0,17940,195,52,433,-279,24.7,1645.3
4756379824,1,18,1,0,9,7,11,0,0,0,0,17635,7.0,17859,200,60,-868,-67,26.0,1763.5,14,4,1,7,9,5,0,0,0,0,18503,6.8,17926,239,48,868,67,28.7,1850.3
4756343908,0,13,11,1,9,6,10,1,1,0,0,18436,7.0,17885,198,60,1198,330,25.8,1843.6,34,1,0,6,9,8,0,0,0,0,17238,7.0,17555,195,60,-1198,-330,25.5,1723.8
4752066249,1,14,1,0,6,2,4,0,0,0,0,17025,7.2,18682,242,56,2509,714,29.8,1702.5,12,0,1,2,6,1,0,0,0,0,14516,7.0,17968,222,56,-2509,-714,27.8,1451.6
4752040799,0,8,2,1,6,5,5,0,0,0,0,16113,7.0,17574,206,56,-1346,-1696,26.2,1611.3,13,0,0,5,6,6,1,1,0,0,17459,7.2,19270,240,60,1346,1696,30.0,1745.9
4751990854,0,12,1,1,6,6,14,0,0,0,0,17791,6.8,17485,232,52,184,-899,28.4,1779.1,11,0,0,6,6,9,1,0,1,0,17607,7.0,18384,238,60,-184,899,29.8,1760.7
4751873107,1,10,0,0,1,1,1,0,0,0,0,14460,7.0,18185,224,58,-340,-133,28.2,1446.0,13,1,1,1,1,0,0,0,0,0,14800,6.8,18318,248,54,340,133,30.2,1480.0
4828310356,0,16,2,0,8,11,8,0,0,0,0,18093,7.4,19665,245,74,-615,1727,31.9,1809.3,12,1,1,11,8,15,1,1,0,0,18708,7.2,17938,226,61,615,-1727,28.7,1870.8
4822394652,0,14,1,0,6,4,8,1,0,1,0,17837,7.4,19672,217,80,1034,659,29.7,1783.7,13,1,1,4,6,5,1,1,0,0,16803,7.0,19013,256,67,-1034,-659,32.3,1680.3
4820516796,1,12,1,1,2,2,1,0,0,0,0,14238,6.8,17310,186,48,124,-85,23.4,1423.8,13,1,0,2,2,1,0,0,0,0,14114,6.8,17395,205,54,-124,85,25.9,1411.4
4813780314,0,14,11,0,4,7,6,1,1,0,0,15126,6.6,16729,201,56,-2733,-1527,25.7,1512.6,35,0,1,7,4,5,0,0,0,0,17859,7.0,18256,225,54,2733,1527,27.9,1785.9
4808091573,1,14,2,1,9,4,6,0,0,0,0,17780,7.0,17958,219,64,918,1406,28.3,1778.0,14,0,0,4,9,8,0,0,0,0,16862,6.6,16552,211,48,-918,-1406,25.9,1686.2
4806226015,1,15,3,0,10,4,11,0,0,0,0,17443,6.8,17623,199,52,2239,1307,25.1,1744.3,78,1,1,4,10,2,0,0,0,0,15204,6.6,16316,178,52,-2239,-1307,23.0,1520.4
4800657422,1,15,0,1,1,3,3,1,1,0,0,15541,7.2,18768,243,56,-404,384,29.9,1554.1,9,0,0,3,1,3,1,0,1,0,15945,6.8,18384,241,52,404,-384,29.3,1594.5
4795819081,0,13,1,1,6,8,4,0,0,0,0,17230,6.6,16698,212,48,-1830,-2927,26.0,1723.0,12,1,0,8,6,7,0,0,0,0,19060,7.2,19625,228,56,1830,2927,28.4,1906.0
4788527231,1,13,1,0,7,4,5,1,0,1,0,17575,7.2,18588,217,66,758,564,28.3,1757.5,12,2,1,4,7,7,0,0,0,0,16817,6.8,18024,219,64,-758,-564,28.3,1681.7
4781192246,0,13,1,0,8,10,13,0,0,0,0,18038,6.8,17353,219,51,-970,-204,27.0,1803.8,77,2,1,10,8,12,1,1,0,0,19008,7.0,17557,210,56,970,204,26.6,1900.8
4775629194,0,69,0,0,9,10,5,0,0,0,0,18646,6.6,17805,214,48,-199,-659,26.2,1864.6,12,3,1,10,9,7,0,0,0,0,18845,7.2,18464,218,63,199,659,28.1,1884.5
4769527528,1,12,0,1,6,1,1,1,1,0,0,18390,7.0,18915,221,64,5665,2948,28.5,1839.0,9,0,0,1,6,0,0,0,0,0,12725,6.6,15967,151,64,-5665,-2948,21.5,1272.5
4768578568,1,10,0,1,5,6,2,0,0,0,0,14575,6.8,17449,173,67,-1820,442,24.0,1457.5,12,0,0,6,5,6,0,0,0,0,16395,6.6,17007,212,32,1820,-442,24.4,1639.5
4768468826,1,13,1,1,8,1,6,0,0,0,0,18667,6.8,17981,218,46,3224,139,26.4,1866.7,13,0,0,1,8,1,0,0,0,0,15443,7.0,17842,236,64,-3224,-139,30.0,1544.3
4767897488,0,8,1,0,2,7,0,0,0,0,0,14146,6.8,17963,167,68,-1350,467,23.5,1414.6,295,0,1,7,2,3,0,0,0,0,15496,6.8,17496,178,56,1350,-467,23.4,1549.6
4751628685,1,3,0,0,12,15,18,0,0,0,0,62366,12.2,56000,2,0,24803,23000,0.2,6236.6,0,0,1,12,9,5,0,0,0,0,37563,7.2,33000,1,0,-24803,-23000,0.1,3756.3
4751621128,1,0,0,1,16,12,13,0,0,0,0,61348,12.0,55000,0,0,24750,22000,0.0,6134.8,0,0,0,6,10,9,0,0,0,0,36598,7.2,33000,0,0,-24750,-22000,0.0,3659.8
4750538740,1,7,0,1,16,13,13,0,0,0,0,63237,12.0,55000,0,0,26724,22000,0.0,6323.7,111,0,0,7,10,7,0,0,0,0,36513,7.2,33000,0,0,-26724,-22000,0.0,3651.3
4750527090,1,21,0,1,19,13,20,0,0,0,0,62700,12.8,61000,0,0,26894,25000,0.0,6270.0,0,0,0,6,12,6,0,0,0,0,35806,7.6,36000,0,0,-26894,-25000,0.0,3580.6
4750520901,1,0,0,0,19,21,24,0,0,0,0,76608,15.6,76920,0,0,32358,36420,0.0,7660.8,0,0,1,13,11,11,0,0,0,0,44250,8.6,40500,0,0,-32358,-36420,0.0,4425.0
4858130383,1,14,4,1,8,6,10,0,0,0,0,17692,6.6,17463,212,40,605,795,25.2,1769.2,241,0,0,6,8,7,0,0,0,0,17087,6.8,16668,236,54,-605,-795,29.0,1708.7
4858083620,0,10,1,0,3,8,2,0,0,0,0,14911,6.8,18321,204,68,-2709,-1097,27.2,1491.1,14,1,1,8,3,8,2,1,1,0,17620,7.2,19418,236,56,2709,1097,29.2,1762.0
4857593573,0,10,0,0,6,5,8,1,1,0,0,15279,6.6,16482,175,64,-1675,-1485,23.9,1527.9,10,0,1,5,6,3,0,0,0,0,16954,7.0,17967,231,64,1675,1485,29.5,1695.4
4857546271,0,8,0,1,4,6,3,0,0,0,0,16255,7.0,17897,214,52,171,1169,26.6,1625.5,11,1,0,6,4,5,0,0,0,0,16084,6.6,16728,184,56,-171,-1169,24.0,1608.4
4857513965,1,0,0,1,20,13,21,0,0,0,0,64866,13.0,62500,0,0,28355,25500,0.0,6486.6,75,0,0,9,16,4,0,0,0,0,36511,8.0,37000,0,0,-28355,-25500,0.0,3651.1
4857403834,1,49,1,0,4,6,3,0,0,0,0,15449,6.8,17539,208,52,225,550,26.0,1544.9,14,1,1,6,4,8,1,1,0,0,15224,6.6,16989,204,44,-225,-550,24.8,1522.4
4857348351,0,16,2,0,7,15,11,0,0,0,0,15990,6.4,15600,155,48,-5469,-3563,20.3,1599.0,13,3,1,15,7,14,1,1,0,0,21459,7.0,19163,248,51,5469,3563,29.9,2145.9
4857281668,1,8,1,1,6,5,6,0,0,0,0,17972,7.0,18083,218,44,2817,2458,26.2,1797.2,9,1,0,4,5,9,0,0,0,0,15155,6.2,15625,140,60,-2817,-2458,20.0,1515.5
4857201406,1,10,5,0,4,4,4,0,0,0,0,15242,6.8,17858,213,48,-1713,-934,26.1,1524.2,18,3,1,4,4,3,1,1,0,0,16955,7.4,18792,242,52,1713,934,29.4,1695.5
4856596005,0,37,1,0,4,6,2,0,0,0,0,15937,6.8,16939,180,52,-1265,-1797,23.2,1593.7,12,12,1,6,4,5,0,0,0,0,17202,7.0,18736,220,56,1265,1797,27.6,1720.2
4856577918,1,13,2,1,8,2,6,0,0,0,0,19068,7.2,19362,232,68,4360,1666,30.0,1906.8,10,2,0,2,8,1,0,0,0,0,14708,7.0,17696,206,72,-4360,-1666,27.8,1470.8
4856555277,1,0,0,1,16,14,15,0,0,0,0,45950,10.0,47500,0,0,18100,16000,0.0,4595.0,0,0,0,9,11,7,0,0,0,0,27850,6.6,31500,0,0,-18100,-16000,0.0,2785.0
4856537887,1,0,0,0,13,20,16,0,0,0,0,62350,12.4,57000,0,0,21300,22000,0.0,6235.0,0,0,1,14,7,12,0,0,0,0,41050,7.6,35000,0,0,-21300,-22000,0.0,4105.0
4856226030,1,0,0,0,11,23,14,0,0,0,0,45950,10.0,47500,0,0,15300,17500,0.0,4595.0,0,0,1,15,3,12,0,0,0,0,30650,6.4,30000,0,0,-15300,-17500,0.0,3065.0
4856201254,1,11,0,1,20,19,19,0,0,0,0,62350,12.0,55000,0,0,24800,18000,0.0,6235.0,0,0,0,10,11,9,0,0,0,0,37550,8.0,37000,0,0,-24800,-18000,0.0,3755.0
4856188910,1,22,0,0,26,13,31,0,0,0,0,65500,13.0,62500,0,0,29692,27000,0.0,6550.0,0,0,1,5,18,5,0,0,0,0,35808,7.6,35500,0,0,-29692,-27000,0.0,3580.8
4856038824,1,14,0,0,18,19,15,0,0,0,0,63050,12.0,55000,0,0,26200,22000,0.0,6305.0,2,0,1,10,9,12,0,0,0,0,36850,7.2,33000,0,0,-26200,-22000,0.0,3685.0
4856015483,1,0,0,1,12,13,16,0,0,0,0,44550,10.0,47500,0,0,18100,19000,0.0,4455.0,0,0,0,9,8,6,0,0,0,0,26450,6.0,28500,0,0,-18100,-19000,0.0,2645.0
4855993190,1,0,0,1,16,14,16,0,0,0,0,45767,10.0,47500,1,0,18218,19000,0.1,4576.7,78,0,0,9,11,7,0,0,0,0,27549,6.0,28500,0,0,-18218,-19000,0.0,2754.9
4855973337,1,3,0,0,13,18,13,0,0,0,0,46300,10.0,47500,0,0,18800,16640,0.0,4630.0,0,0,1,11,6,10,0,0,0,0,27500,6.4,30860,0,0,-18800,-16640,0.0,2750.0
4782677417,1,16,1,1,6,2,6,0,0,0,0,17136,7.0,18018,214,47,1893,236,26.1,1713.6,13,1,0,2,6,2,0,0,0,0,15243,7.0,17782,240,56,-1893,-236,29.6,1524.3
4782630271,0,12,1,0,4,3,1,0,0,0,0,14632,6.6,16979,211,57,-2310,-1313,26.8,1463.2,13,4,1,3,4,4,0,0,0,0,16942,7.2,18292,249,55,2310,1313,30.4,1694.2
4782591846,1,15,1,1,5,3,6,0,0,0,0,18705,7.2,18533,250,55,3280,2025,30.5,1870.5,135,0,0,3,5,2,0,0,0,0,15425,6.6,16508,193,60,-3280,-2025,25.3,1542.5
4782556213,1,18,0,1,9,9,6,0,0,0,0,18116,6.8,17641,230,67,-7,103,29.7,1811.6,9,4,0,9,9,9,0,0,0,0,18123,6.8,17538,203,54,7,-103,25.7,1812.3
4782518089,1,15,4,0,8,9,11,0,0,0,0,20104,7.4,20405,243,72,1539,3129,31.5,2010.4,24,2,1,9,8,13,0,0,0,0,18565,6.6,17276,168,60,-1539,-3129,22.8,1856.5
4782475947,1,13,2,1,3,5,6,0,0,0,0,15749,6.6,16756,211,55,-1327,-1508,26.6,1574.9,15,0,0,5,3,5,0,0,0,0,17076,7.0,18264,245,64,1327,1508,30.9,1707.6
4781602300,0,36,1,0,8,11,7,0,0,0,0,18677,6.8,17862,223,47,-1277,-767,27.0,1867.7,24,17,1,11,8,16,0,0,0,0,19954,7.0,18629,224,60,1277,767,28.4,1995.4
4781534099,1,13,0,0,5,8,3,0,0,0,0,17612,6.8,18346,252,51,-186,80,30.3,1761.2,11,2,1,8,5,10,1,1,0,0,17798,6.8,18266,216,64,186,-80,28.0,1779.8
4781508598,1,15,4,1,4,3,4,0,0,0,0,16957,7.2,18463,263,54,1652,1073,31.7,1695.7,29,2,0,3,4,2,0,0,0,0,15305,6.8,17390,214,53,-1652,-1073,26.7,1530.5
4770664223,1,15,3,1,2,6,2,0,0,0,0,16423,6.8,17771,240,43,-1060,-558,28.3,1642.3,14,0,0,6,2,6,1,1,0,0,17483,7.0,18329,234,64,1060,558,29.8,1748.3
4770611853,1,21,1,0,2,4,1,1,0,1,0,16687,7.0,18848,246,57,1077,195,30.3,1668.7,10,3,1,3,1,5,1,1,0,0,15610,7.0,18653,236,59,-1077,-195,29.5,1561.0
4770579339,0,13,0,1,7,9,5,0,0,0,0,16326,6.6,16531,185,50,-1461,-707,23.5,1632.6,13,0,0,8,6,12,0,0,0,0,17787,6.8,17238,202,49,1461,707,25.1,1778.7
4770553069,1,16,0,1,6,0,3,1,0,1,0,18119,7.0,18496,209,56,3744,1241,26.5,1811.9,12,1,0,0,6,0,0,0,0,0,14375,6.6,17255,239,52,-3744,-1241,29.1,1437.5
4770516418,0,42,3,1,3,6,3,2,1,1,0,16911,7.0,17761,213,70,-977,-1990,28.3,1691.1,11,11,0,6,3,7,0,0,0,0,17888,7.4,19751,237,60,977,1990,29.7,1788.8
4762971111,0,13,1,1,5,6,3,0,0,0,0,16207,6.8,16916,219,56,0,-731,27.5,1620.7,12,1,0,6,5,4,0,0,0,0,16207,6.8,17647,187,51,0,731,23.8,1620.7
4762930413,0,8,0,0,2,5,2,0,0,0,0,14259,6.4,15984,199,60,-3244,-2767,25.9,1425.9,10,0,1,5,2,3,1,1,0,0,17503,7.0,18751,255,64,3244,2767,31.9,1750.3
4762910774,1,14,0,1,7,1,6,0,0,0,0,18283,7.0,19544,262,69,4263,2150,33.1,1828.3,11,0,0,1,7,0,1,1,0,0,14020,6.8,17394,209,58,-4263,-2150,26.7,1402.0
4762864732,0,15,1,0,4,4,7,1,1,0,0,15700,6.8,16887,208,55,-991,-1276,26.3,1570.0,15,0,1,4,4,4,0,0,0,0,16691,7.0,18163,212,51,991,1276,26.3,1669.1
4752878901,0,13,2,0,7,6,8,0,0,0,0,16090,6.2,15632,163,48,-1432,-1372,21.1,1609.0,14,1,1,6,7,6,0,0,0,0,17522,6.8,17004,206,44,1432,1372,25.0,1752.2
4752834556,0,13,0,1,2,2,2,0,0,0,0,14505,6.8,17350,232,47,-612,-348,27.9,1450.5,13,0,0,2,2,2,1,1,0,0,15117,6.8,17698,241,51,612,348,29.2,1511.7
4856371617,0,15,1,1,8,5,8,0,0,0,0,17013,6.8,17731,192,60,625,418,25.2,1701.3,10,1,0,5,8,3,0,0,0,0,16388,6.8,17313,201,56,-625,-418,25.7,1638.8
4856347112,1,0,0,1,14,19,9,0,0,0,0,47340,10.0,47500,4,0,18725,16000,0.4,4734.0,0,0,0,10,5,14,0,0,0,0,28615,6.6,31500,1,0,-18725,-16000,0.1,2861.5
4855481471,0,17,0,0,22,25,48,0,0,0,1,35683,11.0,40646,87,0,-2411,-1726,8.7,3568.3,0,0,1,25,22,44,0,0,0,0,38094,11.2,42372,110,0,2411,1726,11.0,3809.4
4855470002,1,0,0,1,33,29,72,0,0,0,0,39024,12.0,46524,92,0,760,4013,9.2,3902.4,0,0,0,29,33,68,0,0,0,0,38264,11.2,42511,96,0,-760,-4013,9.6,3826.4
4855454040,0,0,0,0,20,21,45,0,0,0,1,35766,10.4,36634,104,0,-631,-1383,10.4,3576.6,0,0,1,21,20,49,0,0,0,0,36397,10.8,38017,115,0,631,1383,11.5,3639.7
4855400579,0,10,0,1,8,8,3,0,0,0,0,17696,7.0,18409,213,56,52,877,26.9,1769.6,15,2,0,8,8,5,0,0,0,0,17644,6.8,17532,185,40,-52,-877,22.5,1764.4
4855314241,0,81,1,0,8,6,8,0,0,0,0,18286,6.6,17449,217,49,1430,-605,26.6,1828.6,11,1,1,6,8,8,0,0,0,0,16856,7.0,18054,200,61,-1430,605,26.1,1685.6
4855290825,1,12,0,1,15,5,14,0,0,0,0,22966,7.4,20545,242,60,7204,4326,30.2,2296.6,8,0,0,5,15,7,0,0,0,0,15762,6.8,16219,179,56,-7204,-4326,23.5,1576.2
4855241197,1,0,0,0,18,14,17,0,0,0,0,62850,12.0,55000,0,0,26000,22000,0.0,6285.0,3,0,1,8,12,10,0,0,0,0,36850,7.2,33000,0,0,-26000,-22000,0.0,3685.0
4855215442,1,36,0,1,16,19,22,0,0,0,0,61650,12.0,55000,0,0,24100,22000,0.0,6165.0,3,0,0,13,10,11,0,0,0,0,37550,7.2,33000,0,0,-24100,-22000,0.0,3755.0
4854779324,1,51,0,1,27,18,22,0,0,0,0,64462,12.0,55000,0,0,27608,22000,0.0,6446.2,0,0,0,6,15,8,0,0,0,0,36854,7.2,33000,0,0,-27608,-22000,0.0,3685.4
4854763972,1,0,0,1,14,15,19,0,0,0,0,61392,12.0,55000,1,0,24188,22000,0.1,6139.2,252,0,0,12,11,6,0,0,0,0,37204,7.2,33000,0,0,-24188,-22000,0.0,3720.4
4854745137,1,0,0,1,15,17,13,0,0,0,0,46670,10.0,47500,0,0,19382,16000,0.0,4667.0,5,0,0,9,7,13,0,0,0,0,27288,6.6,31500,2,0,-19382,-16000,0.2,2728.8
4854159584,0,13,0,0,3,11,4,0,0,0,0,15101,6.6,16744,212,46,-3410,-1882,25.8,1510.1,9,1,1,11,3,8,1,1,0,0,18511,7.0,18626,200,53,3410,1882,25.3,1851.1
4854130284,0,11,0,0,4,6,5,0,0,0,0,14629,6.6,16686,190,56,-2542,-1388,24.6,1462.9,12,0,1,6,4,8,1,1,0,0,17171,7.0,18074,208,52,2542,1388,26.0,1717.1
4854089185,1,13,8,1,7,2,10,1,1,0,0,17036,6.8,17700,214,46,2877,207,26.0,1703.6,35,0,0,2,7,0,0,0,0,0,14159,6.8,17493,214,50,-2877,-207,26.4,1415.9
4854027507,0,17,0,1,5,2,3,0,0,0,0,16488,6.6,17474,204,56,581,-9,26.0,1648.8,13,1,0,2,5,2,0,0,0,0,15907,7.0,17483,213,56,-581,9,26.9,1590.7
4853985880,1,0,0,1,25,13,19,0,0,0,0,49850,10.0,47500,0,0,21300,19000,0.0,4985.0,0,0,0,4,16,11,0,0,0,0,28550,6.0,28500,0,0,-21300,-19000,0.0,2855.0
4853707007,1,28,0,1,22,10,17,0,0,0,0,47700,10.0,47500,0,0,20880,19000,0.0,4770.0,0,2,0,3,15,8,0,0,0,0,26820,6.0,28500,2,0,-20880,-19000,0.2,2682.0
4854749679,0,10,0,1,4,5,3,0,0,0,0,16577,6.6,17102,235,46,-1318,-1887,28.1,1657.7,13,0,0,5,4,5,0,0,0,0,17895,7.2,18989,213,75,1318,1887,28.8,1789.5
4854724994,0,21,1,1,5,6,6,0,0,0,0,15635,6.8,16834,212,48,-2096,-1422,26.0,1563.5,12,2,0,6,5,6,0,0,0,0,17731,7.0,18256,233,44,2096,1422,27.7,1773.1
4854684270,0,14,5,0,3,2,5,0,0,0,0,15221,6.8,17729,214,44,-944,-114,25.8,1522.1,10,3,1,2,3,3,1,1,0,0,16165,7.0,17843,192,62,944,114,25.4,1616.5
4853539106,0,8,4,0,0,6,0,1,1,0,0,14959,6.8,17489,202,60,-2278,-945,26.2,1495.9,15,1,1,6,0,7,0,0,0,0,17237,7.0,18434,206,52,2278,945,25.8,1723.7
4851666834,0,10,1,0,8,7,6,0,0,0,0,15585,6.2,14884,167,19,-1461,-1854,18.6,1558.5,9,1,1,7,8,4,0,0,0,0,17046,6.4,16738,192,52,1461,1854,24.4,1704.6
4851625234,0,55,1,1,6,8,5,1,1,0,0,14998,6.8,16454,159,46,-1944,-2437,20.5,1499.8,242,0,0,8,6,4,0,0,0,0,16942,7.2,18891,212,60,1944,2437,27.2,1694.2
4851566145,1,68,1,1,8,9,8,0,0,0,0,16532,6.6,17303,192,47,-1866,84,23.9,1653.2,12,0,0,9,8,11,0,0,0,0,18398,6.8,17219,232,49,1866,-84,28.1,1839.8
4849848872,0,13,1,1,6,3,4,1,1,0,0,16464,7.0,17742,187,56,1570,607,24.3,1646.4,16,0,0,3,6,2,0,0,0,0,14894,6.4,17135,202,60,-1570,-607,26.2,1489.4
4849814026,0,10,1,0,2,1,2,1,1,0,0,14685,7.0,17441,229,60,-808,-847,28.9,1468.5,18,0,1,1,2,2,0,0,0,0,15493,6.8,18288,256,48,808,847,30.4,1549.3
4849785563,1,1,0,1,17,19,47,0,0,0,0,34720,10.8,38075,100,0,-1006,-1241,10.0,3472.0,9,0,0,19,17,54,0,0,0,0,35726,10.8,39316,100,0,1006,1241,10.0,3572.6
4847753108,1,12,0,1,4,1,5,1,1,0,0,16477,7.0,18752,233,50,2071,1505,28.3,1647.7,10,0,0,1,4,1,1,0,1,0,14406,6.8,17247,227,41,-2071,-1505,26.8,1440.6
4845985337,1,17,2,1,3,4,2,0,0,0,0,15576,7.2,18114,185,40,-2286,-1401,22.5,1557.6,12,4,0,4,3,5,1,0,1,0,17862,7.4,19515,252,60,2286,1401,31.2,1786.2
4845945412,0,8,0,0,3,4,3,0,0,0,0,14840,6.8,17698,190,56,-1752,-517,24.6,1484.0,9,0,1,4,3,4,1,1,0,0,16592,7.0,18215,236,60,1752,517,29.6,1659.2
4845907491,0,39,1,0,1,9,2,0,0,0,0,15027,6.8,17154,193,54,-4376,-1054,24.7,1502.7,85,1,1,9,1,12,1,1,0,0,19403,7.0,18208,215,48,4376,1054,26.3,1940.3
4844143497,1,29,1,1,2,2,0,0,0,0,0,14992,7.0,18246,217,56,462,-80,27.3,1499.2,9,0,0,2,2,1,1,1,0,0,14530,7.0,18326,205,68,-462,80,27.3,1453.0
4844098602,1,10,0,0,1,4,2,0,0,0,0,15100,7.0,18583,221,68,400,828,28.9,1510.0,8,0,1,4,1,2,0,0,0,0,14700,6.8,17755,179,52,-400,-828,23.1,1470.0
4843318864,1,13,4,1,5,1,4,1,0,1,0,17353,7.2,18882,243,56,4102,1796,29.9,1735.3,11,1,0,1,5,0,0,0,0,0,13251,6.8,17086,177,56,-4102,-1796,23.3,1325.1
4842294357,0,14,3,1,3,3,2,1,0,1,0,16736,7.0,19519,256,59,1168,1873,31.5,1673.6,12,2,0,3,3,6,0,0,0,0,15568,6.8,17646,204,64,-1168,-1873,26.8,1556.8
4842259479,1,12,3,1,8,3,9,0,0,0,0,18465,7.2,18065,223,56,3716,566,27.9,1846.5,12,0,0,3,8,0,0,0,0,0,14749,6.8,17499,211,52,-3716,-566,26.3,1474.9
4842217562,1,14,2,0,3,5,3,0,0,0,0,14609,6.6,17249,208,56,-2434,-666,26.4,1460.9,19,2,1,5,3,8,0,0,0,0,17043,6.8,17915,236,47,2434,666,28.3,1704.3
4857690913,0,15,1,1,3,5,2,0,0,0,0,13842,6.4,15354,139,48,-1886,-2897,18.7,1384.2,11,1,0,5,3,4,0,0,0,0,15728,6.8,18251,214,48,1886,2897,26.2,1572.8
4857675428,0,13,13,1,7,8,5,1,1,0,0,15935,7.4,19048,199,52,-2225,271,25.1,1593.5,31,0,0,8,7,7,0,0,0,0,18160,6.8,18777,185,53,2225,-271,23.8,1816.0
4857663224,1,15,1,0,9,6,10,1,1,0,0,17751,6.6,17218,159,68,1450,901,22.7,1775.1,46,0,1,6,9,6,0,0,0,0,16301,6.4,16317,189,36,-1450,-901,22.5,1630.1
4857655832,0,11,0,0,3,7,1,0,0,0,0,13829,6.8,16175,165,56,-3410,-2940,22.1,1382.9,8,0,1,7,3,4,0,0,0,0,17239,7.4,19115,182,68,3410,2940,25.0,1723.9
4857640811,1,12,3,0,3,2,2,0,0,0,0,15509,7.0,18506,219,56,665,1129,27.5,1550.9,14,2,1,2,3,2,0,0,0,0,14844,6.6,17377,188,68,-665,-1129,25.6,1484.4
4857616244,0,13,0,0,3,7,3,0,0,0,0,16077,6.8,18319,187,56,291,337,24.3,1607.7,6,4,1,7,3,5,0,0,0,0,15786,7.0,17982,183,48,-291,-337,23.1,1578.6
4857589670,1,13,0,1,24,16,74,0,0,0,1,37753,11.0,39829,113,0,2201,-322,11.3,3775.3,0,0,0,16,24,39,0,0,0,0,35552,11.0,40151,81,0,-2201,322,8.1,3555.2
4857571656,0,0,0,1,18,21,48,0,0,0,1,33267,10.2,35920,78,0,-2322,-3089,7.8,3326.7,0,0,0,21,18,57,0,0,0,0,35589,11.0,39009,101,0,2322,3089,10.1,3558.9
4853214377,0,11,0,1,9,4,9,1,0,1,0,17625,6.8,17117,172,51,2298,631,22.3,1762.5,10,0,0,4,9,2,1,1,0,0,15327,6.6,16486,149,52,-2298,-631,20.1,1532.7
4853207153,0,12,1,0,5,5,2,0,0,0,0,15329,6.8,17447,163,48,1039,403,21.1,1532.9,13,0,1,5,5,3,1,1,0,0,14290,6.6,17044,170,55,-1039,-403,22.5,1429.0
4853192711,0,15,0,0,2,4,1,1,1,0,0,13225,6.2,14899,116,48,-2381,-3062,16.4,1322.5,14,0,1,4,2,1,1,0,1,0,15606,6.8,17961,189,44,2381,3062,23.3,1560.6
4853166785,1,0,0,0,14,11,33,0,0,0,0,33435,10.6,36196,105,0,548,264,10.5,3343.5,0,0,1,11,14,31,0,0,0,0,32887,10.4,35932,103,0,-548,-264,10.3,3288.7
4852122990,0,0,0,1,28,27,65,0,0,0,1,38297,11.6,43072,102,0,-1213,-825,10.2,3829.7,0,0,0,27,28,65,0,0,0,0,39510,11.6,43897,119,0,1213,825,11.9,3951.0
4832966757,0,14,0,0,3,4,2,0,0,0,0,15863,6.8,17717,182,55,-1268,306,23.7,1586.3,12,0,1,4,3,4,1,1,0,0,17131,6.6,17411,225,48,1268,-306,27.3,1713.1
4832936596,1,15,1,0,7,3,7,1,1,0,0,18049,7.2,18887,214,72,2772,2048,28.6,1804.9,16,0,1,3,7,3,0,0,0,0,15277,6.8,16839,204,48,-2772,-2048,25.2,1527.7
4832914023,0,15,1,0,6,5,6,0,0,0,0,17025,6.8,17937,194,60,-655,-1344,25.4,1702.5,14,1,1,5,6,5,1,1,0,0,17680,7.0,19281,239,64,655,1344,30.3,1768.0
4832886297,1,11,2,1,3,5,0,0,0,0,0,16452,7.2,18587,243,48,802,1392,29.1,1645.2,13,0,0,5,3,6,1,1,0,0,15650,6.8,17195,192,60,-802,-1392,25.2,1565.0
4832860515,0,33,2,0,4,5,6,0,0,0,0,16789,6.8,18421,240,56,-690,-1568,29.6,1678.9,34,1,1,5,4,4,1,0,1,0,17479,7.4,19989,269,72,690,1568,34.1,1747.9
4832830538,0,12,3,0,5,7,5,0,0,0,0,15096,6.8,17368,196,62,-2365,-1772,25.8,1509.6,14,0,1,7,5,7,2,1,1,0,17461,7.2,19140,235,60,2365,1772,29.5,1746.1
4822488293,0,14,1,1,8,9,9,0,0,0,0,18357,6.8,17691,248,44,315,410,29.2,1835.7,12,0,0,9,8,11,0,0,0,0,18042,6.8,17281,191,56,-315,-410,24.7,1804.2
4822469562,0,11,0,1,5,11,5,1,1,0,0,15855,6.4,16447,204,50,-4283,-1788,25.4,1585.5,14,2,0,11,5,11,1,0,1,0,20138,7.2,18235,214,55,4283,1788,26.9,2013.8
4821804292,0,12,0,1,6,2,9,1,1,0,0,16370,6.8,17293,231,52,-236,-1246,28.3,1637.0,13,1,0,2,6,2,0,0,0,0,16606,7.2,18539,237,67,236,1246,30.4,1660.6
4821780300,1,16,3,1,8,2,10,1,1,0,0,18317,7.0,17605,211,55,3411,1430,26.6,1831.7,29,4,0,2,8,2,0,0,0,0,14906,6.4,16175,224,53,-3411,-1430,27.7,1490.6
4821752053,0,7,3,0,8,3,6,0,0,0,0,17390,7.2,18313,221,56,1467,1123,27.7,1739.0,22,3,1,3,8,5,0,0,0,0,15923,7.0,17190,234,63,-1467,-1123,29.7,1592.3
4821723817,1,22,0,0,4,9,6,0,0,0,0,15382,6.4,16350,219,51,-4260,-1515,27.0,1538.2,12,2,1,9,4,16,1,1,0,0,19642,6.8,17865,230,47,4260,1515,27.7,1964.2
4810391077,0,12,1,0,4,6,3,0,0,0,0,15006,6.8,17557,220,60,-1615,-430,28.0,1500.6,7,3,1,6,4,6,0,0,0,0,16621,6.8,17987,220,52,1615,430,27.2,1662.1
4810334866,1,56,5,1,13,7,13,1,1,0,0,21030,7.2,19156,242,51,3902,2614,29.3,2103.0,20,2,0,7,13,9,0,0,0,0,17128,6.6,16542,196,63,-3902,-2614,25.9,1712.8
4807908360,0,12,1,0,3,8,4,0,0,0,0,15555,6.6,17098,210,64,-3064,-990,27.4,1555.5,14,3,1,8,3,9,1,1,0,0,18619,6.8,18088,227,52,3064,990,27.9,1861.9
4807887570,0,13,1,1,4,8,6,0,0,0,0,14720,6.4,15380,206,43,-2245,-1647,24.9,1472.0,15,0,0,8,4,6,1,0,1,0,16965,6.6,17027,173,65,2245,1647,23.8,1696.5
4718913250,0,22,1,0,1,5,2,0,0,0,0,14321,6.6,16774,212,52,-3392,-1764,26.4,1432.1,30,3,1,5,1,7,0,0,0,0,17713,7.0,18538,242,54,3392,1764,29.6,1771.3
4718883197,1,29,1,1,13,5,16,0,0,0,0,20332,7.0,18558,235,54,5035,3935,28.9,2033.2,11,4,0,5,13,4,0,0,0,0,15297,6.4,14623,187,56,-5035,-3935,24.3,1529.7
4716058011,0,14,1,0,1,3,0,0,0,0,0,15491,7.0,18919,283,60,-915,507,34.3,1549.1,13,1,1,3,1,5,1,1,0,0,16406,7.2,18412,253,56,915,-507,30.9,1640.6
4713119113,0,13,2,0,9,6,11,0,0,0,0,21665,6.8,18132,233,56,4779,2909,28.9,2166.5,12,3,1,6,9,11,0,0,0,0,16886,6.2,15223,191,55,-4779,-2909,24.6,1688.6
4713085960,0,10,1,0,3,6,1,1,0,1,0,15090,6.8,17411,216,55,-1914,-190,27.1,1509.0,24,1,1,6,3,9,1,1,0,0,17004,6.8,17601,251,48,1914,190,29.9,1700.4
4713032532,0,19,1,0,2,4,4,0,0,0,0,13958,6.8,16685,183,48,-2870,-1500,23.1,1395.8,28,5,1,4,2,6,0,0,0,0,16828,6.8,18185,239,46,2870,1500,28.5,1682.8
4712210573,1,13,3,0,3,8,4,1,0,1,0,15657,6.6,17569,240,58,-2830,-1525,29.8,1565.7,108,1,1,8,3,6,0,0,0,0,18487,7.0,19094,266,53,2830,1525,31.9,1848.7
4711630745,1,14,1,1,6,6,3,1,1,0,0,16704,7.2,18417,214,64,-1120,-1126,27.8,1670.4,12,1,0,6,6,4,0,0,0,0,17824,7.2,19543,224,59,1120,1126,28.3,1782.4
4711599952,0,27,1,0,8,5,9,0,0,0,0,19213,7.0,18061,195,60,1838,289,25.5,1921.3,13,1,1,5,8,2,1,1,0,0,17375,6.8,17772,233,68,-1838,-289,30.1,1737.5
4710310728,1,11,2,0,8,7,13,1,1,0,0,17075,6.6,16957,192,60,-943,536,25.2,1707.5,16,1,1,7,8,15,0,0,0,0,18018,6.4,16421,226,52,943,-536,27.8,1801.8
4855713018,1,11,5,1,3,1,4,1,1,0,0,15776,7.0,18724,241,75,1374,1219,31.6,1577.6,14,1,0,1,3,1,0,0,0,0,14402,6.8,17505,217,56,-1374,-1219,27.3,1440.2
4854727581,1,10,1,1,2,0,0,0,0,0,0,15726,7.0,18968,244,60,1065,106,30.4,1572.6,14,1,0,0,2,0,0,0,0,0,14661,7.0,18862,253,72,-1065,-106,32.5,1466.1
4854577893,0,13,4,0,2,4,2,0,0,0,0,14717,6.8,17733,219,64,-2285,-2196,28.3,1471.7,15,2,1,4,2,4,1,1,0,0,17002,7.2,19929,239,72,2285,2196,31.1,1700.2
4854526943,1,14,1,0,6,2,5,2,1,1,0,16581,7.0,18309,227,40,1964,452,26.7,1658.1,15,3,1,2,6,1,0,0,0,0,14617,6.8,17857,220,48,-1964,-452,26.8,1461.7
4853630802,0,34,2,0,6,6,6,0,0,0,0,17215,6.6,16796,216,44,296,-1274,26.0,1721.5,35,4,1,6,6,5,0,0,0,0,16919,6.8,18070,222,44,-296,1274,26.6,1691.9
4853596591,0,11,1,0,2,3,2,1,0,1,0,15011,6.6,17191,216,52,-1374,-1256,26.8,1501.1,13,0,1,3,2,2,0,0,0,0,16385,7.0,18447,223,60,1374,1256,28.3,1638.5
4853564210,0,15,0,0,2,6,2,1,1,0,0,15266,7.0,17847,216,67,-2548,-1316,28.3,1526.6,9,3,1,6,2,4,0,0,0,0,17814,7.4,19163,252,60,2548,1316,31.2,1781.4
4851171478,1,175,2,1,14,17,30,0,0,0,0,34392,10.2,35790,119,0,-346,-2744,11.9,3439.2,11,0,0,17,14,32,0,0,0,0,34738,10.8,38534,117,0,346,2744,11.7,3473.8
4851057170,1,79,0,1,20,21,47,0,0,0,1,35270,10.8,38091,103,0,-2243,-3184,10.3,3527.0,19,0,0,21,20,62,0,0,0,0,37513,11.0,41275,109,0,2243,3184,10.9,3751.3
4851032140,1,0,0,1,23,26,47,0,0,0,1,38617,11.4,41392,107,0,2314,657,10.7,3861.7,0,0,0,26,23,59,0,0,0,0,36303,11.2,40735,99,0,-2314,-657,9.9,3630.3
4846597903,1,13,2,0,8,6,5,0,0,0,0,17944,7.0,18520,214,56,2186,1237,27.0,1794.4,8,1,1,6,8,4,0,0,0,0,15758,6.8,17283,185,48,-2186,-1237,23.3,1575.8
4846571646,0,22,3,0,5,6,4,0,0,0,0,15556,7.2,18350,210,56,-918,-239,26.6,1555.6,22,2,1,6,5,4,1,1,0,0,16474,7.2,18589,198,72,918,239,27.0,1647.4
4846560275,1,16,0,0,6,5,9,0,0,0,0,18093,7.2,18664,211,64,3322,2146,27.5,1809.3,10,1,1,5,6,4,0,0,0,0,14771,6.6,16518,190,44,-3322,-2146,23.4,1477.1
4846529240,1,228,0,1,6,6,8,0,0,0,0,16998,6.8,17660,224,48,1211,47,27.2,1699.8,12,0,0,6,6,8,1,1,0,0,15787,6.8,17613,181,68,-1211,-47,24.9,1578.7
4846486929,1,14,2,1,4,4,3,0,0,0,0,16425,7.2,18631,245,40,510,621,28.5,1642.5,78,1,0,4,4,2,0,0,0,0,15915,6.8,18010,215,52,-510,-621,26.7,1591.5
4846465832,1,11,2,1,8,3,8,0,0,0,0,19602,7.2,19821,254,60,3982,1023,31.4,1960.2,12,1,0,3,8,1,1,1,0,0,15620,7.2,18798,244,72,-3982,-1023,31.6,1562.0
4846449242,1,12,0,1,7,2,8,1,0,1,0,17925,7.2,18981,233,64,3635,482,29.7,1792.5,8,0,0,2,7,0,1,1,0,0,14290,7.0,18499,224,52,-3635,-482,27.6,1429.0
4846438921,0,8,2,1,4,4,5,1,1,0,0,15391,7.0,18102,204,64,-667,-186,26.8,1539.1,14,2,0,4,4,2,1,0,1,0,16058,7.0,18288,225,52,667,186,27.7,1605.8
4846424562,0,82,1,0,7,7,4,0,0,0,0,16081,6.4,16572,177,49,-1379,-2044,22.6,1608.1,14,3,1,7,7,4,1,1,0,0,17460,7.0,18616,224,64,1379,2044,28.8,1746.0
4846407905,1,14,1,1,5,2,5,1,1,0,0,15383,6.8,18047,216,48,280,587,26.4,1538.3,11,3,0,2,5,1,0,0,0,0,15103,6.8,17460,238,58,-280,-587,29.6,1510.3
4845001790,0,7,1,1,28,34,71,0,0,0,3,40729,11.4,43953,83,0,-467,-628,8.3,4072.9,18,0,0,34,28,90,0,0,0,0,41196,11.8,44581,89,0,467,628,8.9,4119.6
4843590933,0,10,4,1,8,6,7,0,0,0,0,18153,7.0,18317,221,56,-104,-76,27.7,1815.3,31,2,0,6,8,5,2,1,1,0,18257,7.0,18393,225,64,104,76,28.9,1825.7
4843558920,1,14,2,1,10,0,15,0,0,0,0,19720,7.0,18997,237,51,4651,3016,28.8,1972.0,8,2,0,0,10,0,0,0,0,0,15069,6.6,15981,200,48,-4651,-3016,24.8,1506.9
4843522236,0,14,3,1,3,7,4,0,0,0,0,16163,7.0,17936,226,59,-1709,-505,28.5,1616.3,24,1,0,7,3,9,0,0,0,0,17872,7.0,18441,221,52,1709,505,27.3,1787.2
4843431752,1,10,1,0,7,3,5,1,1,0,0,16446,7.0,17796,199,50,-244,-1350,24.9,1644.6,9,2,1,3,7,1,0,0,0,0,16690,7.2,19146,231,70,244,1350,30.1,1669.0
4843380692,1,10,2,0,12,6,14,1,1,0,0,19852,7.2,18356,204,56,4230,1927,26.0,1985.2,13,1,1,5,11,3,0,0,0,0,15622,6.6,16429,188,59,-4230,-1927,24.7,1562.2
4840908915,1,11,1,1,3,4,2,0,0,0,0,15905,6.8,18226,211,61,593,1150,27.2,1590.5,8,0,0,4,3,5,1,1,0,0,15312,6.8,17076,198,51,-593,-1150,24.9,1531.2
4840881606,0,17,1,0,3,8,2,0,0,0,0,15270,6.6,17144,218,52,-2329,-1148,27.0,1527.0,15,0,1,8,3,6,0,0,0,0,17599,7.0,18292,216,60,2329,1148,27.6,1759.9
4840806195,0,35,1,1,4,5,6,0,0,0,0,16362,6.8,17626,213,64,-1898,-1333,27.7,1636.2,8,17,0,5,4,8,0,0,0,0,18260,7.0,18959,174,56,1898,1333,23.0,1826.0
4840773582,0,14,3,1,6,3,8,0,0,0,0,16546,6.8,17729,211,45,185,-190,25.6,1654.6,15,4,0,3,6,4,1,1,0,0,16361,7.0,17919,215,71,-185,190,28.6,1636.1
4840747731,1,12,0,0,4,3,1,0,0,0,0,16485,7.4,19124,196,59,381,1111,25.5,1648.5,69,1,1,3,4,3,0,0,0,0,16104,7.2,18013,206,60,-381,-1111,26.6,1610.4
4837351348,1,15,0,1,5,3,4,0,0,0,0,16340,6.8,17336,212,48,672,-732,26.0,1634.0,10,2,0,3,5,2,1,1,0,0,15668,7.0,18068,229,62,-672,732,29.1,1566.8
4837325551,0,12,2,0,3,7,1,1,1,0,0,15969,7.2,18490,229,66,-2208,384,29.5,1596.9,10,1,1,7,3,5,0,0,0,0,18177,6.8,18106,251,47,2208,-384,29.8,1817.7
4837300189,0,15,1,0,2,4,1,0,0,0,0,14198,6.8,18203,201,52,-2938,-1039,25.3,1419.8,13,0,1,4,2,5,0,0,0,0,17136,7.2,19242,239,60,2938,1039,29.9,1713.6
4837266048,0,19,1,1,6,1,6,1,1,0,0,17735,7.0,18002,216,48,2868,582,26.4,1773.5,12,0,0,1,6,2,0,0,0,0,14867,6.8,17420,224,52,-2868,-582,27.6,1486.7
4834417880,1,13,0,1,13,5,9,1,1,0,0,19682,7.2,19588,203,72,4614,2736,27.5,1968.2,14,0,0,5,13,3,0,0,0,0,15068,6.8,16852,191,52,-4614,-2736,24.3,1506.8
4834403555,1,9,2,0,3,5,4,0,0,0,0,14988,7.0,18359,217,64,-2737,-1154,28.1,1498.8,14,3,1,5,3,3,0,0,0,0,17725,7.0,19513,242,60,2737,1154,30.2,1772.5
4834395877,1,13,2,1,5,8,3,0,0,0,0,17995,6.8,17996,253,40,1274,556,29.3,1799.5,11,1,0,8,5,5,1,1,0,0,16721,6.6,17440,195,63,-1274,-556,25.8,1672.1
4834362185,1,14,0,1,9,5,8,0,0,0,0,18161,6.8,17116,197,50,904,-264,24.7,1816.1,13,0,0,5,9,7,0,0,0,0,17257,6.6,17380,201,50,-904,264,25.1,1725.7
4834343434,0,53,1,0,7,9,5,0,0,0,0,17638,7.0,18036,192,64,-946,-439,25.6,1763.8,14,2,1,9,7,7,0,0,0,0,18584,7.0,18475,207,63,946,439,27.0,1858.4
4857973515,1,0,0,1,21,15,18,0,0,0,0,66200,12.0,55000,0,0,29000,22000,0.0,6620.0,0,0,0,6,12,10,0,0,0,0,37200,7.2,33000,0,0,-29000,-22000,0.0,3720.0
4857955371,1,0,0,1,21,19,22,0,0,0,0,49037,10.0,47500,0,0,20487,19000,0.0,4903.7,0,0,0,10,12,8,0,0,0,0,28550,6.0,28500,0,0,-20487,-19000,0.0,2855.0
4857350472,1,0,0,0,17,11,21,0,0,0,0,47010,10.0,47500,0,0,21550,19000,0.0,4701.0,14,0,1,7,13,3,0,0,0,0,25460,6.0,28500,0,0,-21550,-19000,0.0,2546.0
4857324432,1,0,0,1,20,19,16,0,0,0,0,63050,13.0,62500,0,0,24800,25000,0.0,6305.0,0,0,0,9,10,12,0,0,0,0,38250,7.8,37500,0,0,-24800,-25000,0.0,3825.0
4857256478,1,0,0,0,14,19,14,0,0,0,0,61650,12.0,55000,0,0,24100,22000,0.0,6165.0,46,0,1,12,7,10,0,0,0,0,37550,7.2,33000,0,0,-24100,-22000,0.0,3755.0
4857229384,1,7,0,1,15,23,17,0,0,0,0,62700,12.0,55000,0,0,24800,22000,0.0,6270.0,0,0,0,15,7,13,0,0,0,0,37900,7.2,33000,0,0,-24800,-22000,0.0,3790.0
4857209174,1,4,0,1,18,13,16,0,0,0,0,62700,12.0,55000,0,0,25500,22000,0.0,6270.0,0,0,0,10,15,8,0,0,0,0,37200,7.2,33000,0,0,-25500,-22000,0.0,3720.0
4857185153,1,26,0,0,14,22,8,0,0,0,0,63400,12.0,55000,0,0,24050,22000,0.0,6340.0,3,0,1,13,5,17,0,0,0,0,39350,7.2,33000,1,0,-24050,-22000,0.1,3935.0
4856049551,1,0,0,0,13,14,12,0,0,0,0,31675,9.0,40000,1,0,13525,16000,0.1,3167.5,0,0,1,8,7,7,0,0,0,0,18150,5.4,24000,0,0,-13525,-16000,0.0,1815.0
4856016597,1,6,0,1,25,20,20,0,0,0,0,64160,12.0,55000,0,0,24815,22000,0.0,6416.0,0,0,0,12,17,16,0,0,0,0,39345,7.2,33000,0,0,-24815,-22000,0.0,3934.5
4855999385,1,0,0,1,10,22,13,0,0,0,0,60600,12.0,55000,0,0,22000,22000,0.0,6060.0,4,0,0,16,4,12,0,0,0,0,38600,7.2,33000,0,0,-22000,-22000,0.0,3860.0
4855965721,1,17,0,1,14,16,14,0,0,0,0,60250,12.0,55000,0,0,22496,22000,0.0,6025.0,6,0,0,11,9,10,0,0,0,0,37754,7.2,33000,0,0,-22496,-22000,0.0,3775.4
4854824133,1,0,0,1,23,17,21,0,0,0,0,47685,10.0,47500,14,0,19105,19000,1.4,4768.5,0,0,0,8,14,7,0,0,0,0,28580,6.0,28500,4,0,-19105,-19000,0.4,2858.0
4854806546,1,5,0,1,19,22,16,0,0,0,0,46835,10.6,50500,7,0,16682,22000,0.7,4683.5,0,0,0,12,9,17,0,0,0,0,30153,6.0,28500,6,0,-16682,-22000,0.6,3015.3
4854763744,1,0,0,0,14,18,13,0,0,0,0,30986,9.0,40000,0,0,10736,16000,0.0,3098.6,0,0,1,13,9,9,0,0,0,0,20250,5.4,24000,0,0,-10736,-16000,0.0,2025.0
4854737614,1,14,0,0,19,22,13,0,0,0,0,47700,10.0,47500,0,0,17400,19000,0.0,4770.0,0,0,1,13,10,13,0,0,0,0,30300,6.0,28500,0,0,-17400,-19000,0.0,3030.0
4854716262,1,9,0,0,16,18,19,0,0,0,0,48400,12.0,55000,0,0,20200,22000,0.0,4840.0,0,0,1,13,11,9,0,0,0,0,28200,7.2,33000,0,0,-20200,-22000,0.0,2820.0
4854690695,1,284,2,1,13,15,12,0,0,0,0,45996,10.0,47500,2,0,17310,19000,0.2,4599.6,0,1,0,11,9,9,0,0,0,0,28686,6.0,28500,3,0,-17310,-19000,0.3,2868.6
4854675761,1,3,0,1,19,18,10,0,0,0,0,46445,10.0,47500,1,0,16840,19000,0.1,4644.5,18,0,0,10,11,19,0,0,0,0,29605,6.0,28500,0,0,-16840,-19000,0.0,2960.5
4854655314,1,0,2,1,14,25,9,0,0,0,0,61811,12.6,59500,0,0,22386,22000,0.0,6181.1,39,0,0,17,6,20,0,0,0,0,39425,7.8,37500,5,0,-22386,-22000,0.5,3942.5
4857568533,0,15,2,0,9,8,4,0,0,0,0,17503,7.0,18679,209,51,-559,1108,26.0,1750.3,21,0,1,8,9,8,1,1,0,0,18062,7.0,17571,208,48,559,-1108,25.6,1806.2
4857433717,0,62,2,1,5,4,4,0,0,0,0,16257,6.8,17943,187,47,-817,-588,23.4,1625.7,75,2,0,4,5,2,2,1,1,0,17074,7.2,18531,203,66,817,588,26.9,1707.4
4856387674,0,15,0,0,9,3,10,1,0,1,0,17573,7.0,18369,205,62,1039,1411,26.7,1757.3,14,4,1,3,9,5,0,0,0,0,16534,6.6,16958,213,56,-1039,-1411,26.9,1653.4
4855455783,1,0,0,1,14,16,14,0,0,0,0,44350,10.0,47500,3,0,16850,19000,0.3,4435.0,0,0,0,11,9,11,0,0,0,0,27500,6.0,28500,0,0,-16850,-19000,0.0,2750.0
4855432436,1,0,0,1,22,14,17,0,0,0,0,46469,10.0,47500,0,0,18949,19000,0.0,4646.9,3,0,0,6,14,9,0,0,0,0,27520,6.0,28500,0,0,-18949,-19000,0.0,2752.0
4854300590,0,10,1,1,8,1,3,0,0,0,0,18180,7.6,20171,215,68,3128,2714,28.3,1818.0,11,0,0,1,8,0,0,0,0,0,15052,6.8,17457,210,48,-3128,-2714,25.8,1505.2
4854276720,0,90,0,0,3,3,3,0,0,0,0,13929,6.8,17166,171,52,-1173,-1531,22.3,1392.9,11,0,1,3,3,0,1,1,0,0,15102,6.8,18697,214,56,1173,1531,27.0,1510.2
4854238642,1,8,0,0,5,3,7,1,0,1,0,16594,7.4,19621,218,68,-137,1713,28.6,1659.4,7,1,1,3,5,5,1,1,0,0,16731,7.0,17908,256,48,137,-1713,30.4,1673.1
4854198034,1,17,3,0,6,4,2,1,1,0,0,15825,7.0,18166,197,44,962,1882,24.1,1582.5,12,0,1,4,6,5,0,0,0,0,14863,6.4,16284,181,56,-962,-1882,23.7,1486.3
4854147255,1,13,1,0,8,4,9,1,0,1,0,18720,7.2,19578,229,72,4072,2666,30.1,1872.0,19,0,1,4,8,2,1,1,0,0,14648,6.6,16912,200,32,-4072,-2666,23.2,1464.8
4854059853,0,15,0,0,6,10,7,1,1,0,0,16149,6.4,16419,216,36,-2721,-1792,25.2,1614.9,13,1,1,10,6,10,0,0,0,0,18870,7.0,18211,189,63,2721,1792,25.2,1887.0
4854002166,1,8,3,0,5,4,3,0,0,0,0,15543,7.0,17668,203,60,-1563,-1524,26.3,1554.3,15,0,1,4,5,2,1,1,0,0,17106,7.2,19192,242,72,1563,1524,31.4,1710.6
4852068134,0,13,2,0,1,7,1,0,0,0,0,14764,6.4,16146,196,44,-3869,-3296,24.0,1476.4,14,1,1,7,1,7,0,0,0,0,18633,7.2,19442,232,75,3869,3296,30.7,1863.3
4847240181,1,31,1,1,2,3,3,0,0,0,0,15740,6.8,17913,238,48,710,38,28.6,1574.0,31,1,0,3,2,5,0,0,0,0,15030,7.0,17875,207,63,-710,-38,27.0,1503.0
4847216830,1,8,0,0,10,8,10,1,1,0,0,19470,6.8,18107,217,47,-241,-1924,26.4,1947.0,13,3,1,8,10,5,1,0,1,0,19711,7.4,20031,203,76,241,1924,27.9,1971.1
4847010141,0,18,3,0,9,7,10,0,0,0,0,18699,6.6,17535,235,52,2214,731,28.7,1869.9,10,2,1,7,9,3,2,1,1,0,16485,6.6,16804,199,56,-2214,-731,25.5,1648.5
4843478014,0,10,0,0,5,16,3,0,0,0,0,16123,7.0,18195,204,67,-5332,-577,27.1,1612.3,14,0,1,16,5,27,1,1,0,0,21455,6.8,18772,233,56,5332,577,28.9,2145.5
4842053707,0,10,0,0,0,1,0,1,1,0,0,15253,7.0,17696,248,60,637,674,30.8,1525.3,12,0,1,1,0,1,0,0,0,0,14616,6.6,17022,195,46,-637,-674,24.1,1461.6
4841577017,0,11,2,0,2,7,0,1,0,1,0,14535,6.6,17552,189,60,-2810,-578,24.9,1453.5,79,0,1,7,2,11,1,1,0,0,17345,6.8,18130,242,47,2810,578,28.9,1734.5
4857494995,1,10,1,0,6,7,5,0,0,0,0,17585,7.0,18431,251,62,162,-775,31.3,1758.5,10,1,1,7,6,6,1,1,0,0,17423,7.4,19206,268,64,-162,775,33.2,1742.3
4856539978,1,13,1,0,3,4,0,0,0,0,0,15914,7.0,17928,203,46,298,82,24.9,1591.4,15,1,1,4,3,2,0,0,0,0,15616,7.0,17846,215,53,-298,-82,26.8,1561.6
4856504300,1,25,2,1,4,6,5,1,1,0,0,15272,6.6,17287,237,52,-707,-752,28.9,1527.2,21,0,0,6,4,6,0,0,0,0,15979,6.8,18039,217,47,707,752,26.4,1597.9
4855871312,0,12,0,1,7,8,4,0,0,0,0,16503,7.0,18212,213,50,-1503,-71,26.3,1650.3,10,1,0,8,7,9,1,1,0,0,18006,7.0,18283,229,54,1503,71,28.3,1800.6
4855833200,0,15,3,0,5,3,6,1,1,0,0,15430,6.8,17705,197,56,713,-652,25.3,1543.0,18,0,1,3,5,0,0,0,0,0,14717,7.0,18357,221,58,-713,652,27.9,1471.7
4855808813,0,10,1,0,7,7,4,1,1,0,0,16707,6.8,16649,185,40,-208,-1549,22.5,1670.7,10,2,1,7,7,3,0,0,0,0,16915,7.0,18198,191,60,208,1549,25.1,1691.5
4847519960,0,23,1,0,10,11,8,0,0,0,0,16568,6.2,15723,161,44,-1330,-1136,20.5,1656.8,14,0,1,11,10,12,0,0,0,0,17898,6.8,16859,184,52,1330,1136,23.6,1789.8
4847495021,1,53,0,0,10,6,7,0,0,0,0,17897,6.8,18010,210,59,1817,3434,26.9,1789.7,12,0,1,6,10,8,0,0,0,0,16080,6.2,14576,153,36,-1817,-3434,18.9,1608.0
4839025124,0,35,0,1,8,18,21,0,0,0,0,31695,11.0,39493,102,73,-2087,-4733,17.5,3169.5,10,1,0,18,8,47,0,0,0,0,33782,11.8,44226,72,58,2087,4733,13.0,3378.2
4838674755,1,7,0,1,17,8,24,0,0,0,2,37454,11.8,43669,104,71,2405,4470,17.5,3745.4,12,1,0,8,17,14,0,0,0,0,35049,11.2,39199,123,67,-2405,-4470,19.0,3504.9
4838661237,1,19,0,0,24,8,37,0,0,0,0,39813,11.4,43309,87,75,9669,11187,16.2,3981.3,14,0,1,8,24,9,0,0,0,0,30144,10.0,32122,65,43,-9669,-11187,10.8,3014.4
4838654102,1,4,0,1,25,6,20,0,0,0,2,25325,7.0,19241,225,0,12635,8973,22.5,2532.5,0,1,0,6,25,7,0,0,0,0,12690,4.8,10268,73,0,-12635,-8973,7.3,1269.0
4832784662,1,29,3,0,4,3,1,0,0,0,0,16975,7.2,18884,220,60,538,1345,28.0,1697.5,11,5,1,3,4,3,1,1,0,0,16437,6.6,17539,189,48,-538,-1345,23.7,1643.7
4828385631,0,13,0,0,4,11,4,0,0,0,0,14759,6.4,15912,186,44,-5536,-2831,23.0,1475.9,8,2,1,11,4,18,0,0,0,0,20295,7.0,18743,219,64,5536,2831,28.3,2029.5
4828367925,0,13,0,0,3,3,2,0,0,0,0,15618,6.8,17560,214,56,-418,-330,27.0,1561.8,11,0,1,3,3,4,0,0,0,0,16036,6.6,17890,212,56,418,330,26.8,1603.6
4823626871,1,14,1,1,5,4,2,0,0,0,0,16456,7.2,19311,234,71,1405,1021,30.5,1645.6,17,0,0,3,4,1,0,0,0,0,15051,6.8,18290,222,60,-1405,-1021,28.2,1505.1
4822553051,1,38,3,1,13,7,19,1,1,0,0,19815,6.8,16950,166,52,2111,1285,21.8,1981.5,32,9,0,7,13,11,0,0,0,0,17704,6.2,15665,190,39,-2111,-1285,22.9,1770.4
4820750783,0,12,1,0,7,8,7,0,0,0,0,17655,7.2,18558,205,48,-260,-796,25.3,1765.5,12,1,1,8,7,7,2,1,1,0,17915,7.2,19354,236,52,260,796,28.8,1791.5
4834844014,1,8,8,1,10,2,9,0,0,0,0,17809,7.0,18336,181,56,4180,2042,23.7,1780.9,36,0,0,2,10,2,0,0,0,0,13629,6.6,16294,174,52,-4180,-2042,22.6,1362.9
4791766078,1,14,1,1,2,0,4,1,1,0,0,15122,7.0,17996,214,67,965,-847,28.1,1512.2,19,1,0,0,2,0,0,0,0,0,14157,6.8,18843,229,59,-965,847,28.8,1415.7
4791746388,0,13,3,1,5,6,5,0,0,0,0,16421,7.0,17486,237,41,686,1426,27.8,1642.1,14,2,0,6,5,6,0,0,0,0,15735,6.2,16060,202,54,-686,-1426,25.6,1573.5
4790787307,1,13,2,0,4,2,2,0,0,0,0,16005,6.8,18048,238,51,782,166,28.9,1600.5,11,4,1,2,4,0,0,0,0,0,15223,7.0,17882,243,60,-782,-166,30.3,1522.3
4790767329,0,8,2,0,5,9,6,0,0,0,0,16575,6.8,17623,230,60,-1295,-1404,29.0,1657.5,16,0,1,9,5,9,0,0,0,0,17870,7.0,19027,220,59,1295,1404,27.9,1787.0
4790748994,0,10,2,0,5,11,3,0,0,0,0,15531,6.6,16335,209,55,-2173,-1003,26.4,1553.1,10,2,1,11,5,8,1,1,0,0,17704,6.8,17338,196,35,2173,1003,23.1,1770.4
4790704951,1,14,1,0,8,4,7,0,0,0,0,17153,7.0,18719,221,39,1163,1613,26.0,1715.3,12,0,1,4,8,7,0,0,0,0,15990,6.6,17106,199,51,-1163,-1613,25.0,1599.0
4788229094,1,0,0,0,32,26,81,0,0,0,1,38913,11.8,45239,85,0,824,2384,8.5,3891.3,0,0,1,26,32,60,0,0,0,0,38089,11.4,42855,98,0,-824,-2384,9.8,3808.9
4788222936,1,0,0,0,14,17,40,0,0,0,0,34782,10.8,38175,101,0,-1594,-2553,10.1,3478.2,0,0,1,17,14,50,0,0,0,0,36376,11.0,40728,113,0,1594,2553,11.3,3637.6
4788209102,0,13,0,0,24,33,48,0,0,0,0,37821,11.4,41953,121,0,-2029,-2051,12.1,3782.1,0,2,1,33,24,78,0,0,0,0,39850,11.8,44004,127,0,2029,2051,12.7,3985.0
4788197222,0,29,0,1,24,18,61,0,0,0,0,35500,11.0,39479,98,0,442,1119,9.8,3550.0,1,0,0,18,24,49,0,0,0,0,35058,11.0,38360,100,0,-442,-1119,10.0,3505.8
4788182149,0,64,1,1,2,6,2,0,0,0,0,15758,6.8,17252,233,52,160,-851,28.5,1575.8,11,0,0,6,2,4,0,0,0,0,15598,7.0,18103,217,48,-160,851,26.5,1559.8
4788161981,0,40,1,0,2,6,4,0,0,0,0,14395,6.4,16136,191,52,-3292,-1953,24.3,1439.5,11,2,1,6,2,3,0,0,0,0,17687,7.0,18089,208,52,3292,1953,26.0,1768.7
4788125949,1,8,1,1,8,13,6,0,0,0,0,16894,6.6,16708,167,48,-378,-1598,21.5,1689.4,10,1,0,12,7,6,0,0,0,0,17272,6.8,18306,155,56,378,1598,21.1,1727.2
4786651703,0,11,1,1,6,6,5,0,0,0,0,16656,6.6,16786,194,64,-1170,-251,25.8,1665.6,17,1,0,6,6,5,1,1,0,0,17826,6.8,17037,195,72,1170,251,26.7,1782.6
4785953277,0,13,3,0,7,5,9,1,1,0,0,17775,6.8,16936,216,55,349,-291,27.1,1777.5,17,2,1,5,7,8,1,0,1,0,17426,7.0,17227,222,55,-349,291,27.7,1742.6
4785907694,1,8,3,0,6,5,6,0,0,0,0,16869,7.0,17788,210,56,-462,-755,26.6,1686.9,13,1,1,5,6,6,0,0,0,0,17331,7.0,18543,250,62,462,755,31.2,1733.1
4785883945,1,12,1,1,7,6,8,0,0,0,0,17565,6.8,17623,204,71,616,490,27.5,1756.5,24,1,0,6,7,8,0,0,0,0,16949,6.6,17133,212,48,-616,-490,26.0,1694.9
4785810346,1,16,2,1,5,4,4,0,0,0,0,17698,7.4,19371,271,70,2121,2628,34.1,1769.8,12,2,0,4,5,6,2,1,1,0,15577,6.6,16743,198,62,-2121,-2628,26.0,1557.7
4785778397,1,42,0,1,8,5,5,2,1,1,0,18773,7.2,19525,228,68,2503,1194,29.6,1877.3,11,1,0,5,8,3,0,0,0,0,16270,7.0,18331,215,56,-2503,-1194,27.1,1627.0
4841170519,0,13,2,0,5,9,2,1,0,1,0,16587,7.0,17858,204,59,-1123,-1112,26.3,1658.7,18,1,1,8,4,7,0,0,0,0,17710,7.2,18970,206,55,1123,1112,26.1,1771.0
4841128661,0,10,1,0,12,13,10,0,0,0,0,18850,6.6,16619,178,28,-1176,-1054,20.6,1885.0,18,1,1,13,12,9,0,0,0,0,20026,6.8,17673,211,40,1176,1054,25.1,2002.6
4839260137,0,13,1,1,5,4,3,1,1,0,0,16877,7.0,18276,199,52,339,76,25.1,1687.7,13,2,0,3,4,1,0,0,0,0,16538,6.8,18200,239,60,-339,-76,29.9,1653.8
4839220783,1,12,0,1,11,1,8,0,0,0,0,18788,7.0,18500,202,64,3200,1145,26.6,1878.8,15,3,0,1,11,2,1,1,0,0,15588,6.8,17355,207,67,-3200,-1145,27.4,1558.8
4823601953,0,15,1,0,5,4,5,0,0,0,0,17214,7.0,18906,235,63,546,614,29.8,1721.4,14,2,1,4,5,2,0,0,0,0,16668,7.0,18292,229,56,-546,-614,28.5,1666.8
4823569407,0,18,2,0,5,13,4,0,0,0,0,15770,6.6,17506,221,32,-3659,-1273,25.3,1577.0,17,7,1,13,5,9,0,0,0,0,19429,7.2,18779,207,76,3659,1273,28.3,1942.9
4820820595,0,16,2,1,4,2,5,1,1,0,0,16504,7.2,18345,242,68,399,-227,31.0,1650.4,17,2,0,2,4,2,0,0,0,0,16105,7.2,18572,257,68,-399,227,32.5,1610.5
4820794893,1,13,2,1,5,3,3,0,0,0,0,16971,7.4,19555,240,64,1628,829,30.4,1697.1,12,4,0,3,5,4,1,1,0,0,15343,7.2,18726,231,52,-1628,-829,28.3,1534.3
4820579993,1,12,0,1,3,1,3,0,0,0,0,17703,7.2,19211,247,73,3348,1988,32.0,1770.3,199,3,0,1,3,1,1,1,0,0,14355,6.4,17223,202,46,-3348,-1988,24.8,1435.5
4820553837,0,11,2,0,6,8,6,0,0,0,0,15527,6.4,16067,181,45,-2529,-1928,22.6,1552.7,16,3,1,8,6,12,1,1,0,0,18056,7.0,17995,198,70,2529,1928,26.8,1805.6
4820531934,0,15,0,0,6,4,9,1,1,0,0,16363,6.8,17540,205,48,-170,-11,25.3,1636.3,7,1,1,4,6,2,0,0,0,0,16533,6.8,17551,227,62,170,11,28.9,1653.3
4820500318,1,14,1,0,3,6,2,0,0,0,0,15916,6.6,17113,191,44,-1230,-1130,23.5,1591.6,14,0,1,6,3,3,0,0,0,0,17146,6.8,18243,201,59,1230,1130,26.0,1714.6
4820359948,1,13,0,1,6,3,3,0,0,0,0,16854,7.0,18644,230,51,254,801,28.1,1685.4,12,1,0,3,6,1,0,0,0,0,16600,6.8,17843,226,56,-254,-801,28.2,1660.0
4820340477,1,13,4,1,12,4,20,0,0,0,0,20883,7.2,19699,269,68,5846,3564,33.7,2088.3,15,0,0,4,12,7,0,0,0,0,15037,6.4,16135,194,52,-5846,-3564,24.6,1503.7
4819522689,1,13,1,0,6,10,7,1,0,1,0,17159,6.8,17250,226,58,-1988,-266,28.4,1715.9,17,1,1,10,6,14,0,0,0,0,19147,6.8,17516,175,46,1988,266,22.1,1914.7
4819003428,1,14,0,0,6,6,4,1,0,1,0,18134,7.4,19723,237,72,223,1275,30.9,1813.4,7,1,1,6,6,8,1,1,0,0,17911,7.2,18448,234,56,-223,-1275,29.0,1791.1
4818966916,1,25,2,0,8,9,9,0,0,0,0,17093,7.0,18715,204,64,-687,-206,26.8,1709.3,12,3,1,9,8,6,0,0,0,0,17780,6.8,18921,203,64,687,206,26.7,1778.0
4818911203,1,47,1,1,2,1,1,0,0,0,0,15774,6.8,17766,189,52,-184,-444,24.1,1577.4,15,0,0,1,2,1,0,0,0,0,15958,7.0,18210,247,60,184,444,30.7,1595.8
4818801161,0,13,0,1,4,1,1,0,0,0,0,15763,7.0,19112,210,70,-74,773,28.0,1576.3,11,0,0,1,4,1,0,0,0,0,15837,7.0,18339,218,50,74,-773,26.8,1583.7
4795847720,0,9,0,1,5,5,2,0,0,0,0,16383,7.2,19214,226,64,25,1266,29.0,1638.3,9,1,0,5,5,6,0,0,0,0,16358,6.8,17948,229,59,-25,-1266,28.8,1635.8
4795831800,0,15,0,0,7,6,3,1,1,0,0,17827,6.8,18809,212,54,516,1269,26.6,1782.7,78,1,1,6,7,5,1,0,1,0,17311,7.0,17540,190,55,-516,-1269,24.5,1731.1
4795732301,1,52,1,0,5,7,7,0,0,0,0,16578,6.6,17612,205,55,-796,-832,26.0,1657.8,11,2,1,7,5,7,0,0,0,0,17374,6.8,18444,240,50,796,832,29.0,1737.4
4794884536,1,17,3,1,4,3,2,0,0,0,0,16651,7.0,18510,257,50,1846,317,30.7,1665.1,11,4,0,3,4,1,0,0,0,0,14805,6.8,18193,236,56,-1846,-317,29.2,1480.5
4794862790,1,8,7,0,5,5,2,1,1,0,0,16354,7.2,18651,227,64,-818,925,29.1,1635.4,31,0,1,5,5,6,1,0,1,0,17172,7.0,17726,209,60,818,-925,26.9,1717.2
4794825049,1,13,0,1,5,7,6,1,1,0,0,17168,7.0,16692,225,52,10,-1760,27.7,1716.8,9,4,0,7,5,6,0,0,0,0,17158,7.0,18452,222,56,-10,1760,27.8,1715.8
4794797149,0,56,1,0,5,5,3,1,1,0,0,16701,7.0,18750,190,75,-169,1470,26.5,1670.1,21,1,1,5,5,6,0,0,0,0,16870,6.8,17280,203,45,169,-1470,24.8,1687.0
4794774949,1,11,0,1,9,13,6,0,0,0,0,16050,6.2,14683,146,44,-3497,-2743,19.0,1605.0,11,1,0,13,9,11,0,0,0,0,19547,6.8,17426,187,67,3497,2743,25.4,1954.7
4792842422,1,61,2,1,11,7,9,0,0,0,0,19476,6.8,17351,175,45,1925,839,22.0,1947.6,9,0,0,7,11,6,0,0,0,0,17551,6.8,16512,224,43,-1925,-839,26.7,1755.1
4792818496,1,12,1,1,3,3,2,0,0,0,0,16603,7.2,18399,221,48,1749,913,26.9,1660.3,14,0,0,3,3,3,1,1,0,0,14854,6.6,17486,177,64,-1749,-913,24.1,1485.4
4792797104,1,32,1,0,5,3,4,1,0,1,0,16952,7.4,19401,207,82,1734,1303,28.9,1695.2,12,8,1,3,5,4,0,0,0,0,15218,6.8,18098,224,40,-1734,-1303,26.4,1521.8
4792779762,1,18,2,1,12,6,14,0,0,0,0,19659,7.0,18804,219,56,3660,2725,27.5,1965.9,11,4,0,6,12,4,0,0,0,0,15999,6.4,16079,228,24,-3660,-2725,25.2,1599.9
4792141826,0,11,1,0,4,8,2,0,0,0,0,16841,7.0,18489,226,52,-1363,727,27.8,1684.1,14,1,1,8,4,5,1,1,0,0,18204,6.8,17762,213,52,1363,-727,26.5,1820.4
4792101394,1,13,0,1,7,3,8,1,1,0,0,18841,7.2,18836,230,56,2070,755,28.6,1884.1,11,1,0,3,7,3,0,0,0,0,16771,6.8,18081,230,54,-2070,-755,28.4,1677.1
4792074141,0,55,1,1,3,9,1,0,0,0,0,15130,7.2,18053,185,64,-3566,-122,24.9,1513.0,17,0,0,9,3,7,1,1,0,0,18696,7.0,18175,242,56,3566,122,29.8,1869.6
4792037320,1,13,2,0,9,5,8,0,0,0,0,16746,6.6,16611,157,48,-497,-1794,20.5,1674.6,16,2,1,4,8,4,0,0,0,0,17243,6.8,18405,254,44,497,1794,29.8,1724.3
4789476091,1,13,1,1,12,7,15,1,1,0,0,21178,7.0,18030,200,54,5271,3628,25.4,2117.8,13,2,0,7,12,10,0,0,0,0,15907,6.0,14402,159,49,-5271,-3628,20.8,1590.7
4789460891,1,12,1,1,6,1,7,0,0,0,0,17343,6.8,17908,203,56,2868,911,25.9,1734.3,14,1,0,1,6,2,0,0,0,0,14475,6.8,16997,224,64,-2868,-911,28.8,1447.5
4789431486,0,13,1,1,6,5,7,0,0,0,0,17412,7.0,17757,203,36,-191,-1450,23.9,1741.2,15,1,0,5,6,3,2,1,1,0,17603,7.0,19207,199,90,191,1450,28.9,1760.3
4788659230,1,13,4,1,5,3,3,0,0,0,0,17086,7.2,18775,217,56,898,712,27.3,1708.6,16,1,0,3,5,3,1,1,0,0,16188,7.0,18063,239,60,-898,-712,29.9,1618.8
4838099734,1,13,1,0,4,3,1,0,0,0,0,17041,6.8,18285,239,64,1886,2137,30.3,1704.1,13,3,1,3,4,5,0,0,0,0,15155,6.6,16148,212,44,-1886,-2137,25.6,1515.5
4799070596,1,11,2,0,6,5,5,0,0,0,0,16409,7.0,17648,201,38,676,251,23.9,1640.9,16,2,1,5,6,3,0,0,0,0,15733,6.8,17397,215,62,-676,-251,27.7,1573.3
4799059122,0,18,1,0,5,9,6,0,0,0,0,16285,6.6,16405,187,33,-2531,-2330,22.0,1628.5,25,2,1,9,5,9,0,0,0,0,18816,7.2,18735,232,68,2531,2330,30.0,1881.6
4799041949,1,18,18,1,4,0,3,0,0,0,0,16110,7.2,18357,216,60,2542,487,27.6,1611.0,35,1,0,0,4,0,0,0,0,0,13568,6.8,17870,223,56,-2542,-487,27.9,1356.8
4799014276,1,21,0,1,12,3,10,1,1,0,0,18712,7.4,19561,210,68,3284,1825,27.8,1871.2,10,0,0,3,12,4,0,0,0,0,15428,7.0,17736,197,56,-3284,-1825,25.3,1542.8
4798990018,0,16,3,1,6,4,0,0,0,0,0,16797,7.0,17796,207,56,895,276,26.3,1679.7,27,3,0,4,6,3,0,0,0,0,15902,6.8,17520,204,56,-895,-276,26.0,1590.2
4798944671,1,13,2,1,2,3,1,0,0,0,0,15403,7.2,18567,226,60,-146,939,28.6,1540.3,16,2,0,3,2,4,0,0,0,0,15549,6.8,17628,219,52,146,-939,27.1,1554.9
4798904616,1,11,2,0,6,5,5,1,0,1,0,16659,7.0,18475,210,68,-359,880,27.8,1665.9,13,2,1,5,6,7,1,1,0,0,17018,7.0,17595,225,48,359,-880,27.3,1701.8
4798875998,1,15,2,1,5,4,7,0,0,0,0,17101,7.0,18702,238,56,485,-449,29.4,1710.1,14,2,0,4,5,7,1,1,0,0,16616,7.2,19151,206,78,-485,449,28.4,1661.6
4795460712,0,13,2,0,3,6,3,0,0,0,0,16010,6.8,17338,187,52,-710,-1341,23.9,1601.0,10,1,1,6,3,3,1,1,0,0,16720,7.2,18679,230,60,710,1341,29.0,1672.0
4795457381,1,12,2,0,8,6,8,0,0,0,0,18096,7.0,18076,217,48,1427,1761,26.5,1809.6,11,2,1,6,8,9,0,0,0,0,16669,6.6,16315,197,56,-1427,-1761,25.3,1666.9
4795443897,0,17,2,1,13,12,14,1,0,1,0,21714,6.8,17902,216,40,2416,525,25.6,2171.4,13,3,0,11,12,8,1,1,0,0,19298,6.8,17377,206,56,-2416,-525,26.2,1929.8
4795421961,1,8,0,0,26,35,60,0,0,0,1,38007,11.2,40435,109,0,-4976,-6553,10.9,3800.7,0,0,1,35,26,96,0,0,0,0,42983,12.0,46988,129,0,4976,6553,12.9,4298.3
4795405566,0,0,0,0,18,28,37,0,0,0,0,35963,10.8,37758,102,0,-3400,-5452,10.2,3596.3,0,0,1,28,18,70,0,0,0,0,39363,11.6,43210,110,0,3400,5452,11.0,3936.3
4795381079,1,14,3,1,4,5,7,0,0,0,0,16434,7.0,17366,221,72,856,-69,29.3,1643.4,15,2,0,5,4,4,0,0,0,0,15578,6.8,17435,186,48,-856,69,23.4,1557.8
4795255094,0,81,2,1,7,5,6,0,0,0,0,16455,6.4,15630,188,44,247,-1220,23.2,1645.5,12,1,0,5,7,5,0,0,0,0,16208,6.6,16850,200,63,-247,1220,26.3,1620.8
4795204960,1,15,2,1,5,5,3,0,0,0,0,17458,6.8,18037,180,51,-514,-761,23.1,1745.8,13,5,0,5,5,6,0,0,0,0,17972,7.0,18798,232,52,514,761,28.4,1797.2
4795154952,0,23,0,1,10,7,17,0,0,0,0,20295,7.2,18781,247,56,3822,1890,30.3,2029.5,23,1,0,7,10,11,0,0,0,0,16473,6.6,16891,195,39,-3822,-1890,23.4,1647.3
4795012201,0,16,0,1,4,3,4,0,0,0,0,16032,6.8,17494,242,55,131,-42,29.7,1603.2,11,3,0,3,4,2,0,0,0,0,15901,6.8,17536,213,51,-131,42,26.4,1590.1
4857362515,0,40,0,1,5,11,4,0,0,0,0,17456,6.6,17368,221,48,-1917,-1609,26.9,1745.6,8,7,0,11,5,8,1,1,0,0,19373,7.2,18977,205,64,1917,1609,26.9,1937.3
4857322076,1,23,1,1,9,5,12,0,0,0,0,18664,6.6,17473,209,55,2579,1691,26.4,1866.4,13,1,0,5,9,5,0,0,0,0,16085,6.4,15782,210,33,-2579,-1691,24.3,1608.5
4857270513,0,24,2,1,9,7,6,0,0,0,0,17909,6.8,16658,157,49,562,-533,20.6,1790.9,15,2,0,6,8,2,1,1,0,0,17347,6.4,17191,194,48,-562,533,24.2,1734.7
4857062113,1,25,2,1,6,3,2,1,0,1,0,16758,7.2,18928,225,68,1650,584,29.3,1675.8,11,4,0,2,5,0,0,0,0,0,15108,7.0,18344,224,44,-1650,-584,26.8,1510.8
4857042970,1,13,1,0,3,3,3,0,0,0,0,15397,7.2,18879,201,56,378,359,25.7,1539.7,11,3,1,3,3,2,1,1,0,0,15019,7.0,18520,217,56,-378,-359,27.3,1501.9
4857002088,1,20,1,1,10,10,10,1,1,0,0,19062,7.2,18280,160,60,1468,1690,22.0,1906.2,18,1,0,10,10,9,0,0,0,0,17594,6.6,16590,162,52,-1468,-1690,21.4,1759.4
4856971476,1,0,2,0,23,20,20,0,0,0,0,47840,10.0,47500,4,0,16785,19000,0.4,4784.0,26,0,1,12,15,13,0,0,0,0,31055,6.0,28500,1,0,-16785,-19000,0.1,3105.5
4856960069,1,92,0,1,16,18,14,0,0,0,0,47173,10.6,50500,2,0,18772,22000,0.2,4717.3,0,0,0,13,11,12,0,0,0,0,28401,6.0,28500,3,0,-18772,-22000,0.3,2840.1
4856942017,1,6,0,1,18,9,18,0,0,0,0,47517,10.0,47500,3,0,20967,19000,0.3,4751.7,0,0,0,4,13,3,0,0,0,0,26550,6.0,28500,2,0,-20967,-19000,0.2,2655.0
4856923516,1,0,0,0,19,20,10,0,0,0,0,63164,12.0,55000,0,0,25443,22000,0.0,6316.4,0,0,1,12,11,15,0,0,0,0,37721,7.2,33000,0,0,-25443,-22000,0.0,3772.1
4856471715,1,0,6,1,20,15,47,0,0,0,0,34748,10.8,37582,109,0,-1429,-2121,10.9,3474.8,21,0,0,15,20,25,0,0,0,0,36177,11.2,39703,114,0,1429,2121,11.4,3617.7
4856452318,1,16,0,1,26,30,57,0,0,0,1,37633,11.2,40455,117,0,-1359,-1910,11.7,3763.3,13,0,0,30,26,73,0,0,0,0,38992,11.4,42365,96,0,1359,1910,9.6,3899.2
4856426377,1,0,0,0,19,28,49,0,0,0,0,35621,10.6,38445,110,0,-2489,-1604,11.0,3562.1,0,0,1,28,19,80,0,0,0,0,38110,11.0,40049,112,0,2489,1604,11.2,3811.0
4856397965,0,0,1,0,24,22,56,0,0,0,0,36327,11.2,41564,98,0,433,805,9.8,3632.7,19,0,1,22,24,49,0,0,0,0,35894,11.2,40759,96,0,-433,-805,9.6,3589.4
4856369316,0,68,0,0,33,36,75,0,0,0,2,41406,11.8,45551,102,0,1720,676,10.2,4140.6,2,0,1,36,33,78,0,0,0,0,39686,11.8,44875,114,0,-1720,-676,11.4,3968.6
4856092091,0,17,0,0,23,22,56,0,0,0,1,38808,11.2,40096,125,0,2151,-735,12.5,3880.8,0,6,1,22,23,46,0,0,0,0,36657,11.2,40831,90,0,-2151,735,9.0,3665.7
4856059595,1,29,0,0,23,19,53,0,0,0,0,36102,11.0,39368,103,0,448,2050,10.3,3610.2,0,0,1,19,23,39,0,0,0,0,35654,10.8,37318,110,0,-448,-2050,11.0,3565.4
4856025356,1,14,0,0,25,15,65,0,0,0,1,38180,11.0,39910,114,0,3379,1824,11.4,3818.0,0,0,1,15,25,33,0,0,0,0,34801,10.8,38086,91,0,-3379,-1824,9.1,3480.1
4856006034,1,0,0,1,36,27,99,0,0,0,2,43435,12.0,46629,107,0,7127,5211,10.7,4343.5,0,0,0,25,34,63,0,0,0,0,36308,11.2,41418,71,0,-7127,-5211,7.1,3630.8
4855488386,0,23,0,0,25,34,52,0,0,0,1,37141,10.8,39751,92,0,-5349,-6750,9.2,3714.1,2,3,1,34,25,81,0,0,0,0,42490,12.0,46501,122,0,5349,6750,12.2,4249.0
4837296967,0,88,0,1,23,29,54,0,0,0,0,37008,11.0,39106,101,0,-728,-3397,10.1,3700.8,0,0,0,29,23,73,0,0,0,0,37736,11.6,42503,92,0,728,3397,9.2,3773.6
4831270782,1,24,0,1,31,29,83,0,0,0,0,41309,11.8,45776,121,0,2302,3313,12.1,4130.9,0,26,0,29,31,75,0,0,0,0,39007,11.4,42463,91,0,-2302,-3313,9.1,3900.7
4830529520,0,17,2,1,7,13,8,1,1,0,0,16655,6.4,15382,179,43,-3517,-2573,22.2,1665.5,15,4,0,13,7,12,0,0,0,0,20172,6.8,17955,211,47,3517,2573,25.8,2017.2
4830479382,0,11,2,0,5,6,3,0,0,0,0,16345,7.0,18829,230,43,-1160,-430,27.3,1634.5,13,0,1,6,5,5,0,0,0,0,17505,7.2,19259,217,60,1160,430,27.7,1750.5
4829313504,0,0,0,1,25,27,70,0,0,0,2,40578,11.6,42419,115,0,1375,-1067,11.5,4057.8,0,0,0,27,25,76,0,0,0,0,39203,11.8,43486,105,0,-1375,1067,10.5,3920.3
4820916427,1,17,0,0,18,23,31,0,0,0,0,39954,11.2,41828,96,68,3936,1036,16.4,3995.4,15,0,1,23,18,49,0,0,0,0,36018,11.0,40792,67,59,-3936,-1036,12.6,3601.8
4793056653,0,71,3,1,3,3,1,1,1,0,0,15129,7.0,18051,186,47,-2124,-615,23.3,1512.9,11,5,0,3,3,2,1,0,1,0,17253,7.2,18666,206,60,2124,615,26.6,1725.3
4793029301,0,11,3,1,1,5,1,0,0,0,0,15287,6.6,16747,193,47,-1211,-281,24.0,1528.7,11,1,0,5,1,4,2,1,1,0,16498,6.6,17028,195,64,1211,281,25.9,1649.8
4792990555,0,13,1,1,2,1,0,1,0,1,0,15561,7.2,19334,251,65,994,137,31.6,1556.1,13,2,0,1,2,2,1,1,0,0,14567,7.0,19197,234,57,-994,-137,29.1,1456.7
4792818998,0,13,1,0,5,1,6,1,1,0,0,15737,6.8,17667,222,48,874,-396,27.0,1573.7,11,4,1,1,5,1,0,0,0,0,14863,7.2,18063,244,44,-874,396,28.8,1486.3
4792797852,0,12,3,1,6,2,9,0,0,0,0,16620,6.8,17083,207,48,59,-452,25.5,1662.0,18,1,0,2,6,2,2,1,1,0,16561,7.0,17535,213,62,-59,452,27.5,1656.1
4792355800,0,0,0,0,21,28,53,0,0,0,1,37173,11.0,39843,112,0,-3313,-3732,11.2,3717.3,0,0,1,28,21,77,0,0,0,0,40486,11.4,43575,105,0,3313,3732,10.5,4048.6
4792337968,0,0,0,0,33,33,79,0,0,0,1,39573,11.6,45175,91,0,-3352,-423,9.1,3957.3,0,0,1,33,33,87,0,0,0,0,42925,12.0,45598,98,0,3352,423,9.8,4292.5
4792312372,0,11,9,0,2,5,1,0,0,0,0,14498,7.2,18989,189,64,-1523,549,25.3,1449.8,34,0,1,5,2,5,0,0,0,0,16021,7.0,18440,197,56,1523,-549,25.3,1602.1
4792258723,0,12,4,0,3,5,3,0,0,0,0,15798,6.6,16969,162,52,-1172,-732,21.4,1579.8,16,0,1,5,3,3,1,1,0,0,16970,7.0,17701,202,48,1172,732,25.0,1697.0
4792085911,0,11,3,0,1,13,1,0,0,0,0,13612,6.8,16460,174,47,-6172,-2265,22.1,1361.2,11,2,1,13,1,14,1,1,0,0,19784,7.2,18725,216,36,6172,2265,25.2,1978.4
4792040624,1,12,1,0,6,3,5,1,0,1,0,18353,7.2,19955,261,56,4096,2840,31.7,1835.3,11,0,1,3,6,2,0,0,0,0,14257,6.6,17115,183,60,-4096,-2840,24.3,1425.7
4789862966,0,54,4,1,5,6,4,0,0,0,0,16549,6.6,17288,217,56,-167,-3,27.3,1654.9,17,4,0,6,5,6,1,1,0,0,16716,6.8,17291,193,48,167,3,24.1,1671.6
4789830872,1,14,1,1,5,1,3,1,1,0,0,17495,7.2,19760,227,44,2737,2130,27.1,1749.5,9,0,0,1,5,1,0,0,0,0,14758,6.8,17630,238,64,-2737,-2130,30.2,1475.8
4789788133,0,14,2,1,4,6,4,1,1,0,0,14857,6.2,15723,212,45,-2142,-1442,25.7,1485.7,10,1,0,5,3,6,0,0,0,0,16999,6.8,17165,219,46,2142,1442,26.5,1699.9
4855406518,1,2,0,0,15,17,12,0,0,0,0,33750,9.0,40000,2,0,14900,16000,0.2,3375.0,0,0,1,9,7,8,0,0,0,0,18850,5.4,24000,0,0,-14900,-16000,0.0,1885.0
4855369381,0,8,0,1,6,4,2,0,0,0,0,16448,7.2,18685,206,56,338,-650,26.2,1644.8,7,0,0,4,6,3,0,0,0,0,16110,7.2,19335,211,56,-338,650,26.7,1611.0
4855331845,0,13,3,0,2,7,2,0,0,0,0,14470,6.6,16764,210,56,-3174,-2176,26.6,1447.0,17,2,1,7,2,6,1,1,0,0,17644,7.2,18940,214,63,3174,2176,27.7,1764.4
4848718374,1,57,2,0,8,7,11,1,1,0,0,16741,7.0,17798,182,59,-750,1331,24.1,1674.1,15,2,1,7,8,10,0,0,0,0,17491,6.6,16467,198,56,750,-1331,25.4,1749.1
4848698221,1,129,2,1,12,7,19,0,0,0,0,19899,7.0,18347,206,67,2564,1874,27.3,1989.9,9,1,0,7,12,12,1,0,1,0,17335,6.6,16473,207,41,-2564,-1874,24.8,1733.5
4848669435,0,22,1,0,6,6,5,0,0,0,0,16698,6.8,17952,187,58,-16,1787,24.5,1669.8,15,0,1,6,6,4,0,0,0,0,16714,6.4,16165,196,43,16,-1787,23.9,1671.4
4848647660,1,0,0,0,24,30,51,0,0,0,0,38237,11.8,44258,102,0,270,1495,10.2,3823.7,0,0,1,30,24,82,0,0,0,0,37967,11.6,42763,93,0,-270,-1495,9.3,3796.7
4848610424,0,16,1,1,7,5,4,1,0,1,0,17935,7.6,19353,242,48,629,344,29.0,1793.5,7,2,0,5,7,4,0,0,0,0,17306,7.2,19009,220,66,-629,-344,28.6,1730.6
4848540427,0,12,1,1,13,9,8,0,0,0,0,19010,6.6,16752,168,48,-510,-1292,21.6,1901.0,15,0,0,9,13,8,0,0,0,0,19520,7.0,18044,200,64,510,1292,26.4,1952.0
4847871021,0,18,3,1,3,6,6,1,1,0,0,15430,6.8,17382,223,64,-1275,-1270,28.7,1543.0,14,1,0,6,3,4,0,0,0,0,16705,6.8,18652,237,55,1275,1270,29.2,1670.5
4847565346,1,11,2,1,8,5,9,0,0,0,0,18370,7.2,18607,222,64,2447,1548,28.6,1837.0,12,2,0,5,8,5,0,0,0,0,15923,6.8,17059,213,60,-2447,-1548,27.3,1592.3
4847539383,0,19,3,0,3,10,0,0,0,0,0,14420,6.8,16890,212,52,-4299,-1607,26.4,1442.0,87,1,1,10,3,10,1,1,0,0,18719,7.0,18497,185,54,4299,1607,23.9,1871.9
4841880825,1,37,2,1,5,3,5,1,1,0,0,18119,7.4,19475,224,64,3203,1568,28.8,1811.9,31,5,0,3,5,4,0,0,0,0,14916,7.0,17907,220,52,-3203,-1568,27.2,1491.6
4841848723,0,14,0,1,2,3,3,0,0,0,0,15045,6.8,17830,201,64,-963,-498,26.5,1504.5,12,0,0,3,2,2,0,0,0,0,16008,6.8,18328,216,52,963,498,26.8,1600.8
4840757423,0,19,0,0,1,4,1,0,0,0,0,15387,6.8,17408,217,52,-1544,-581,26.9,1538.7,11,2,1,4,1,5,0,0,0,0,16931,6.8,17989,196,52,1544,581,24.8,1693.1
4840733704,0,13,0,1,7,8,8,1,1,0,0,17320,6.8,17596,204,40,-1383,-1309,24.4,1732.0,12,0,0,8,7,7,0,0,0,0,18703,7.0,18905,201,60,1383,1309,26.1,1870.3
4840340714,0,12,1,0,5,8,2,0,0,0,0,15963,6.8,18054,178,53,-795,431,23.1,1596.3,9,0,1,8,5,4,0,0,0,0,16758,6.8,17623,201,58,795,-431,25.9,1675.8
4840297737,1,13,2,0,8,3,6,0,0,0,0,17829,7.0,19267,245,60,2796,917,30.5,1782.9,9,1,1,3,8,2,1,1,0,0,15033,7.0,18350,178,59,-2796,-917,23.7,1503.3
4840256901,1,9,0,1,8,3,12,0,0,0,0,18889,6.8,18750,214,56,3718,1596,27.0,1888.9,40,0,0,3,8,5,0,0,0,0,15171,6.8,17154,195,68,-3718,-1596,26.3,1517.1
4857539498,0,13,1,0,0,1,0,0,0,0,0,14552,7.0,18118,228,64,-1137,0,29.2,1455.2,10,2,1,1,0,1,0,0,0,0,15689,6.8,18118,192,72,1137,0,26.4,1568.9
4857496624,1,11,2,1,6,3,6,0,0,0,0,17757,6.8,17930,217,58,2600,510,27.5,1775.7,14,1,0,3,6,2,0,0,0,0,15157,6.8,17420,224,56,-2600,-510,28.0,1515.7
4857446411,1,20,4,1,10,3,10,1,1,0,0,18896,7.0,18361,217,56,4838,1956,27.3,1889.6,12,4,0,3,10,2,0,0,0,0,14058,6.6,16405,185,52,-4838,-1956,23.7,1405.8
4857402506,1,13,1,0,6,4,4,1,1,0,0,17224,7.2,19273,219,76,2323,1936,29.5,1722.4,15,0,1,3,5,1,0,0,0,0,14901,6.8,17337,190,48,-2323,-1936,23.8,1490.1
4857354737,1,14,1,0,9,1,15,0,0,0,0,17937,6.6,17110,241,40,2716,-655,28.1,1793.7,12,3,1,1,9,4,0,0,0,0,15221,7.0,17765,251,44,-2716,655,29.5,1522.1
4857316268,1,11,3,1,7,1,3,1,1,0,0,18188,7.4,19755,240,56,3587,1942,29.6,1818.8,17,3,0,1,7,1,0,0,0,0,14601,6.8,17813,241,60,-3587,-1942,30.1,1460.1
4857061062,1,26,2,1,9,4,8,0,0,0,0,17929,6.6,18092,195,48,2160,199,24.3,1792.9,18,0,0,4,9,3,0,0,0,0,15769,6.8,17893,211,72,-2160,-199,28.3,1576.9
4857037778,0,15,1,0,2,12,3,0,0,0,0,14482,6.4,15184,173,37,-5270,-3364,21.0,1448.2,15,2,1,12,2,7,0,0,0,0,19752,7.0,18548,239,54,5270,3364,29.3,1975.2
4856783057,1,216,0,0,16,20,8,0,0,0,0,47172,10.0,47500,3,0,18112,19000,0.3,4717.2,0,0,1,11,7,14,0,0,0,0,29060,6.0,28500,3,0,-18112,-19000,0.3,2906.0
4856466853,1,13,1,0,6,6,4,0,0,0,0,16941,6.8,17663,230,48,-115,-1004,27.8,1694.1,20,0,1,6,6,5,0,0,0,0,17056,7.0,18667,203,56,115,1004,25.9,1705.6
4856307694,1,0,0,1,21,15,18,0,0,0,0,52200,12.0,55000,0,0,22000,22000,0.0,5220.0,0,0,0,5,11,6,0,0,0,0,30200,7.2,33000,0,0,-22000,-22000,0.0,3020.0
4856281921,1,0,0,1,15,15,12,0,0,0,0,45600,10.0,47500,0,0,17400,19000,0.0,4560.0,0,0,0,10,10,11,0,0,0,0,28200,6.0,28500,0,0,-17400,-19000,0.0,2820.0
4856235148,1,0,0,1,27,26,86,0,0,0,1,39187,11.4,42392,98,0,1020,-168,9.8,3918.7,0,0,0,26,27,78,0,0,0,0,38167,11.4,42560,81,0,-1020,168,8.1,3816.7
4856195554,1,34,0,0,16,20,40,0,0,0,0,34308,10.4,36163,112,0,-726,-1446,11.2,3430.8,34,0,1,20,16,67,0,0,0,0,35034,10.6,37609,100,0,726,1446,10.0,3503.4
4856154739,1,0,0,1,22,19,55,0,0,0,1,36024,11.0,39668,119,0,1603,1058,11.9,3602.4,0,0,0,19,22,40,0,0,0,0,34421,11.0,38610,95,0,-1603,-1058,9.5,3442.1
4856089819,1,0,0,1,18,10,17,0,0,0,0,46512,10.0,47500,3,0,20380,19000,0.3,4651.2,0,0,0,4,12,5,0,0,0,0,26132,6.0,28500,0,0,-20380,-19000,0.0,2613.2
4856062306,1,1,0,0,14,20,13,0,0,0,0,61030,12.0,55000,0,0,22080,22000,0.0,6103.0,44,0,1,14,8,14,0,0,0,0,38950,7.2,33000,0,0,-22080,-22000,0.0,3895.0
4856043000,1,0,0,0,17,19,24,0,0,0,0,62129,12.0,55000,2,0,23439,22000,0.2,6212.9,0,0,1,17,15,12,0,0,0,0,38690,7.2,33000,1,0,-23439,-22000,0.1,3869.0
4856016459,1,23,0,1,14,16,14,0,0,0,0,61744,12.0,55000,1,0,22044,22000,0.1,6174.4,216,1,0,12,10,10,0,0,0,0,39700,7.2,33000,2,0,-22044,-22000,0.2,3970.0
4855862391,1,11,1,0,0,4,0,1,1,0,0,13110,6.4,16114,179,64,-2738,-2054,24.3,1311.0,9,2,1,4,0,4,0,0,0,0,15848,6.8,18168,229,56,2738,2054,28.5,1584.8
4841973782,1,2,17,0,21,35,63,0,0,0,1,36951,11.4,42392,96,0,-3648,-2430,9.6,3695.1,30,0,1,35,21,98,0,0,0,0,40599,11.8,44822,112,0,3648,2430,11.2,4059.9
4841947244,1,0,0,0,19,17,48,0,0,0,1,36216,11.0,39095,109,0,-1149,768,10.9,3621.6,0,0,1,17,19,37,0,0,0,0,37365,10.8,38327,117,0,1149,-768,11.7,3736.5
4841928365,0,0,14,0,28,27,67,0,0,0,1,38254,11.4,43197,90,0,-1008,-129,9.0,3825.4,26,0,1,27,28,77,0,0,0,0,39262,11.4,43326,109,0,1008,129,10.9,3926.2
4824758480,1,0,0,1,19,18,59,0,0,0,1,35032,10.4,36408,103,0,-166,-7,10.3,3503.2,0,0,0,18,19,50,0,0,0,0,35198,10.6,36415,112,0,166,7,11.2,3519.8
4824719899,1,0,3,1,12,15,33,0,0,0,0,34028,10.4,35705,105,0,-449,-1916,10.5,3402.8,13,0,0,15,12,45,0,0,0,0,34477,10.6,37621,105,0,449,1916,10.5,3447.7
4823594863,1,0,1,1,29,27,62,0,0,0,0,38469,11.6,44904,109,0,51,300,10.9,3846.9,9,0,0,27,29,62,0,0,0,0,38418,11.6,44604,108,0,-51,-300,10.8,3841.8
4822733064,0,0,0,1,26,25,66,0,0,0,2,36766,11.0,40265,80,0,-2206,-2767,8.0,3676.6,0,0,0,25,26,54,0,0,0,0,38972,11.6,43032,110,0,2206,2767,11.0,3897.2
4822717861,0,0,0,1,35,33,96,0,0,0,0,40714,12.0,45789,102,0,236,-1641,10.2,4071.4,0,0,0,33,35,83,0,0,0,0,40478,12.2,47430,106,0,-236,1641,10.6,4047.8
4822695484,1,0,0,0,18,22,45,0,0,0,1,36214,10.6,37390,112,0,874,-572,11.2,3621.4,22,0,1,22,18,59,0,0,0,0,35340,10.8,37962,106,0,-874,572,10.6,3534.0
4822617738,0,15,2,0,3,6,5,0,0,0,0,15224,6.4,15959,170,52,-1573,200,22.2,1522.4,12,1,1,6,3,8,0,0,0,0,16797,6.4,15759,203,36,1573,-200,23.9,1679.7
4822591260,0,90,0,1,23,17,52,0,0,0,0,36612,11.0,39419,114,0,1681,2233,11.4,3661.2,0,0,0,17,23,34,0,0,0,0,34931,10.6,37186,101,0,-1681,-2233,10.1,3493.1
4821544324,1,0,0,0,24,25,61,0,0,0,1,37481,11.2,40054,128,0,-248,-1099,12.8,3748.1,0,0,1,25,24,65,0,0,0,0,37729,11.2,41153,107,0,248,1099,10.7,3772.9
4821530636,1,0,0,1,33,21,95,0,0,0,1,39645,11.4,42828,114,0,2990,2762,11.4,3964.5,0,0,0,21,33,51,0,0,0,0,36655,10.8,40066,88,0,-2990,-2762,8.8,3665.5
4821521990,0,0,0,1,28,25,81,0,0,0,0,37986,11.4,41944,98,0,468,-49,9.8,3798.6,22,0,0,25,28,72,0,0,0,0,37518,11.4,41993,111,0,-468,49,11.1,3751.8
4821504651,0,0,0,1,20,19,63,0,0,0,1,36970,11.0,39208,107,0,1418,3414,10.7,3697.0,3,0,0,18,19,45,0,0,0,0,35552,10.2,35794,112,0,-1418,-3414,11.2,3555.2
4772359449,1,11,4,0,1,8,2,0,0,0,0,15735,6.8,17649,213,72,-1986,-1114,28.5,1573.5,12,1,1,8,1,7,1,1,0,0,17721,7.2,18763,218,64,1986,1114,28.2,1772.1
4772329976,1,50,0,0,13,21,33,0,0,0,0,33465,10.6,36667,75,0,-4122,-5369,7.5,3346.5,34,0,1,21,13,58,0,0,0,0,37587,11.4,42036,114,0,4122,5369,11.4,3758.7
4771999176,0,34,3,0,2,7,0,0,0,0,0,15324,6.8,18129,233,78,-2156,-544,31.1,1532.4,33,3,1,7,2,6,2,1,1,0,17480,7.2,18673,193,57,2156,544,25.0,1748.0
4771967620,0,3,0,0,28,27,54,0,0,0,1,37942,11.6,42985,108,0,-936,-2049,10.8,3794.2,0,0,1,27,28,60,0,0,0,0,38878,11.8,45034,92,0,936,2049,9.2,3887.8
4771957062,1,0,0,1,28,22,63,0,0,0,1,41028,11.6,43660,112,0,5040,4123,11.2,4102.8,0,0,0,22,28,56,0,0,0,0,35988,11.0,39537,84,0,-5040,-4123,8.4,3598.8
4855867671,0,21,1,0,6,6,7,0,0,0,0,17397,7.4,18984,230,60,-125,522,29.0,1739.7,20,4,1,6,6,8,0,0,0,0,17522,7.2,18462,221,64,125,-522,28.5,1752.2
4855831557,1,124,3,1,6,2,7,1,1,0,0,16379,7.0,18167,218,52,2442,927,27.0,1637.9,12,2,0,2,6,0,0,0,0,0,13937,6.8,17240,196,56,-2442,-927,25.2,1393.7
4855807222,1,76,1,0,8,6,6,0,0,0,0,18060,7.4,18758,222,64,233,5,28.6,1806.0,13,1,1,6,8,5,1,1,0,0,17827,7.2,18753,216,64,-233,-5,28.0,1782.7
4854150391,0,20,2,1,3,8,3,0,0,0,0,16182,7.0,17581,212,56,-2033,-2173,26.8,1618.2,11,2,0,8,3,11,1,1,0,0,18215,7.2,19754,263,56,2033,2173,31.9,1821.5
4854115404,1,7,1,0,4,3,1,1,1,0,0,16324,7.0,18978,218,64,821,1492,28.2,1632.4,13,1,1,3,4,4,0,0,0,0,15503,6.8,17486,208,44,-821,-1492,25.2,1550.3
4853846377,1,12,1,1,8,3,10,1,1,0,0,17870,6.8,17402,211,52,1474,-1493,26.3,1787.0,15,0,0,3,8,0,0,0,0,0,16396,7.2,18895,225,73,-1474,1493,29.8,1639.6
4845132029,1,14,3,1,2,9,1,0,0,0,0,14919,6.4,17279,207,52,-3851,-1161,25.9,1491.9,14,3,0,9,2,12,1,1,0,0,18770,6.8,18440,222,48,3851,1161,27.0,1877.0
4845093007,0,17,1,0,3,4,3,0,0,0,0,15472,6.8,16920,183,61,-1155,-1347,24.4,1547.2,13,2,1,4,3,3,1,1,0,0,16627,7.0,18267,223,60,1155,1347,28.3,1662.7
4844859907,1,15,1,1,6,10,9,0,0,0,0,16816,6.6,16678,217,46,-2614,-1163,26.3,1681.6,85,0,0,10,6,15,0,0,0,0,19430,6.8,17841,229,44,2614,1163,27.3,1943.0
4844411924,0,9,0,0,2,4,1,1,1,0,0,16545,6.8,18479,262,56,-709,-2191,31.8,1654.5,12,0,1,4,2,2,0,0,0,0,17254,7.6,20670,236,68,709,2191,30.4,1725.4
4844390845,0,11,1,0,4,4,4,0,0,0,0,15682,7.0,17312,230,60,-403,-576,29.0,1568.2,73,0,1,4,4,2,1,1,0,0,16085,6.8,17888,239,54,403,576,29.3,1608.5
4843925527,0,10,1,0,5,5,6,1,1,0,0,16062,6.8,17224,189,50,-470,-578,23.9,1606.2,12,2,1,5,5,2,0,0,0,0,16532,7.0,17802,240,51,470,578,29.1,1653.2
4843910893,1,17,1,1,4,1,2,1,1,0,0,17067,7.4,20399,232,84,2294,1823,31.6,1706.7,37,1,0,1,4,1,0,0,0,0,14773,7.0,18576,211,62,-2294,-1823,27.3,1477.3
4843831237,1,74,4,1,7,6,6,0,0,0,0,17905,7.2,18619,216,56,1262,-110,27.2,1790.5,13,0,0,6,7,5,1,1,0,0,16643,7.0,18729,225,59,-1262,110,28.4,1664.3
4843815900,1,12,2,1,4,5,4,0,0,0,0,16305,7.0,17975,214,54,-107,-438,26.8,1630.5,12,1,0,5,4,4,1,1,0,0,16412,7.0,18413,219,56,107,438,27.5,1641.2
4842032512,1,13,1,0,6,4,4,0,0,0,0,19080,7.0,18948,240,44,2435,767,28.4,1908.0,10,2,1,4,6,3,0,0,0,0,16645,7.0,18181,205,64,-2435,-767,26.9,1664.5
4835756080,1,15,1,0,5,3,1,0,0,0,0,17780,7.4,20202,256,68,1316,1759,32.4,1778.0,11,1,1,3,5,2,0,0,0,0,16464,7.0,18443,237,55,-1316,-1759,29.2,1646.4
4834603482,1,12,4,0,15,8,11,1,1,0,0,21823,7.4,19635,226,66,6004,4434,29.2,2182.3,10,1,1,8,15,8,0,0,0,0,15819,6.2,15201,173,33,-6004,-4434,20.6,1581.9
4834582887,1,15,0,0,3,4,3,0,0,0,0,15668,7.0,17781,213,59,-1783,-1646,27.2,1566.8,14,2,1,4,3,3,2,1,1,0,17451,7.4,19427,266,64,1783,1646,33.0,1745.1
4833611679,1,15,1,1,6,3,6,1,1,0,0,16494,6.8,17575,242,44,1677,276,28.6,1649.4,10,1,0,3,6,2,0,0,0,0,14817,6.6,17299,198,52,-1677,-276,25.0,1481.7
4856220260,0,0,0,0,18,22,36,0,0,0,1,35704,10.8,37822,72,0,-1229,-3177,7.2,3570.4,0,0,1,22,18,50,0,0,0,0,36933,11.4,40999,98,0,1229,3177,9.8,3693.3
4855305698,0,0,0,0,12,18,36,0,0,0,0,33251,10.4,35256,93,0,-2084,-4130,9.3,3325.1,0,0,1,18,12,42,0,0,0,0,35335,11.0,39386,101,0,2084,4130,10.1,3533.5
4855285125,1,0,0,1,30,10,80,0,0,0,0,37780,11.2,42254,107,0,4851,7572,10.7,3778.0,17,0,0,10,30,20,0,0,0,0,32929,10.2,34682,91,0,-4851,-7572,9.1,3292.9
4854247862,0,0,0,0,20,24,58,0,0,0,1,35445,11.0,37762,89,0,-3338,-2116,8.9,3544.5,0,0,1,24,20,53,0,0,0,0,38783,11.2,39878,123,0,3338,2116,12.3,3878.3
4854226210,0,0,0,1,26,31,72,0,0,0,1,37320,11.0,40619,104,0,-1459,-2251,10.4,3732.0,18,0,0,31,26,74,0,0,0,0,38779,11.4,42870,96,0,1459,2251,9.6,3877.9
4854199390,0,93,0,0,25,24,54,0,0,0,1,37046,11.2,41602,76,0,-1266,132,7.6,3704.6,2,0,1,24,25,51,0,0,0,0,38312,11.0,41470,117,0,1266,-132,11.7,3831.2
4854174472,0,59,0,0,26,25,63,0,0,0,1,38471,11.6,43650,111,0,1364,2617,11.1,3847.1,0,20,1,25,26,65,0,0,0,0,37107,11.0,41033,94,0,-1364,-2617,9.4,3710.7
4848675914,0,0,0,0,32,37,76,0,0,0,2,38499,11.2,42373,90,0,-4655,-5856,9.0,3849.9,0,0,1,37,32,112,0,0,0,0,43154,12.4,48229,116,0,4655,5856,11.6,4315.4
4848564364,1,0,11,1,20,25,59,0,0,0,1,38156,11.4,40735,116,0,1367,985,11.6,3815.6,30,0,0,25,20,66,0,0,0,0,36789,10.8,39750,91,0,-1367,-985,9.1,3678.9
4848552114,1,1,0,1,25,28,48,0,0,0,0,38754,11.4,43513,102,0,1209,539,10.2,3875.4,0,0,0,28,25,71,0,0,0,0,37545,11.6,42974,99,0,-1209,-539,9.9,3754.5
4848531554,0,11,0,0,30,26,82,0,0,0,0,39227,11.4,42217,110,0,1787,1081,11.0,3922.7,3,0,1,26,30,64,0,0,0,0,37440,11.0,41136,90,0,-1787,-1081,9.0,3744.0
4842272730,0,2,0,0,14,28,29,0,0,0,1,34532,10.6,36897,100,0,-1696,-2486,10.0,3453.2,0,0,1,28,14,83,0,0,0,0,36228,11.0,39383,110,0,1696,2486,11.0,3622.8
4835963869,1,0,13,0,15,20,37,0,0,0,0,33848,10.6,36780,115,0,-1443,-2623,11.5,3384.8,38,0,1,20,15,47,0,0,0,0,35291,11.0,39403,90,0,1443,2623,9.0,3529.1
4835932960,0,0,2,0,15,22,32,0,0,0,1,35280,10.6,37357,101,0,-1191,-3319,10.1,3528.0,3,0,1,22,15,53,0,0,0,0,36471,11.2,40676,109,0,1191,3319,10.9,3647.1
4835901121,0,14,0,1,27,22,68,0,0,0,2,38155,11.4,42452,104,0,1296,2515,10.4,3815.5,226,3,0,22,27,46,0,0,0,0,36859,11.2,39937,90,0,-1296,-2515,9.0,3685.9
4834908930,1,21,0,0,18,25,34,0,0,0,0,36823,11.0,40787,98,0,-80,280,9.8,3682.3,0,20,1,25,18,57,0,0,0,0,36903,11.0,40507,99,0,80,-280,9.9,3690.3
4834878541,1,0,21,1,19,24,50,0,0,0,1,37102,11.2,40998,96,0,1223,2261,9.6,3710.2,23,0,0,24,19,54,0,0,0,0,35879,10.8,38737,103,0,-1223,-2261,10.3,3587.9
4834862991,1,0,5,1,37,25,95,0,0,0,1,40604,11.8,45096,121,0,4066,3453,12.1,4060.4,13,0,0,25,37,45,0,0,0,0,36538,11.4,41643,92,0,-4066,-3453,9.2,3653.8
4834841182,1,88,0,0,28,22,71,0,0,0,0,41243,11.6,44354,111,0,3985,4510,11.1,4124.3,0,0,1,22,28,60,0,0,0,0,37258,11.0,39844,98,0,-3985,-4510,9.8,3725.8
4857213461,1,13,2,0,4,5,2,0,0,0,0,15274,7.0,18047,191,60,-1122,-511,25.1,1527.4,12,0,1,5,4,3,0,0,0,0,16396,7.0,18558,245,68,1122,511,31.3,1639.6
4854272331,0,6,0,1,32,37,81,0,0,0,2,39293,11.8,44282,78,0,-2649,-633,7.8,3929.3,0,0,0,37,32,97,0,0,0,0,41942,11.8,44915,115,0,2649,633,11.5,4194.2
4854227716,0,14,1,0,3,10,3,1,1,0,0,14091,6.6,16580,173,56,-3497,-2025,22.9,1409.1,8,1,1,10,3,8,0,0,0,0,17588,7.0,18605,212,56,3497,2025,26.8,1758.8
4854188223,0,14,0,0,6,8,3,0,0,0,0,17079,7.2,18991,224,64,-2168,1911,28.8,1707.9,12,1,1,8,6,12,1,1,0,0,19247,7.0,17080,191,52,2168,-1911,24.3,1924.7
4854150055,0,20,2,0,4,7,3,0,0,0,0,15513,6.8,17794,217,52,-2506,-1516,26.9,1551.3,15,3,1,7,4,5,1,0,1,0,18019,7.0,19310,229,72,2506,1516,30.1,1801.9
4853957896,1,49,0,0,9,5,8,0,0,0,0,18960,7.0,18951,227,60,2227,1120,28.7,1896.0,8,0,1,5,9,8,0,0,0,0,16733,6.8,17831,210,56,-2227,-1120,26.6,1673.3
4852312104,0,101,4,0,8,5,11,1,1,0,0,18526,7.2,19001,210,64,1954,98,27.4,1852.6,30,3,1,5,8,3,1,0,1,0,16572,7.4,18903,216,60,-1954,-98,27.6,1657.2
4851851026,1,22,2,1,6,6,12,1,1,0,0,16832,6.8,16692,216,63,-246,-796,27.9,1683.2,14,2,0,6,6,6,0,0,0,0,17078,7.0,17488,189,52,246,796,24.1,1707.8
4851134257,1,3,4,1,40,27,85,0,0,0,1,42532,12.2,47749,126,0,3161,3620,12.6,4253.2,14,0,0,27,40,72,0,0,0,0,39371,11.6,44129,96,0,-3161,-3620,9.6,3937.1
4851114328,0,15,1,0,5,4,4,1,1,0,0,15585,6.8,17318,181,48,-2500,-1858,22.9,1558.5,11,1,1,4,5,2,0,0,0,0,18085,7.2,19176,226,72,2500,1858,29.8,1808.5
4851082571,0,11,0,1,6,2,5,0,0,0,0,16895,7.0,18260,231,56,365,-218,28.7,1689.5,12,1,0,2,6,1,0,0,0,0,16530,7.0,18478,236,56,-365,218,29.2,1653.0
4851051787,0,12,2,1,7,5,6,1,1,0,0,17673,7.6,19737,252,67,318,775,31.9,1767.3,10,1,0,5,7,3,0,0,0,0,17355,7.0,18962,235,48,-318,-775,28.3,1735.5
4851028074,1,12,0,0,9,2,5,0,0,0,0,17188,7.2,18635,205,72,3406,2753,27.7,1718.8,13,0,1,2,9,0,0,0,0,0,13782,6.4,15882,170,49,-3406,-2753,21.9,1378.2
4850190807,1,34,1,1,11,6,11,0,0,0,0,20033,7.4,19141,234,63,4162,2491,29.7,2003.3,28,1,0,6,11,4,0,0,0,0,15871,6.4,16650,179,40,-4162,-2491,21.9,1587.1
4850154663,0,11,2,0,4,5,4,0,0,0,0,16413,7.0,18471,229,58,637,412,28.7,1641.3,11,0,1,5,4,4,1,1,0,0,15776,7.0,18059,184,68,-637,-412,25.2,1577.6
4848137061,0,11,2,1,9,8,12,0,0,0,0,17387,6.8,17532,179,43,122,-1156,22.2,1738.7,12,1,0,8,9,3,0,0,0,0,17265,7.2,18688,225,60,-122,1156,28.5,1726.5
4848096468,0,12,0,0,2,8,1,0,0,0,0,14375,7.0,17485,179,68,-4271,-2692,24.7,1437.5,10,1,1,8,2,3,1,1,0,0,18646,7.4,20177,244,64,4271,2692,30.8,1864.6
4848053491,1,17,2,1,5,4,6,1,1,0,0,17567,6.8,17957,231,56,1100,-416,28.7,1756.7,13,2,0,4,5,2,0,0,0,0,16467,6.8,18373,222,53,-1100,416,27.5,1646.7
4848021967,0,14,0,1,5,7,6,0,0,0,0,16741,6.8,17204,212,48,-643,-1080,26.0,1674.1,8,1,0,7,5,5,0,0,0,0,17384,7.2,18284,244,60,643,1080,30.4,1738.4
4812808286,1,11,1,0,2,2,1,1,1,0,0,15790,7.0,18755,263,54,1131,1666,31.7,1579.0,15,0,1,2,2,0,1,0,1,0,14659,6.8,17089,215,64,-1131,-1666,27.9,1465.9
4788550521,0,19,1,0,7,7,3,0,0,0,0,16930,7.0,18057,239,60,182,-164,29.9,1693.0,13,0,1,6,6,3,1,1,0,0,16748,7.0,18221,209,56,-182,164,26.5,1674.8
4784477619,0,15,2,1,10,3,6,0,0,0,0,18523,7.0,17859,222,56,2536,1385,27.8,1852.3,11,1,0,3,10,0,1,1,0,0,15987,6.6,16474,196,58,-2536,-1385,25.4,1598.7
4784439237,1,12,4,0,9,7,9,0,0,0,0,17868,6.6,16982,214,40,594,-791,25.4,1786.8,18,0,1,6,8,9,1,1,0,0,17274,6.8,17773,195,59,-594,791,25.4,1727.4
4784283598,0,15,1,1,3,5,4,0,0,0,0,15953,6.8,17703,214,64,-457,-162,27.8,1595.3,15,2,0,5,3,6,0,0,0,0,16410,6.8,17865,242,52,457,162,29.4,1641.0
4782531917,1,12,0,1,5,5,8,0,0,0,0,17199,7.0,18299,210,55,-205,-145,26.5,1719.9,11,0,0,5,5,5,0,0,0,0,17404,7.2,18444,261,59,205,145,32.0,1740.4
4776075174,0,11,8,1,4,1,4,0,0,0,0,16616,6.8,17866,223,60,1884,45,28.3,1661.6,44,0,0,1,4,1,1,0,1,0,14732,7.0,17821,214,53,-1884,-45,26.7,1473.2
4776032245,1,15,2,0,4,7,0,2,1,1,0,15002,6.8,17409,197,64,-2229,-570,26.1,1500.2,12,1,1,7,4,5,0,0,0,0,17231,7.0,17979,211,55,2229,570,26.6,1723.1
4775993051,1,16,2,0,7,6,7,1,1,0,0,17867,7.2,18566,229,61,194,1726,29.0,1786.7,14,1,1,6,7,7,1,0,1,0,17673,6.8,16840,206,48,-194,-1726,25.4,1767.3
4775956752,1,10,3,1,8,11,7,1,1,0,0,18513,7.0,18425,191,58,-633,132,24.9,1851.3,12,1,0,11,8,10,0,0,0,0,19146,7.2,18293,193,64,633,-132,25.7,1914.6
4723068063,1,42,0,1,21,18,20,0,0,0,0,64599,12.0,55000,8,0,26737,22000,0.8,6459.9,0,0,0,9,12,11,0,0,0,0,37862,7.2,33000,4,0,-26737,-22000,0.4,3786.2
4722988220,1,0,0,0,13,16,18,0,0,0,0,60150,12.0,55000,0,0,23500,21000,0.0,6015.0,0,0,1,11,8,7,0,0,0,0,36650,7.4,34000,0,0,-23500,-21000,0.0,3665.0
4722974809,1,9,0,1,15,17,24,0,0,0,0,64690,13.0,62500,3,0,27760,25000,0.3,6469.0,0,0,0,14,12,4,0,0,0,0,36930,7.8,37500,0,0,-27760,-25000,0.0,3693.0
4722946603,1,0,0,1,20,14,11,0,0,0,0,48150,10.0,47500,2,0,21000,19000,0.2,4815.0,0,0,0,5,11,10,0,0,0,0,27150,6.0,28500,0,0,-21000,-19000,0.0,2715.0
4722937977,1,30,4,1,16,17,14,0,0,0,0,63800,12.0,55000,1,0,21980,22000,0.1,6380.0,0,4,0,10,9,11,0,0,0,0,41820,7.2,33000,1,0,-21980,-22000,0.1,4182.0
4722912645,1,87,0,1,16,20,15,0,0,0,0,62143,12.0,55000,0,0,22822,22000,0.0,6214.3,0,0,0,12,8,15,0,0,0,0,39321,7.2,33000,0,0,-22822,-22000,0.0,3932.1
4722893051,1,5,0,1,23,14,19,0,0,0,0,65150,12.0,55000,6,0,27600,22000,0.6,6515.0,0,0,0,5,14,12,0,0,0,0,37550,7.2,33000,2,0,-27600,-22000,0.2,3755.0
4722868529,1,0,0,1,17,20,18,0,0,0,0,64100,13.0,62500,0,0,25500,25000,0.0,6410.0,0,0,0,12,9,11,0,0,0,0,38600,7.8,37500,0,0,-25500,-25000,0.0,3860.0
4722849068,1,32,0,1,18,14,26,0,0,0,0,66352,12.0,55000,4,0,30902,22000,0.4,6635.2,0,0,0,9,13,1,0,0,0,0,35450,7.2,33000,0,0,-30902,-22000,0.0,3545.0
4722831980,1,10,0,0,15,18,16,0,0,0,0,60610,12.8,59000,1,0,22469,26000,0.1,6061.0,34,1,1,11,8,13,0,0,0,0,38141,7.2,33000,1,0,-22469,-26000,0.1,3814.1
4850346887,0,80,0,1,27,26,69,0,0,0,1,37142,11.2,41960,98,0,-3177,-1364,9.8,3714.2,0,0,0,26,27,77,0,0,0,0,40319,11.4,43324,130,0,3177,1364,13.0,4031.9
4845733820,1,0,0,0,21,18,56,0,0,0,1,37062,11.2,39514,115,0,3117,2991,11.5,3706.2,0,0,1,18,21,47,0,0,0,0,33945,10.6,36523,89,0,-3117,-2991,8.9,3394.5
4835487574,0,14,0,0,16,22,27,0,0,0,0,32555,10.4,35518,96,55,-8174,-8731,15.1,3255.5,32,0,1,22,16,54,0,0,0,0,40729,11.8,44249,96,64,8174,8731,16.0,4072.9
4835478499,1,18,0,0,16,18,24,0,0,0,0,39932,11.8,43529,131,64,3328,4839,19.5,3993.2,21,0,1,18,16,25,0,0,0,0,36604,11.0,38690,89,59,-3328,-4839,14.8,3660.4
4835473953,1,14,1,0,18,10,29,0,0,0,1,31372,10.6,35261,56,59,197,157,11.5,3137.2,19,0,1,10,18,17,0,0,0,0,31175,10.4,35104,76,45,-197,-157,12.1,3117.5
4835462209,0,22,1,1,16,21,38,0,0,0,1,33932,11.0,39385,104,51,-1201,152,15.5,3393.2,15,4,0,21,16,48,0,0,0,0,35133,11.0,39233,90,57,1201,-152,14.7,3513.3
4834766808,1,11,2,1,15,9,28,0,0,0,0,35462,11.2,39546,94,71,5077,4219,16.5,3546.2,34,0,0,9,15,18,0,0,0,0,30385,10.4,35327,85,55,-5077,-4219,14.0,3038.5
4834737349,0,15,0,1,18,28,32,0,0,0,2,38656,11.2,42185,97,59,-5744,-6574,15.6,3865.6,13,0,0,27,17,45,0,0,0,0,44400,12.2,48759,140,71,5744,6574,21.1,4440.0
4834588700,1,17,0,1,23,13,42,0,0,0,0,39393,12.0,48160,127,58,8000,8829,18.5,3939.3,212,0,0,12,22,33,0,0,0,0,31393,11.2,39331,86,36,-8000,-8829,12.2,3139.3
4834583833,1,17,0,0,11,9,15,0,0,0,0,34724,11.2,40782,111,63,4690,3114,17.4,3472.4,11,1,1,8,10,22,0,0,0,0,30034,10.6,37668,107,55,-4690,-3114,16.2,3003.4
4832668938,0,62,2,0,7,19,16,0,0,0,0,33995,11.0,37823,100,43,-1750,-6028,14.3,3399.5,65,0,1,19,7,41,0,0,0,0,35745,11.6,43851,56,63,1750,6028,11.9,3574.5
4832656139,0,195,3,1,9,13,14,0,0,0,0,32416,10.6,36873,79,63,-1687,-1337,14.2,3241.6,16,0,0,13,9,21,0,0,0,0,34103,11.0,38210,105,61,1687,1337,16.6,3410.3
4832645363,0,0,0,1,18,31,42,0,0,0,2,36801,10.8,38882,98,0,-2121,-2871,9.8,3680.1,0,0,0,31,18,90,0,0,0,0,38922,11.4,41753,115,0,2121,2871,11.5,3892.2
4832640128,0,19,0,0,11,19,33,0,0,0,0,30470,10.4,36444,92,47,-11014,-9169,13.9,3047.0,15,0,1,19,11,36,0,0,0,0,41484,11.8,45613,115,80,11014,9169,19.5,4148.4
4832630402,0,9,1,0,9,16,24,0,0,0,1,32924,10.6,36606,85,63,-2137,-3469,14.8,3292.4,8,0,1,16,9,40,0,0,0,0,35061,11.0,40075,90,64,2137,3469,15.4,3506.1
4832589788,0,0,4,1,18,23,36,0,0,0,0,35388,10.8,39017,111,0,-1870,-1655,11.1,3538.8,21,0,0,23,18,48,0,0,0,0,37258,11.0,40672,122,0,1870,1655,12.2,3725.8
4832580762,0,9,0,0,8,24,15,0,0,0,1,35316,10.8,38602,102,56,-5806,-3471,15.8,3531.6,16,1,1,24,8,52,0,0,0,0,41122,11.4,42073,86,72,5806,3471,15.8,4112.2
4832564544,0,12,0,0,11,16,22,0,0,0,0,30789,10.6,35631,93,55,-8408,-10732,14.8,3078.9,95,0,1,16,11,36,0,0,0,0,39197,12.0,46363,126,79,8408,10732,20.5,3919.7
4832557222,1,0,0,0,30,20,89,0,0,0,0,38200,11.2,42290,106,0,529,2014,10.6,3820.0,0,0,1,20,30,51,0,0,0,0,37671,11.2,40276,100,0,-529,-2014,10.0,3767.1
4857270384,1,28,0,0,17,14,17,0,0,0,0,46650,10.0,47500,0,0,18790,19000,0.0,4665.0,0,0,1,10,13,5,0,0,0,0,27860,6.0,28500,1,0,-18790,-19000,0.1,2786.0
4857239706,1,7,0,1,12,23,12,0,0,0,0,44924,10.0,47500,0,0,15994,19000,0.0,4492.4,3,0,0,15,4,13,0,0,0,0,28930,6.0,28500,0,0,-15994,-19000,0.0,2893.0
4857218359,1,109,0,1,19,15,19,0,0,0,0,46978,10.0,47500,0,0,19048,19000,0.0,4697.8,0,0,0,8,12,9,0,0,0,0,27930,6.0,28500,0,0,-19048,-19000,0.0,2793.0
4857193216,1,381,0,0,20,21,24,0,0,0,0,47070,10.0,47500,2,0,19535,19000,0.2,4707.0,0,4,1,11,10,10,0,0,0,0,27535,6.0,28500,0,0,-19535,-19000,0.0,2753.5
4856712876,1,44,0,1,23,21,24,0,0,0,0,48279,10.0,47500,0,0,20429,17820,0.0,4827.9,0,0,0,9,11,8,0,0,0,0,27850,6.2,29680,0,0,-20429,-17820,0.0,2785.0
4856703230,1,0,0,1,12,12,11,0,0,0,0,30615,9.0,40000,0,0,12785,16000,0.0,3061.5,0,0,0,6,6,6,0,0,0,0,17830,5.4,24000,0,0,-12785,-16000,0.0,1783.0
4856695529,1,0,0,0,21,16,19,0,0,0,0,47244,10.0,47500,8,0,20444,19000,0.8,4724.4,0,0,1,6,11,7,0,0,0,0,26800,6.0,28500,4,0,-20444,-19000,0.4,2680.0
4856688729,1,28,0,1,25,13,23,0,0,0,0,41150,10.6,50500,0,0,14633,20500,0.0,4115.0,0,0,0,4,16,4,0,0,0,0,26517,6.4,30000,0,0,-14633,-20500,0.0,2651.7
4856682685,1,0,0,1,13,12,13,0,0,0,0,45420,10.4,49000,0,0,18081,20500,0.0,4542.0,0,0,0,7,8,8,0,0,0,0,27339,6.0,28500,0,0,-18081,-20500,0.0,2733.9
4856680382,1,0,0,1,23,18,19,0,0,0,0,63825,12.0,55000,0,0,26275,22000,0.0,6382.5,8,0,0,11,16,11,0,0,0,0,37550,7.2,33000,0,0,-26275,-22000,0.0,3755.0
4856673658,1,0,0,1,20,19,14,0,0,0,0,46680,10.0,47500,0,0,18130,19000,0.0,4668.0,0,0,0,9,10,12,0,0,0,0,28550,6.0,28500,0,0,-18130,-19000,0.0,2855.0
4856672187,1,0,0,1,20,20,22,0,0,0,0,46360,10.0,47500,0,0,18115,19000,0.0,4636.0,0,0,0,9,9,11,0,0,0,0,28245,6.0,28500,0,0,-18115,-19000,0.0,2824.5
4854903171,1,0,0,1,17,17,14,0,0,0,0,46380,10.0,47500,1,0,18775,19000,0.1,4638.0,4,0,0,9,9,10,0,0,0,0,27605,6.0,28500,1,0,-18775,-19000,0.1,2760.5
4854879422,1,216,0,0,18,19,20,0,0,0,0,63776,12.4,58000,0,0,32170,22000,0.0,6377.6,0,0,1,13,12,11,0,0,0,0,31606,7.6,36000,1,0,-32170,-22000,0.1,3160.6
4854859986,1,6,0,1,15,19,17,0,0,0,0,46300,10.2,48680,0,0,18100,20180,0.0,4630.0,4,0,0,10,6,9,0,0,0,0,28200,6.0,28500,0,0,-18100,-20180,0.0,2820.0
4854830725,1,0,0,1,17,19,13,0,0,0,0,45950,10.0,47500,0,0,18100,17500,0.0,4595.0,2,0,0,9,7,11,0,0,0,0,27850,6.4,30000,0,0,-18100,-17500,0.0,2785.0
4854814501,1,19,2,0,17,16,22,0,0,0,0,46700,10.0,47500,2,0,19480,19000,0.2,4670.0,0,1,1,11,12,5,0,0,0,0,27220,6.0,28500,1,0,-19480,-19000,0.1,2722.0
4853860408,1,77,0,1,18,16,17,0,0,0,0,47727,10.0,47500,0,0,19500,19000,0.0,4772.7,0,0,0,8,10,7,0,0,0,0,28227,6.0,28500,0,0,-19500,-19000,0.0,2822.7
4853838359,1,0,0,1,23,13,19,0,0,0,0,64100,12.0,55000,0,0,27600,22000,0.0,6410.0,0,0,0,5,15,6,0,0,0,0,36500,7.2,33000,0,0,-27600,-22000,0.0,3650.0
4853811273,1,0,0,1,22,21,20,0,0,0,0,64078,12.0,55000,0,0,25798,22000,0.0,6407.8,0,0,0,11,12,11,0,0,0,0,38280,7.2,33000,0,0,-25798,-22000,0.0,3828.0
4761232901,0,94,2,0,3,5,2,0,0,0,0,15070,6.4,17374,194,59,-2239,-875,25.3,1507.0,11,8,1,5,3,6,2,1,1,0,17309,6.8,18249,238,60,2239,875,29.8,1730.9
4761186470,0,35,2,1,7,8,7,0,0,0,0,16763,6.8,17390,220,45,-588,-216,26.5,1676.3,13,12,0,8,7,7,0,0,0,0,17351,6.8,17606,211,45,588,216,25.6,1735.1
4739843130,1,15,2,0,5,7,3,0,0,0,0,16328,7.0,18007,223,61,-442,-365,28.4,1632.8,14,1,1,7,5,5,1,1,0,0,16770,7.0,18372,186,70,442,365,25.6,1677.0
4736760716,1,12,4,0,9,8,9,1,1,0,0,19401,6.8,17546,216,54,2263,-264,27.0,1940.1,14,0,1,8,9,7,0,0,0,0,17138,6.8,17810,197,62,-2263,264,25.9,1713.8
4723006414,1,273,0,0,12,17,15,0,0,0,0,62332,12.0,55000,3,0,24648,22000,0.3,6233.2,28,0,1,10,5,9,0,0,0,0,37684,7.2,33000,2,0,-24648,-22000,0.2,3768.4
4722982730,1,85,0,1,16,12,17,0,0,0,0,62980,12.0,55000,0,0,26818,22000,0.0,6298.0,2,0,0,6,10,6,0,0,0,0,36162,7.2,33000,0,0,-26818,-22000,0.0,3616.2
4722970165,1,228,0,1,13,17,20,0,0,0,0,61755,13.0,62500,0,0,23995,25000,0.0,6175.5,0,0,0,13,9,8,0,0,0,0,37760,7.8,37500,1,0,-23995,-25000,0.1,3776.0
4722957777,1,4,0,1,17,20,14,0,0,0,0,62350,12.0,55000,0,0,22700,22000,0.0,6235.0,0,0,0,12,9,15,0,0,0,0,39650,7.2,33000,0,0,-22700,-22000,0.0,3965.0
4722924615,1,0,3,1,11,16,18,0,0,0,0,62075,12.4,57000,0,0,21245,22000,0.0,6207.5,35,0,0,13,8,3,0,0,0,0,40830,7.6,35000,4,0,-21245,-22000,0.4,4083.0
4722905789,1,8,3,1,3,2,5,1,1,0,0,15857,7.2,18165,236,47,300,-1019,28.3,1585.7,13,1,0,2,3,2,0,0,0,0,15557,7.2,19184,258,65,-300,1019,32.3,1555.7
4722872885,1,45,1,1,3,5,4,1,0,1,0,15693,7.0,17949,217,65,-1577,-1373,28.2,1569.3,12,15,0,5,3,6,0,0,0,0,17270,7.2,19322,261,73,1577,1373,33.4,1727.0
4722292625,1,12,3,0,4,4,1,0,0,0,0,17882,7.6,19892,266,56,2568,3693,32.2,1788.2,20,0,1,4,4,5,1,1,0,0,15314,6.6,16199,197,61,-2568,-3693,25.8,1531.4
4722252107,1,9,1,1,5,4,7,0,0,0,0,17993,6.8,17648,212,56,1886,-302,26.8,1799.3,13,0,0,4,5,5,0,0,0,0,16107,7.0,17950,239,76,-1886,302,31.5,1610.7
4722215648,1,14,2,1,5,4,3,1,1,0,0,16423,7.0,17886,199,60,95,-79,25.9,1642.3,11,1,0,4,5,5,0,0,0,0,16328,7.0,17965,220,56,-95,79,27.6,1632.8
4722101196,0,39,0,1,7,5,7,0,0,0,0,17615,7.2,17748,228,49,1301,165,27.7,1761.5,31,0,0,5,7,6,0,0,0,0,16314,6.8,17583,222,54,-1301,-165,27.6,1631.4
4722039651,1,13,1,0,6,4,8,2,1,1,0,17137,7.0,18238,206,55,768,1696,26.1,1713.7,16,0,1,4,6,3,0,0,0,0,16369,6.4,16542,229,52,-768,-1696,28.1,1636.9
4722013067,1,16,2,1,8,3,11,1,1,0,0,19149,7.2,17932,207,64,2681,656,27.1,1914.9,69,2,0,3,8,3,0,0,0,0,16468,6.8,17276,214,39,-2681,-656,25.3,1646.8
4721583875,1,10,0,0,8,10,8,0,0,0,0,16899,6.4,15769,162,52,-2103,-1300,21.4,1689.9,15,1,1,10,8,16,0,0,0,0,19002,6.8,17069,194,52,2103,1300,24.6,1900.2
4721324777,1,14,2,0,6,7,7,0,0,0,0,16941,7.0,17808,210,58,-158,327,26.8,1694.1,17,1,1,7,6,8,1,1,0,0,17099,6.8,17481,216,52,158,-327,26.8,1709.9
4721291763,0,12,1,1,4,1,4,0,0,0,0,17377,6.8,18296,246,55,1994,961,30.1,1737.7,15,1,0,1,4,2,0,0,0,0,15383,7.0,17335,212,53,-1994,-961,26.5,1538.3
4784249227,0,95,0,0,5,7,7,0,0,0,0,17547,7.0,17906,235,64,400,-650,29.9,1754.7,8,2,1,7,5,4,1,1,0,0,17147,7.0,18556,238,60,-400,650,29.8,1714.7
4784198136,1,13,7,1,9,4,6,0,0,0,0,19759,7.2,19684,258,64,4849,3726,32.2,1975.9,34,1,0,4,9,4,0,0,0,0,14910,6.6,15958,200,48,-4849,-3726,24.8,1491.0
4784180012,1,16,0,1,7,2,9,2,1,1,0,18337,6.8,18180,230,44,4488,2475,27.4,1833.7,15,3,0,2,7,3,0,0,0,0,13849,6.4,15705,200,31,-4488,-2475,23.1,1384.9
4780537120,0,47,1,0,2,10,2,0,0,0,0,14958,6.8,17313,218,48,-5077,-2315,26.6,1495.8,13,18,1,10,2,10,1,1,0,0,20035,7.0,19628,243,52,5077,2315,29.5,2003.5
4780494225,0,11,0,1,3,7,1,0,0,0,0,13597,6.2,15067,149,56,-6147,-5049,20.5,1359.7,23,0,0,7,3,8,1,1,0,0,19744,7.6,20116,263,75,6147,5049,33.8,1974.4
4780461671,0,15,1,0,3,6,3,0,0,0,0,15127,6.6,16527,190,52,-3740,-1829,24.2,1512.7,11,1,1,6,3,4,1,1,0,0,18867,7.0,18356,224,53,3740,1829,27.7,1886.7
4774941959,1,14,1,1,1,1,1,2,1,1,0,16057,7.2,18761,238,66,1861,1181,30.4,1605.7,7,0,0,1,1,1,0,0,0,0,14196,6.8,17580,232,48,-1861,-1181,28.0,1419.6
4774905260,0,12,1,1,6,4,3,0,0,0,0,17205,6.8,17791,203,50,2087,1202,25.3,1720.5,21,1,0,4,6,4,1,1,0,0,15118,6.8,16589,202,49,-2087,-1202,25.1,1511.8
4773963564,0,17,0,1,1,1,0,0,0,0,0,15020,7.2,18611,257,64,-403,-974,32.1,1502.0,15,2,0,1,1,1,1,1,0,0,15423,7.2,19585,251,72,403,974,32.3,1542.3
4773944756,1,18,2,1,5,3,8,1,1,0,0,16871,6.8,17717,246,52,1659,157,29.8,1687.1,12,0,0,3,5,3,1,0,1,0,15212,6.8,17560,194,56,-1659,-157,25.0,1521.2
4772980141,0,9,0,1,5,11,3,1,1,0,0,14979,6.6,16523,196,44,-4689,-580,24.0,1497.9,11,0,0,11,5,13,1,0,1,0,19668,6.8,17103,194,52,4689,580,24.6,1966.8
4771564376,1,11,3,0,8,3,11,1,1,0,0,17170,6.6,17288,222,44,2497,852,26.6,1717.0,14,0,1,3,8,4,0,0,0,0,14673,6.6,16436,203,52,-2497,-852,25.5,1467.3
4771546905,0,13,1,0,4,6,4,0,0,0,0,15896,6.8,16616,191,60,-3355,-2053,25.1,1589.6,16,0,1,6,4,6,2,1,1,0,19251,7.0,18669,221,64,3355,2053,28.5,1925.1
4769526640,1,72,5,0,5,2,7,1,0,1,0,17087,7.4,19095,214,60,2863,2689,27.4,1708.7,16,2,1,2,5,2,0,0,0,0,14224,6.6,16406,198,58,-2863,-2689,25.6,1422.4
4769498623,1,14,1,1,8,5,6,0,0,0,0,18628,7.0,18520,236,59,2620,1575,29.5,1862.8,11,0,0,5,8,3,1,1,0,0,16008,6.8,16945,203,52,-2620,-1575,25.5,1600.8
4769477351,1,16,2,1,5,5,3,0,0,0,0,17094,7.2,19598,227,76,721,1598,30.3,1709.4,13,3,0,5,5,8,1,1,0,0,16373,7.0,18000,221,44,-721,-1598,26.5,1637.3
4767736684,0,11,0,0,12,5,7,0,0,0,0,19542,6.8,18100,211,54,2969,1312,26.5,1954.2,10,0,1,5,12,9,1,0,1,0,16573,6.6,16788,180,50,-2969,-1312,23.0,1657.3
4767692194,1,12,2,0,1,8,0,0,0,0,0,14573,6.6,16142,199,48,-4345,-2296,24.7,1457.3,12,2,1,8,1,6,1,1,0,0,18918,7.0,18438,235,59,4345,2296,29.4,1891.8
4767674216,1,10,1,0,3,5,3,0,0,0,0,16344,7.2,18047,211,72,-385,-950,28.3,1634.4,17,1,1,5,3,6,0,0,0,0,16729,7.2,18997,191,68,385,950,25.9,1672.9
4766068676,0,10,2,1,6,5,6,1,1,0,0,16947,6.8,18429,220,64,-877,-583,28.4,1694.7,13,1,0,5,6,4,1,0,1,0,17824,7.0,19012,227,64,877,583,29.1,1782.4
4855286861,0,0,0,0,10,20,27,0,0,0,0,33735,10.2,35579,123,0,-1002,-1634,12.3,3373.5,12,0,1,20,10,45,0,0,0,0,34737,10.6,37213,96,0,1002,1634,9.6,3473.7
4855247035,0,34,6,1,32,20,79,0,0,0,1,40092,11.8,44657,120,0,2724,4029,12.0,4009.2,49,0,0,20,32,41,0,0,0,0,37368,11.2,40628,76,0,-2724,-4029,7.6,3736.8
4855218625,0,1,16,1,29,37,71,0,0,0,2,40785,11.8,44145,87,0,-20,-2016,8.7,4078.5,71,0,0,37,29,96,0,0,0,0,40805,11.8,46161,115,0,20,2016,11.5,4080.5
4855200255,0,0,0,0,21,20,58,0,0,0,1,35547,10.8,37350,108,0,-2425,-6677,10.8,3554.7,0,0,1,20,21,57,0,0,0,0,37972,11.8,44027,130,0,2425,6677,13.0,3797.2
4854597988,0,15,0,0,7,8,11,0,0,0,0,16519,6.8,17559,195,60,-592,113,25.5,1651.9,12,1,1,8,7,8,0,0,0,0,17111,6.8,17446,217,48,592,-113,26.5,1711.1
4854569465,0,13,1,0,0,11,0,0,0,0,0,13595,6.8,16425,225,48,-5376,-2322,27.3,1359.5,12,2,1,11,0,11,1,1,0,0,18971,7.0,18747,230,52,5376,2322,28.2,1897.1
4851811847,0,75,1,0,5,7,4,0,0,0,0,15490,6.8,17147,193,56,-2624,-2194,24.9,1549.0,11,0,1,7,5,2,0,0,0,0,18114,7.2,19341,246,67,2624,2194,31.3,1811.4
4851764415,0,72,0,0,9,4,9,1,1,0,0,17797,6.8,18149,200,64,122,-362,26.4,1779.7,11,1,1,4,9,4,0,0,0,0,17675,7.0,18511,219,68,-122,362,28.7,1767.5
4851714491,1,10,0,1,5,1,4,1,1,0,0,15427,7.0,18204,202,45,1148,-711,24.7,1542.7,15,0,0,1,5,0,0,0,0,0,14279,7.0,18915,207,65,-1148,711,27.2,1427.9
4847429024,1,18,1,0,24,24,59,0,0,0,1,37716,11.2,41002,104,0,-1933,-1315,10.4,3771.6,1,3,1,24,24,56,0,0,0,0,39649,11.6,42317,125,0,1933,1315,12.5,3964.9
4843271525,0,17,2,1,7,7,11,2,1,1,0,18264,7.4,20009,218,76,351,1402,29.4,1826.4,14,3,0,7,7,11,0,0,0,0,17913,7.0,18607,245,60,-351,-1402,30.5,1791.3
4843160975,0,18,2,1,10,5,8,0,0,0,0,17640,7.0,18385,213,48,1247,847,26.1,1764.0,23,0,0,5,10,4,0,0,0,0,16393,6.8,17538,189,56,-1247,-847,24.5,1639.3
4842338009,0,2,0,0,20,32,51,0,0,0,1,37609,11.0,38800,99,0,-4668,-7621,9.9,3760.9,7,0,1,32,20,86,0,0,0,0,42277,12.0,46421,130,0,4668,7621,13.0,4227.7
4842306662,0,0,1,0,26,38,63,0,0,0,1,38905,11.8,43993,106,0,-2280,-1036,10.6,3890.5,6,0,1,38,26,90,0,0,0,0,41185,11.8,45029,110,0,2280,1036,11.0,4118.5
4842291110,0,0,1,1,29,35,81,0,0,0,2,40285,11.4,42277,117,0,-1277,-2344,11.7,4028.5,1,0,0,35,29,107,0,0,0,0,41562,11.8,44621,96,0,1277,2344,9.6,4156.2
4842254607,1,13,0,1,26,29,73,0,0,0,0,36708,11.0,40553,113,0,-318,-252,11.3,3670.8,0,0,0,29,26,79,0,0,0,0,37026,11.0,40805,89,0,318,252,8.9,3702.6
4842227722,1,10,0,1,17,16,36,0,0,0,0,34636,10.6,37210,93,0,281,-581,9.3,3463.6,0,0,0,15,16,49,0,0,0,0,34355,10.8,37791,98,0,-281,581,9.8,3435.5
4842200416,1,0,0,1,34,26,96,0,0,0,1,41275,11.6,44582,112,0,3471,4601,11.2,4127.5,0,0,0,26,34,69,0,0,0,0,37804,11.0,39981,97,0,-3471,-4601,9.7,3780.4
4842184774,1,0,0,1,32,26,82,0,0,0,1,40267,11.4,43564,120,0,912,-1922,12.0,4026.7,0,0,0,26,32,80,0,0,0,0,39355,12.0,45486,112,0,-912,1922,11.2,3935.5
4842127720,1,13,1,1,4,2,3,0,0,0,0,16824,7.2,18835,228,60,2786,1953,28.8,1682.4,12,1,0,2,4,1,0,0,0,0,14038,6.8,16882,187,43,-2786,-1953,23.0,1403.8
4823182942,0,12,3,0,9,6,10,0,0,0,0,17250,6.8,17221,176,41,-1181,-962,21.7,1725.0,14,2,1,6,9,4,0,0,0,0,18431,7.2,18183,211,54,1181,962,26.5,1843.1
4823145493,1,13,0,1,1,4,0,0,0,0,0,16024,7.0,18837,251,72,-969,-804,32.3,1602.4,10,2,0,4,1,0,0,0,0,0,16993,7.2,19641,265,68,969,804,33.3,1699.3
4823123368,1,11,2,1,6,3,5,1,1,0,0,17405,6.8,18045,216,48,1378,1416,26.4,1740.5,13,1,0,3,6,5,0,0,0,0,16027,6.4,16629,206,60,-1378,-1416,26.6,1602.7
4823085817,0,11,1,0,1,9,1,0,0,0,0,13995,7.0,17533,199,71,-3770,-1191,27.0,1399.5,19,1,1,9,1,5,1,1,0,0,17765,7.2,18724,236,65,3770,1191,30.1,1776.5
4822226342,1,37,1,1,4,2,3,1,1,0,0,16526,7.0,19232,227,60,1591,1418,28.7,1652.6,7,12,0,2,4,2,0,0,0,0,14935,7.0,17814,225,60,-1591,-1418,28.5,1493.5
4822190689,1,14,1,1,11,4,4,0,0,0,0,16081,7.0,18031,169,51,1381,1775,22.0,1608.1,10,1,0,4,11,2,1,1,0,0,14700,6.6,16256,207,38,-1381,-1775,24.5,1470.0
4821920222,1,14,1,0,7,7,5,0,0,0,0,17313,6.8,18052,214,58,667,980,27.2,1731.3,14,2,1,7,7,6,1,1,0,0,16646,6.8,17072,171,51,-667,-980,22.2,1664.6
4821868353,1,13,1,1,4,5,2,2,1,1,0,16138,7.0,18635,229,60,-507,333,28.9,1613.8,9,0,0,5,4,3,0,0,0,0,16645,7.0,18302,237,52,507,-333,28.9,1664.5
4821187135,0,12,5,0,1,4,1,0,0,0,0,15246,6.8,17045,241,56,-547,-106,29.7,1524.6,12,0,1,4,1,4,1,1,0,0,15793,6.8,17151,224,48,547,106,27.2,1579.3
4821149090,0,14,6,0,2,2,1,0,0,0,0,14964,6.8,17714,249,48,-672,-471,29.7,1496.4,14,2,1,2,2,1,1,1,0,0,15636,7.2,18185,226,68,672,471,29.4,1563.6
4821101875,1,14,1,0,3,6,5,0,0,0,0,14994,6.4,15829,183,64,-1751,-1582,24.7,1499.4,11,2,1,6,3,4,0,0,0,0,16745,6.8,17411,204,52,1751,1582,25.6,1674.5
4821044655,1,16,2,0,5,7,3,0,0,0,0,16860,6.8,17535,222,60,56,292,28.2,1686.0,13,2,1,7,5,7,1,1,0,0,16804,6.8,17243,210,28,-56,-292,23.8,1680.4
4820169370,0,53,1,0,2,8,1,0,0,0,0,14004,6.6,16707,183,48,-3801,-639,23.1,1400.4,118,0,1,8,2,15,0,0,0,0,17805,6.8,17346,228,54,3801,639,28.2,1780.5
4820143042,0,72,1,0,5,6,4,0,0,0,0,17419,7.0,17345,191,60,702,-1228,25.1,1741.9,16,2,1,6,5,2,2,1,1,0,16717,7.0,18573,199,64,-702,1228,26.3,1671.7
4820108822,1,10,0,1,1,5,1,1,0,1,0,14728,7.0,17199,224,60,-2239,-2593,28.4,1472.8,173,0,0,5,1,4,1,1,0,0,16967,7.4,19792,240,60,2239,2593,30.0,1696.7
4818835857,0,11,1,0,4,8,5,0,0,0,1,15707,6.4,16213,157,64,-3565,-2035,22.1,1570.7,14,0,1,8,4,7,0,0,0,0,19272,7.0,18248,236,56,3565,2035,29.2,1927.2
4817839442,0,11,0,0,3,4,3,0,0,0,0,15239,6.6,17347,245,52,-1164,-1748,29.7,1523.9,11,0,1,4,3,6,1,1,0,0,16403,7.0,19095,235,84,1164,1748,31.9,1640.3
4817820069,0,14,1,0,6,7,5,0,0,0,0,18967,7.2,18933,248,63,742,686,31.1,1896.7,11,2,1,7,6,10,0,0,0,0,18225,7.0,18247,216,64,-742,-686,28.0,1822.5
4817787665,1,11,4,0,2,2,0,1,1,0,0,15229,6.8,18059,227,64,-580,321,29.1,1522.9,15,1,1,2,2,2,0,0,0,0,15809,6.8,17738,238,52,580,-321,29.0,1580.9
4816406218,1,10,0,1,2,2,2,0,0,0,0,15624,7.0,18212,201,64,-172,-324,26.5,1562.4,14,1,0,2,2,2,0,0,0,0,15796,6.8,18536,243,60,172,324,30.3,1579.6
4858117446,0,10,3,1,10,8,5,0,0,0,0,16475,6.6,17464,209,44,-275,-1396,25.3,1647.5,17,0,0,8,10,3,0,0,0,0,16750,7.0,18860,204,62,275,1396,26.6,1675.0
4857907434,1,10,1,1,5,5,1,1,1,0,0,14904,7.0,17825,185,60,-927,-373,24.5,1490.4,14,0,0,5,5,2,0,0,0,0,15831,7.0,18198,205,52,927,373,25.7,1583.1
4857455025,0,0,0,0,23,15,60,0,0,0,1,36544,11.0,40645,86,0,-441,2403,8.6,3654.4,0,0,1,15,23,30,0,0,0,0,36985,11.0,38242,127,0,441,-2403,12.7,3698.5
4857420354,1,0,0,1,17,15,52,0,0,0,1,36935,10.8,38692,115,0,3649,3149,11.5,3693.5,0,0,0,15,17,41,0,0,0,0,33286,10.2,35543,80,0,-3649,-3149,8.0,3328.6
4857395702,0,14,0,1,24,27,66,0,0,0,1,36917,10.6,39662,112,0,-2782,-4235,11.2,3691.7,0,0,0,27,24,77,0,0,0,0,39699,11.6,43897,115,0,2782,4235,11.5,3969.9
4857301170,0,12,1,0,4,10,2,0,0,0,0,13588,6.2,15726,179,0,-3447,-2099,17.9,1358.8,12,1,1,10,4,11,0,0,0,0,17035,6.8,17825,148,48,3447,2099,19.6,1703.5
4857258138,0,15,2,1,2,1,1,1,1,0,0,14221,6.8,18378,197,52,401,115,24.9,1422.1,9,2,0,1,2,1,0,0,0,0,13820,7.0,18263,184,64,-401,-115,24.8,1382.0
4857183131,1,22,1,0,2,5,3,1,1,0,0,16929,6.6,17891,184,72,-84,117,25.6,1692.9,235,1,1,5,2,3,0,0,0,0,17013,6.8,17774,222,52,84,-117,27.4,1701.3
4856359529,1,22,0,1,5,1,4,0,0,0,0,15770,7.0,18062,223,60,1039,799,28.3,1577.0,13,1,0,1,5,1,0,0,0,0,14731,6.8,17263,196,60,-1039,-799,25.6,1473.1
4856320850,1,20,2,1,8,5,7,1,1,0,0,18039,7.0,18433,211,64,2325,2722,27.5,1803.9,17,0,0,5,8,7,0,0,0,0,15714,6.4,15711,204,52,-2325,-2722,25.6,1571.4
4856283976,1,0,0,1,22,17,52,0,0,0,0,35017,10.8,38190,73,0,-691,-1642,7.3,3501.7,0,0,0,17,22,32,0,0,0,0,35708,11.0,39832,114,0,691,1642,11.4,3570.8
4856260800,1,9,0,1,55,27,140,0,0,0,2,47787,12.6,52249,83,0,10260,8864,8.3,4778.7,91,0,0,27,55,57,0,0,0,0,37527,11.4,43385,82,0,-10260,-8864,8.2,3752.7
4856051510,0,85,0,1,5,4,5,0,0,0,0,15772,6.6,16500,179,40,-1442,-875,21.9,1577.2,12,1,0,4,5,4,0,0,0,0,17214,7.0,17375,202,64,1442,875,26.6,1721.4
4855334105,0,12,2,0,4,4,5,0,0,0,0,15860,7.0,18664,216,60,694,733,27.6,1586.0,23,4,1,4,4,4,0,0,0,0,15166,7.0,17931,209,40,-694,-733,24.9,1516.6
4855305539,0,14,2,0,2,8,3,0,0,0,0,13892,6.6,16911,168,60,-3808,-1488,22.8,1389.2,15,2,1,8,2,11,0,0,0,0,17700,6.8,18399,217,55,3808,1488,27.2,1770.0
4855271285,0,10,0,1,4,6,2,0,0,0,0,15506,7.2,17882,226,67,-1100,-1284,29.3,1550.6,8,1,0,6,4,4,1,1,0,0,16606,7.2,19166,214,60,1100,1284,27.4,1660.6
4854891827,1,19,4,1,5,1,5,0,0,0,0,15623,6.6,17169,178,60,1481,126,23.8,1562.3,13,2,0,1,5,2,0,0,0,0,14142,6.6,17043,208,52,-1481,-126,26.0,1414.2
4854834983,1,14,0,1,7,3,8,0,0,0,0,16893,7.0,18022,235,44,2007,-206,27.9,1689.3,13,2,0,3,7,1,0,0,0,0,14886,6.8,18228,203,72,-2007,206,27.5,1488.6
4854811132,1,0,0,1,27,23,79,0,0,0,1,39351,11.6,42819,106,0,3524,3978,10.6,3935.1,16,0,0,23,27,67,0,0,0,0,35827,10.8,38841,98,0,-3524,-3978,9.8,3582.7
4829761356,0,16,2,0,1,7,0,0,0,0,0,14920,6.8,17770,228,60,-2613,-1201,28.8,1492.0,15,5,1,7,1,7,1,1,0,0,17533,7.2,18971,224,60,2613,1201,28.4,1753.3
4829736498,0,35,3,0,1,6,2,0,0,0,0,15281,6.8,17415,236,49,-2919,-1747,28.5,1528.1,32,2,1,6,1,6,1,1,0,0,18200,7.2,19162,233,58,2919,1747,29.1,1820.0
4829701107,0,13,1,0,6,7,5,1,1,0,0,16108,7.2,18146,197,55,-1033,911,25.2,1610.8,16,1,1,7,6,8,0,0,0,0,17141,6.8,17235,201,51,1033,-911,25.2,1714.1
4828863294,1,0,0,1,26,19,74,0,0,0,0,36490,11.2,41894,95,0,1296,3278,9.5,3649.0,0,0,0,19,26,43,0,0,0,0,35194,10.8,38616,105,0,-1296,-3278,10.5,3519.4
4825863963,1,13,2,0,7,7,6,0,0,0,0,17427,6.8,17479,214,44,-338,-698,25.8,1742.7,16,3,1,7,7,10,0,0,0,0,17765,7.0,18177,237,54,338,698,29.1,1776.5
4825815048,0,13,3,1,9,5,9,1,1,0,0,19051,7.2,18903,221,52,1478,-19,27.3,1905.1,17,3,0,5,9,5,1,0,1,0,17573,7.0,18922,231,58,-1478,19,28.9,1757.3
4825753734,0,13,2,0,7,8,9,1,1,0,0,16496,6.4,16154,203,44,-510,-1202,24.7,1649.6,15,2,1,8,7,10,0,0,0,0,17006,6.8,17356,228,52,510,1202,28.0,1700.6
4825716427,0,14,3,0,8,8,6,0,0,0,0,18117,7.2,18280,187,52,614,-408,23.9,1811.7,14,3,1,8,8,6,0,0,0,0,17503,7.2,18688,220,44,-614,408,26.4,1750.3
4824501003,0,16,0,0,6,10,5,0,0,0,0,16329,6.8,16766,204,48,-2326,-1404,25.2,1632.9,13,2,1,10,6,6,1,1,0,0,18655,6.8,18170,199,64,2326,1404,26.3,1865.5
4824469769,0,15,3,1,4,5,3,0,0,0,0,15803,6.4,16321,234,35,-604,-1771,26.9,1580.3,16,2,0,5,4,3,0,0,0,0,16407,6.8,18092,185,68,604,1771,25.3,1640.7
4824449088,1,20,5,1,7,4,9,0,0,0,0,17264,6.8,17078,189,48,1069,12,23.7,1726.4,16,1,0,4,7,4,0,0,0,0,16195,6.8,17066,233,48,-1069,-12,28.1,1619.5
4824038162,1,15,2,0,9,5,6,0,0,0,0,17897,7.0,18335,211,60,1006,311,27.1,1789.7,15,3,1,5,9,3,1,1,0,0,16891,7.0,18024,239,48,-1006,-311,28.7,1689.1
4824008878,0,79,0,1,7,5,9,0,0,0,0,17392,6.6,16677,189,44,258,-1855,23.3,1739.2,21,3,0,5,7,5,1,1,0,0,17134,6.8,18532,256,47,-258,1855,30.3,1713.4
4823966310,0,16,1,1,4,4,4,1,1,0,0,14978,6.6,16519,182,61,-2171,-936,24.3,1497.8,42,1,0,4,4,4,0,0,0,0,17149,6.8,17455,229,46,2171,936,27.5,1714.9
4822228527,1,15,1,0,3,5,3,0,0,0,0,15240,6.8,16894,175,63,-1438,-1215,23.8,1524.0,19,3,1,5,3,3,0,0,0,0,16678,7.0,18109,228,51,1438,1215,27.9,1667.8
4822201596,0,16,2,1,4,5,4,1,1,0,0,16193,6.8,17411,242,52,-798,-518,29.4,1619.3,15,0,0,5,4,6,0,0,0,0,16991,6.8,17929,227,44,798,518,27.1,1699.1
4822062407,0,18,1,0,4,2,4,1,1,0,0,16603,6.8,17979,248,56,1589,121,30.4,1660.3,19,4,1,2,4,1,0,0,0,0,15014,6.8,17858,252,52,-1589,-121,30.4,1501.4
4822012461,1,10,5,0,1,5,1,0,0,0,0,15028,6.8,18457,270,52,-1666,-415,32.2,1502.8,20,2,1,5,1,3,1,1,0,0,16694,7.0,18872,266,63,1666,415,32.9,1669.4
4821056958,1,15,1,1,6,2,4,1,1,0,0,15867,6.8,17907,210,48,297,497,25.8,1586.7,15,2,0,2,6,3,0,0,0,0,15570,6.8,17410,235,52,-297,-497,28.7,1557.0
4821026705,1,12,2,1,12,7,14,0,0,0,0,19187,7.6,19723,212,48,1996,2882,26.0,1918.7,13,1,0,7,12,7,0,0,0,0,17191,6.8,16841,201,52,-1996,-2882,25.3,1719.1
4855163612,1,18,0,0,21,26,50,0,0,0,1,39125,11.2,41477,104,0,154,-1333,10.4,3912.5,1,2,1,26,21,73,0,0,0,0,38971,11.4,42810,94,0,-154,1333,9.4,3897.1
4855128561,1,0,6,0,26,27,55,0,0,0,1,38414,11.8,43538,111,0,-794,1529,11.1,3841.4,22,0,1,26,25,67,0,0,0,0,39208,11.2,42009,101,0,794,-1529,10.1,3920.8
4855098998,1,13,0,0,23,32,50,0,0,0,1,38838,11.6,43378,106,0,-2735,-2000,10.6,3883.8,0,2,1,32,23,84,0,0,0,0,41573,11.8,45378,132,0,2735,2000,13.2,4157.3
4840295033,0,9,3,1,9,7,12,0,0,0,0,18894,6.6,17460,191,56,1776,486,24.7,1889.4,14,1,0,7,9,6,0,0,0,0,17118,7.0,16974,199,64,-1776,-486,26.3,1711.8
4815360223,0,15,2,1,6,2,7,1,1,0,0,17000,7.2,18442,203,56,1292,1156,25.9,1700.0,79,0,0,2,6,2,0,0,0,0,15708,6.6,17286,211,56,-1292,-1156,26.7,1570.8
4809448653,1,11,1,0,4,9,4,0,0,0,0,16376,7.2,17654,224,60,-1334,-1954,28.4,1637.6,13,0,1,9,4,4,1,1,0,0,17710,7.4,19608,191,71,1334,1954,26.2,1771.0
4807416965,0,0,0,0,14,28,31,0,0,0,1,33847,10.4,36809,79,0,-5857,-4740,7.9,3384.7,0,0,1,28,14,70,0,0,0,0,39704,11.4,41549,90,0,5857,4740,9.0,3970.4
4807391728,1,0,0,1,20,20,53,0,0,0,1,36647,11.0,39655,113,0,1964,4151,11.3,3664.7,0,0,0,20,20,59,0,0,0,0,34683,10.2,35504,100,0,-1964,-4151,10.0,3468.3
4807363520,0,83,0,1,25,35,63,0,0,0,2,37172,11.0,40283,101,0,-4580,-7261,10.1,3717.2,28,0,0,35,25,83,0,0,0,0,41752,12.2,47544,106,0,4580,7261,10.6,4175.2
4806539552,1,0,0,1,29,28,74,0,0,0,1,38704,11.6,42854,107,0,924,-374,10.7,3870.4,0,0,0,28,29,69,0,0,0,0,37780,11.6,43228,84,0,-924,374,8.4,3778.0
4806526978,1,15,0,0,39,28,121,0,0,0,1,44311,12.6,49101,100,0,5384,7897,10.0,4431.1,0,0,1,28,39,72,0,0,0,0,38927,11.4,41204,85,0,-5384,-7897,8.5,3892.7
4806493214,1,0,0,0,29,17,71,0,0,0,1,39277,11.4,41695,114,0,4731,4585,11.4,3927.7,68,0,1,17,29,42,0,0,0,0,34546,10.8,37110,103,0,-4731,-4585,10.3,3454.6
4806461391,0,19,0,0,20,24,44,0,0,0,0,37272,11.0,39544,117,0,-526,-297,11.7,3727.2,0,0,1,24,20,70,0,0,0,0,37798,11.2,39841,103,0,526,297,10.3,3779.8
4806424520,0,0,2,1,24,35,43,0,0,0,0,37977,11.2,41912,113,0,-1480,-3232,11.3,3797.7,7,0,0,35,24,84,0,0,0,0,39457,11.8,45144,110,0,1480,3232,11.0,3945.7
4806389932,0,16,0,0,15,19,30,0,0,0,0,35819,10.8,38399,103,0,366,757,10.3,3581.9,17,2,1,19,15,36,0,0,0,0,35453,10.6,37642,96,0,-366,-757,9.6,3545.3
4800786111,0,209,0,0,15,17,36,0,0,0,0,32784,10.4,36049,92,0,-1642,-1666,9.2,3278.4,0,0,1,17,15,41,0,0,0,0,34426,10.6,37715,90,0,1642,1666,9.0,3442.6
4800748055,0,0,0,0,19,14,54,0,0,0,1,36702,11.0,39404,124,0,3320,2682,12.4,3670.2,0,0,1,14,19,31,0,0,0,0,33382,10.4,36722,80,0,-3320,-2682,8.0,3338.2
4800699986,0,27,0,1,24,21,65,0,0,0,1,36335,11.2,40670,110,0,-1123,472,11.0,3633.5,11,17,0,21,24,51,0,0,0,0,37458,11.0,40198,88,0,1123,-472,8.8,3745.8
4800673371,1,0,0,1,20,23,50,0,0,0,0,36349,11.2,40567,110,0,385,1439,11.0,3634.9,0,0,0,23,20,64,0,0,0,0,35964,10.8,39128,102,0,-385,-1439,10.2,3596.4
4799915869,1,11,2,0,2,4,3,0,0,0,0,16117,6.6,17765,213,56,-498,-1163,26.9,1611.7,79,1,1,4,2,1,0,0,0,0,16615,7.2,18928,225,60,498,1163,28.5,1661.5
4836951829,1,69,1,1,6,2,7,0,0,0,0,17122,6.6,17628,236,40,2279,86,27.6,1712.2,12,1,0,2,6,2,0,0,0,0,14843,6.6,17542,209,72,-2279,-86,28.1,1484.3
4832311302,1,16,0,0,5,1,4,1,1,0,0,16732,7.0,19771,245,75,2548,2336,32.0,1673.2,14,0,1,1,5,0,1,0,1,0,14184,6.8,17435,192,52,-2548,-2336,24.4,1418.4
4823048894,1,12,0,0,9,9,10,1,1,0,0,18201,6.6,17069,192,40,-238,885,23.2,1820.1,8,0,1,9,9,12,0,0,0,0,18439,6.2,16184,209,60,238,-885,26.9,1843.9
4823013856,1,52,0,0,6,7,9,1,0,1,0,16583,7.0,16922,203,55,-778,-1919,25.8,1658.3,12,2,1,7,6,5,0,0,0,0,17361,7.2,18841,230,64,778,1919,29.4,1736.1
4817961093,0,11,1,1,10,3,8,0,0,0,0,18490,7.2,18585,241,44,2636,1079,28.5,1849.0,10,0,0,3,10,2,0,0,0,0,15854,6.8,17506,190,68,-2636,-1079,25.8,1585.4
4802358963,0,10,2,0,9,3,9,1,1,0,0,17761,6.8,16909,214,48,2655,663,26.2,1776.1,9,1,1,3,9,2,0,0,0,0,15106,6.4,16246,196,44,-2655,-663,24.0,1510.6
4802330666,0,14,1,1,5,5,5,1,1,0,0,16026,6.8,18130,226,56,-166,-326,28.2,1602.6,14,3,0,5,5,6,0,0,0,0,16192,6.8,18456,243,64,166,326,30.7,1619.2
4802317915,0,20,3,1,8,3,10,1,1,0,0,18121,7.6,19986,245,71,1700,1645,31.6,1812.1,78,2,0,3,8,3,0,0,0,0,16421,6.8,18341,242,52,-1700,-1645,29.4,1642.1
4788477866,1,16,0,1,6,8,7,0,0,0,0,18664,7.0,19141,233,72,107,999,30.5,1866.4,80,0,0,8,6,13,1,1,0,0,18557,7.0,18142,219,56,-107,-999,27.5,1855.7
4788460008,0,12,0,1,5,9,4,0,0,0,0,15748,6.8,16408,208,48,-2641,-4069,25.6,1574.8,12,2,0,9,5,5,0,0,0,0,18389,7.4,20477,236,67,2641,4069,30.3,1838.9
4788446797,1,10,2,1,11,1,21,0,0,0,0,20703,7.4,19622,235,64,6306,2025,29.9,2070.3,11,0,0,1,11,1,0,0,0,0,14397,6.8,17597,220,60,-6306,-2025,28.0,1439.7
4781310875,1,12,0,1,8,12,15,0,0,0,0,18396,6.4,15659,195,32,-969,-615,22.7,1839.6,12,1,0,12,8,8,0,0,0,0,19365,6.6,16274,172,48,969,615,22.0,1936.5
4752035890,0,0,3,0,23,19,65,0,0,0,2,37978,10.8,39582,108,0,1969,930,10.8,3797.8,18,0,1,19,23,43,0,0,0,0,36009,10.8,38652,105,0,-1969,-930,10.5,3600.9
4752006029,1,23,0,0,33,28,73,0,0,0,1,42915,11.8,46715,125,0,4928,4716,12.5,4291.5,0,0,1,28,33,56,0,0,0,0,37987,11.2,41999,83,0,-4928,-4716,8.3,3798.7
4751964468,0,0,0,1,27,26,70,0,0,0,1,37516,11.2,41095,91,0,-2951,-3371,9.1,3751.6,9,0,0,26,27,62,0,0,0,0,40467,11.6,44466,110,0,2951,3371,11.0,4046.7
4747934271,1,16,3,0,3,1,6,0,0,0,0,17238,7.4,19441,272,56,1331,2147,32.8,1723.8,12,2,1,1,3,4,1,1,0,0,15907,7.0,17294,249,56,-1331,-2147,30.5,1590.7
4747043917,0,13,1,1,3,3,2,1,1,0,0,16573,7.2,19041,237,68,-399,-1012,30.5,1657.3,9,4,0,3,3,3,0,0,0,0,16972,7.2,20053,245,76,399,1012,32.1,1697.2
4747015537,1,10,0,1,7,2,9,0,0,0,0,18451,6.8,17474,242,55,2519,-268,29.7,1845.1,12,0,0,2,7,3,1,1,0,0,15932,6.6,17742,214,52,-2519,268,26.6,1593.2
4746996240,1,8,1,0,6,5,7,0,0,0,0,16957,7.0,19387,216,64,-363,456,28.0,1695.7,29,1,1,5,6,6,1,1,0,0,17320,7.2,18931,253,80,363,-456,33.3,1732.0
4742669484,0,14,0,1,4,5,7,0,0,0,0,16692,7.0,17979,234,60,19,507,29.4,1669.2,7,1,0,5,4,6,0,0,0,0,16673,7.0,17472,224,60,-19,-507,28.4,1667.3
4786288305,0,19,3,0,8,9,12,1,0,1,0,17812,6.2,15211,164,42,-2998,-3226,20.6,1781.2,14,5,1,9,8,16,0,0,0,0,20810,6.8,18437,236,53,2998,3226,28.9,2081.0
4786269480,1,14,0,0,10,6,12,1,0,1,0,17962,6.8,18048,185,51,1788,1336,23.6,1796.2,14,2,1,6,10,5,0,0,0,0,16174,6.4,16712,196,48,-1788,-1336,24.4,1617.4
4786244613,0,15,3,1,8,5,14,0,0,0,0,18923,7.2,18523,254,64,3249,1554,31.8,1892.3,16,1,0,5,8,5,0,0,0,0,15674,6.6,16969,197,51,-3249,-1554,24.8,1567.4
4786223475,0,11,6,0,2,4,2,0,0,0,0,14392,6.8,17278,193,41,-1804,-422,23.4,1439.2,14,1,1,4,2,6,0,0,0,0,16196,6.6,17700,224,54,1804,422,27.8,1619.6
4786195432,0,9,0,0,4,9,4,0,0,0,0,16219,6.4,16531,229,52,-1691,-753,28.1,1621.9,10,2,1,9,4,10,1,1,0,0,17910,6.8,17284,193,47,1691,753,24.0,1791.0
4786162727,0,13,4,1,2,2,2,0,0,0,0,14375,7.0,17746,210,52,-1866,867,26.2,1437.5,16,1,0,2,2,2,0,0,0,0,16241,6.6,16879,200,40,1866,-867,24.0,1624.1
4784143254,1,14,4,1,6,4,6,0,0,0,0,17229,7.0,18526,247,48,314,-34,29.5,1722.9,14,2,0,4,6,3,1,1,0,0,16915,7.0,18560,251,72,-314,34,32.3,1691.5
4784127744,0,14,1,0,2,5,0,0,0,0,0,15382,6.6,17288,261,31,-1159,-32,29.2,1538.2,16,3,1,5,2,3,2,1,1,0,16541,6.6,17320,228,60,1159,32,28.8,1654.1
4783710444,0,11,0,0,7,7,9,0,0,0,0,16448,6.8,17867,169,60,-1888,-124,22.9,1644.8,17,1,1,7,7,10,1,0,1,0,18336,7.0,17991,209,48,1888,124,25.7,1833.6
4783687511,0,66,1,0,6,10,6,0,0,0,0,16335,6.0,13871,151,50,-2764,-2511,20.1,1633.5,14,0,1,10,6,16,1,0,1,0,19099,6.4,16382,190,52,2764,2511,24.2,1909.9
4783660124,0,10,2,0,6,12,8,0,0,0,0,15084,6.6,15579,142,48,-4734,-1792,19.0,1508.4,12,3,1,12,6,18,0,0,0,0,19818,6.6,17371,185,48,4734,1792,23.3,1981.8
4783632914,0,14,1,0,5,11,12,0,0,0,0,15570,6.6,16304,181,56,-3622,-2057,23.7,1557.0,14,3,1,11,5,18,0,0,0,0,19192,6.8,18361,176,64,3622,2057,24.0,1919.2
4783579353,0,12,2,1,9,7,7,0,0,0,0,18294,6.8,17878,229,44,86,529,27.3,1829.4,14,0,0,7,9,6,1,1,0,0,18208,6.6,17349,178,55,-86,-529,23.3,1820.8
4783530559,0,12,1,1,3,6,4,0,0,0,0,15858,6.8,17548,212,58,-1523,-185,27.0,1585.8,18,1,0,6,3,8,1,1,0,0,17381,6.8,17733,219,44,1523,185,26.3,1738.1
4783493556,0,14,1,0,4,12,4,0,0,0,0,16403,6.6,16090,194,52,-3161,-2338,24.6,1640.3,12,0,1,12,4,10,0,0,0,0,19564,6.8,18428,222,44,3161,2338,26.6,1956.4
4783451084,0,12,3,1,2,8,1,0,0,0,0,14662,6.6,16951,203,60,-3524,-1138,26.3,1466.2,13,1,0,8,2,13,2,1,1,0,18186,6.8,18089,200,52,3524,1138,25.2,1818.6
4783410860,1,16,1,1,7,4,7,1,0,1,0,18488,7.2,18239,207,72,3045,836,27.9,1848.8,10,2,0,4,7,2,0,0,0,0,15443,6.8,17403,227,60,-3045,-836,28.7,1544.3
4783389975,0,11,0,1,7,10,10,0,0,0,0,17037,6.8,17017,214,40,-1958,-1758,25.4,1703.7,10,0,0,10,7,4,1,1,0,0,18995,7.0,18775,207,63,1958,1758,27.0,1899.5
4783334362,0,22,2,1,6,9,6,1,1,0,0,18302,6.8,17053,214,58,-739,-719,27.2,1830.2,14,1,0,9,6,10,1,0,1,0,19041,6.8,17772,205,58,739,719,26.3,1904.1
4783300216,0,13,2,0,6,10,5,0,0,0,0,16534,6.6,16732,206,43,-3560,-1070,24.9,1653.4,18,1,1,10,6,9,0,0,0,0,20094,6.8,17802,203,48,3560,1070,25.1,2009.4
4841438410,1,10,0,0,10,4,12,1,1,0,0,18471,6.8,17792,205,56,2933,1716,26.1,1847.1,10,1,1,4,10,2,0,0,0,0,15538,6.4,16076,163,58,-2933,-1716,22.1,1553.8
4841416191,0,16,0,1,4,8,9,0,0,0,0,14882,6.4,15482,197,40,-4320,-3394,23.7,1488.2,75,0,0,8,4,10,0,0,0,0,19202,7.2,18876,246,46,4320,3394,29.2,1920.2
4841375835,0,14,2,0,4,7,2,0,0,0,0,16617,7.4,19643,235,68,-642,1453,30.3,1661.7,12,0,1,7,4,8,1,1,0,0,17259,6.8,18190,216,76,642,-1453,29.2,1725.9
4841341224,1,0,0,0,28,32,69,0,0,0,1,39040,11.6,44587,109,0,-320,1265,10.9,3904.0,0,0,1,32,28,65,0,0,0,0,39360,11.6,43322,115,0,320,-1265,11.5,3936.0
4840329383,0,13,0,1,8,5,5,2,1,1,0,16849,7.0,18045,162,89,404,696,25.1,1684.9,16,0,0,5,8,6,0,0,0,0,16445,7.0,17349,201,39,-404,-696,24.0,1644.5
4840278754,1,11,0,0,8,6,5,1,1,0,0,16494,6.6,17440,165,56,-567,-389,22.1,1649.4,10,0,1,6,8,5,0,0,0,0,17061,6.8,17829,189,47,567,389,23.6,1706.1
4839326195,1,17,2,1,7,4,11,1,1,0,0,16828,6.6,17218,180,48,2556,256,22.8,1682.8,13,0,0,4,7,2,0,0,0,0,14272,6.6,16962,176,52,-2556,-256,22.8,1427.2
4839259619,1,270,1,0,5,8,4,0,0,0,0,16342,6.6,16228,161,48,-24,-799,20.9,1634.2,13,1,1,8,5,3,0,0,0,0,16366,6.6,17027,191,48,24,799,23.9,1636.6
4839212271,0,13,0,0,11,6,13,1,0,1,0,19887,7.0,18232,176,48,2584,65,22.4,1988.7,10,0,1,6,11,7,0,0,0,0,17303,7.0,18167,197,64,-2584,-65,26.1,1730.3
4839177288,1,12,1,1,7,6,6,0,0,0,0,16520,7.2,18354,202,62,661,-250,26.4,1652.0,133,1,0,6,7,4,1,1,0,0,15859,7.0,18604,219,48,-661,250,26.7,1585.9
4839137032,0,3,0,0,20,27,45,0,0,0,2,37197,11.0,39548,102,0,-1099,-3220,10.2,3719.7,0,0,1,27,20,71,0,0,0,0,38296,11.2,42768,98,0,1099,3220,9.8,3829.6
4796288510,0,24,0,1,23,21,58,0,0,0,0,35722,11.2,40141,95,0,-548,1153,9.5,3572.2,0,0,0,21,23,43,0,0,0,0,36270,10.6,38988,112,0,548,-1153,11.2,3627.0
4796254139,1,38,0,1,4,2,4,0,0,0,0,17259,7.2,18895,230,64,1537,1717,29.4,1725.9,11,9,0,2,4,3,0,0,0,0,15722,6.8,17178,185,44,-1537,-1717,22.9,1572.2
4796228236,1,29,11,0,8,5,8,1,1,0,0,17845,6.8,17668,190,48,2598,901,23.8,1784.5,34,2,1,4,7,2,0,0,0,0,15247,6.6,16767,170,56,-2598,-901,22.6,1524.7
4796176393,0,14,0,1,3,2,5,0,0,0,0,15623,7.0,18135,184,44,76,429,22.8,1562.3,12,1,0,2,3,1,0,0,0,0,15547,6.8,17706,219,55,-76,-429,27.4,1554.7
4796144268,1,3,0,1,25,24,80,0,0,0,1,39028,11.6,42774,96,0,2512,2960,9.6,3902.8,0,0,0,24,25,66,0,0,0,0,36516,11.2,39814,102,0,-2512,-2960,10.2,3651.6
4796091359,0,10,0,0,0,6,0,0,0,0,0,14008,6.6,16993,183,60,-3453,-1871,24.3,1400.8,14,1,1,6,0,5,0,0,0,0,17461,7.0,18864,246,48,3453,1871,29.4,1746.1
4796047110,0,10,0,1,5,5,6,0,0,0,0,16339,7.2,18139,214,62,-1666,-254,27.6,1633.9,76,0,0,5,5,3,0,0,0,0,18005,6.8,18393,192,64,1666,254,25.6,1800.5
4796012055,1,12,2,0,2,5,3,0,0,0,0,16609,7.2,19477,230,76,133,1312,30.6,1660.9,14,4,1,5,2,6,0,0,0,0,16476,7.0,18165,206,60,-133,-1312,26.6,1647.6
4857899628,0,13,2,1,8,5,11,0,0,0,0,17638,7.0,17904,227,59,979,1463,28.6,1763.8,14,0,0,5,8,7,0,0,0,0,16659,6.4,16441,205,39,-979,-1463,24.4,1665.9
4857882902,1,16,2,0,14,10,13,1,0,1,0,20093,7.0,19392,211,59,1344,2034,27.0,2009.3,12,1,1,10,14,13,0,0,0,0,18749,7.0,17358,209,56,-1344,-2034,26.5,1874.9
4857861103,1,13,0,1,7,2,5,1,1,0,0,17174,7.2,19011,200,64,2880,933,26.4,1717.4,27,1,0,2,7,1,0,0,0,0,14294,6.8,18078,206,56,-2880,-933,26.2,1429.4
4856892584,1,14,1,1,4,4,5,0,0,0,0,16998,7.0,18985,242,70,1326,1454,31.2,1699.8,12,2,0,4,4,4,1,0,1,0,15672,6.8,17531,184,70,-1326,-1454,25.4,1567.2
4856860657,0,56,0,1,4,5,4,0,0,0,0,16473,6.8,17662,210,52,-1479,-1626,26.2,1647.3,12,4,0,5,4,8,1,1,0,0,17952,7.2,19288,222,60,1479,1626,28.2,1795.2
4856843300,0,53,2,0,5,7,9,1,1,0,0,15270,6.6,16419,183,52,-405,1214,23.5,1527.0,12,0,1,7,5,5,0,0,0,0,15675,6.4,15205,201,20,405,-1214,22.1,1567.5
4854983993,0,14,0,0,5,7,1,0,0,0,0,15872,6.8,17449,213,40,-1522,-826,25.3,1587.2,8,2,1,7,5,7,0,0,0,0,17394,7.2,18275,199,67,1522,826,26.6,1739.4
4853417788,0,22,0,0,19,31,46,0,0,0,1,37069,11.2,41462,116,0,-3402,-2627,11.6,3706.9,0,4,1,31,19,69,0,0,0,0,40471,11.4,44089,125,0,3402,2627,12.5,4047.1
4853403968,0,0,22,0,31,30,79,0,0,0,1,37989,11.6,42514,115,0,-1373,-200,11.5,3798.9,20,0,1,30,31,65,0,0,0,0,39362,11.4,42714,123,0,1373,200,12.3,3936.2
4846476399,1,73,0,1,8,7,7,2,1,1,0,18529,7.0,18588,205,60,1588,890,26.5,1852.9,8,0,0,6,7,6,0,0,0,0,16941,7.0,17698,193,44,-1588,-890,23.7,1694.1
4846456359,1,37,0,0,1,7,2,1,1,0,0,15537,7.2,18131,211,63,-2089,-2339,27.4,1553.7,10,16,1,7,1,2,0,0,0,0,17626,7.4,20470,259,60,2089,2339,31.9,1762.6
4846443185,1,122,2,0,6,6,6,0,0,0,0,15839,6.6,16423,188,40,-1235,-2618,22.8,1583.9,11,3,1,6,6,3,0,0,0,0,17074,7.0,19041,226,62,1235,2618,28.8,1707.4
4846430565,1,13,1,1,12,4,20,1,0,1,0,20177,7.4,18954,219,73,4796,2581,29.2,2017.7,14,0,0,4,12,6,0,0,0,0,15381,6.4,16373,208,42,-4796,-2581,25.0,1538.1
4846413405,0,9,0,0,8,9,5,0,0,0,0,16891,6.8,16518,208,44,-2185,-1981,25.2,1689.1,11,1,1,9,8,9,1,1,0,0,19076,7.0,18499,204,72,2185,1981,27.6,1907.6
4837857881,0,52,1,1,4,3,4,1,1,0,0,15950,6.8,17231,199,48,136,-1165,24.7,1595.0,14,1,0,3,4,1,0,0,0,0,15814,6.8,18396,210,68,-136,1165,27.8,1581.4
4837821415,1,15,1,0,8,3,3,0,0,0,0,16640,7.0,18559,213,56,296,1240,26.9,1664.0,15,2,1,3,8,2,2,1,1,0,16344,7.0,17319,203,56,-296,-1240,25.9,1634.4
4837798712,1,12,2,1,3,2,4,2,1,1,0,16553,7.2,18858,242,68,2312,246,31.0,1655.3,14,3,0,1,2,0,0,0,0,0,14241,7.0,18612,235,48,-2312,-246,28.3,1424.1
4837691117,0,7,1,0,2,6,1,0,0,0,0,15412,6.6,16641,202,60,-1313,-1597,26.2,1541.2,14,1,1,6,2,3,0,0,0,0,16725,7.0,18238,226,60,1313,1597,28.6,1672.5
4837652454,1,13,1,1,5,5,4,0,0,0,0,16627,6.8,17814,224,60,1827,1248,28.4,1662.7,41,2,0,5,5,5,0,0,0,0,14800,6.6,16566,181,44,-1827,-1248,22.5,1480.0
4837628718,1,15,2,0,6,4,5,0,0,0,0,17007,7.2,17969,202,64,493,715,26.6,1700.7,9,0,1,4,6,4,0,0,0,0,16514,6.8,17254,221,40,-493,-715,26.1,1651.4
4773646859,1,16,3,1,10,4,8,1,0,1,0,18612,7.0,17743,233,48,1485,934,28.1,1861.2,26,3,0,4,10,6,0,0,0,0,17127,6.6,16809,196,52,-1485,-934,24.8,1712.7
4773621692,0,13,0,1,2,5,2,1,1,0,0,16522,6.8,18233,225,59,-979,575,28.4,1652.2,15,3,0,5,2,4,1,0,1,0,17501,7.0,17658,218,52,979,-575,27.0,1750.1
4768641121,1,14,0,1,18,3,24,1,1,0,0,21437,7.0,18528,208,60,6147,1253,26.8,2143.7,12,1,0,3,18,0,1,0,1,0,15290,6.6,17275,227,68,-6147,-1253,29.5,1529.0
4768617744,0,77,2,0,4,5,4,0,0,0,0,15842,6.8,17471,195,64,-980,-563,25.9,1584.2,13,4,1,5,4,6,0,0,0,0,16822,7.0,18034,244,52,980,563,29.6,1682.2
4768194029,1,13,2,0,4,5,4,1,1,0,0,16815,7.2,18369,194,64,1102,2143,25.8,1681.5,19,2,1,5,4,6,0,0,0,0,15713,6.6,16226,216,44,-1102,-2143,26.0,1571.3
4766581190,0,12,3,1,6,6,8,1,1,0,0,17374,6.8,17760,213,56,-1843,-1326,26.9,1737.4,6,0,0,6,6,6,0,0,0,0,19217,7.2,19086,235,60,1843,1326,29.5,1921.7
4766549557,1,15,0,0,4,10,7,0,0,0,0,16687,6.4,17203,227,42,-938,299,26.9,1668.7,13,2,1,10,4,15,0,0,0,0,17625,6.6,16904,197,60,938,-299,25.7,1762.5
4766514353,0,12,2,1,6,6,6,0,0,0,0,16291,7.0,18085,219,51,176,533,27.0,1629.1,11,0,0,6,6,7,0,0,0,0,16115,6.8,17552,225,48,-176,-533,27.3,1611.5
4766149853,0,10,1,1,7,8,6,0,0,0,0,17600,6.8,17602,201,47,-2147,-648,24.8,1760.0,11,1,0,8,7,8,2,1,1,0,19747,7.2,18250,208,76,2147,648,28.4,1974.7
4764894506,0,13,1,0,3,4,2,1,0,1,0,15518,7.0,18736,226,64,-1932,1233,29.0,1551.8,11,2,1,4,3,3,1,1,0,0,17450,6.8,17503,227,52,1932,-1233,27.9,1745.0
4763545732,1,12,1,1,10,4,10,0,0,0,0,17420,6.8,17250,205,56,2093,246,26.1,1742.0,12,2,0,4,10,5,1,1,0,0,15327,6.8,17004,212,59,-2093,-246,27.1,1532.7
4763534891,0,53,0,0,2,6,2,0,0,0,0,14435,6.8,17614,186,64,-3355,-1347,25.0,1443.5,11,1,1,6,2,8,1,1,0,0,17790,7.2,18961,248,67,3355,1347,31.5,1779.0
4763503344,1,29,1,0,5,5,9,0,0,0,0,15441,6.2,15959,175,56,-1179,-1935,23.1,1544.1,32,2,1,5,5,5,0,0,0,0,16620,6.8,17894,203,60,1179,1935,26.3,1662.0
4763233247,1,15,0,1,4,2,7,0,0,0,0,15706,6.6,16630,212,52,424,-1803,26.4,1570.6,9,2,0,2,4,0,0,0,0,0,15282,7.0,18433,221,56,-424,1803,27.7,1528.2
4763218001,0,20,1,1,5,3,4,0,0,0,0,15837,6.8,16900,225,48,463,-426,27.3,1583.7,13,2,0,3,5,1,2,1,1,0,15374,7.0,17326,206,64,-463,426,27.0,1537.4
4763077295,0,10,2,1,6,8,7,1,1,0,0,16187,6.4,16330,232,40,-2418,-2511,27.2,1618.7,12,0,0,8,6,12,1,0,1,0,18605,7.2,18841,222,64,2418,2511,28.6,1860.5
4763049941,1,9,2,1,7,5,9,0,0,0,0,18341,6.8,17344,193,51,859,256,24.4,1834.1,10,0,0,5,7,5,1,1,0,0,17482,6.8,17088,201,48,-859,-256,24.9,1748.2
4763030744,0,14,0,1,2,9,2,0,0,0,0,13891,6.2,15417,192,40,-4026,-4229,23.2,1389.1,11,3,0,9,2,9,1,1,0,0,17917,7.2,19646,220,56,4026,4229,27.6,1791.7
4762977337,1,13,0,1,6,3,4,0,0,0,0,17825,7.2,18656,236,56,1974,1695,29.2,1782.5,11,2,0,3,6,5,0,0,0,0,15851,6.6,16961,200,36,-1974,-1695,23.6,1585.1
4762946146,0,19,1,1,4,4,2,0,0,0,0,15631,6.8,18143,215,56,-1786,-878,27.1,1563.1,39,0,0,4,4,3,1,1,0,0,17417,7.2,19021,215,63,1786,878,27.8,1741.7
4837283414,0,15,1,0,3,1,3,0,0,0,0,15819,7.2,18554,235,55,1611,1356,29.0,1581.9,16,2,1,1,3,2,1,1,0,0,14208,6.8,17198,232,44,-1611,-1356,27.6,1420.8
4793735921,0,10,2,1,2,6,1,0,0,0,0,16741,6.8,17266,247,48,582,1533,29.5,1674.1,12,2,0,6,2,6,0,0,0,0,16159,6.2,15733,225,33,-582,-1533,25.8,1615.9
4792141005,1,14,2,1,5,2,3,1,1,0,0,17741,7.0,18961,251,64,3637,2753,31.5,1774.1,17,2,0,2,5,1,0,0,0,0,14104,6.6,16208,184,64,-3637,-2753,24.8,1410.4
4791307354,0,11,3,1,6,5,7,0,0,0,0,17080,6.8,17493,221,48,327,-1304,26.9,1708.0,18,3,0,5,6,7,0,0,0,0,16753,7.2,18797,240,51,-327,1304,29.1,1675.3
4775155236,0,9,4,0,5,4,3,1,1,0,0,15607,7.0,17680,199,54,-2595,-1170,25.3,1560.7,11,0,1,4,5,2,0,0,0,0,18202,7.4,18850,234,57,2595,1170,29.1,1820.2
4775130106,1,11,2,1,6,4,3,1,1,0,0,18577,7.0,18648,232,64,3525,2109,29.6,1857.7,12,0,0,4,6,3,0,0,0,0,15052,6.6,16539,214,48,-3525,-2109,26.2,1505.2
4775078975,0,13,3,0,7,6,6,1,1,0,0,17281,7.0,17842,202,46,-959,-1596,24.8,1728.1,14,0,1,6,7,4,0,0,0,0,18240,7.4,19438,233,74,959,1596,30.7,1824.0
4769017789,1,15,4,1,3,1,3,0,0,0,0,15674,7.0,18292,210,56,-123,12,26.6,1567.4,10,5,0,1,3,1,0,0,0,0,15797,7.0,18280,239,51,123,-12,29.0,1579.7
4709685253,1,15,0,1,7,5,6,0,0,0,0,17298,6.8,17393,233,48,709,-455,28.1,1729.8,10,3,0,4,6,7,1,1,0,0,16589,6.8,17848,236,44,-709,455,28.0,1658.9
4702979033,1,11,0,1,7,4,10,0,0,0,0,16123,6.6,16181,182,48,-907,-899,23.0,1612.3,11,1,0,4,7,5,0,0,0,0,17030,6.8,17080,209,47,907,899,25.6,1703.0
4702964910,1,14,6,1,14,7,15,0,0,0,0,19495,7.2,19629,213,48,1941,2157,26.1,1949.5,16,4,0,7,14,7,0,0,0,0,17554,6.8,17472,211,44,-1941,-2157,25.5,1755.4
4702724495,0,8,0,0,7,11,4,0,0,0,0,16820,6.4,16011,191,50,-4028,-1700,24.1,1682.0,11,0,1,11,7,16,0,0,0,0,20848,7.0,17711,203,45,4028,1700,24.8,2084.8
4693526019,1,4,2,1,8,4,7,0,0,0,0,16675,7.2,18147,216,56,770,-299,27.2,1667.5,9,0,0,4,8,3,1,0,1,0,15905,7.2,18446,202,68,-770,299,27.0,1590.5
4693473522,0,15,3,0,1,9,0,0,0,0,0,12961,6.2,15416,164,36,-5236,-2219,20.0,1296.1,15,2,1,9,1,11,1,1,0,0,18197,6.6,17635,204,52,5236,2219,25.6,1819.7
4693443402,1,12,2,0,10,6,9,1,0,1,0,19422,6.8,17971,176,68,1903,1767,24.4,1942.2,35,2,1,6,10,10,0,0,0,0,17519,6.6,16204,212,56,-1903,-1767,26.8,1751.9
4692867862,1,11,3,1,5,3,8,1,1,0,0,16714,6.8,17318,227,44,718,-577,27.1,1671.4,16,2,0,3,5,2,0,0,0,0,15996,6.8,17895,209,52,-718,577,26.1,1599.6
4692733119,0,36,5,1,10,5,10,1,1,0,0,21301,7.0,18218,225,48,4221,2509,27.3,2130.1,67,1,0,5,10,9,1,0,1,0,17080,6.4,15709,180,40,-4221,-2509,22.0,1708.0
4691772294,1,10,3,0,6,4,8,0,0,0,0,18974,7.6,20359,245,64,3327,3570,30.9,1897.4,13,1,1,4,6,3,1,1,0,0,15647,6.6,16789,181,51,-3327,-3570,23.2,1564.7
4691479484,0,17,3,0,3,7,2,0,0,0,0,15871,6.8,17101,234,52,-1402,-291,28.6,1587.1,20,0,1,7,3,4,1,1,0,0,17273,6.8,17392,192,52,1402,291,24.4,1727.3
4691284474,0,10,3,0,5,8,5,0,0,0,0,15389,6.6,16536,192,39,-3021,-3449,23.1,1538.9,15,4,1,8,5,6,1,0,1,0,18410,7.4,19985,210,54,3021,3449,26.4,1841.0
4855286197,0,13,1,1,7,9,4,0,0,0,0,16203,7.0,17399,168,40,-801,187,20.8,1620.3,11,1,0,9,7,8,0,0,0,0,17004,6.8,17212,190,49,801,-187,23.9,1700.4
4855224423,1,13,7,1,11,9,18,1,1,0,0,19811,7.0,18239,190,50,1255,-225,24.0,1981.1,44,1,0,9,11,9,0,0,0,0,18556,6.8,18464,198,66,-1255,225,26.4,1855.6
4855174474,1,18,0,1,8,6,6,0,0,0,0,16382,6.8,17207,182,56,-31,844,23.8,1638.2,14,1,0,6,8,6,0,0,0,0,16413,6.6,16363,197,48,31,-844,24.5,1641.3
4855151082,1,8,0,0,21,17,53,0,0,0,0,36246,11.0,40064,114,0,1175,2571,11.4,3624.6,0,0,1,17,21,47,0,0,0,0,35071,10.6,37493,80,0,-1175,-2571,8.0,3507.1
4855113910,0,0,0,1,19,13,47,0,0,0,0,35617,11.0,38760,103,0,2123,1306,10.3,3561.7,0,0,0,13,19,25,0,0,0,0,33494,10.8,37454,101,0,-2123,-1306,10.1,3349.4
4853397990,1,10,5,1,8,2,5,0,0,0,0,18061,7.4,19939,243,64,3534,2742,30.7,1806.1,16,2,0,2,8,2,0,0,0,0,14527,7.0,17197,233,43,-3534,-2742,27.6,1452.7
4853379052,1,72,0,1,7,3,4,0,0,0,0,16747,6.8,16992,191,40,-190,-607,23.1,1674.7,10,1,0,3,7,5,1,1,0,0,16937,6.8,17599,230,60,190,607,29.0,1693.7
4852990796,1,4,0,1,19,22,17,0,0,0,0,64800,12.0,55000,0,0,26900,22000,0.0,6480.0,0,0,0,13,10,13,0,0,0,0,37900,7.2,33000,0,0,-26900,-22000,0.0,3790.0
4848259165,1,0,3,0,20,16,43,0,0,0,0,36420,10.8,39450,114,0,2521,1235,11.4,3642.0,16,0,1,16,20,26,0,0,0,0,33899,10.6,38215,88,0,-2521,-1235,8.8,3389.9
4848256750,1,21,1,1,23,14,62,0,0,0,0,36846,11.0,38844,115,0,2894,1274,11.5,3684.6,39,0,0,14,23,26,0,0,0,0,33952,10.8,37570,99,0,-2894,-1274,9.9,3395.2
4848237371,1,0,2,1,28,28,71,0,0,0,1,38890,11.6,42939,107,0,-1846,-2618,10.7,3889.0,13,0,0,28,28,63,0,0,0,0,40736,11.8,45557,124,0,1846,2618,12.4,4073.6
4848229088,1,2,0,0,32,28,79,0,0,0,1,42935,12.0,46475,108,0,4055,2908,10.8,4293.5,0,0,1,28,32,66,0,0,0,0,38880,11.6,43567,85,0,-4055,-2908,8.5,3888.0
4848212221,1,0,0,0,28,26,68,0,0,0,0,37606,11.4,41559,100,0,-1272,-3033,10.0,3760.6,0,0,1,26,28,72,0,0,0,0,38878,11.6,44592,86,0,1272,3033,8.6,3887.8
4848204911,1,0,0,0,38,24,93,0,0,0,1,41701,12.0,47406,126,0,4835,8382,12.6,4170.1,0,0,1,23,37,57,0,0,0,0,36866,10.8,39024,98,0,-4835,-8382,9.8,3686.6
4848185257,0,0,0,1,27,25,75,0,0,0,1,38107,11.4,41083,98,0,-626,-1946,9.8,3810.7,0,0,0,25,27,68,0,0,0,0,38733,11.4,43029,109,0,626,1946,10.9,3873.3
4845434928,1,1,0,1,23,19,44,0,0,0,1,39092,11.6,42664,111,0,2345,3303,11.1,3909.2,0,0,0,19,23,37,0,0,0,0,36747,11.0,39361,88,0,-2345,-3303,8.8,3674.7
4845422151,0,0,0,1,22,24,61,0,0,0,1,37702,11.0,40626,120,0,-442,-63,12.0,3770.2,0,0,0,24,22,60,0,0,0,0,38144,11.2,40689,91,0,442,63,9.1,3814.4
4845402670,0,3,0,1,14,14,36,0,0,0,1,34421,10.2,35315,113,0,1140,539,11.3,3442.1,14,0,0,14,14,37,0,0,0,0,33281,10.0,34776,100,0,-1140,-539,10.0,3328.1
4845397241,0,0,0,0,28,38,71,0,0,0,2,37217,11.4,42514,87,0,-5067,-3842,8.7,3721.7,20,0,1,38,28,94,0,0,0,0,42284,12.2,46356,120,0,5067,3842,12.0,4228.4
4845383921,1,0,0,1,18,23,36,0,0,0,0,36195,10.8,38603,106,0,629,-1039,10.6,3619.5,17,0,0,23,18,53,0,0,0,0,35566,10.8,39642,90,0,-629,1039,9.0,3556.6
4856346759,1,1,0,1,17,15,34,0,0,0,1,35821,10.8,38834,129,0,1198,1843,12.9,3582.1,19,0,0,15,17,39,0,0,0,0,34623,10.4,36991,104,0,-1198,-1843,10.4,3462.3
4856301713,1,0,0,0,20,31,58,0,0,0,1,37447,10.8,39492,120,0,-1223,-3659,12.0,3744.7,0,0,1,31,20,90,0,0,0,0,38670,11.6,43151,103,0,1223,3659,10.3,3867.0
4856238030,1,1,0,1,24,29,59,0,0,0,1,38352,11.4,41888,116,0,-54,-1388,11.6,3835.2,37,0,0,29,24,78,0,0,0,0,38406,11.6,43276,92,0,54,1388,9.2,3840.6
4855497112,1,0,0,1,20,22,21,0,0,0,0,48850,10.0,47500,1,0,20634,19000,0.1,4885.0,0,0,0,12,10,6,0,0,0,0,28216,6.0,28500,0,0,-20634,-19000,0.0,2821.6
4854329019,1,31,7,1,11,16,15,0,0,0,0,44826,10.0,47500,9,0,16266,19000,0.9,4482.6,0,2,0,13,8,11,0,0,0,0,28560,6.0,28500,0,0,-16266,-19000,0.0,2856.0
4854307419,1,0,0,1,18,17,12,0,0,0,0,46666,10.0,47500,0,0,18116,19000,0.0,4666.6,0,0,0,10,11,11,0,0,0,0,28550,6.0,28500,0,0,-18116,-19000,0.0,2855.0
4854291213,1,0,2,0,14,11,15,0,0,0,0,46934,10.0,47500,2,0,19604,19000,0.2,4693.4,11,0,1,7,10,6,0,0,0,0,27330,6.0,28500,3,0,-19604,-19000,0.3,2733.0
4852096808,0,13,1,0,4,13,5,0,0,0,0,16186,6.4,14911,187,28,-2241,-903,21.5,1618.6,20,5,1,13,4,13,0,0,0,0,18427,6.4,15814,165,44,2241,903,20.9,1842.7
4852061673,1,11,1,0,10,6,9,0,0,0,0,18511,7.0,18206,198,44,2512,588,24.2,1851.1,15,0,1,6,10,3,0,0,0,0,15999,6.8,17618,195,48,-2512,-588,24.3,1599.9
4852036254,1,19,1,0,6,6,6,1,1,0,0,16732,7.2,18571,210,48,888,1029,25.8,1673.2,11,2,1,6,6,4,0,0,0,0,15844,6.8,17542,203,56,-888,-1029,25.9,1584.4
4851164980,0,0,0,0,30,28,63,0,0,0,1,39675,11.8,44347,78,0,653,297,7.8,3967.5,0,0,1,28,30,63,0,0,0,0,39022,11.6,44050,95,0,-653,-297,9.5,3902.2
4851148973,0,0,0,1,29,32,50,0,0,0,1,37124,11.4,41528,89,0,-1823,-3975,8.9,3712.4,0,0,0,32,29,77,0,0,0,0,38947,12.0,45503,105,0,1823,3975,10.5,3894.7
4851128616,1,16,0,0,23,16,56,0,0,0,0,38185,11.0,41168,103,0,2957,2779,10.3,3818.5,2,0,1,16,23,33,0,0,0,0,35228,10.6,38389,81,0,-2957,-2779,8.1,3522.8
4850995858,0,0,0,0,24,35,59,0,0,0,2,39522,11.4,42728,87,0,-3050,-3620,8.7,3952.2,11,0,1,35,24,100,0,0,0,0,42572,12.0,46348,101,0,3050,3620,10.1,4257.2
4850968264,0,0,0,0,35,25,86,0,0,0,2,40054,11.8,44118,98,0,-694,-592,9.8,4005.4,0,0,1,25,35,62,0,0,0,0,40748,11.6,44710,107,0,694,592,10.7,4074.8
4850953801,1,79,0,1,33,29,55,0,0,0,1,39562,12.0,45246,97,0,1831,2525,9.7,3956.2,21,0,0,29,33,70,0,0,0,0,37731,11.6,42721,82,0,-1831,-2525,8.2,3773.1
4850231357,0,0,0,1,30,31,79,0,0,0,1,39709,11.6,44159,113,0,528,638,11.3,3970.9,0,0,0,31,30,90,0,0,0,0,39181,11.4,43521,98,0,-528,-638,9.8,3918.1
4848294916,1,9,0,0,3,13,2,1,0,1,1,13881,6.2,15783,188,44,-6291,-2076,23.2,1388.1,9,0,1,13,3,14,0,0,0,0,20172,6.8,17859,232,43,6291,2076,27.5,2017.2
4848278283,0,13,2,0,6,13,5,0,0,0,0,16321,6.6,17076,219,44,-3051,-2054,26.3,1632.1,179,1,1,13,6,6,0,0,0,0,19372,7.0,19130,211,40,3051,2054,25.1,1937.2
4847759547,1,0,0,1,22,16,60,0,0,0,0,36309,10.6,38681,95,0,695,668,9.5,3630.9,0,0,0,16,22,41,0,0,0,0,35614,10.8,38013,99,0,-695,-668,9.9,3561.4
4805674460,1,14,1,1,4,3,3,1,1,0,0,16872,7.2,18847,245,60,1604,393,30.5,1687.2,10,2,0,3,4,2,0,0,0,0,15268,7.0,18454,230,67,-1604,-393,29.7,1526.8
4805646904,0,14,3,1,13,8,20,1,1,0,0,20083,7.0,17225,212,46,976,-810,25.8,2008.3,15,0,0,8,13,9,0,0,0,0,19107,7.0,18035,169,64,-976,810,23.3,1910.7
4805622872,0,53,3,0,5,8,6,0,0,0,0,16051,6.4,16643,184,44,-1332,-808,22.8,1605.1,16,1,1,8,5,6,0,0,0,0,17383,6.8,17451,228,41,1332,808,26.9,1738.3
4804852188,1,15,0,1,5,5,5,1,0,1,0,16157,6.8,18736,215,56,-31,1530,27.1,1615.7,12,0,0,5,5,6,0,0,0,0,16188,7.0,17206,212,64,31,-1530,27.6,1618.8
4804843900,1,15,1,1,3,3,1,0,0,0,0,15700,6.8,17608,201,46,339,189,24.7,1570.0,14,3,0,3,3,5,0,0,0,0,15361,6.8,17419,230,60,-339,-189,29.0,1536.1
4804825469,1,12,0,0,6,2,5,1,1,0,0,17678,7.0,18927,211,68,2960,1767,27.9,1767.8,11,2,1,2,6,1,0,0,0,0,14718,6.8,17160,217,60,-2960,-1767,27.7,1471.8
4804810518,0,12,3,0,5,4,2,0,0,0,0,16661,7.2,18284,197,60,-261,690,25.7,1666.1,17,0,1,4,5,2,1,0,1,0,16922,6.8,17594,215,59,261,-690,27.4,1692.2
4804788635,1,21,1,1,7,3,5,0,0,0,0,17477,7.0,18535,221,52,2217,1556,27.3,1747.7,15,0,0,3,7,2,0,0,0,0,15260,6.4,16979,192,56,-2217,-1556,24.8,1526.0
4804783770,1,11,0,0,7,11,5,0,0,0,0,17237,6.8,18281,243,48,-2448,-124,29.1,1723.7,12,1,1,11,7,8,0,0,0,0,19685,7.0,18405,234,40,2448,124,27.4,1968.5
4795435429,1,27,2,0,8,2,6,1,1,0,0,18478,7.2,18879,228,61,4385,2323,28.9,1847.8,16,1,1,2,8,0,0,0,0,0,14093,6.6,16556,187,66,-4385,-2323,25.3,1409.3
4795418526,1,18,4,1,11,4,12,0,0,0,0,19666,7.2,19778,248,64,3421,1463,31.2,1966.6,10,3,0,4,11,2,0,0,0,0,16245,6.8,18315,236,67,-3421,-1463,30.3,1624.5
4795402228,0,10,2,1,6,3,4,0,0,0,0,15734,6.8,17658,215,48,-740,-265,26.3,1573.4,13,1,0,3,6,3,0,0,0,0,16474,6.8,17923,219,70,740,265,28.9,1647.4
4795356478,1,10,5,1,11,3,14,1,1,0,0,21784,7.2,20217,245,80,7857,3943,32.5,2178.4,10,1,0,3,11,2,0,0,0,0,13927,6.6,16274,186,52,-7857,-3943,23.8,1392.7
4795327533,1,13,1,0,5,6,6,0,0,0,0,16858,6.6,15975,173,60,-1047,-2139,23.3,1685.8,14,2,1,6,5,5,0,0,0,0,17905,7.0,18114,234,60,1047,2139,29.4,1790.5
4795301974,1,34,1,0,3,3,3,0,0,0,0,16470,7.2,18297,221,64,1144,816,28.5,1647.0,34,4,1,3,3,4,1,1,0,0,15326,6.8,17481,214,44,-1144,-816,25.8,1532.6
4790864408,0,12,1,0,10,7,8,1,0,1,0,18107,6.8,17788,184,69,1563,1348,25.3,1810.7,11,1,1,7,10,3,0,0,0,0,16544,6.6,16440,201,54,-1563,-1348,25.5,1654.4
4787200995,1,55,0,1,4,2,4,1,1,0,0,16437,7.0,18481,212,60,1675,1182,27.2,1643.7,10,3,0,2,4,2,0,0,0,0,14762,7.0,17299,197,56,-1675,-1182,25.3,1476.2
4787173047,1,9,1,0,8,10,8,1,1,0,0,17448,6.6,16166,186,48,-1530,-1476,23.4,1744.8,11,0,1,10,8,3,0,0,0,0,18978,6.8,17642,191,44,1530,1476,23.5,1897.8
4787142428,0,25,3,1,6,5,3,0,0,0,0,15760,6.6,16739,183,48,-1498,-2187,23.1,1576.0,13,2,0,5,6,6,0,0,0,0,17258,7.0,18926,221,52,1498,2187,27.3,1725.8
4787111500,1,22,2,1,11,8,15,1,1,0,0,19555,7.2,18708,209,72,3797,1110,28.1,1955.5,91,3,0,8,11,4,0,0,0,0,15758,6.8,17598,195,60,-3797,-1110,25.5,1575.8
4746747954,1,0,0,0,12,15,18,0,0,0,0,61354,12.0,55000,0,0,24112,22000,0.0,6135.4,0,0,1,11,8,6,0,0,0,0,37242,7.2,33000,0,0,-24112,-22000,0.0,3724.2
4745502112,1,0,0,1,18,14,18,0,0,0,0,63522,12.0,55000,5,0,26335,22000,0.5,6352.2,612,0,0,8,12,8,0,0,0,0,37187,7.2,33000,6,0,-26335,-22000,0.6,3718.7
4743855124,0,0,0,1,20,21,48,0,0,0,0,36398,11.0,39328,102,0,500,-1084,10.2,3639.8,0,0,0,21,20,58,0,0,0,0,35898,11.0,40412,96,0,-500,1084,9.6,3589.8
4743839040,1,0,0,1,32,24,83,0,0,0,2,40971,12.0,44431,122,0,3731,3405,12.2,4097.1,20,0,0,24,32,54,0,0,0,0,37240,11.0,41026,116,0,-3731,-3405,11.6,3724.0
4743815469,1,0,2,0,29,27,65,0,0,0,1,38402,11.2,41126,125,0,-343,1993,12.5,3840.2,18,0,1,27,29,73,0,0,0,0,38745,11.0,39133,116,0,343,-1993,11.6,3874.5
4743480204,0,0,0,0,20,25,43,0,0,0,2,36277,10.6,37390,110,0,-3348,-3254,11.0,3627.7,0,0,1,25,20,57,0,0,0,0,39625,11.0,40644,126,0,3348,3254,12.6,3962.5
4743430600,1,0,0,0,24,38,55,0,0,0,2,38048,11.2,40716,94,0,-3158,-4589,9.4,3804.8,0,0,1,38,24,106,0,0,0,0,41206,11.8,45305,113,0,3158,4589,11.3,4120.6
4743424904,0,0,0,1,27,39,78,0,0,0,0,38801,11.4,43404,90,0,-2586,-3037,9.0,3880.1,0,0,0,39,27,120,0,0,0,0,41387,12.0,46441,113,0,2586,3037,11.3,4138.7
4742626840,1,20,0,0,36,37,79,0,0,0,1,40500,12.2,47688,99,0,-2156,-19,9.9,4050.0,16,0,1,37,36,90,0,0,0,0,42656,12.2,47707,102,0,2156,19,10.2,4265.6
4742587511,0,0,3,1,18,23,48,0,0,0,0,36486,10.6,37798,123,0,-737,-1546,12.3,3648.6,30,0,0,23,18,75,0,0,0,0,37223,10.8,39344,120,0,737,1546,12.0,3722.3
4742570770,1,415,0,1,13,17,11,0,0,0,0,61584,12.0,55000,0,0,23630,22000,0.0,6158.4,48,0,0,11,7,12,0,0,0,0,37954,7.2,33000,0,0,-23630,-22000,0.0,3795.4
4742510520,1,30,0,0,35,25,97,0,0,0,1,41565,12.2,48193,119,0,2564,4949,11.9,4156.5,13,1,1,25,35,57,0,0,0,0,39001,11.4,43244,93,0,-2564,-4949,9.3,3900.1
4741155502,1,3,0,1,24,13,27,0,0,0,0,64860,12.8,61000,0,0,29060,25000,0.0,6486.0,0,0,0,5,16,6,0,0,0,0,35800,7.6,36000,0,0,-29060,-25000,0.0,3580.0
4740902400,0,0,4,1,31,29,71,0,0,0,2,39840,11.6,43438,116,0,458,-1103,11.6,3984.0,17,0,0,29,31,63,0,0,0,0,39382,11.6,44541,98,0,-458,1103,9.8,3938.2
4740890810,1,0,0,0,23,23,73,0,0,0,1,38719,11.0,41083,104,0,1036,2140,10.4,3871.9,0,0,1,23,23,69,0,0,0,0,37683,10.8,38943,99,0,-1036,-2140,9.9,3768.3
4740840427,0,16,3,0,1,3,1,0,0,0,0,14798,6.6,16902,199,44,-1927,-1363,24.3,1479.8,16,5,1,3,1,3,1,1,0,0,16725,7.0,18265,235,60,1927,1363,29.5,1672.5
4740804184,0,13,0,0,8,7,8,0,0,0,0,18014,6.8,17565,222,56,-612,-1044,27.8,1801.4,9,4,1,7,8,4,0,0,0,0,18626,7.2,18609,216,51,612,1044,26.7,1862.6
4740194596,0,11,2,1,5,7,8,0,0,0,0,16201,7.0,17518,199,56,-1146,-934,25.5,1620.1,33,1,0,7,5,8,0,0,0,0,17347,7.0,18452,230,68,1146,934,29.8,1734.7
4740181306,1,36,2,1,4,4,2,0,0,0,0,16679,7.2,18600,238,64,-71,76,30.2,1667.9,33,2,0,4,4,4,0,0,0,0,16750,7.2,18524,222,52,71,-76,27.4,1675.0
4739342874,1,17,1,1,7,10,9,0,0,0,0,17675,6.8,17561,196,62,-1428,-218,25.8,1767.5,25,0,0,10,7,11,1,1,0,0,19103,7.0,17779,188,72,1428,218,26.0,1910.3
4855366940,0,0,0,1,19,25,50,0,0,0,1,35699,10.8,37202,105,0,-4542,-5900,10.5,3569.9,85,0,0,25,19,60,0,0,0,0,40241,11.6,43102,124,0,4542,5900,12.4,4024.1
4855338269,1,68,3,0,16,24,35,0,0,0,1,35428,11.0,40492,107,0,-1993,656,10.7,3542.8,20,0,1,24,16,57,0,0,0,0,37421,10.8,39836,119,0,1993,-656,11.9,3742.1
4855298148,1,12,2,1,10,15,7,0,0,0,0,19732,6.6,17123,182,49,-236,-25,23.1,1973.2,17,0,0,15,10,16,1,1,0,0,19968,6.8,17148,160,62,236,25,22.2,1996.8
4855256836,1,11,0,1,5,2,4,1,1,0,0,16783,7.2,18774,223,67,971,266,29.0,1678.3,9,1,0,2,5,2,0,0,0,0,15812,7.2,18508,206,72,-971,-266,27.8,1581.2
4855212201,0,18,2,1,8,4,13,1,0,1,0,18099,6.8,18469,238,60,2066,565,29.8,1809.9,15,1,0,4,8,7,1,1,0,0,16033,6.6,17904,199,60,-2066,-565,25.9,1603.3
4855152041,1,33,2,0,3,6,1,0,0,0,0,15047,7.0,18355,229,60,-1669,-149,28.9,1504.7,13,11,1,6,3,4,0,0,0,0,16716,7.0,18504,205,72,1669,149,27.7,1671.6
4855122394,1,22,0,0,17,13,48,0,0,0,1,35125,11.0,37602,114,0,2066,2220,11.4,3512.5,24,14,1,13,17,40,0,0,0,0,33059,10.2,35382,89,0,-2066,-2220,8.9,3305.9
4855092388,1,0,0,1,17,14,56,0,0,0,1,37024,10.8,39299,127,0,2908,3125,12.7,3702.4,0,0,0,14,17,30,0,0,0,0,34116,10.2,36174,114,0,-2908,-3125,11.4,3411.6
4855061766,1,0,0,1,20,9,63,0,0,0,1,37172,10.8,39771,109,0,4187,3626,10.9,3717.2,0,0,0,9,20,16,0,0,0,0,32985,10.4,36145,97,0,-4187,-3626,9.7,3298.5
4853000034,0,14,1,1,5,2,6,0,0,0,0,16466,6.8,18560,254,46,656,-87,30.0,1646.6,14,1,0,2,5,2,1,1,0,0,15810,7.0,18647,211,61,-656,87,27.2,1581.0
4852904499,1,0,0,1,33,21,96,0,0,0,2,40897,11.4,42561,118,0,5062,4482,11.8,4089.7,0,0,0,21,33,46,0,0,0,0,35835,10.6,38079,97,0,-5062,-4482,9.7,3583.5
4852805399,0,14,0,1,6,7,4,0,0,0,0,16743,7.2,18582,220,48,-170,824,26.8,1674.3,80,0,0,7,6,7,0,0,0,0,16913,7.0,17758,202,48,170,-824,25.0,1691.3
4852763295,1,18,2,1,13,6,12,1,1,0,0,19834,7.4,19638,204,68,3763,3291,27.2,1983.4,15,0,0,6,13,3,0,0,0,0,16071,6.6,16347,186,48,-3763,-3291,23.4,1607.1
4852638367,1,14,1,1,10,4,9,0,0,0,0,18053,7.2,18926,237,50,2485,1655,28.7,1805.3,23,1,0,4,10,1,0,0,0,0,15568,6.8,17271,195,49,-2485,-1655,24.4,1556.8
4852578848,0,39,1,0,6,5,6,0,0,0,0,17286,7.2,18607,227,64,972,421,29.1,1728.6,14,6,1,5,6,3,1,1,0,0,16314,6.8,18186,214,68,-972,-421,28.2,1631.4
4852532368,1,21,0,0,6,4,8,1,1,0,0,17156,7.0,18481,210,60,1939,909,27.0,1715.6,14,2,1,4,6,6,0,0,0,0,15217,7.0,17572,214,60,-1939,-909,27.4,1521.7
4851030583,1,75,2,1,14,5,12,0,0,0,0,20586,7.0,18183,172,71,4808,3612,24.3,2058.6,12,1,0,5,14,8,1,0,1,0,15778,6.0,14571,173,4,-4808,-3612,17.7,1577.8
4850980725,1,9,2,1,5,3,3,0,0,0,0,16723,7.0,18443,206,58,1945,658,26.4,1672.3,69,1,0,3,5,3,0,0,0,0,14778,6.8,17785,185,60,-1945,-658,24.5,1477.8
4850942402,1,12,0,0,6,6,7,0,0,0,0,17022,7.0,18432,214,48,149,201,26.2,1702.2,11,0,1,6,6,6,1,1,0,0,16873,7.2,18231,218,61,-149,-201,27.9,1687.3
4850920203,0,21,2,0,4,6,3,0,0,0,0,15601,6.8,17659,234,56,-1787,-1600,29.0,1560.1,69,1,1,6,4,7,1,1,0,0,17388,7.2,19259,258,64,1787,1600,32.2,1738.8
4855285136,0,15,3,1,6,3,13,1,1,0,0,16963,6.8,17357,221,60,2017,739,28.1,1696.3,13,4,0,3,6,4,0,0,0,0,14946,6.6,16618,224,55,-2017,-739,27.9,1494.6
4855243007,0,15,2,1,4,7,4,0,0,0,0,15311,6.2,15002,161,36,-1588,-2699,19.7,1531.1,13,1,0,7,4,5,1,1,0,0,16899,6.6,17701,229,52,1588,2699,28.1,1689.9
4855205528,1,15,2,1,10,2,7,1,1,0,0,19765,7.6,20062,257,64,6119,4003,32.1,1976.5,13,1,0,1,9,1,0,0,0,0,13646,6.6,16059,201,52,-6119,-4003,25.3,1364.6
4855034604,1,16,1,0,9,10,4,0,0,0,0,19010,7.2,19042,210,59,1967,3078,26.9,1901.0,28,1,1,10,9,10,0,0,0,0,17043,6.4,15964,186,32,-1967,-3078,21.8,1704.3
4852316263,0,50,2,0,10,12,5,1,1,0,0,16302,6.8,16513,175,36,-2459,-2407,21.1,1630.2,12,2,1,12,10,14,0,0,0,0,18761,7.0,18920,218,56,2459,2407,27.4,1876.1
4835163462,0,50,0,1,1,3,0,0,0,0,0,13603,7.0,17013,194,44,-2069,-1201,23.8,1360.3,14,2,0,3,1,3,0,0,0,0,15672,7.0,18214,212,64,2069,1201,27.6,1567.2
4835124881,1,15,1,1,8,7,10,0,0,0,0,16686,6.6,15982,163,52,-1407,-1137,21.5,1668.6,11,3,0,7,8,11,0,0,0,0,18093,6.6,17119,202,56,1407,1137,25.8,1809.3
4835098215,0,23,1,0,3,6,1,0,0,0,0,14974,6.6,17294,202,56,-2396,-598,25.8,1497.4,14,1,1,6,3,7,1,1,0,0,17370,6.8,17892,211,56,2396,598,26.7,1737.0
4835045506,0,19,1,0,6,7,7,1,1,0,0,16643,7.2,18763,217,64,-474,200,28.1,1664.3,14,2,1,7,6,4,0,0,0,0,17117,7.2,18563,223,64,474,-200,28.7,1711.7
4834634149,1,13,2,0,5,3,1,0,0,0,0,16001,7.0,18432,230,64,-69,5,29.4,1600.1,9,0,1,3,5,3,1,1,0,0,16070,6.8,18427,208,59,69,-5,26.7,1607.0
4834615083,0,56,2,0,2,5,2,0,0,0,0,14237,6.6,17053,171,66,-2529,-1328,23.7,1423.7,22,0,1,5,2,5,1,1,0,0,16766,7.0,18381,253,68,2529,1328,32.1,1676.6
4834586664,1,11,2,0,1,4,0,0,0,0,0,15047,6.6,17139,207,52,-908,-907,25.9,1504.7,12,1,1,4,1,7,0,0,0,0,15955,6.8,18046,220,56,908,907,27.6,1595.5
4834568036,0,13,0,1,9,8,6,0,0,0,0,17761,7.0,18353,189,51,-44,586,24.0,1776.1,10,0,0,8,9,6,0,0,0,0,17805,6.8,17767,207,52,44,-586,25.9,1780.5
4834556077,0,12,1,0,8,9,6,0,0,0,0,18228,7.0,17928,194,40,-1275,-40,23.4,1822.8,13,3,1,9,8,13,0,0,0,0,19503,7.2,17968,222,64,1275,40,28.6,1950.3
4834542107,1,12,1,0,4,4,4,0,0,0,0,16360,6.8,18423,226,48,61,106,27.4,1636.0,12,1,1,4,4,5,0,0,0,0,16299,7.0,18317,223,64,-61,-106,28.7,1629.9
4821456199,1,50,4,0,3,3,1,0,0,0,0,15658,7.0,19021,231,59,1000,396,29.0,1565.8,14,0,1,3,3,4,1,1,0,0,14658,7.2,18625,181,60,-1000,-396,24.1,1465.8
4800438507,0,10,0,0,21,22,51,0,0,0,1,36516,11.0,40023,98,0,-2168,-398,9.8,3651.6,88,2,1,22,21,55,0,0,0,0,38684,11.0,40421,106,0,2168,398,10.6,3868.4
4800396434,1,15,2,1,5,1,3,2,1,1,0,17019,7.4,19566,246,67,2569,2286,31.3,1701.9,67,2,0,1,5,2,0,0,0,0,14450,6.6,17280,227,60,-2569,-2286,28.7,1445.0
4800362138,1,11,3,1,1,1,2,1,1,0,0,16326,7.0,19155,251,64,571,624,31.5,1632.6,10,2,0,1,1,2,0,0,0,0,15755,7.2,18531,247,64,-571,-624,31.1,1575.5
4858135414,0,23,1,0,0,3,0,1,0,1,0,14277,7.0,17894,213,59,-1901,-80,27.2,1427.7,11,2,1,3,0,3,1,1,0,0,16178,7.0,17974,231,52,1901,80,28.3,1617.8
4858102199,1,12,0,1,3,2,3,1,1,0,0,17240,7.0,19197,248,64,1684,1921,31.2,1724.0,11,1,0,2,3,5,0,0,0,0,15556,6.8,17276,241,50,-1684,-1921,29.1,1555.6
4856337926,0,101,0,1,17,17,49,0,0,0,0,36553,11.0,39070,106,0,1485,1770,10.6,3655.3,0,0,0,17,17,54,0,0,0,0,35068,10.8,37300,117,0,-1485,-1770,11.7,3506.8
4856303466,0,1,0,0,19,29,56,0,0,0,1,36519,11.0,38240,101,0,-3480,-4217,10.1,3651.9,36,0,1,29,19,79,0,0,0,0,39999,11.6,42457,112,0,3480,4217,11.2,3999.9
4856274396,1,0,5,1,21,18,63,0,0,0,1,37351,11.2,39419,122,0,1774,1452,12.2,3735.1,20,0,0,18,21,46,0,0,0,0,35577,10.6,37967,118,0,-1774,-1452,11.8,3557.7
4847844656,0,15,1,0,3,5,3,0,0,0,0,15014,6.8,17490,203,47,-2006,-1390,25.0,1501.4,23,0,1,5,3,4,0,0,0,0,17020,7.2,18880,237,56,2006,1390,29.3,1702.0
4846169922,1,12,2,0,4,4,5,0,0,0,0,16734,7.0,18040,210,60,491,-640,27.0,1673.4,12,1,1,4,4,1,0,0,0,0,16243,7.0,18680,247,48,-491,640,29.5,1624.3
4846129764,1,9,0,1,8,3,5,1,1,0,0,17808,7.4,19868,237,47,3093,2242,28.4,1780.8,8,0,0,2,7,4,0,0,0,0,14715,6.8,17626,226,44,-3093,-2242,27.0,1471.5
4846075435,0,11,0,1,2,1,2,1,1,0,0,15080,7.0,18480,219,54,643,-1594,27.3,1508.0,13,0,0,1,2,1,0,0,0,0,14437,7.2,20074,234,46,-643,1594,28.0,1443.7
4845907755,1,13,1,0,21,8,25,0,0,0,0,22589,7.2,18947,222,52,6033,3200,27.4,2258.9,12,0,1,8,21,8,0,0,0,0,16556,6.4,15747,187,44,-6033,-3200,23.1,1655.6
4845458444,1,10,4,1,7,4,6,0,0,0,0,16746,7.0,19044,207,40,2207,1641,24.7,1674.6,12,3,0,3,6,2,1,1,0,0,14539,6.8,17403,201,64,-2207,-1641,26.5,1453.9
4845447167,1,12,1,1,11,4,16,0,0,0,0,18614,6.8,17438,187,44,2858,1494,23.1,1861.4,23,0,0,4,11,10,0,0,0,0,15756,6.6,15944,193,40,-2858,-1494,23.3,1575.6
4845430434,1,7,2,1,18,10,26,1,1,0,0,20891,7.0,18088,219,48,2428,1115,26.7,2089.1,19,1,0,10,18,16,0,0,0,0,18463,6.6,16973,182,42,-2428,-1115,22.4,1846.3
4845413412,0,12,4,1,3,1,1,1,1,0,0,15886,6.8,18551,237,60,1957,1345,29.7,1588.6,14,0,0,1,3,1,0,0,0,0,13929,6.6,17206,207,48,-1957,-1345,25.5,1392.9
4841218931,0,13,0,1,6,6,2,0,0,0,0,15803,6.8,17461,226,51,-1762,-2022,27.7,1580.3,8,0,0,6,6,3,0,0,0,0,17565,7.4,19483,220,60,1762,2022,28.0,1756.5
4841009252,0,30,5,0,3,6,4,0,0,0,0,14773,6.6,16994,219,47,-1648,-1752,26.6,1477.3,35,1,1,6,3,4,1,1,0,0,16421,7.2,18746,226,45,1648,1752,27.1,1642.1
4840978064,1,13,1,1,10,4,8,0,0,0,0,18795,7.2,18915,225,64,3197,2265,28.9,1879.5,14,0,0,4,10,7,0,0,0,0,15598,6.6,16650,204,48,-3197,-2265,25.2,1559.8
4840934129,1,35,2,0,6,3,4,0,0,0,0,16373,7.0,17730,188,52,707,598,24.0,1637.3,32,2,1,3,6,2,1,1,0,0,15666,6.8,17132,213,52,-707,-598,26.5,1566.6
4840287520,1,11,1,0,3,2,1,0,0,0,0,15098,7.0,18124,216,67,-138,-51,28.3,1509.8,111,0,1,2,3,1,0,0,0,0,15236,6.8,18175,225,48,138,51,27.3,1523.6
4839255245,1,18,1,0,5,6,6,0,0,0,0,16028,6.6,17803,217,54,-1256,-914,27.1,1602.8,15,3,1,6,5,8,0,0,0,0,17284,7.2,18717,204,66,1256,914,27.0,1728.4
4826711217,0,14,2,1,4,4,1,1,1,0,0,16569,7.2,19303,246,64,-86,347,31.0,1656.9,12,0,0,4,4,5,0,0,0,0,16655,7.0,18956,233,60,86,-347,29.3,1665.5
4783788961,1,10,1,1,11,2,9,1,1,0,0,18618,7.2,18837,236,52,5125,1537,28.8,1861.8,10,0,0,1,10,0,0,0,0,0,13493,6.6,17300,184,52,-5125,-1537,23.6,1349.3
4783764114,0,44,1,0,6,7,7,0,0,0,0,16208,6.8,17182,221,49,-1678,-2263,27.0,1620.8,101,16,1,6,5,4,1,0,1,0,17886,7.4,19445,215,67,1678,2263,28.2,1788.6
4783752788,0,13,2,0,8,13,9,0,0,0,0,16944,6.4,15442,136,47,-3824,-2487,18.3,1694.4,16,0,1,13,8,12,0,0,0,0,20768,7.0,17929,195,44,3824,2487,23.9,2076.8
4782813309,1,52,0,0,1,4,2,0,0,0,0,16401,7.4,19263,241,55,756,2003,29.6,1640.1,14,0,1,4,1,2,1,1,0,0,15645,6.6,17260,216,56,-756,-2003,27.2,1564.5
4782768272,0,58,1,1,7,4,7,1,1,0,0,17970,6.8,18005,235,55,1647,-806,29.0,1797.0,31,12,0,4,7,4,1,0,1,0,16323,7.0,18811,220,48,-1647,806,26.8,1632.3
4768948853,0,13,1,1,7,7,7,0,0,0,0,17839,6.8,16694,215,44,-792,-1493,25.9,1783.9,8,1,0,7,7,6,0,0,0,0,18631,7.0,18187,181,52,792,1493,23.3,1863.1
4768905640,0,12,0,1,5,4,3,2,1,1,0,17181,7.0,18241,222,59,480,221,28.1,1718.1,12,1,0,4,5,6,0,0,0,0,16701,7.0,18020,231,68,-480,-221,29.9,1670.1
4768078862,1,15,2,1,12,9,4,1,1,0,0,19942,7.4,19073,232,39,2126,2127,27.1,1994.2,13,0,0,9,12,6,0,0,0,0,17816,6.6,16946,221,40,-2126,-2127,26.1,1781.6
4768045754,1,13,2,0,8,3,6,0,0,0,0,18920,7.2,19556,247,64,3025,1833,31.1,1892.0,11,1,1,3,8,3,0,0,0,0,15895,7.0,17723,229,55,-3025,-1833,28.4,1589.5
4767389730,0,14,3,0,2,4,0,0,0,0,0,16720,7.2,19358,235,56,-307,742,29.1,1672.0,22,4,1,4,2,2,1,1,0,0,17027,7.4,18616,232,63,307,-742,29.5,1702.7
4767361466,0,13,0,0,2,4,1,0,0,0,0,15945,7.2,18792,256,57,-1526,-160,31.3,1594.5,16,4,1,4,2,5,1,1,0,0,17471,7.2,18952,248,62,1526,160,31.0,1747.1
4767308909,0,12,0,0,4,3,3,0,0,0,0,15730,7.0,17998,206,52,-887,396,25.8,1573.0,13,1,1,3,4,3,1,1,0,0,16617,6.8,17602,223,52,887,-396,27.5,1661.7
4767256479,0,11,5,1,5,3,7,1,1,0,0,16552,6.8,17257,214,40,929,-1098,25.4,1655.2,15,2,0,3,5,0,0,0,0,0,15623,7.0,18355,196,64,-929,1098,26.0,1562.3
4765643703,0,13,0,0,7,10,9,0,0,0,0,18200,7.0,17871,226,40,-1465,-1343,26.6,1820.0,11,1,1,10,7,8,1,1,0,0,19665,7.2,19214,227,64,1465,1343,29.1,1966.5
4765616627,0,18,2,0,3,8,1,1,0,1,0,15770,6.8,17915,206,56,-3375,-1012,26.2,1577.0,14,2,1,8,3,11,0,0,0,0,19145,6.8,18927,233,48,3375,1012,28.1,1914.5
4765598259,1,13,1,1,4,1,4,0,0,0,0,16469,7.2,18630,220,57,3030,2060,27.7,1646.9,12,0,0,1,4,1,1,1,0,0,13439,6.8,16570,198,46,-3030,-2060,24.4,1343.9
4747643723,0,18,1,0,1,8,1,1,0,1,0,15742,6.6,16854,190,40,-1670,-1610,23.0,1574.2,18,0,1,8,1,7,0,0,0,0,17412,7.2,18464,225,55,1670,1610,28.0,1741.2
4747606154,1,14,0,0,4,8,2,0,0,0,0,14581,6.8,17462,203,56,-3536,-1788,25.9,1458.1,14,1,1,8,4,8,1,1,0,0,18117,7.2,19250,251,52,3536,1788,30.3,1811.7
4858034195,1,36,0,1,10,7,10,1,1,0,0,20032,7.0,19099,250,51,2242,1594,30.1,2003.2,8,10,0,7,10,7,0,0,0,0,17790,7.0,17505,190,60,-2242,-1594,25.0,1779.0
4857876014,0,11,2,1,3,2,3,0,0,0,0,15199,6.6,17202,214,52,-852,-2239,26.6,1519.9,24,0,0,2,3,3,1,1,0,0,16051,7.2,19441,238,76,852,2239,31.4,1605.1
4857855377,1,14,3,1,8,3,8,1,1,0,0,18943,7.2,18791,232,64,2850,1104,29.6,1894.3,14,2,0,3,8,2,0,0,0,0,16093,6.8,17687,193,63,-2850,-1104,25.6,1609.3
4857813588,1,13,15,1,7,2,10,1,1,0,0,17965,7.2,18768,223,58,2893,448,28.1,1796.5,41,2,0,2,7,1,1,0,1,0,15072,7.0,18320,227,64,-2893,-448,29.1,1507.2
4857803208,0,79,1,1,4,9,3,1,0,1,0,15315,7.0,18221,183,66,-3541,-437,24.9,1531.5,11,1,0,9,4,7,0,0,0,0,18856,7.0,18658,226,60,3541,437,28.6,1885.6
4856873697,0,11,1,0,0,4,0,0,0,0,0,13668,6.8,18034,223,60,-4816,-2093,28.3,1366.8,12,1,1,4,0,8,2,1,1,0,18484,7.4,20127,262,60,4816,2093,32.2,1848.4
4856851684,0,11,1,0,5,6,5,0,0,0,0,16357,7.0,18303,227,56,-833,-459,28.3,1635.7,16,1,1,6,5,7,2,1,1,0,17190,7.2,18762,232,68,833,459,30.0,1719.0
4855878316,0,12,15,0,6,9,6,1,1,0,0,16707,6.6,16831,193,48,-2206,-1219,24.1,1670.7,37,0,1,9,6,6,1,0,1,0,18913,7.0,18050,219,52,2206,1219,27.1,1891.3
4855852753,1,15,0,1,3,3,3,0,0,0,0,15443,6.8,17823,220,56,-886,-1240,27.6,1544.3,12,2,0,3,3,4,0,0,0,0,16329,7.2,19063,243,70,886,1240,31.3,1632.9
4855817455,0,111,3,0,3,7,3,0,0,0,0,15862,6.8,16883,258,36,-2441,-19,29.4,1586.2,15,2,1,7,3,16,0,0,0,0,18303,6.6,16902,217,40,2441,19,25.7,1830.3
4855704783,1,11,2,1,5,2,5,0,0,0,0,16912,7.2,19055,230,68,752,172,29.8,1691.2,11,2,0,2,5,3,0,0,0,0,16160,7.2,18883,258,64,-752,-172,32.2,1616.0
4855682221,1,11,2,0,4,3,3,0,0,0,0,15977,6.8,17791,234,38,712,-494,27.2,1597.7,18,2,1,3,4,4,1,1,0,0,15265,6.8,18285,172,92,-712,494,26.4,1526.5
4855668233,1,14,2,1,5,5,4,1,0,1,0,16233,6.6,16966,206,56,531,405,26.2,1623.3,12,1,0,5,5,6,1,1,0,0,15702,6.6,16561,177,56,-531,-405,23.3,1570.2
4855629381,0,33,0,0,5,4,6,1,1,0,0,17008,6.6,17423,208,48,502,-525,25.6,1700.8,8,9,1,4,5,2,0,0,0,0,16506,7.0,17948,207,56,-502,525,26.3,1650.6
4852526903,1,7,0,1,20,24,20,0,0,0,0,63050,12.6,59500,0,0,23400,20520,0.0,6305.0,0,0,0,14,10,14,0,0,0,0,39650,8.0,38980,0,0,-23400,-20520,0.0,3965.0
4852505255,1,0,0,1,14,21,12,0,0,0,0,45300,10.0,47500,1,0,16660,19000,0.1,4530.0,0,0,0,13,6,15,0,0,0,0,28640,6.0,28500,1,0,-16660,-19000,0.1,2864.0
4852491111,1,7,0,1,16,13,12,0,0,0,0,46700,10.0,47500,0,0,18500,17500,0.0,4670.0,0,0,0,10,13,10,0,0,0,0,28200,6.4,30000,0,0,-18500,-17500,0.0,2820.0
4852475351,1,93,0,1,18,15,19,0,0,0,0,62033,12.0,55000,0,0,25527,22000,0.0,6203.3,0,0,0,9,12,8,0,0,0,0,36506,7.2,33000,0,0,-25527,-22000,0.0,3650.6
4852459223,1,0,0,0,21,15,21,0,0,0,0,47350,10.0,47500,0,0,19500,19000,0.0,4735.0,0,0,1,9,15,11,0,0,0,0,27850,6.0,28500,0,0,-19500,-19000,0.0,2785.0
4852438054,1,15,1,0,11,10,11,1,1,0,0,19779,7.4,20124,230,52,963,2134,28.2,1977.9,12,2,1,10,11,18,0,0,0,0,18816,7.0,17990,219,56,-963,-2134,27.5,1881.6
4841730302,1,32,0,0,4,4,3,0,0,0,0,14482,6.4,15680,197,44,-2681,-2772,24.1,1448.2,34,1,1,4,4,2,0,0,0,0,17163,7.0,18452,225,50,2681,2772,27.5,1716.3
4839209083,1,9,0,0,2,7,0,0,0,0,0,14760,6.8,16745,206,64,-2379,-2248,27.0,1476.0,11,0,1,7,2,1,0,0,0,0,17139,7.2,18993,228,64,2379,2248,29.2,1713.9
4837872160,0,17,3,0,8,10,11,0,0,0,0,18938,6.8,17470,194,56,722,-656,25.0,1893.8,16,1,1,10,8,11,1,1,0,0,18216,7.0,18126,206,60,-722,656,26.6,1821.6
4837840912,0,6,1,1,6,7,6,0,0,0,0,16866,6.8,16828,197,44,-933,-1450,24.1,1686.6,10,0,0,7,6,4,0,0,0,0,17799,7.0,18278,227,56,933,1450,28.3,1779.9
4837801452,1,15,1,0,5,2,3,0,0,0,0,18226,7.2,19374,235,68,2339,1225,30.3,1822.6,12,2,1,2,5,4,2,1,1,0,15887,7.0,18149,227,64,-2339,-1225,29.1,1588.7
4835681850,0,29,0,1,5,2,3,0,0,0,0,17424,6.8,16944,224,48,2742,-1029,27.2,1742.4,30,0,0,2,5,1,0,0,0,0,14682,7.0,17973,190,60,-2742,1029,25.0,1468.2
4834778174,1,12,2,1,5,2,7,0,0,0,0,16609,7.0,18127,220,63,1977,1488,28.3,1660.9,16,1,0,2,5,1,0,0,0,0,14632,6.8,16639,199,60,-1977,-1488,25.9,1463.2
4834749266,1,11,2,0,9,3,7,1,1,0,0,17885,7.2,18338,223,61,3180,618,28.4,1788.5,231,0,1,3,9,1,0,0,0,0,14705,6.8,17720,202,51,-3180,-618,25.3,1470.5
4829410939,1,11,0,0,6,3,4,1,1,0,0,16705,7.0,18326,197,67,1477,733,26.4,1670.5,52,0,1,3,6,4,1,0,1,0,15228,7.0,17593,224,40,-1477,-733,26.4,1522.8
4826343837,0,14,2,0,5,5,3,0,0,0,0,15998,6.6,17528,199,50,-674,944,24.9,1599.8,11,1,1,5,5,3,1,0,1,0,16672,6.6,16584,212,38,674,-944,25.0,1667.2
4826319976,0,21,0,1,13,15,33,0,0,0,0,32345,10.2,34917,111,0,-2281,-2950,11.1,3234.5,0,4,0,15,13,30,0,0,0,0,34626,10.8,37867,107,0,2281,2950,10.7,3462.6
4824630805,0,2,0,0,12,23,23,0,0,0,1,32764,10.4,36358,95,0,-5292,-5454,9.5,3276.4,0,0,1,23,12,46,0,0,0,0,38056,11.4,41812,107,0,5292,5454,10.7,3805.6
4824564560,0,15,1,1,4,5,4,0,0,0,0,14693,6.8,17416,164,52,-1815,-2183,21.6,1469.3,44,5,0,5,4,3,2,1,1,0,16508,7.2,19599,236,52,1815,2183,28.8,1650.8
4824535067,0,13,0,1,8,8,3,0,0,0,0,18046,7.2,18627,227,64,1661,1147,29.1,1804.6,12,1,0,8,8,6,0,0,0,0,16385,6.8,17480,189,48,-1661,-1147,23.7,1638.5
4824513906,1,13,2,0,5,6,3,1,1,0,0,16837,7.0,18384,214,60,1257,1483,27.4,1683.7,14,0,1,6,5,7,0,0,0,0,15580,6.8,16901,190,33,-1257,-1483,22.3,1558.0
4824477911,0,14,0,1,8,11,2,0,0,0,0,17694,6.6,17339,181,48,-822,-851,22.9,1769.4,11,0,0,11,8,5,0,0,0,0,18516,7.0,18190,197,52,822,851,24.9,1851.6
4822787234,1,14,1,1,18,12,45,0,0,0,1,34965,10.4,36135,127,0,2921,2075,12.7,3496.5,12,0,0,12,18,15,0,0,0,0,32044,10.0,34060,77,0,-2921,-2075,7.7,3204.4
4822772208,0,9,1,0,11,27,29,0,0,0,0,30305,10.2,33247,58,59,-7842,-6457,11.7,3030.5,35,0,1,27,11,72,0,0,0,0,38147,11.2,39704,65,51,7842,6457,11.6,3814.7
4822728117,0,11,2,0,1,3,3,0,0,0,0,14388,7.0,18174,223,48,-1963,-768,27.1,1438.8,12,6,1,3,1,3,2,1,1,0,16351,7.0,18942,272,60,1963,768,33.2,1635.1
4822694621,1,11,3,0,5,5,5,0,0,0,0,16250,6.6,17183,191,48,160,177,23.9,1625.0,18,2,1,5,5,9,1,1,0,0,16090,6.8,17006,181,62,-160,-177,24.3,1609.0
4846281563,0,20,3,0,6,3,3,0,0,0,0,16053,7.2,19123,220,56,941,1530,27.6,1605.3,13,3,1,3,6,3,0,0,0,0,15112,6.8,17593,220,60,-941,-1530,28.0,1511.2
4846263753,1,14,2,1,5,0,5,1,1,0,0,15980,7.2,18454,212,56,2723,2075,26.8,1598.0,8,1,0,0,5,0,0,0,0,0,13257,6.6,16379,206,48,-2723,-2075,25.4,1325.7
4840541932,1,25,0,1,28,21,63,0,0,0,1,39072,11.2,40421,125,0,3270,726,12.5,3907.2,49,19,0,21,28,45,0,0,0,0,35802,11.2,39695,85,0,-3270,-726,8.5,3580.2
4809547719,0,40,0,1,7,8,5,1,0,1,0,17315,6.8,17504,218,45,-770,-1518,26.3,1731.5,31,0,0,8,7,7,0,0,0,0,18085,7.4,19022,191,50,770,1518,24.1,1808.5
4808258300,0,15,2,1,8,10,4,0,0,0,0,17265,7.0,18419,182,64,-331,1258,24.6,1726.5,12,1,0,10,8,9,0,0,0,0,17596,6.8,17161,185,43,331,-1258,22.8,1759.6
4808232770,1,17,2,1,9,5,3,2,1,1,0,18192,7.0,17969,201,64,1648,17,26.5,1819.2,22,0,0,5,9,8,0,0,0,0,16544,7.0,17952,196,44,-1648,-17,24.0,1654.4
4808198326,1,21,2,1,3,5,3,0,0,0,0,14819,6.6,16648,208,51,-1127,-758,25.9,1481.9,13,0,0,5,3,9,1,0,1,0,15946,7.0,17406,214,44,1127,758,25.8,1594.6
4800028818,0,0,2,1,34,17,98,0,0,0,0,40359,11.8,45850,111,0,5528,7709,11.1,4035.9,11,0,0,17,34,33,0,0,0,0,34831,11.0,38141,96,0,-5528,-7709,9.6,3483.1
4800012213,1,0,0,0,35,24,85,0,0,0,1,41363,12.2,47576,130,0,4374,6626,13.0,4136.3,2,0,1,24,35,47,0,0,0,0,36989,11.2,40950,96,0,-4374,-6626,9.6,3698.9
4794831780,0,11,0,0,0,5,0,0,0,0,0,12106,6.2,14097,165,52,-5843,-4811,21.7,1210.6,12,0,1,5,0,5,1,1,0,0,17949,7.2,18908,242,67,5843,4811,30.9,1794.9
4768822067,1,9,2,1,5,7,0,0,0,0,0,17312,7.2,20082,234,72,345,2088,30.6,1731.2,16,2,0,7,5,8,1,1,0,0,16967,7.0,17994,198,56,-345,-2088,25.4,1696.7
4768800256,1,15,4,1,9,3,10,0,0,0,0,19032,7.0,18937,244,43,2351,1690,28.7,1903.2,19,2,0,3,9,4,0,0,0,0,16681,6.6,17247,234,52,-2351,-1690,28.6,1668.1
4768774286,0,13,2,0,3,7,3,0,0,0,0,16063,6.8,17321,220,56,-2112,-1619,27.6,1606.3,19,2,1,7,3,8,1,0,1,0,18175,7.4,18940,206,48,2112,1619,25.4,1817.5
4768727458,0,85,1,0,5,3,2,2,1,1,0,16761,6.8,17878,226,60,1832,669,28.6,1676.1,102,2,1,3,5,4,0,0,0,0,14929,6.6,17209,213,52,-1832,-669,26.5,1492.9
4768692943,1,9,3,1,16,3,10,1,1,0,0,21279,7.2,19172,205,56,7917,4596,26.1,2127.9,14,0,0,3,16,3,0,0,0,0,13362,6.2,14576,135,48,-7917,-4596,18.3,1336.2
4768657705,1,13,2,0,5,3,5,0,0,0,0,17831,6.8,17966,215,60,542,-197,27.5,1783.1,10,1,1,3,5,3,1,1,0,0,17289,7.0,18163,237,52,-542,197,28.9,1728.9
4768632525,0,11,1,1,7,3,8,2,1,1,0,20910,7.4,20711,271,76,5456,2224,34.7,2091.0,16,4,0,2,6,2,0,0,0,0,15454,6.8,18487,221,56,-5456,-2224,27.7,1545.4
4768619149,1,14,2,0,10,4,9,1,1,0,0,18913,7.0,18848,221,60,3591,3661,28.1,1891.3,20,0,1,4,10,4,0,0,0,0,15322,6.2,15187,211,31,-3591,-3661,24.2,1532.2
4768590593,1,14,2,1,11,10,10,0,0,0,0,19973,7.2,18582,242,55,1039,758,29.7,1997.3,20,2,0,10,11,11,0,0,0,0,18934,6.8,17824,200,56,-1039,-758,25.6,1893.4
4857111528,0,14,3,1,5,1,9,0,0,0,0,16701,7.0,17473,253,46,615,257,29.9,1670.1,14,1,0,1,5,2,0,0,0,0,16086,6.8,17216,247,54,-615,-257,30.1,1608.6
4857088799,1,19,0,0,5,6,6,1,1,0,0,16507,6.4,16584,200,44,14,-739,24.4,1650.7,14,2,1,6,5,7,0,0,0,0,16493,7.0,17323,197,48,-14,739,24.5,1649.3
4857051776,0,22,1,0,4,7,3,0,0,0,0,15590,7.2,18276,201,52,-1926,-348,25.3,1559.0,14,4,1,7,4,6,1,1,0,0,17516,7.2,18624,234,56,1926,348,29.0,1751.6
4776615261,0,15,4,1,4,4,3,1,1,0,0,17620,7.0,18261,257,49,1653,-85,30.6,1762.0,14,2,0,4,4,4,1,0,1,0,15967,7.0,18346,218,71,-1653,85,28.9,1596.7
4776605411,0,13,1,0,8,6,12,0,0,0,0,16953,6.8,16581,195,57,-1454,-1514,25.2,1695.3,9,2,1,6,8,10,1,1,0,0,18407,6.8,18095,227,51,1454,1514,27.8,1840.7
4776595538,1,36,2,1,14,6,11,1,1,0,0,22792,7.4,20563,236,56,5676,3060,29.2,2279.2,34,2,0,6,14,4,0,0,0,0,17116,7.0,17503,217,52,-5676,-3060,26.9,1711.6
4758412835,0,86,1,1,4,8,5,0,0,0,0,15866,6.6,16508,229,47,-2365,-1466,27.6,1586.6,15,2,0,8,4,8,1,1,0,0,18231,7.0,17974,229,55,2365,1466,28.4,1823.1
4758396684,0,14,1,0,4,9,3,0,0,0,0,14492,6.6,16491,174,56,-5937,-542,23.0,1449.2,13,2,1,9,4,15,0,0,0,0,20429,6.6,17033,187,52,5937,542,23.9,2042.9
4758385660,0,14,0,0,1,4,1,0,0,0,0,14418,6.8,17291,215,42,-3332,-2432,25.7,1441.8,13,0,1,4,1,3,2,1,1,0,17750,7.4,19723,229,74,3332,2432,30.3,1775.0
4757811737,0,48,0,0,4,3,3,0,0,0,0,16859,7.2,18763,216,59,170,-580,27.5,1685.9,16,1,1,3,4,3,1,1,0,0,16689,7.4,19343,255,56,-170,580,31.1,1668.9
4757777150,0,14,3,0,6,5,10,0,0,0,0,17331,7.0,17547,236,68,1136,953,30.4,1733.1,14,2,1,5,6,9,0,0,0,0,16195,6.8,16594,223,40,-1136,-953,26.3,1619.5
4708702559,1,16,0,1,14,2,9,0,0,0,0,20896,7.4,20061,230,68,6696,4370,29.8,2089.6,13,0,0,2,14,2,0,0,0,0,14200,6.4,15691,161,52,-6696,-4370,21.3,1420.0
4695230549,1,120,1,1,7,7,3,0,0,0,0,16959,7.2,18926,230,68,253,700,29.8,1695.9,23,2,0,7,7,2,1,1,0,0,16706,7.0,18226,198,43,-253,-700,24.1,1670.6
4695195930,0,14,0,0,0,4,0,0,0,0,0,13224,6.4,16031,205,39,-5650,-3706,24.4,1322.4,12,0,1,4,0,1,1,1,0,0,18874,7.4,19737,253,67,5650,3706,32.0,1887.4
4689828195,1,11,1,1,8,3,11,1,1,0,0,18560,7.0,18076,234,56,3101,1599,29.0,1856.0,19,1,0,3,8,4,0,0,0,0,15459,6.6,16477,169,68,-3101,-1599,23.7,1545.9
4689378762,0,34,1,1,3,8,5,0,0,0,0,15713,7.0,17782,230,52,-2710,-1111,28.2,1571.3,37,2,0,8,3,8,0,0,0,0,18423,7.2,18893,231,60,2710,1111,29.1,1842.3
4681948295,0,17,2,0,3,11,4,0,0,0,0,14648,6.4,15786,177,50,-4556,-3115,22.7,1464.8,12,0,1,11,3,7,0,0,0,0,19204,7.2,18901,232,56,4556,3115,28.8,1920.4
4679783734,1,13,1,0,7,6,9,0,0,0,0,17656,6.8,17005,218,44,694,-916,26.2,1765.6,16,1,1,6,7,3,1,1,0,0,16962,6.8,17921,219,59,-694,916,27.8,1696.2
4679771341,0,14,2,0,2,7,3,0,0,0,0,15815,7.0,18257,250,60,-3511,-1403,31.0,1581.5,12,5,1,7,2,10,1,1,0,0,19326,7.4,19660,253,72,3511,1403,32.5,1932.6
4791828662,1,11,1,1,7,4,5,1,1,0,0,16784,7.0,18046,220,56,804,1279,27.6,1678.4,24,1,0,4,7,1,0,0,0,0,15980,6.6,16767,214,52,-804,-1279,26.6,1598.0
4783077795,1,16,0,0,5,9,4,1,0,1,0,16098,6.6,17127,191,56,-3812,75,24.7,1609.8,15,1,1,9,5,9,0,0,0,0,19910,6.6,17052,226,48,3812,-75,27.4,1991.0
4783056349,1,80,3,1,7,4,6,0,0,0,0,17514,7.0,18508,209,52,1629,-100,26.1,1751.4,16,4,0,4,7,2,0,0,0,0,15885,7.2,18608,197,52,-1629,100,24.9,1588.5
4783046236,1,208,2,0,9,13,17,0,0,0,0,18893,6.8,16978,205,44,-562,12,24.9,1889.3,14,2,1,13,9,16,0,0,0,0,19455,6.8,16966,191,59,562,-12,25.0,1945.5
4782705512,1,11,3,0,5,6,7,0,0,0,0,17554,6.8,17374,217,59,701,1069,27.6,1755.4,45,1,1,6,5,9,2,1,1,0,16853,6.8,16305,196,52,-701,-1069,24.8,1685.3
4782668962,0,16,0,1,14,9,14,0,0,0,0,20743,6.8,17350,201,37,2750,-472,23.8,2074.3,12,2,0,9,14,8,0,0,0,0,17993,7.0,17822,207,54,-2750,472,26.1,1799.3
4782638686,1,16,1,1,9,2,8,0,0,0,0,18293,7.2,18512,199,51,3423,1800,25.0,1829.3,13,3,0,2,9,3,0,0,0,0,14870,6.6,16712,201,68,-3423,-1800,26.9,1487.0
4782603666,1,13,1,1,8,5,11,0,0,0,0,19581,6.8,18290,235,52,2918,479,28.7,1958.1,15,1,0,5,8,6,1,1,0,0,16663,6.6,17811,197,60,-2918,-479,25.7,1666.3
4781832706,0,13,0,0,6,11,8,0,0,0,0,16239,6.8,17651,182,52,-3525,-899,23.4,1623.9,13,1,1,11,6,14,1,1,0,0,19764,7.0,18550,224,55,3525,899,27.9,1976.4
4764505901,1,15,1,1,2,4,1,0,0,0,0,15719,7.0,18422,248,60,-1295,-65,30.8,1571.9,110,1,0,4,2,6,0,0,0,0,17014,7.2,18487,219,66,1295,65,28.5,1701.4
4763160074,0,15,2,1,8,2,4,0,0,0,0,17806,6.8,17678,213,49,3475,1697,26.2,1780.6,14,2,0,2,8,2,1,1,0,0,14331,6.6,15981,186,63,-3475,-1697,24.9,1433.1
4763123419,1,14,2,1,7,2,6,1,0,1,0,18004,7.4,18655,205,61,1927,255,26.6,1800.4,11,0,0,2,7,1,1,1,0,0,16077,7.0,18400,239,56,-1927,-255,29.5,1607.7
4763044770,1,10,1,1,6,7,7,0,0,0,0,17392,6.6,16562,165,54,-1416,-1916,21.9,1739.2,13,1,0,7,6,3,0,0,0,0,18808,7.0,18478,254,44,1416,1916,29.8,1880.8
4763010778,0,14,1,0,1,6,1,1,1,0,0,15093,6.8,16959,197,56,-2392,-2163,25.3,1509.3,12,1,1,6,1,5,1,0,1,0,17485,7.4,19122,260,55,2392,2163,31.5,1748.5
4762855184,1,42,2,0,5,4,5,1,1,0,0,16918,7.2,18529,231,60,325,1271,29.1,1691.8,15,20,1,4,5,5,0,0,0,0,16593,6.8,17258,203,64,-325,-1271,26.7,1659.3
4760909568,1,9,5,1,6,2,4,0,0,0,0,16889,7.2,19463,217,64,803,1114,28.1,1688.9,19,1,0,2,6,3,0,0,0,0,16086,7.2,18349,228,55,-803,-1114,28.3,1608.6
4757302357,1,13,3,0,10,6,15,0,0,0,0,18896,6.8,17592,242,44,1896,54,28.6,1889.6,16,1,1,6,10,5,0,0,0,0,17000,7.0,17538,222,56,-1896,-54,27.8,1700.0
4755443120,1,13,15,0,4,2,6,2,1,1,0,15813,6.6,17500,218,52,1004,880,27.0,1581.3,42,1,1,2,4,2,0,0,0,0,14809,6.6,16620,198,48,-1004,-880,24.6,1480.9
4752141216,0,12,2,1,4,6,3,0,0,0,0,14866,6.8,17036,214,40,-2575,-1409,25.4,1486.6,19,2,0,6,4,7,1,1,0,0,17441,7.2,18445,224,48,2575,1409,27.2,1744.1
4752105365,0,13,1,0,6,8,4,0,0,0,0,16583,7.0,18173,225,55,-1029,228,28.0,1658.3,14,1,1,8,6,6,1,1,0,0,17612,6.8,17945,226,58,1029,-228,28.4,1761.2
4848915720,1,12,0,1,5,3,5,0,0,0,0,17109,7.0,18748,244,72,1160,1192,31.6,1710.9,23,2,0,3,5,5,0,0,0,0,15949,6.8,17556,185,53,-1160,-1192,23.8,1594.9
4848864095,1,11,1,1,8,7,10,0,0,0,0,17766,7.0,18011,212,52,1800,1367,26.4,1776.6,15,1,0,7,8,3,0,0,0,0,15966,6.6,16644,205,52,-1800,-1367,25.7,1596.6
4844273100,1,9,2,0,11,12,10,0,0,0,0,19231,6.8,18737,181,56,-1048,784,23.7,1923.1,12,0,1,12,11,9,0,0,0,0,20279,7.0,17953,217,48,1048,-784,26.5,2027.9
4844215159,0,14,8,0,5,3,5,1,0,1,0,16651,7.2,18529,226,55,1592,-179,28.1,1665.1,34,2,1,3,5,0,1,1,0,0,15059,7.0,18708,198,72,-1592,179,27.0,1505.9
4844174234,0,12,3,1,4,5,3,0,0,0,0,16144,6.8,16668,210,44,3,-1241,25.4,1614.4,17,1,0,5,4,7,1,1,0,0,16141,6.8,17909,202,38,-3,1241,24.0,1614.1
4843396230,0,12,2,0,3,5,3,0,0,0,0,14898,7.0,18040,204,52,-2096,-219,25.6,1489.8,15,1,1,5,3,7,1,0,1,0,16994,7.2,18259,224,58,2096,219,28.2,1699.4
4843353380,1,17,2,1,9,2,12,1,1,0,0,17576,7.2,18088,198,45,144,996,24.3,1757.6,14,3,0,2,9,2,0,0,0,0,17432,6.6,17092,187,55,-144,-996,24.2,1743.2
4843316493,0,10,0,1,5,7,8,0,0,0,0,14961,6.4,15635,165,49,-2966,-3200,21.4,1496.1,10,1,0,7,5,5,1,1,0,0,17927,7.0,18835,273,56,2966,3200,32.9,1792.7
4843258708,0,9,0,0,2,7,1,1,0,1,0,15795,6.8,18580,211,64,-1751,-1198,27.5,1579.5,13,1,1,7,2,7,1,1,0,0,17546,7.6,19778,219,63,1751,1198,28.2,1754.6
4843241964,0,14,1,1,6,6,5,0,0,0,0,15345,6.6,16139,166,54,-2769,-2307,22.0,1534.5,12,0,0,6,6,9,1,1,0,0,18114,7.2,18446,225,57,2769,2307,28.2,1811.4
4829943691,0,11,1,1,6,9,6,0,0,0,0,16657,6.6,16767,206,36,-2214,-833,24.2,1665.7,18,2,0,9,6,10,0,0,0,0,18871,7.0,17600,221,48,2214,833,26.9,1887.1
4829943885,0,68,1,0,7,13,9,0,0,0,0,17746,6.6,16722,208,52,-2901,-2959,26.0,1774.6,12,3,1,13,7,14,1,1,0,0,20647,7.2,19681,232,58,2901,2959,29.0,2064.7
4828494322,1,8,0,1,5,4,3,0,0,0,0,16914,7.2,18560,233,56,2121,1456,28.9,1691.4,9,0,0,3,4,4,0,0,0,0,14793,6.6,17104,203,52,-2121,-1456,25.5,1479.3
4828459169,0,17,3,0,5,8,4,0,0,0,0,18866,7.0,18928,212,52,1804,1415,26.4,1886.6,11,2,1,8,5,10,1,1,0,0,17062,7.0,17513,177,41,-1804,-1415,21.8,1706.2
4828423073,0,26,1,1,4,2,3,0,0,0,0,15972,7.0,18005,244,48,1886,1072,29.2,1597.2,14,2,0,2,4,3,1,1,0,0,14086,7.0,16933,190,58,-1886,-1072,24.8,1408.6
4827055189,0,11,1,0,3,7,2,0,0,0,0,15032,6.6,16917,201,45,-2289,-1225,24.6,1503.2,13,0,1,7,3,6,1,1,0,0,17321,6.8,18142,211,53,2289,1225,26.4,1732.1
4821365744,1,31,1,1,8,4,16,0,0,0,0,18242,6.4,16579,224,41,3225,1215,26.5,1824.2,12,1,0,4,8,7,1,1,0,0,15017,6.2,15364,181,56,-3225,-1215,23.7,1501.7
4821343518,1,15,0,1,7,5,6,0,0,0,0,17428,7.0,18675,207,59,2038,746,26.6,1742.8,12,2,0,5,7,2,1,1,0,0,15390,7.0,17929,176,76,-2038,-746,25.2,1539.0
4821330305,1,13,1,0,3,7,1,0,0,0,0,16043,7.0,18552,216,56,-829,-468,27.2,1604.3,10,1,1,6,2,7,1,1,0,0,16872,7.2,19020,240,64,829,468,30.4,1687.2
4858157973,1,0,3,1,34,19,83,0,0,0,1,40284,11.8,44843,106,0,5315,8073,10.6,4028.4,9,0,0,19,34,46,0,0,0,0,34969,10.4,36770,94,0,-5315,-8073,9.4,3496.9
4858131865,1,0,0,1,19,25,54,0,0,0,0,36722,11.0,40036,90,0,-1879,-2625,9.0,3672.2,0,0,0,25,19,70,0,0,0,0,38601,11.6,42661,98,0,1879,2625,9.8,3860.1
4858104887,1,0,0,1,32,31,94,0,0,0,1,38906,11.6,44100,80,0,-235,797,8.0,3890.6,0,0,0,31,32,87,0,0,0,0,39141,11.6,43303,96,0,235,-797,9.6,3914.1
4858077368,1,25,0,0,22,16,65,0,0,0,1,36828,11.0,40177,105,0,2145,2188,10.5,3682.8,0,4,1,16,22,33,0,0,0,0,34683,10.6,37989,95,0,-2145,-2188,9.5,3468.3
4857748144,1,0,0,0,10,5,29,0,0,0,0,32653,10.0,33229,118,0,2516,930,11.8,3265.3,0,0,1,5,10,9,0,0,0,0,30137,9.6,32299,106,0,-2516,-930,10.6,3013.7
4857740854,1,0,0,1,20,20,50,0,0,0,0,36409,10.8,38316,98,0,-201,-531,9.8,3640.9,0,0,0,20,20,62,0,0,0,0,36610,11.2,38847,119,0,201,531,11.9,3661.0
4857736011,0,0,0,1,17,26,28,0,0,0,1,35414,10.8,39809,95,0,-2840,-1480,9.5,3541.4,0,0,0,26,17,79,0,0,0,0,38254,11.4,41289,111,0,2840,1480,11.1,3825.4
4857726353,0,39,0,1,9,17,21,0,0,0,1,33576,10.6,35774,107,0,-1252,-2343,10.7,3357.6,34,0,0,17,9,47,0,0,0,0,34828,11.0,38117,94,0,1252,2343,9.4,3482.8
4857683639,1,14,1,1,8,5,5,0,0,0,0,17885,6.6,16774,211,44,1912,108,25.5,1788.5,9,3,0,5,8,6,0,0,0,0,15973,6.8,16666,177,56,-1912,-108,23.3,1597.3
4857673196,0,26,0,0,8,11,12,0,0,0,0,17278,6.2,15614,154,46,-2677,-3570,20.0,1727.8,10,3,1,11,8,10,2,1,1,0,19955,7.2,19184,237,81,2677,3570,31.8,1995.5
4857656998,1,27,1,1,11,6,8,0,0,0,0,19587,7.4,20008,241,60,2524,2800,30.1,1958.7,82,2,0,6,11,5,0,0,0,0,17063,6.6,17208,204,60,-2524,-2800,26.4,1706.3
4857612715,1,19,3,1,1,2,1,0,0,0,0,15084,7.0,18120,230,52,-594,-457,28.2,1508.4,13,3,0,2,1,2,0,0,0,0,15678,7.0,18577,240,67,594,457,30.7,1567.8
4857102456,1,47,1,1,17,20,18,0,0,0,0,47387,12.0,55000,0,0,18682,22000,0.0,4738.7,30,1,0,14,11,11,0,0,0,0,28705,7.2,33000,6,0,-18682,-22000,0.6,2870.5
4857087127,1,0,0,1,8,18,11,0,0,0,0,29945,9.0,40000,0,0,10685,16000,0.0,2994.5,0,0,0,14,4,10,0,0,0,0,19260,5.4,24000,0,0,-10685,-16000,0.0,1926.0
4857071852,1,353,0,1,17,25,17,0,0,0,0,60966,12.2,56000,0,0,22538,23000,0.0,6096.6,0,0,0,15,7,15,0,0,0,0,38428,7.2,33000,3,0,-22538,-23000,0.3,3842.8
4856665854,1,49,0,1,20,18,16,0,0,0,0,64939,12.0,55000,0,0,27030,22000,0.0,6493.9,90,0,0,8,10,11,0,0,0,0,37909,7.2,33000,0,0,-27030,-22000,0.0,3790.9
4856656327,1,0,0,1,19,19,23,0,0,0,0,63400,12.0,55000,0,0,24800,22000,0.0,6340.0,42,0,0,13,13,10,0,0,0,0,38600,7.2,33000,0,0,-24800,-22000,0.0,3860.0
4856649260,1,0,0,1,22,15,21,0,0,0,0,47000,10.0,47500,0,0,17969,19000,0.0,4700.0,0,0,0,6,13,7,0,0,0,0,29031,6.0,28500,0,0,-17969,-19000,0.0,2903.1
4856635084,1,12,1,1,8,4,8,0,0,0,0,17150,6.8,18017,221,54,1651,1076,27.5,1715.0,18,0,0,4,8,2,0,0,0,0,15499,6.6,16941,214,53,-1651,-1076,26.7,1549.9
4856615007,0,17,2,1,6,10,3,0,0,0,0,16788,7.0,17367,191,68,-2039,-681,25.9,1678.8,7,0,0,10,6,7,0,0,0,0,18827,6.8,18048,225,52,2039,681,27.7,1882.7
4857824452,0,32,3,1,13,9,17,0,0,0,0,21560,7.0,19233,220,72,2951,582,29.2,2156.0,31,0,0,9,13,7,0,0,0,0,18609,7.0,18651,232,68,-2951,-582,30.0,1860.9
4856965758,1,14,0,0,5,8,9,0,0,0,0,16111,6.8,17679,222,48,-1208,-680,27.0,1611.1,14,1,1,8,5,8,1,1,0,0,17319,7.0,18359,231,56,1208,680,28.7,1731.9
4852458073,0,18,0,1,9,10,5,0,0,0,0,16022,6.4,16202,148,44,-720,-985,19.2,1602.2,5,0,0,10,9,4,0,0,0,0,16742,6.8,17187,165,54,720,985,21.9,1674.2
4852435129,1,75,0,0,9,7,6,0,0,0,0,16838,6.8,18285,174,60,1196,778,23.4,1683.8,4,0,1,7,9,4,0,0,0,0,15642,6.8,17507,159,52,-1196,-778,21.1,1564.2
4852407691,1,15,1,1,8,3,4,1,1,0,0,16730,7.2,18670,174,52,3045,2465,22.6,1673.0,12,1,0,3,8,2,0,0,0,0,13685,6.6,16205,150,44,-3045,-2465,19.4,1368.5
4846277722,0,7,2,1,6,5,3,0,0,0,0,16750,6.6,18062,233,56,1445,1131,28.9,1675.0,13,1,0,5,6,7,0,0,0,0,15305,6.6,16931,150,48,-1445,-1131,19.8,1530.5
4843567198,1,32,0,0,12,7,8,0,0,0,0,18038,7.0,18765,154,48,2863,2228,20.2,1803.8,27,0,1,7,12,4,1,1,0,0,15175,6.6,16537,147,44,-2863,-2228,19.1,1517.5
4843546808,1,13,0,0,3,9,2,0,0,0,0,14350,6.6,16076,189,48,-1314,-308,23.7,1435.0,10,0,1,9,3,10,0,0,0,0,15664,6.8,16384,126,44,1314,308,17.0,1566.4
4843517478,1,234,0,0,11,10,15,0,0,0,0,18067,6.4,16110,160,36,917,-442,19.6,1806.7,10,0,1,10,11,6,0,0,0,0,17150,6.8,16552,163,40,-917,442,20.3,1715.0
4843488330,0,8,0,0,11,5,8,0,0,0,0,17341,6.4,16552,149,40,1809,-102,18.9,1734.1,12,1,1,5,11,2,0,0,0,0,15532,6.4,16654,163,56,-1809,102,21.9,1553.2
4835820109,0,113,0,1,15,12,18,0,0,0,1,34663,11.4,41431,80,64,657,1367,14.4,3466.3,107,0,0,12,15,12,0,0,0,0,34006,11.2,40064,103,55,-657,-1367,15.8,3400.6
4835802987,1,104,0,1,21,8,32,0,0,0,1,37108,11.0,39386,92,47,6786,5155,13.9,3710.8,12,1,0,8,21,8,0,0,0,0,30322,10.4,34231,78,59,-6786,-5155,13.7,3032.2
4835737662,1,138,0,1,8,2,7,0,0,0,0,16655,6.8,17701,163,48,2655,1447,21.1,1665.5,11,1,0,2,8,3,0,0,0,0,14000,6.6,16254,168,48,-2655,-1447,21.6,1400.0
4835719008,0,15,0,1,11,9,18,1,1,0,0,18176,6.0,13965,138,52,-732,-2069,19.0,1817.6,155,0,0,9,11,8,0,0,0,0,18908,6.4,16034,161,56,732,2069,21.7,1890.8
4835259567,0,12,0,0,4,9,1,0,0,0,0,15398,6.6,16374,166,42,-1621,-1117,20.8,1539.8,10,0,1,9,4,3,2,1,1,0,17019,6.8,17491,158,68,1621,1117,22.6,1701.9
4835236129,1,9,0,0,11,9,7,1,1,0,0,17715,7.2,18605,151,44,420,1907,19.5,1771.5,6,0,1,9,11,9,0,0,0,0,17295,6.8,16698,158,52,-420,-1907,21.0,1729.5
4835211074,0,121,0,0,9,7,5,0,0,0,0,15713,6.6,16644,148,48,732,-1156,19.6,1571.3,5,0,1,7,9,0,1,1,0,0,14981,6.8,17800,146,52,-732,1156,19.8,1498.1
4835174676,0,3,0,0,4,10,1,0,0,0,0,14177,6.4,16349,141,44,-5309,-2223,18.5,1417.7,11,0,1,10,4,8,1,1,0,0,19486,7.2,18572,211,40,5309,2223,25.1,1948.6
4806344894,0,81,0,0,4,4,6,1,0,1,0,16007,7.0,17889,179,68,412,-353,24.7,1600.7,8,0,1,4,4,3,0,0,0,0,15595,7.0,18242,230,60,-412,353,29.0,1559.5
4839996532,1,24,0,0,14,19,31,0,0,0,1,39043,11.4,42726,113,53,2605,1246,16.6,3904.3,9,0,1,19,14,32,0,0,0,0,36438,11.2,41480,110,63,-2605,-1246,17.3,3643.8
4819601471,0,138,2,0,13,8,20,0,0,0,0,33215,11.2,40295,95,75,-11,258,17.0,3321.5,14,1,1,8,13,11,0,0,0,0,33226,11.2,40037,115,50,11,-258,16.5,3322.6
4812872501,0,10,0,0,10,16,13,0,0,0,0,29519,10.4,34423,77,51,-8080,-6708,12.8,2951.9,13,0,1,16,10,19,0,0,0,0,37599,11.4,41131,104,66,8080,6708,17.0,3759.9
4812522873,1,7,0,1,18,19,40,0,0,0,1,38814,10.6,37418,99,45,4838,3960,14.4,3881.4,26,0,0,18,17,25,0,0,0,0,33976,10.2,33458,67,42,-4838,-3960,10.9,3397.6
4810478980,1,12,0,1,6,3,10,1,1,0,0,17168,6.6,17207,215,52,2843,1306,26.7,1716.8,12,0,0,3,6,7,0,0,0,0,14325,6.2,15901,183,56,-2843,-1306,23.9,1432.5
4805930512,0,0,0,1,33,30,70,0,0,0,1,38675,11.8,44676,91,0,-1096,-2124,9.1,3867.5,0,0,0,30,33,69,0,0,0,0,39771,12.0,46800,104,0,1096,2124,10.4,3977.1
4775370165,0,11,0,0,3,5,2,0,0,0,0,16550,7.0,18566,247,56,574,892,30.3,1655.0,14,2,1,5,3,3,1,1,0,0,15976,6.8,17674,193,56,-574,-892,24.9,1597.6
4775321202,1,12,1,0,5,10,4,0,0,0,0,14873,6.4,15994,208,43,-3771,-2906,25.1,1487.3,13,1,1,10,5,7,1,1,0,0,18644,7.2,18900,211,68,3771,2906,27.9,1864.4
4775288948,1,12,0,1,5,4,4,1,1,0,0,16092,7.2,17479,198,58,-1,-517,25.6,1609.2,14,1,0,4,5,3,0,0,0,0,16093,6.8,17996,226,52,1,517,27.8,1609.3
4775264458,1,34,0,1,25,32,58,0,0,0,1,38697,11.4,41574,93,0,-1231,-3198,9.3,3869.7,34,0,0,32,25,89,0,0,0,0,39928,11.8,44772,113,0,1231,3198,11.3,3992.8
4774325947,0,8,0,1,6,9,5,0,0,0,0,16641,6.6,16204,211,40,-867,-1847,25.1,1664.1,11,1,0,9,6,5,1,1,0,0,17508,7.0,18051,201,44,867,1847,24.5,1750.8
4774263452,1,12,2,0,5,5,5,1,1,0,0,16226,7.0,18257,215,56,-1255,153,27.1,1622.6,17,0,1,5,5,3,0,0,0,0,17481,7.2,18104,219,47,1255,-153,26.6,1748.1
4774224127,0,10,1,0,7,12,6,0,0,0,0,17956,6.6,16345,211,53,-1508,-1030,26.4,1795.6,15,2,1,12,7,12,0,0,0,0,19464,6.8,17375,177,58,1508,1030,23.5,1946.4
4774158662,0,15,0,0,6,3,4,1,1,0,0,16841,7.0,18718,207,60,1145,1004,26.7,1684.1,9,1,1,3,6,1,0,0,0,0,15696,7.0,17714,184,64,-1145,-1004,24.8,1569.6
4774021031,0,14,2,0,5,4,3,0,0,0,0,16589,6.8,18010,226,56,393,-272,28.2,1658.9,12,0,1,4,5,4,1,1,0,0,16196,7.0,18282,211,60,-393,272,27.1,1619.6
4773981646,0,13,1,0,11,12,23,0,0,0,0,19872,6.6,17255,196,56,-850,-1107,25.2,1987.2,16,3,1,12,11,15,2,1,1,0,20722,7.0,18362,233,53,850,1107,28.6,2072.2
4773951077,1,17,3,0,7,8,8,1,1,0,0,16857,7.0,16843,215,60,-795,-69,27.5,1685.7,12,2,1,8,7,4,0,0,0,0,17652,6.6,16912,208,44,795,69,25.2,1765.2
4773911316,0,14,2,1,7,5,3,2,1,1,0,17612,7.4,19092,238,56,1474,1913,29.4,1761.2,11,2,0,5,7,5,0,0,0,0,16138,6.8,17179,184,64,-1474,-1913,24.8,1613.8
4856323171,1,5,0,0,20,15,17,0,0,0,0,69000,13.6,65000,0,0,31100,27500,0.0,6900.0,0,0,1,9,14,8,0,0,0,0,37900,7.8,37500,0,0,-31100,-27500,0.0,3790.0
4856306875,1,0,0,1,20,19,26,0,0,0,0,66169,12.6,59500,0,0,27899,22000,0.0,6616.9,0,0,0,12,13,10,0,0,0,0,38270,7.8,37500,0,0,-27899,-22000,0.0,3827.0
4856282002,1,0,0,0,22,16,18,0,0,0,0,66834,12.0,55000,0,0,29954,22000,0.0,6683.4,0,0,1,9,15,11,0,0,0,0,36880,7.2,33000,0,0,-29954,-22000,0.0,3688.0
4856251440,1,0,0,1,19,16,19,0,0,0,0,62350,12.0,55000,0,0,26200,21000,0.0,6235.0,0,0,0,8,11,8,0,0,0,0,36150,7.4,34000,0,0,-26200,-21000,0.0,3615.0
4856222345,1,213,0,1,18,15,18,0,0,0,0,62000,12.0,55000,0,0,25500,18000,0.0,6200.0,0,0,0,8,11,8,0,0,0,0,36500,8.0,37000,0,0,-25500,-18000,0.0,3650.0
4856194709,1,5,0,0,17,18,12,0,0,0,0,47008,10.0,47500,0,0,19858,19000,0.0,4700.8,11,0,1,8,7,10,0,0,0,0,27150,6.0,28500,0,0,-19858,-19000,0.0,2715.0
4813431394,0,14,1,1,7,7,5,0,0,0,0,16348,6.8,17976,204,55,73,609,25.9,1634.8,14,0,0,7,7,8,1,1,0,0,16275,7.0,17367,209,44,-73,-609,25.3,1627.5
4806013987,1,11,0,0,4,4,1,1,1,0,0,15785,7.4,19520,241,76,133,2000,31.7,1578.5,15,1,1,4,4,2,0,0,0,0,15652,7.0,17520,212,51,-133,-2000,26.3,1565.2
4780193519,0,12,0,0,4,8,4,0,0,0,0,15229,6.8,17091,210,45,-2471,-2014,25.5,1522.9,19,2,1,8,4,8,1,1,0,0,17700,7.0,19105,202,75,2471,2014,27.7,1770.0
4779738758,1,17,1,1,11,3,12,0,0,0,0,19902,7.2,19482,194,67,4409,1855,26.1,1990.2,13,0,0,3,11,2,0,0,0,0,15493,7.0,17627,226,52,-4409,-1855,27.8,1549.3
4779703745,1,14,3,1,5,3,4,1,1,0,0,17845,7.4,19699,253,60,2661,2803,31.3,1784.5,18,3,0,3,5,2,0,0,0,0,15184,7.0,16896,223,60,-2661,-2803,28.3,1518.4
4779643305,0,14,1,1,4,4,4,0,0,0,0,16391,6.8,18101,226,64,-154,-835,29.0,1639.1,19,3,0,4,4,4,1,1,0,0,16545,7.0,18936,255,44,154,835,29.9,1654.5
4779094577,0,10,0,0,6,7,4,0,0,0,0,16290,6.6,17694,218,50,-1389,-1418,26.8,1629.0,12,0,1,7,6,4,1,1,0,0,17679,7.2,19112,237,74,1389,1418,31.1,1767.9
4779016082,0,51,0,0,6,10,9,0,0,0,0,16912,6.8,17073,185,67,-2048,-2062,25.2,1691.2,16,1,1,10,6,7,1,1,0,0,18960,7.0,19135,210,79,2048,2062,28.9,1896.0
4778984756,1,12,1,0,8,4,11,0,0,0,0,19397,7.2,18374,212,61,4103,1729,27.3,1939.7,192,0,1,4,8,2,0,0,0,0,15294,6.6,16645,173,52,-4103,-1729,22.5,1529.4
4778846719,0,31,0,0,7,10,7,0,0,0,0,16744,7.0,17311,202,56,-2351,-1321,25.8,1674.4,8,3,1,10,7,10,1,1,0,0,19095,7.0,18632,213,63,2351,1321,27.6,1909.5
4778777592,1,84,2,0,6,5,3,1,1,0,0,17260,7.0,18963,187,60,1413,2096,24.7,1726.0,11,1,1,5,6,3,0,0,0,0,15847,6.8,16867,209,40,-1413,-2096,24.9,1584.7
4778295984,0,11,4,0,7,3,1,0,0,0,0,16387,7.0,18110,205,51,1586,1262,25.6,1638.7,17,0,1,3,7,1,1,1,0,0,14801,6.8,16848,200,48,-1586,-1262,24.8,1480.1
4778183437,1,73,1,1,9,12,10,0,0,0,0,19274,7.4,19067,234,63,284,1248,29.7,1927.4,12,2,0,12,9,17,0,0,0,0,18990,6.8,17819,197,52,-284,-1248,24.9,1899.0
4777951649,0,12,2,1,9,7,8,0,0,0,0,19548,7.2,19260,216,68,2148,2187,28.4,1954.8,14,1,0,7,9,4,1,1,0,0,17400,6.8,17073,202,60,-2148,-2187,26.2,1740.0
4858147120,0,11,0,0,7,6,9,0,0,0,0,16358,7.0,17842,208,48,73,-44,25.6,1635.8,12,1,1,6,7,4,0,0,0,0,16285,6.8,17886,206,72,-73,44,27.8,1628.5
4857584403,1,11,0,1,5,1,2,1,1,0,0,15244,7.0,18406,185,68,1488,1553,25.3,1524.4,12,0,0,1,5,0,0,0,0,0,13756,6.6,16853,224,58,-1488,-1553,28.2,1375.6
4857545842,0,10,0,0,6,6,5,1,1,0,0,16741,6.8,17006,203,47,-962,-1475,25.0,1674.1,13,2,1,6,6,8,0,0,0,0,17703,6.8,18481,217,71,962,1475,28.8,1770.3
4857117431,1,13,3,1,5,1,6,1,0,1,0,18723,7.4,19639,276,60,3531,1991,33.6,1872.3,79,0,0,1,5,1,0,0,0,0,15192,6.8,17648,216,44,-3531,-1991,26.0,1519.2
4857040869,0,14,2,1,5,3,3,1,1,0,0,15814,6.8,17343,209,60,73,-996,26.9,1581.4,11,0,0,3,5,3,0,0,0,0,15741,7.0,18339,228,72,-73,996,30.0,1574.1
4856603719,1,10,1,1,6,3,4,0,0,0,1,18372,7.2,18661,241,48,4435,1921,28.9,1837.2,8,1,0,3,6,2,0,0,0,0,13937,6.8,16740,177,54,-4435,-1921,23.1,1393.7
4856585972,0,9,2,1,5,5,5,2,1,1,0,17608,7.2,18599,204,77,1924,1264,28.1,1760.8,11,2,0,5,5,5,0,0,0,0,15684,6.6,17335,216,46,-1924,-1264,26.2,1568.4
4856556901,0,16,1,1,8,6,3,0,0,0,0,17939,6.6,17387,237,36,1033,-904,27.3,1793.9,11,1,0,6,8,3,1,1,0,0,16906,7.0,18291,195,52,-1033,904,24.7,1690.6
4856416367,0,11,11,1,7,9,2,0,0,0,0,16976,7.2,19381,207,66,-1646,766,27.3,1697.6,36,0,0,9,7,8,1,0,1,0,18622,7.2,18615,236,64,1646,-766,30.0,1862.2
4856279207,1,12,0,1,5,5,1,1,1,0,0,16401,7.2,19034,228,64,-167,801,29.2,1640.1,10,1,0,5,5,5,0,0,0,0,16568,7.0,18233,210,68,167,-801,27.8,1656.8
4856074686,1,11,0,1,7,4,7,0,0,0,0,16906,7.2,18969,214,68,1370,1245,28.2,1690.6,11,0,0,4,7,4,0,0,0,0,15536,6.8,17724,206,64,-1370,-1245,27.0,1553.6
4855988615,1,14,0,1,8,3,10,1,1,0,0,17550,6.6,16388,193,44,2044,-509,23.7,1755.0,16,0,0,3,8,3,0,0,0,0,15506,6.6,16897,174,56,-2044,509,23.0,1550.6
4855869527,1,22,0,1,10,2,9,0,0,0,0,18504,6.8,17575,198,53,2877,-51,25.1,1850.4,12,1,0,2,10,2,0,0,0,0,15627,7.0,17626,226,59,-2877,51,28.5,1562.7
4855497233,1,14,1,0,4,6,2,1,1,0,0,17095,7.4,19940,242,77,489,2052,31.9,1709.5,12,3,1,6,4,9,0,0,0,0,16606,6.8,17888,218,56,-489,-2052,27.4,1660.6
4855346577,0,12,1,1,5,8,0,0,0,0,0,15234,6.8,17799,194,56,-1778,-1748,25.0,1523.4,8,3,0,8,5,2,0,0,0,0,17012,7.2,19547,242,64,1778,1748,30.6,1701.2
4855263234,0,8,0,0,0,3,0,0,0,0,0,15585,6.8,18481,227,56,-704,-1265,28.3,1558.5,13,0,1,3,0,2,2,1,1,0,16289,7.2,19746,198,68,704,1265,26.6,1628.9
4854881689,0,13,1,0,1,5,0,0,0,0,0,15460,7.0,18019,188,55,-1171,453,24.3,1546.0,13,1,1,5,1,4,0,0,0,0,16631,7.0,17566,237,56,1171,-453,29.3,1663.1
4854817196,0,13,0,1,9,8,10,0,0,0,0,20789,7.6,19933,241,60,3657,2879,30.1,2078.9,9,1,0,8,9,9,0,0,0,0,17132,6.8,17054,201,52,-3657,-2879,25.3,1713.2
4854349894,1,12,1,1,5,3,7,0,0,0,0,17131,7.0,18220,219,53,1959,1532,27.2,1713.1,14,0,0,3,5,4,1,1,0,0,15172,6.6,16688,207,48,-1959,-1532,25.5,1517.2
4854302751,0,19,1,0,2,9,1,0,0,0,0,14107,6.4,16666,198,49,-4845,-2735,24.7,1410.7,9,3,1,9,2,9,1,1,0,0,18952,7.2,19401,210,63,4845,2735,27.3,1895.2
4857970282,0,96,3,1,10,6,6,0,0,0,0,17498,7.2,18486,191,54,963,1005,24.5,1749.8,12,0,0,6,10,4,0,0,0,0,16535,6.8,17481,205,47,-963,-1005,25.2,1653.5
4857595641,0,47,1,0,6,11,4,0,0,0,0,15545,6.6,16124,202,40,-2339,-638,24.2,1554.5,20,0,1,11,6,15,0,0,0,0,17884,6.4,16762,188,60,2339,638,24.8,1788.4
4857564984,0,14,1,0,5,9,6,0,0,0,1,16990,6.8,17241,215,40,-804,322,25.5,1699.0,11,0,1,9,5,7,0,0,0,0,17794,6.8,16919,169,52,804,-322,22.1,1779.4
4857539248,1,0,0,0,21,18,28,0,0,0,0,63750,12.0,55000,0,0,26900,22000,0.0,6375.0,4,0,1,14,17,7,0,0,0,0,36850,7.2,33000,0,0,-26900,-22000,0.0,3685.0
4857521376,1,0,0,1,19,19,15,0,0,0,0,47132,10.0,47500,0,0,18914,19000,0.0,4713.2,0,0,0,10,10,11,0,0,0,0,28218,6.0,28500,0,0,-18914,-19000,0.0,2821.8
4857499601,1,115,0,1,22,22,18,0,0,0,0,62700,12.0,55000,0,0,25490,22000,0.0,6270.0,12,1,0,12,12,16,0,0,0,0,37210,7.2,33000,1,0,-25490,-22000,0.1,3721.0
4857472616,1,352,0,1,12,10,11,0,0,0,0,29900,9.0,40025,0,0,12100,16025,0.0,2990.0,0,0,0,6,8,6,0,0,0,0,17800,5.4,24000,0,0,-12100,-16025,0.0,1780.0
4857450064,1,40,7,1,23,22,15,0,0,0,0,49365,10.0,47500,9,0,21135,19000,0.9,4936.5,0,6,0,11,12,11,0,0,0,0,28230,6.0,28500,0,0,-21135,-19000,0.0,2823.0
4857425901,1,18,0,1,17,17,22,0,0,0,0,63255,12.4,57000,0,0,26755,24000,0.0,6325.5,6,0,0,12,12,8,0,0,0,0,36500,7.2,33000,0,0,-26755,-24000,0.0,3650.0
4857397405,1,32,5,1,17,21,8,0,0,0,0,61810,12.0,55000,5,0,22845,22000,0.5,6181.0,0,3,0,10,6,15,0,0,0,0,38965,7.2,33000,0,0,-22845,-22000,0.0,3896.5
4856919183,1,81,11,0,3,4,3,0,0,0,0,15852,7.0,19146,234,68,194,668,30.2,1585.2,35,1,1,4,3,1,0,0,0,0,15658,7.0,18478,236,52,-194,-668,28.8,1565.8
4856891108,1,14,1,0,12,6,11,0,0,0,0,21184,7.6,20739,239,76,4125,2422,31.5,2118.4,18,0,1,6,12,4,0,0,0,0,17059,7.2,18317,225,59,-4125,-2422,28.4,1705.9
4856492347,1,0,0,0,17,20,22,0,0,0,0,64450,12.0,55000,0,0,26200,18000,0.0,6445.0,0,0,1,12,9,10,0,0,0,0,38250,8.0,37000,0,0,-26200,-18000,0.0,3825.0
4856474547,1,41,2,1,15,16,14,0,0,0,0,45785,10.4,49000,9,0,17570,20500,0.9,4578.5,0,2,0,10,9,8,0,0,0,0,28215,6.0,28500,4,0,-17570,-20500,0.4,2821.5
4856455282,1,0,0,1,16,18,20,0,0,0,0,64540,12.0,55000,2,0,24890,22000,0.2,6454.0,0,0,0,13,11,5,0,0,0,0,39650,7.2,33000,0,0,-24890,-22000,0.0,3965.0
4856435819,1,0,0,0,20,14,23,0,0,0,0,62350,12.0,55000,0,0,26900,22000,0.0,6235.0,0,0,1,8,14,5,0,0,0,0,35450,7.2,33000,0,0,-26900,-22000,0.0,3545.0
4856403863,1,34,5,0,17,19,20,0,0,0,0,62850,12.0,55000,6,0,24930,22000,0.6,6285.0,0,4,1,12,10,10,0,0,0,0,37920,7.2,33000,0,0,-24930,-22000,0.0,3792.0
4856369678,1,0,0,0,12,13,14,0,0,0,0,45737,10.2,48680,0,0,18925,20180,0.0,4573.7,252,0,1,9,8,5,0,0,0,0,26812,6.0,28500,0,0,-18925,-20180,0.0,2681.2
4856325380,1,16,0,0,23,28,73,0,0,0,0,37881,11.2,40208,117,0,-1,-1261,11.7,3788.1,0,0,1,28,23,69,0,0,0,0,37882,11.2,41469,105,0,1,1261,10.5,3788.2
4856296237,0,0,0,1,38,30,107,0,0,0,1,40104,12.0,45332,85,0,518,3016,8.5,4010.4,0,0,0,30,38,71,0,0,0,0,39586,11.4,42316,91,0,-518,-3016,9.1,3958.6
4857660672,0,0,0,0,30,39,75,0,0,0,1,39062,11.6,43766,92,0,-2472,-3005,9.2,3906.2,13,0,1,39,30,107,0,0,0,0,41534,12.0,46771,100,0,2472,3005,10.0,4153.4
4856476318,1,0,0,1,14,17,16,0,0,0,0,45600,10.0,47500,0,0,16700,19000,0.0,4560.0,0,0,0,13,10,10,0,0,0,0,28900,6.0,28500,0,0,-16700,-19000,0.0,2890.0
4856451520,1,0,0,1,20,18,18,0,0,0,0,45950,10.0,47500,0,0,18100,19000,0.0,4595.0,5,0,0,8,10,10,0,0,0,0,27850,6.0,28500,0,0,-18100,-19000,0.0,2785.0
4856432048,1,0,0,1,17,13,15,0,0,0,0,46650,10.0,47500,0,0,18100,19000,0.0,4665.0,105,0,0,8,12,8,0,0,0,0,28550,6.0,28500,0,0,-18100,-19000,0.0,2855.0
4856408739,1,0,0,0,19,16,22,0,0,0,0,47700,12.0,55000,0,0,19500,22000,0.0,4770.0,0,0,1,12,15,10,0,0,0,0,28200,7.2,33000,0,0,-19500,-22000,0.0,2820.0
4856373518,1,5,0,1,22,16,24,0,0,0,0,62700,12.0,55000,0,0,25275,22000,0.0,6270.0,0,0,0,7,13,8,0,0,0,0,37425,7.2,33000,0,0,-25275,-22000,0.0,3742.5
4856291038,0,0,0,0,23,39,62,0,0,0,0,39627,11.4,42093,122,0,-1271,-5223,12.2,3962.7,0,0,1,39,23,102,0,0,0,0,40898,12.2,47316,101,0,1271,5223,10.1,4089.8
4856252512,1,0,0,1,32,20,92,0,0,0,1,39606,11.8,44240,126,0,2766,6006,12.6,3960.6,3,0,0,19,31,46,0,0,0,0,36840,10.6,38234,101,0,-2766,-6006,10.1,3684.0
4856204294,1,0,0,1,24,20,62,0,0,0,0,39317,11.4,42432,99,0,3805,4649,9.9,3931.7,25,0,0,20,24,57,0,0,0,0,35512,10.8,37783,98,0,-3805,-4649,9.8,3551.2
4855090019,1,12,0,1,42,39,124,0,0,0,1,43565,12.6,50092,113,0,856,2823,11.3,4356.5,0,2,0,39,42,99,0,0,0,0,42709,12.0,47269,112,0,-856,-2823,11.2,4270.9
4855051806,0,0,2,0,19,21,60,0,0,0,0,37212,11.2,40577,116,0,819,1500,11.6,3721.2,19,0,1,21,19,58,0,0,0,0,36393,11.0,39077,107,0,-819,-1500,10.7,3639.3
4855006296,1,0,2,0,22,24,60,0,0,0,2,39609,11.0,40954,116,0,1325,684,11.6,3960.9,13,0,1,24,22,72,0,0,0,0,38284,11.0,40270,85,0,-1325,-684,8.5,3828.4
4854984978,0,6,0,1,23,22,58,0,0,0,1,37001,11.0,39965,85,0,-763,-12,8.5,3700.1,0,0,0,22,23,60,0,0,0,0,37764,11.0,39977,105,0,763,12,10.5,3776.4
4854934634,1,10,3,1,10,6,10,0,0,0,0,17560,6.6,16855,176,55,881,-740,23.1,1756.0,11,2,0,6,10,4,0,0,0,0,16679,6.8,17595,210,52,-881,740,26.2,1667.9
4854920111,1,0,0,0,29,23,72,0,0,0,1,39863,11.8,44107,117,0,3626,5638,11.7,3986.3,0,0,1,23,29,59,0,0,0,0,36237,11.0,38469,99,0,-3626,-5638,9.9,3623.7
4854894553,1,0,10,1,20,20,62,0,0,0,1,37069,10.6,37278,137,0,2561,-504,13.7,3706.9,46,0,0,20,20,49,0,0,0,0,34508,10.8,37782,101,0,-2561,504,10.1,3450.8
4853624625,0,36,0,0,19,37,42,0,0,0,1,37685,11.0,40295,110,0,-3472,-5265,11.0,3768.5,34,0,1,37,19,109,0,0,0,0,41157,11.8,45560,104,0,3472,5265,10.4,4115.7
4853610831,1,22,0,1,18,37,41,0,0,0,1,37959,11.0,39775,112,0,-1787,-4949,11.2,3795.9,0,2,0,37,18,98,0,0,0,0,39746,12.0,44724,83,0,1787,4949,8.3,3974.6
4853585509,0,1,0,0,25,26,67,0,0,0,1,38932,11.6,43321,128,0,2790,2366,12.8,3893.2,369,0,1,26,25,65,0,0,0,0,36142,11.2,40955,89,0,-2790,-2366,8.9,3614.2
4853563489,1,0,4,0,16,13,20,0,0,0,0,63260,12.0,55000,0,0,32335,22000,0.0,6326.0,32,0,1,9,12,5,0,0,0,0,30925,7.2,33000,3,0,-32335,-22000,0.3,3092.5
4816663716,1,17,1,1,5,4,2,0,0,0,0,16955,6.8,18605,254,55,1709,1841,30.9,1695.5,12,3,0,4,5,2,1,1,0,0,15246,6.4,16764,197,53,-1709,-1841,25.0,1524.6
4816653418,1,15,0,1,10,6,10,0,0,0,0,21363,7.4,20092,251,60,5329,3507,31.1,2136.3,15,1,0,6,10,7,1,1,0,0,16034,6.6,16585,213,56,-5329,-3507,26.9,1603.4
4816632330,1,11,1,1,9,5,7,1,1,0,0,18818,7.2,18423,234,63,2020,1108,29.7,1881.8,10,2,0,5,9,6,0,0,0,0,16798,6.8,17315,209,48,-2020,-1108,25.7,1679.8
4816629950,0,11,3,0,6,16,8,0,0,0,0,16606,6.2,15144,181,44,-5191,-5169,22.5,1660.6,14,2,1,16,6,16,1,1,0,0,21797,7.4,20313,257,80,5191,5169,33.7,2179.7
4816618015,0,15,4,1,9,8,6,0,0,0,0,17945,6.8,17819,214,57,177,347,27.1,1794.5,11,2,0,8,9,6,0,0,0,0,17768,6.8,17472,197,54,-177,-347,25.1,1776.8
4816598484,0,13,3,1,7,9,7,0,0,0,0,18003,6.8,16457,209,32,-1063,-1779,24.1,1800.3,15,0,0,9,7,8,1,1,0,0,19066,7.0,18236,193,44,1063,1779,23.7,1906.6
4816592221,0,16,1,1,10,2,10,0,0,0,0,17437,6.6,17010,204,41,2181,-39,24.5,1743.7,14,0,0,2,10,3,1,1,0,0,15256,6.6,17049,215,48,-2181,39,26.3,1525.6
4816588937,0,11,1,1,7,10,5,0,0,0,0,17594,7.2,18176,237,60,-2140,-961,29.7,1759.4,9,2,0,10,7,11,1,1,0,0,19734,7.0,19137,208,64,2140,961,27.2,1973.4
4816569576,1,12,2,1,14,10,17,1,1,0,0,21194,6.8,17974,187,46,3169,3099,23.3,2119.4,14,0,0,10,14,11,0,0,0,0,18025,6.2,14875,146,42,-3169,-3099,18.8,1802.5
4816554557,1,13,3,0,10,10,13,0,0,0,0,18861,7.0,17088,194,56,302,472,25.0,1886.1,15,0,1,10,10,12,1,0,1,0,18559,6.8,16616,205,44,-302,-472,24.9,1855.9
4816538716,1,14,3,0,10,13,11,0,0,0,0,18677,6.6,17004,208,47,-664,65,25.5,1867.7,13,2,1,13,10,12,0,0,0,0,19341,7.0,16939,187,56,664,-65,24.3,1934.1
4816532193,1,10,0,1,10,4,7,0,0,0,0,19240,6.8,18296,196,53,2943,1377,24.9,1924.0,11,0,0,4,10,4,0,0,0,0,16297,6.6,16919,171,48,-2943,-1377,21.9,1629.7
4795902984,0,13,0,1,4,10,3,0,0,0,0,16833,7.2,18300,214,70,-2169,-2682,28.4,1683.3,10,0,0,10,4,7,0,0,0,0,19002,7.4,20982,205,76,2169,2682,28.1,1900.2
4795878851,1,15,1,0,6,9,5,0,0,0,0,17779,7.2,18607,211,80,2011,1527,29.1,1777.9,7,1,1,9,6,3,0,0,0,0,15768,6.6,17080,182,36,-2011,-1527,21.8,1576.8
4794503969,1,11,2,1,5,4,6,1,0,1,0,16407,6.8,17625,223,65,-531,-401,28.8,1640.7,15,2,0,4,5,2,0,0,0,0,16938,6.8,18026,220,58,531,401,27.8,1693.8
4793763884,1,19,2,1,7,6,6,0,0,0,0,18192,7.0,17825,199,52,875,258,25.1,1819.2,14,5,0,6,7,5,0,0,0,0,17317,6.8,17567,224,48,-875,-258,27.2,1731.7
4773883670,0,9,1,0,31,28,59,0,0,0,2,39116,11.6,43910,98,0,-526,957,9.8,3911.6,219,0,1,28,31,79,0,0,0,0,39642,11.6,42953,108,0,526,-957,10.8,3964.2
4762045855,0,9,2,0,4,8,7,0,0,0,0,15778,6.4,15937,205,44,-3850,-3009,24.9,1577.8,19,3,1,8,4,11,1,1,0,0,19628,7.2,18946,242,76,3850,3009,31.8,1962.8
4761988136,1,19,1,1,11,9,7,0,0,0,0,18608,6.6,17064,215,48,848,426,26.3,1860.8,19,2,0,7,9,8,0,0,0,0,17760,6.6,16638,219,52,-848,-426,27.1,1776.0
4856521323,0,23,0,1,5,5,5,1,1,0,0,15092,6.6,17120,202,42,-1683,3,24.4,1509.2,14,0,0,5,5,6,0,0,0,0,16775,6.8,17117,224,56,1683,-3,28.0,1677.5
4856488103,1,16,2,1,4,2,3,0,0,0,0,15488,6.6,16592,190,52,-353,-871,24.2,1548.8,11,1,0,2,4,1,1,1,0,0,15841,6.6,17463,202,56,353,871,25.8,1584.1
4856256419,1,29,2,0,5,6,2,0,0,0,0,14984,6.8,17256,212,54,-1617,1041,26.6,1498.4,12,3,1,6,5,2,0,0,0,0,16601,6.6,16215,201,37,1617,-1041,23.8,1660.1
4856229199,1,28,1,1,10,2,10,0,0,0,0,18433,7.0,18270,226,59,4339,2095,28.5,1843.3,17,0,0,2,10,1,0,0,0,0,14094,6.6,16175,166,56,-4339,-2095,22.2,1409.4
4856174552,1,21,0,1,7,5,6,0,0,0,0,16679,6.6,17724,230,48,-131,-331,27.8,1667.9,13,1,0,5,7,9,1,1,0,0,16810,7.0,18055,215,72,131,331,28.7,1681.0
4856002946,1,11,0,0,8,2,6,1,1,0,0,16935,6.8,17444,192,45,1603,-31,23.7,1693.5,12,0,1,2,8,0,0,0,0,0,15332,6.8,17475,225,53,-1603,31,27.8,1533.2
4855966308,0,10,0,0,8,6,5,0,0,0,0,17153,7.2,19066,224,70,635,1338,29.4,1715.3,11,0,1,6,8,5,0,0,0,0,16518,6.8,17728,207,51,-635,-1338,25.8,1651.8
4855235585,1,73,1,0,4,3,4,1,1,0,0,16983,7.4,18506,234,63,815,-537,29.7,1698.3,13,0,1,3,4,3,1,0,1,0,16168,7.2,19043,218,72,-815,537,29.0,1616.8
4855177134,0,15,2,1,4,10,3,0,0,0,0,15926,6.4,16831,215,44,-2467,-844,25.9,1592.6,17,3,0,10,4,8,0,0,0,0,18393,7.0,17675,198,40,2467,844,23.8,1839.3
4854940069,1,15,3,1,11,7,14,0,0,0,0,17995,6.6,16490,184,40,2144,1476,22.4,1799.5,28,2,0,7,11,5,0,0,0,0,15851,6.2,15014,177,44,-2144,-1476,22.1,1585.1
4854891413,1,26,2,1,3,2,0,1,0,1,0,15322,6.8,17715,244,44,839,757,28.8,1532.2,11,1,0,2,3,1,1,1,0,0,14483,6.6,16958,225,64,-839,-757,28.9,1448.3
4854627950,1,13,0,1,6,6,9,1,1,0,0,15955,6.4,16369,204,34,-580,-2090,23.8,1595.5,9,1,0,6,6,4,0,0,0,0,16535,7.0,18459,220,78,580,2090,29.8,1653.5
4854611783,1,15,0,1,13,6,9,1,0,1,0,20574,7.4,20293,229,71,3801,2510,30.0,2057.4,13,2,0,6,13,6,1,1,0,0,16773,6.8,17783,206,52,-3801,-2510,25.8,1677.3
4854583946,1,12,2,1,7,2,5,1,1,0,0,18427,7.4,19843,255,60,3889,3469,31.5,1842.7,16,1,0,2,7,3,0,0,0,0,14538,6.6,16374,193,60,-3889,-3469,25.3,1453.8
4853432754,1,13,0,1,7,2,7,0,0,0,0,17669,7.2,19053,212,58,1996,2078,27.0,1766.9,10,0,0,2,7,2,0,0,0,0,15673,6.6,16975,220,49,-1996,-2078,26.9,1567.3
4852916312,0,36,3,1,2,8,2,0,0,0,0,14814,6.6,17274,212,52,-3099,-1480,26.4,1481.4,32,11,0,8,2,6,1,0,1,0,17913,7.0,18754,220,56,3099,1480,27.6,1791.3
4852844850,1,36,1,1,6,3,10,0,0,0,0,16784,6.8,17443,220,54,2110,1017,27.4,1678.4,14,4,0,3,6,4,1,1,0,0,14674,6.4,16426,203,54,-2110,-1017,25.7,1467.4
4852789851,1,19,0,1,8,3,4,0,0,0,0,16769,6.8,17424,189,56,1093,-663,24.5,1676.9,11,0,0,3,8,1,1,1,0,0,15676,7.0,18087,201,54,-1093,663,25.5,1567.6
4852731169,1,26,1,1,9,3,11,0,0,0,0,18437,6.8,17677,214,52,3597,537,26.6,1843.7,44,0,0,3,9,1,1,1,0,0,14840,6.8,17140,203,56,-3597,-537,25.9,1484.0
4849211325,1,20,0,1,4,2,2,0,0,0,0,16329,7.4,19364,243,71,2298,2588,31.4,1632.9,11,0,0,2,4,2,0,0,0,0,14031,6.8,16776,194,44,-2298,-2588,23.8,1403.1
4849178518,0,14,0,1,5,5,6,0,0,0,0,16184,6.4,16138,188,56,892,330,24.4,1618.4,12,1,0,5,5,9,1,1,0,0,15292,6.6,15808,176,64,-892,-330,24.0,1529.2
4848029861,1,11,1,1,13,5,13,1,0,1,0,20757,7.4,19907,210,71,2970,1343,28.1,2075.7,13,3,0,5,13,5,1,1,0,0,17787,7.0,18564,231,52,-2970,-1343,28.3,1778.7
4843207752,0,12,0,1,5,3,3,1,1,0,0,15844,6.8,17546,242,46,493,0,28.8,1584.4,11,2,0,3,5,4,0,0,0,0,15351,6.6,17546,222,56,-493,0,27.8,1535.1
4835211269,1,5,2,1,11,7,8,0,0,0,0,18842,7.0,18364,207,60,181,-368,26.7,1884.2,10,3,0,7,11,8,1,1,0,0,18661,7.0,18732,239,52,-181,368,29.1,1866.1
4835178936,1,37,3,1,7,5,12,2,1,1,0,18210,6.8,16747,225,44,2279,499,26.9,1821.0,36,3,0,5,7,7,0,0,0,0,15931,6.6,16248,193,46,-2279,-499,23.9,1593.1
4835123569,1,34,0,1,7,5,4,0,0,0,0,16764,7.0,18636,221,55,1477,2092,27.6,1676.4,6,8,0,5,7,5,1,1,0,0,15287,6.6,16544,179,48,-1477,-2092,22.7,1528.7
4835088259,1,19,1,1,2,2,1,0,0,0,0,15231,6.8,18013,231,60,1072,1423,29.1,1523.1,19,0,0,2,2,4,0,0,0,0,14159,6.8,16590,191,47,-1072,-1423,23.8,1415.9
4834255531,1,9,1,1,9,3,3,1,1,0,0,16669,7.2,19700,181,76,1732,2473,25.7,1666.9,13,1,0,3,9,3,0,0,0,0,14937,6.6,17227,155,48,-1732,-2473,20.3,1493.7
4834232296,1,83,0,0,8,10,5,0,0,0,0,17591,7.0,17451,216,52,-444,105,26.8,1759.1,12,3,1,10,8,13,0,0,0,0,18035,6.8,17346,199,44,444,-105,24.3,1803.5
4834196932,0,11,0,1,9,12,3,0,0,0,0,19143,7.2,18268,174,60,-169,391,23.4,1914.3,8,1,0,12,9,9,0,0,0,0,19312,6.8,17877,202,50,169,-391,25.2,1931.2
4833420569,1,14,2,0,7,8,7,0,0,0,0,18103,7.0,18253,206,60,1357,1192,26.6,1810.3,15,4,1,8,7,8,0,0,0,0,16746,6.6,17061,184,56,-1357,-1192,24.0,1674.6
4833416929,0,19,0,0,5,8,7,0,0,0,0,16667,7.0,17702,208,52,-1817,-338,26.0,1666.7,11,0,1,8,5,9,0,0,0,0,18484,6.8,18040,219,60,1817,338,27.9,1848.4
4833391873,0,13,1,0,3,5,2,1,0,1,0,15092,6.6,16613,204,56,-1874,-1755,26.0,1509.2,13,2,1,5,3,4,1,1,0,0,16966,7.0,18368,210,64,1874,1755,27.4,1696.6
4832498107,0,11,1,1,4,8,3,0,0,0,0,14967,6.4,15674,196,48,-3394,-3316,24.4,1496.7,17,1,0,8,4,5,0,0,0,0,18361,7.2,18990,208,64,3394,3316,27.2,1836.1
4832486840,0,14,2,0,7,3,4,0,0,0,0,16892,7.0,18147,194,60,-466,503,25.4,1689.2,12,2,1,3,7,5,0,0,0,0,17358,7.0,17644,216,50,466,-503,26.6,1735.8
4831625622,0,12,1,1,5,7,4,1,1,0,0,14905,6.6,16751,173,48,-2852,-1418,22.1,1490.5,15,1,0,7,5,6,0,0,0,0,17757,6.8,18169,215,47,2852,1418,26.2,1775.7
4831608236,1,12,0,0,8,4,5,0,0,0,0,16591,6.4,16538,181,48,2344,1374,22.9,1659.1,8,1,1,4,8,10,1,1,0,0,14247,6.2,15164,159,48,-2344,-1374,20.7,1424.7
4831595557,0,14,1,0,4,9,4,1,0,1,0,16982,6.8,17260,240,56,-286,-350,29.6,1698.2,13,1,1,9,4,9,0,0,0,0,17268,7.0,17610,242,44,286,350,28.6,1726.8
4857593049,1,14,3,1,3,5,2,0,0,0,0,16305,6.8,17903,242,48,478,-694,29.0,1630.5,12,3,0,5,3,5,0,0,0,0,15827,7.0,18597,214,52,-478,694,26.6,1582.7
4857565977,0,20,0,0,3,6,2,0,0,0,0,14484,6.6,16860,200,47,-3044,-1874,24.7,1448.4,10,0,1,6,3,4,0,0,0,0,17528,7.2,18734,236,56,3044,1874,29.2,1752.8
4857521065,1,13,2,1,9,7,14,0,0,0,0,17645,6.6,17096,202,52,1014,691,25.4,1764.5,18,4,0,7,9,5,1,1,0,0,16631,6.6,16405,207,26,-1014,-691,23.3,1663.1
4857465111,1,10,1,1,7,2,9,1,1,0,0,16778,6.8,17327,214,44,2604,248,25.8,1677.8,13,0,0,2,7,0,0,0,0,0,14174,6.6,17079,199,52,-2604,-248,25.1,1417.4
4857431199,1,16,0,1,13,8,13,0,0,0,0,18950,7.2,17907,134,68,2094,1890,20.2,1895.0,10,2,0,8,13,9,0,0,0,0,16856,6.4,16017,215,4,-2094,-1890,21.9,1685.6
4857188844,0,1,0,0,26,34,68,0,0,0,1,37755,11.2,40435,118,0,-2996,-5476,11.8,3775.5,1,0,1,33,25,79,0,0,0,0,40751,11.8,45911,111,0,2996,5476,11.1,4075.1
4857154335,0,10,1,0,3,13,0,0,0,0,0,14808,6.8,16418,171,48,-5207,-2794,21.9,1480.8,16,1,1,13,3,11,0,0,0,0,20015,7.0,19212,239,56,5207,2794,29.5,2001.5
4857118942,0,15,0,0,2,2,1,0,0,0,0,15338,7.0,18367,200,68,73,376,26.8,1533.8,8,3,1,2,2,2,1,1,0,0,15265,6.8,17991,234,60,-73,-376,29.4,1526.5
4857074394,0,11,1,1,3,4,1,0,0,0,0,15481,7.0,17792,223,42,-657,-151,26.5,1548.1,13,2,0,4,3,3,1,1,0,0,16138,7.0,17943,207,46,657,151,25.3,1613.8
4857045040,0,31,2,1,5,6,2,0,0,0,0,15948,6.8,17987,226,64,-890,210,29.0,1594.8,11,14,0,6,5,5,1,1,0,0,16838,7.0,17777,198,52,890,-210,25.0,1683.8
4857021553,1,10,0,1,8,2,4,1,1,0,0,17835,7.2,19168,232,55,4120,2836,28.7,1783.5,10,0,0,2,8,0,0,0,0,0,13715,6.6,16332,162,62,-4120,-2836,22.4,1371.5
4856992656,1,10,3,1,8,3,13,0,0,0,0,19341,7.0,17816,224,60,4800,1719,28.4,1934.1,15,3,0,3,8,3,0,0,0,0,14541,6.4,16097,192,48,-4800,-1719,24.0,1454.1
4856554094,0,35,0,0,4,6,2,0,0,0,0,15563,7.2,18191,197,64,-1448,7,26.1,1556.3,12,1,1,6,4,5,0,0,0,0,17011,6.8,18184,228,64,1448,-7,29.2,1701.1
4856512195,1,11,2,1,3,3,3,0,0,0,0,16154,7.0,18256,232,54,1781,1377,28.6,1615.4,29,0,0,3,3,4,0,0,0,0,14373,6.8,16879,202,45,-1781,-1377,24.7,1437.3
4856478589,1,11,0,1,6,3,2,0,0,0,0,16951,7.0,19344,250,64,2102,1303,31.4,1695.1,9,1,0,3,6,2,0,0,0,0,14849,7.0,18041,194,60,-2102,-1303,25.4,1484.9
4856442869,0,24,1,0,9,9,6,1,0,1,0,18624,6.6,17150,187,52,-124,170,23.9,1862.4,13,0,1,9,9,8,0,0,0,0,18748,6.8,16980,192,48,124,-170,24.0,1874.8
4856389599,0,13,1,0,3,5,1,0,0,0,0,14405,6.8,17699,215,52,-2537,-1042,26.7,1440.5,18,2,1,5,3,8,1,1,0,0,16942,7.0,18741,251,56,2537,1042,30.7,1694.2
4856372283,1,0,0,1,23,15,24,0,0,0,0,64450,12.0,55000,0,0,26900,22000,0.0,6445.0,0,0,0,6,14,8,0,0,0,0,37550,7.2,33000,0,0,-26900,-22000,0.0,3755.0
4856324526,0,11,3,0,2,5,2,0,0,0,0,15057,7.2,17884,235,58,-1725,-134,29.3,1505.7,20,2,1,5,2,8,1,1,0,0,16782,6.8,18018,232,66,1725,134,29.8,1678.2
4856269742,1,38,1,0,7,9,7,0,0,0,0,16294,6.8,16213,201,41,-958,-175,24.2,1629.4,13,7,1,9,7,8,0,0,0,0,17252,6.6,16388,190,50,958,175,24.0,1725.2
4790717528,0,11,0,0,5,11,6,0,0,0,0,15396,6.8,16815,194,44,-3060,-802,23.8,1539.6,19,0,1,11,5,10,0,0,0,0,18456,6.6,17617,199,53,3060,802,25.2,1845.6
4785424636,1,11,2,1,6,4,5,0,0,0,0,16601,7.0,18009,216,64,931,1331,28.0,1660.1,12,1,0,4,6,3,0,0,0,0,15670,6.6,16678,221,35,-931,-1331,25.6,1567.0
4785404344,0,12,1,0,3,5,3,0,0,0,0,16738,7.0,18034,197,56,450,-229,25.3,1673.8,19,1,1,5,3,6,1,1,0,0,16288,6.8,18263,220,63,-450,229,28.3,1628.8
4785362058,1,54,2,1,1,2,0,1,0,1,0,15005,7.0,18013,209,59,-241,262,26.8,1500.5,13,1,0,2,1,1,0,0,0,0,15246,6.8,17751,228,60,241,-262,28.8,1524.6
4784586101,1,19,0,1,12,7,11,0,0,0,0,17612,6.2,16284,206,48,371,-357,25.4,1761.2,8,1,0,6,11,6,0,0,0,0,17241,6.6,16641,222,56,-371,357,27.8,1724.1
4784546518,1,12,1,1,6,7,1,0,0,0,0,16001,7.0,17780,209,55,-2088,-1472,26.4,1600.1,12,0,0,5,4,6,0,0,0,0,18089,7.2,19252,236,68,2088,1472,30.4,1808.9
4784508432,1,31,1,1,13,3,17,1,1,0,0,20363,7.0,18218,229,51,4464,1240,28.0,2036.3,13,0,0,3,13,2,0,0,0,0,15899,6.6,16978,196,60,-4464,-1240,25.6,1589.9
4784360426,0,56,2,0,6,7,6,1,1,0,0,16697,7.0,17404,201,48,-2058,-1228,24.9,1669.7,14,1,1,7,6,7,0,0,0,0,18755,7.2,18632,202,64,2058,1228,26.6,1875.5
4784325750,1,13,1,1,5,2,3,1,1,0,0,17058,7.2,19419,232,68,1702,1482,30.0,1705.8,11,0,0,2,5,2,0,0,0,0,15356,7.0,17937,216,71,-1702,-1482,28.7,1535.6
4784282107,1,15,0,1,4,2,1,1,1,0,0,15659,7.0,17585,219,60,571,63,27.9,1565.9,13,1,0,2,4,3,0,0,0,0,15088,6.8,17522,200,60,-571,-63,26.0,1508.8
4784231743,0,13,2,1,7,6,7,0,0,0,0,17794,7.0,18603,215,72,402,-594,28.7,1779.4,10,2,0,6,7,3,0,0,0,0,17392,7.2,19197,198,75,-402,594,27.3,1739.2
4784206641,1,13,2,0,4,1,9,1,0,1,0,18515,7.4,20056,266,72,4233,3784,33.8,1851.5,22,2,1,1,4,4,1,1,0,0,14282,6.4,16272,205,49,-4233,-3784,25.4,1428.2
4783770174,0,31,2,1,4,1,4,0,0,0,0,16597,6.8,17812,223,50,2345,395,27.3,1659.7,13,3,0,1,4,1,1,1,0,0,14252,6.8,17417,203,68,-2345,-395,27.1,1425.2
4783747293,0,15,3,1,4,5,1,0,0,0,0,16602,7.0,18216,257,55,272,1339,31.2,1660.2,14,3,0,5,4,8,1,0,1,0,16330,6.6,16877,211,48,-272,-1339,25.9,1633.0
4783697907,1,22,1,0,6,7,5,0,0,0,0,16476,6.6,16528,198,42,-1218,-1618,24.0,1647.6,13,0,1,7,6,4,2,1,1,0,17694,6.8,18146,196,59,1218,1618,25.5,1769.4
4783665983,0,13,1,1,7,7,3,0,0,0,0,18203,7.2,18688,223,50,1001,862,27.3,1820.3,18,2,0,7,7,10,1,1,0,0,17202,7.2,17826,197,52,-1001,-862,24.9,1720.2
4783591838,1,36,0,0,9,5,8,0,0,0,0,17731,6.8,17280,227,43,704,-421,27.0,1773.1,11,12,1,5,9,6,0,0,0,0,17027,7.0,17701,198,52,-704,421,25.0,1702.7
4783500749,1,13,0,1,6,2,2,1,1,0,0,18065,7.4,20054,229,72,3600,4032,30.1,1806.5,13,0,0,2,6,3,1,0,1,0,14465,6.8,16022,172,60,-3600,-4032,23.2,1446.5
4783447890,0,10,0,1,4,4,2,0,0,0,0,15788,6.8,17766,228,63,-584,-994,29.1,1578.8,11,0,0,4,4,2,1,0,1,0,16372,7.2,18760,220,64,584,994,28.4,1637.2
4850371258,1,16,0,1,8,5,7,1,0,1,0,18825,7.2,18709,215,52,2361,1880,26.7,1882.5,17,4,0,5,8,6,0,0,0,0,16464,6.6,16829,203,52,-2361,-1880,25.5,1646.4
4801344247,1,18,0,1,6,5,7,0,0,0,0,17667,6.8,17726,223,52,2085,914,27.5,1766.7,14,0,0,5,6,6,0,0,0,0,15582,6.8,16812,221,44,-2085,-914,26.5,1558.2
4801321861,0,11,2,0,6,6,5,0,0,0,0,16051,6.6,16352,175,40,-1061,-1463,21.5,1605.1,10,1,1,6,6,4,0,0,0,0,17112,6.8,17815,203,52,1061,1463,25.5,1711.2
4801300909,0,13,3,0,4,6,6,0,0,0,0,15766,6.6,17099,215,55,-905,-1617,27.0,1576.6,15,2,1,6,4,8,0,0,0,0,16671,7.0,18716,216,56,905,1617,27.2,1667.1
4801284457,1,52,0,1,10,4,12,0,0,0,0,20745,7.2,19506,247,48,5563,2188,29.5,2074.5,17,1,0,4,10,2,0,0,0,0,15182,6.8,17318,200,48,-5563,-2188,24.8,1518.2
4801266109,1,13,1,1,9,2,10,0,0,0,0,17830,6.8,18188,171,56,3188,1380,22.7,1783.0,215,4,0,2,9,1,1,1,0,0,14642,6.6,16808,212,48,-3188,-1380,26.0,1464.2
4801248931,0,9,0,0,0,5,0,0,0,0,0,12834,6.4,16691,166,56,-4356,-1866,22.2,1283.4,17,2,1,5,0,8,0,0,0,0,17190,7.0,18557,237,52,4356,1866,28.9,1719.0
4801225475,1,16,3,0,4,5,7,1,1,0,1,16251,7.0,17612,226,53,-361,-751,27.9,1625.1,14,2,1,5,4,1,0,0,0,0,16612,7.0,18363,233,56,361,751,28.9,1661.2
4789538784,1,12,3,1,5,2,6,1,1,0,0,17464,7.2,18969,236,65,3785,2026,30.1,1746.4,11,4,0,2,5,0,0,0,0,0,13679,6.6,16943,216,43,-3785,-2026,25.9,1367.9
4789507987,1,12,1,1,6,2,6,0,0,0,0,17821,6.6,17400,213,55,775,-248,26.8,1782.1,10,0,0,2,6,3,0,0,0,0,17046,6.8,17648,218,52,-775,248,27.0,1704.6
4776863701,0,12,1,0,5,7,9,0,0,0,0,15996,6.4,15956,190,56,-4827,-2795,24.6,1599.6,12,1,1,7,5,6,2,1,1,0,20823,7.2,18751,224,56,4827,2795,28.0,2082.3
4776842221,1,34,1,1,9,9,4,0,0,0,0,17494,6.6,17215,222,52,-460,-467,27.4,1749.4,13,9,0,8,8,11,1,0,1,0,17954,6.8,17682,196,64,460,467,26.0,1795.4
4769031374,0,15,2,1,5,7,1,1,1,0,0,18522,7.0,18568,236,56,2004,900,29.2,1852.2,15,0,0,6,4,1,0,0,0,0,16518,6.8,17668,228,55,-2004,-900,28.3,1651.8
4768998681,1,13,0,0,11,7,17,0,0,0,0,19895,7.0,17528,221,44,1764,83,26.5,1989.5,10,0,1,7,11,6,0,0,0,0,18131,6.6,17445,207,60,-1764,-83,26.7,1813.1
4768963572,1,15,5,1,5,4,3,0,0,0,0,16050,7.2,18205,222,56,-1252,-112,27.8,1605.0,16,4,0,4,5,4,1,1,0,0,17302,7.0,18317,216,64,1252,112,28.0,1730.2
4768840113,0,14,1,0,6,8,5,1,1,0,0,17843,7.0,17753,215,59,-271,137,27.4,1784.3,12,2,1,8,6,8,0,0,0,0,18114,7.0,17616,189,55,271,-137,24.4,1811.4
4768776721,0,13,0,1,5,7,5,0,0,0,0,17128,7.0,18265,236,48,-86,-332,28.4,1712.8,13,1,0,7,5,7,0,0,0,0,17214,7.0,18597,226,52,86,332,27.8,1721.4
4765356942,1,12,1,0,6,6,5,0,0,0,0,16771,7.0,18162,200,52,-1379,-1888,25.2,1677.1,19,4,1,6,6,5,1,1,0,0,18150,7.6,20050,218,84,1379,1888,30.2,1815.0
4764128317,0,12,2,0,3,4,3,0,0,0,0,14321,6.4,16459,208,40,-1409,-1329,24.8,1432.1,14,1,1,4,3,3,0,0,0,0,15730,6.8,17788,206,56,1409,1329,26.2,1573.0
4756682689,1,15,2,1,6,7,7,0,0,0,0,16964,6.6,16632,207,64,-1406,-1998,27.1,1696.4,20,2,0,7,6,11,1,1,0,0,18370,7.0,18630,223,48,1406,1998,27.1,1837.0
4756287903,1,13,2,0,0,1,0,0,0,0,0,14563,7.2,18250,247,52,-840,-241,29.9,1456.3,23,2,1,1,0,1,0,0,0,0,15403,6.8,18491,240,60,840,241,30.0,1540.3
4756248041,1,9,2,0,9,9,7,1,0,1,0,18550,7.0,18404,222,48,402,324,27.0,1855.0,12,3,1,9,9,7,0,0,0,0,18148,7.2,18080,218,52,-402,-324,27.0,1814.8
4755884869,1,16,2,0,6,4,7,1,1,0,0,17835,6.8,17648,222,50,1109,1111,27.2,1783.5,14,1,1,4,6,0,0,0,0,0,16726,6.6,16537,191,57,-1109,-1111,24.8,1672.6
4755858822,1,16,2,1,10,4,17,1,1,0,0,19282,6.8,17752,236,52,3120,-71,28.8,1928.2,72,0,0,4,10,4,0,0,0,0,16162,7.0,17823,216,68,-3120,71,28.4,1616.2
4755789254,0,20,3,1,4,3,5,0,0,0,0,17382,7.2,18207,227,51,1356,369,27.8,1738.2,73,3,0,3,4,3,0,0,0,0,16026,6.6,17838,219,55,-1356,-369,27.4,1602.6
4755763639,0,21,1,1,7,0,10,1,1,0,0,18535,7.2,19014,266,52,3248,1074,31.8,1853.5,12,2,0,0,7,0,0,0,0,0,15287,7.0,17940,254,60,-3248,-1074,31.4,1528.7
4754953297,1,9,2,1,9,4,12,1,0,1,0,18836,7.2,18962,243,64,3109,987,30.7,1883.6,12,2,0,4,9,4,0,0,0,0,15727,6.8,17975,214,74,-3109,-987,28.8,1572.7
4754938120,1,18,4,1,2,3,3,1,1,0,0,15914,7.0,17583,190,64,615,416,25.4,1591.4,81,1,0,3,2,2,0,0,0,0,15299,6.8,17167,220,36,-615,-416,25.6,1529.9
4754739216,0,25,0,0,1,8,0,0,0,0,0,13738,6.8,16932,203,60,-5106,-1558,26.3,1373.8,11,1,1,8,1,14,1,0,1,0,18844,7.2,18490,233,60,5106,1558,29.3,1884.4
4754688523,0,9,1,0,4,9,3,0,0,0,0,15388,6.4,16439,189,60,-3874,-2121,24.9,1538.8,13,0,1,9,4,12,0,0,0,0,19262,7.0,18560,217,56,3874,2121,27.3,1926.2
4754630145,1,18,3,0,12,8,8,1,1,0,0,18867,7.0,18122,217,52,2514,2624,26.9,1886.7,17,2,1,7,11,7,0,0,0,0,16353,6.4,15498,191,34,-2514,-2624,22.5,1635.3
4754603205,1,14,2,1,5,4,7,0,0,0,0,18120,7.0,18175,223,56,1346,443,27.9,1812.0,13,0,0,4,5,5,0,0,0,0,16774,6.6,17732,221,52,-1346,-443,27.3,1677.4
4754553272,0,17,0,1,5,1,2,1,1,0,0,16128,7.0,19284,235,63,1434,1074,29.8,1612.8,10,1,0,1,5,2,0,0,0,0,14694,7.2,18210,247,50,-1434,-1074,29.7,1469.4
4754511701,0,13,1,0,6,11,11,1,1,0,0,16379,6.2,15228,177,60,-3564,-3238,23.7,1637.9,15,2,1,11,6,11,1,0,1,0,19943,7.0,18466,216,56,3564,3238,27.2,1994.3
4754475135,0,11,1,1,8,7,5,0,0,0,0,17685,7.0,17751,226,36,-370,-1166,26.2,1768.5,8,2,0,7,8,7,0,0,0,0,18055,7.2,18917,220,72,370,1166,29.2,1805.5
4753878994,1,11,2,0,5,6,3,1,0,1,0,17201,6.6,17379,207,55,245,946,26.2,1720.1,16,3,1,6,5,6,0,0,0,0,16956,6.8,16433,183,56,-245,-946,23.9,1695.6
4753838921,1,10,1,1,5,4,13,1,1,0,0,17362,7.0,18049,233,64,1713,463,29.7,1736.2,14,1,0,4,5,4,0,0,0,0,15649,6.6,17586,222,56,-1713,-463,27.8,1564.9
4753804806,0,8,2,0,7,10,6,0,0,0,0,17148,7.0,17597,226,48,-1399,-576,27.4,1714.8,12,2,1,10,7,18,1,1,0,0,18547,7.0,18173,235,62,1399,576,29.7,1854.7
4753358277,0,11,2,0,2,6,2,0,0,0,0,14067,6.2,15612,159,52,-2515,-3333,21.1,1406.7,11,1,1,6,2,5,0,0,0,0,16582,7.2,18945,215,60,2515,3333,27.5,1658.2
4848071239,1,16,1,1,10,9,9,0,0,0,0,18335,7.2,18531,228,60,801,1514,28.8,1833.5,14,2,0,9,10,8,0,0,0,0,17534,6.4,17017,200,40,-801,-1514,24.0,1753.4
4848032357,0,12,2,0,6,5,2,0,0,0,0,15948,7.0,17783,214,40,-1298,-1611,25.4,1594.8,11,0,1,5,6,3,0,0,0,0,17246,7.2,19394,241,72,1298,1611,31.3,1724.6
4847983171,0,11,2,1,5,5,5,0,0,0,0,16814,7.0,18873,249,48,443,-439,29.7,1681.4,13,0,0,5,5,3,0,0,0,0,16371,7.2,19312,210,72,-443,439,28.2,1637.1
4847953706,1,17,2,1,8,9,11,0,0,0,0,19510,6.8,17603,230,49,2433,1344,27.9,1951.0,11,4,0,9,8,4,1,1,0,0,17077,6.6,16259,172,64,-2433,-1344,23.6,1707.7
4831851247,0,11,0,0,5,6,4,1,0,1,0,17057,7.0,18313,226,56,-128,236,28.2,1705.7,14,0,1,6,5,5,0,0,0,0,17185,7.0,18077,192,40,128,-236,23.2,1718.5
4831826178,0,14,2,1,8,6,6,1,1,0,0,17437,7.0,17698,182,52,-741,-553,23.4,1743.7,14,1,0,6,8,3,0,0,0,0,18178,7.0,18251,205,68,741,553,27.3,1817.8
4831760231,1,33,1,1,5,2,10,1,1,0,0,16434,6.6,17058,199,52,1168,-1434,25.1,1643.4,41,0,0,2,5,3,0,0,0,0,15266,7.0,18492,218,52,-1168,1434,27.0,1526.6
4831741270,0,8,1,1,6,7,7,0,0,0,0,16723,7.4,19260,203,52,-568,2024,25.5,1672.3,14,0,0,7,6,10,0,0,0,0,17291,6.8,17236,186,64,568,-2024,25.0,1729.1
4831724603,1,16,2,1,4,0,8,0,0,0,0,17881,7.0,18243,248,42,4905,1512,29.0,1788.1,13,3,0,0,4,0,0,0,0,0,12976,6.4,16731,200,55,-4905,-1512,25.5,1297.6
4830693918,1,16,2,1,6,5,5,0,0,0,0,16049,6.8,17899,217,60,-473,197,27.7,1604.9,14,2,0,5,6,7,0,0,0,0,16522,7.0,17702,206,59,473,-197,26.5,1652.2
4830659079,1,52,1,1,7,1,11,0,0,0,0,17975,7.4,19753,225,52,3126,2506,27.7,1797.5,12,0,0,1,7,2,1,0,1,0,14849,6.8,17247,202,60,-3126,-2506,26.2,1484.9
4830623916,1,15,2,0,5,5,4,0,0,0,0,15874,7.0,17535,207,46,-1278,-1087,25.3,1587.4,7,1,1,5,5,5,0,0,0,0,17152,7.0,18622,247,69,1278,1087,31.6,1715.2
4802967556,0,14,2,1,9,11,13,0,0,0,0,18057,7.0,17461,209,36,-1353,-1285,24.5,1805.7,14,1,0,11,9,8,0,0,0,0,19410,6.8,18746,226,56,1353,1285,28.2,1941.0
4802938040,0,14,1,0,2,5,3,0,0,0,0,15839,6.8,17838,219,48,-686,-669,26.7,1583.9,11,1,1,5,2,3,1,1,0,0,16525,7.2,18507,244,68,686,669,31.2,1652.5
4786874034,0,7,0,1,3,10,3,0,0,0,0,16256,6.8,17460,234,52,-3092,-1417,28.6,1625.6,21,1,0,10,3,11,0,0,0,0,19348,7.2,18877,230,52,3092,1417,28.2,1934.8
4786841328,1,13,0,1,8,4,3,0,0,0,0,18747,6.8,17924,249,56,4497,2291,30.5,1874.7,43,0,0,4,8,5,0,0,0,0,14250,6.4,15633,155,40,-4497,-2291,19.5,1425.0
4786809285,0,22,0,1,3,6,2,0,0,0,0,16325,6.8,17656,260,56,56,-1207,31.6,1632.5,13,1,0,6,3,8,1,1,0,0,16269,7.0,18863,196,68,-56,1207,26.4,1626.9
4786785687,1,9,0,1,13,5,12,0,0,0,0,21562,7.6,20204,253,72,6119,3248,32.5,2156.2,11,1,0,5,13,5,1,1,0,0,15443,6.8,16956,203,52,-6119,-3248,25.5,1544.3
4782700381,0,10,0,1,5,11,6,0,0,0,0,16023,6.6,16415,196,50,-4023,-2532,24.6,1602.3,84,1,0,11,5,10,1,1,0,0,20046,7.0,18947,224,61,4023,2532,28.5,2004.6
4782658153,1,13,0,0,9,9,8,0,0,0,0,18625,6.8,17718,214,52,1708,509,26.6,1862.5,16,0,1,9,9,4,0,0,0,0,16917,6.6,17209,200,48,-1708,-509,24.8,1691.7
4857966410,0,27,1,0,3,3,1,0,0,0,0,14964,7.4,19848,197,74,-879,1358,27.1,1496.4,30,0,1,3,3,4,0,0,0,0,15843,7.2,18490,209,52,879,-1358,26.1,1584.3
4857946945,0,9,4,0,9,2,9,0,0,0,0,17003,6.8,17752,196,48,473,171,24.4,1700.3,17,0,1,2,9,2,0,0,0,0,16530,6.8,17581,215,56,-473,-171,27.1,1653.0
4857653534,0,13,0,1,6,7,5,0,0,0,0,16967,6.6,17460,191,48,-346,-402,23.9,1696.7,365,0,0,7,6,5,1,1,0,0,17313,7.0,17862,177,68,346,402,24.5,1731.3
4857639038,1,17,0,1,3,0,3,1,1,0,0,15468,6.8,18142,187,56,1946,16,24.3,1546.8,158,0,0,0,3,0,0,0,0,0,13522,7.0,18126,178,60,-1946,-16,23.8,1352.2
4857617709,0,93,0,1,7,8,2,1,1,0,0,16967,7.2,18545,241,56,705,840,29.7,1696.7,11,1,0,8,7,6,0,0,0,0,16262,6.8,17705,176,44,-705,-840,22.0,1626.2
4857598467,1,11,0,0,4,5,3,1,1,0,0,16535,7.2,18804,175,60,1254,2037,23.5,1653.5,13,0,1,5,4,4,0,0,0,0,15281,6.6,16767,196,40,-1254,-2037,23.6,1528.1
4857006236,1,35,0,0,13,17,15,0,0,0,0,44550,10.0,47500,0,0,16002,19000,0.0,4455.0,0,0,1,15,11,11,0,0,0,0,28548,6.0,28500,0,0,-16002,-19000,0.0,2854.8
4856991929,1,352,0,1,21,12,22,0,0,0,0,52200,12.0,55000,0,0,22675,22000,0.0,5220.0,16,0,0,5,14,6,0,0,0,0,29525,7.2,33000,1,0,-22675,-22000,0.1,2952.5
4856970180,1,82,0,1,13,14,11,0,0,0,0,46729,10.2,48680,0,0,17971,20180,0.0,4672.9,0,0,0,10,9,10,0,0,0,0,28758,6.0,28500,0,0,-17971,-20180,0.0,2875.8
4856954570,1,16,4,0,13,20,14,0,0,0,0,60978,13.8,66500,0,0,22553,29000,0.0,6097.8,34,0,1,14,7,12,0,0,0,0,38425,7.8,37500,7,0,-22553,-29000,0.7,3842.5
4856949006,1,399,2,0,12,16,19,0,0,0,0,60810,12.0,55000,8,0,23485,22000,0.8,6081.0,3,1,1,13,9,9,0,0,0,0,37325,7.2,33000,2,0,-23485,-22000,0.2,3732.5
4856641202,1,13,1,0,5,3,2,0,0,0,0,15750,6.8,17919,195,56,584,-553,25.1,1575.0,9,1,1,3,5,4,0,0,0,0,15166,7.0,18472,194,80,-584,553,27.4,1516.6
4856622416,1,14,0,0,5,7,5,0,0,0,0,16197,6.8,17970,190,48,-688,-597,23.8,1619.7,204,1,1,7,5,7,0,0,0,0,16885,7.0,18567,242,52,688,597,29.4,1688.5
4855456201,1,290,0,1,6,3,1,1,1,0,0,16959,6.8,16986,184,44,1853,1999,22.8,1695.9,13,2,0,3,6,2,0,0,0,0,15106,6.4,14987,151,48,-1853,-1999,19.9,1510.6
4855426858,1,194,0,0,4,7,3,0,0,0,1,14268,6.6,15990,191,36,-3483,-2303,22.7,1426.8,8,0,1,7,4,4,0,0,0,0,17751,7.2,18293,195,56,3483,2303,25.1,1775.1
4855373272,1,0,3,1,30,23,71,0,0,0,0,38857,11.4,42176,97,0,711,-940,9.7,3885.7,27,0,0,23,30,58,0,0,0,0,38146,11.6,43116,97,0,-711,940,9.7,3814.6
4855349442,0,9,0,0,23,26,51,0,0,0,0,35720,11.2,40486,87,0,-1697,294,8.7,3572.0,0,0,1,26,23,62,0,0,0,0,37417,11.2,40192,97,0,1697,-294,9.7,3741.7
4853200114,0,8,0,0,1,9,1,0,0,0,0,13297,6.4,15346,158,56,-5683,-3463,21.4,1329.7,72,0,1,9,1,6,0,0,0,0,18980,7.0,18809,237,43,5683,3463,28.0,1898.0
4853169408,1,34,0,1,11,7,9,1,1,0,0,16633,6.2,15438,148,48,-1439,-434,19.6,1663.3,267,9,0,7,11,6,0,0,0,0,18072,6.4,15872,177,36,1439,434,21.3,1807.2
4853155604,1,0,0,0,14,17,21,0,0,0,0,62826,12.0,55000,2,0,24182,21000,0.2,6282.6,0,0,1,12,9,9,0,0,0,0,38644,7.4,34000,1,0,-24182,-21000,0.1,3864.4
4742728626,1,12,3,1,5,6,5,0,0,0,0,16403,6.8,17426,222,51,-754,-841,27.3,1640.3,13,2,0,6,5,6,1,1,0,0,17157,7.0,18267,222,68,754,841,29.0,1715.7
4742709189,1,9,1,1,7,6,2,0,0,0,0,17227,7.2,19188,194,76,2448,3869,27.0,1722.7,14,1,0,6,7,7,0,0,0,0,14779,6.2,15319,177,40,-2448,-3869,21.7,1477.9
4742666128,0,10,2,1,6,7,5,1,1,0,0,15781,6.8,17464,187,48,-1113,-48,23.5,1578.1,8,1,0,7,6,8,0,0,0,0,16894,6.8,17512,186,52,1113,48,23.8,1689.4
4718155826,0,10,0,1,6,8,4,0,0,0,0,17151,7.0,18312,243,56,-578,1311,29.9,1715.1,11,1,0,8,6,14,0,0,0,0,17729,6.8,17001,188,56,578,-1311,24.4,1772.9
4718117704,1,12,1,1,8,1,11,2,1,1,0,18729,7.4,19944,238,63,4451,2458,30.1,1872.9,20,0,0,1,8,2,0,0,0,0,14278,6.8,17486,226,60,-4451,-2458,28.6,1427.8
4718086186,0,11,1,0,3,5,3,0,0,0,0,15127,6.6,16674,230,52,-2172,-1416,28.2,1512.7,16,2,1,5,3,5,1,1,0,0,17299,7.0,18090,228,60,2172,1416,28.8,1729.9
4718043191,0,80,1,1,3,4,4,1,0,1,0,15733,6.8,17297,177,72,907,477,24.9,1573.3,14,1,0,4,3,4,0,0,0,0,14826,6.6,16820,191,52,-907,-477,24.3,1482.6
4717980516,0,15,2,1,2,8,3,1,0,1,0,15606,7.0,18303,220,71,-2313,-788,29.1,1560.6,14,0,0,8,2,10,0,0,0,0,17919,7.0,19091,211,64,2313,788,27.5,1791.9
4717920435,0,19,7,1,6,3,6,0,0,0,0,16346,6.6,16569,219,43,476,-43,26.2,1634.6,17,3,0,3,6,2,0,0,0,0,15870,6.6,16612,179,52,-476,43,23.1,1587.0
4717876473,0,66,1,0,3,5,4,0,0,0,0,16117,7.0,17783,197,67,-295,-1020,26.4,1611.7,20,2,1,5,3,9,0,0,0,0,16412,7.2,18803,216,52,295,1020,26.8,1641.2
4716090227,1,11,1,0,6,8,5,0,0,0,0,16198,6.8,17458,201,59,-1379,-229,26.0,1619.8,10,2,1,8,6,8,0,0,0,0,17577,7.0,17687,208,51,1379,229,25.9,1757.7
4716042026,1,72,3,1,9,4,12,0,0,0,0,19004,7.0,18453,234,56,3348,1517,29.0,1900.4,13,0,0,4,9,3,0,0,0,0,15656,6.8,16936,217,63,-3348,-1517,28.0,1565.6
4716004796,1,12,2,1,3,0,3,1,1,0,0,15731,7.0,17830,237,64,215,-1148,30.1,1573.1,15,0,0,0,3,0,0,0,0,0,15516,7.2,18978,228,60,-215,1148,28.8,1551.6
4715955991,0,10,12,0,1,2,1,1,0,1,0,16015,7.0,17874,227,52,-34,-402,27.9,1601.5,34,0,1,2,1,4,0,0,0,0,16049,6.8,18276,225,59,34,402,28.4,1604.9
4715915238,0,11,0,0,5,15,5,0,0,0,0,15333,6.8,16717,184,59,-6117,-3509,24.3,1533.3,13,1,1,15,5,12,1,1,0,0,21450,7.2,20226,248,56,6117,3509,30.4,2145.0
4715875753,0,8,2,1,3,7,2,0,0,0,0,15925,6.8,17817,232,52,-2168,-712,28.4,1592.5,13,1,0,7,3,6,1,0,1,0,18093,6.8,18529,222,59,2168,712,28.1,1809.3
4715834784,0,18,1,0,2,7,3,0,0,0,0,14665,6.4,15798,181,60,-2368,-2918,24.1,1466.5,190,4,1,7,2,5,1,1,0,0,17033,6.8,18716,228,48,2368,2918,27.6,1703.3
4715800692,0,14,1,0,2,9,2,0,0,0,0,14184,7.0,17091,218,43,-4285,-2488,26.1,1418.4,14,1,1,9,2,5,0,0,0,0,18469,7.2,19579,242,58,4285,2488,30.0,1846.9
4715768294,1,14,2,0,2,5,1,0,0,0,0,16279,6.8,17589,198,52,227,198,25.0,1627.9,20,3,1,5,2,6,0,0,0,0,16052,7.0,17391,192,59,-227,-198,25.1,1605.2
4715746934,1,51,2,1,2,5,0,0,0,0,0,14814,6.8,17602,195,54,-3024,-255,24.9,1481.4,14,4,0,5,2,5,1,1,0,0,17838,7.0,17857,222,60,3024,255,28.2,1783.8
4858132843,1,9,12,1,6,8,3,0,0,0,0,16194,7.2,18209,158,60,165,254,21.8,1619.4,33,0,0,8,6,3,0,0,0,0,16029,6.8,17955,175,36,-165,-254,21.1,1602.9
4858088766,1,14,3,0,5,6,3,1,1,0,0,17270,7.0,19264,228,71,144,1443,29.9,1727.0,14,3,1,6,5,9,0,0,0,0,17126,6.8,17821,228,64,-144,-1443,29.2,1712.6
4858040758,1,16,0,0,3,7,1,0,0,0,0,15069,7.0,17990,214,65,-2248,-390,27.9,1506.9,14,1,1,7,3,5,0,0,0,0,17317,7.0,18380,192,62,2248,390,25.4,1731.7
4858010129,1,12,2,1,6,3,9,1,1,0,0,17212,7.0,18876,250,68,1081,-386,31.8,1721.2,12,1,0,3,6,3,0,0,0,0,16131,7.2,19262,262,68,-1081,386,33.0,1613.1
4857902742,1,14,1,1,6,5,6,2,1,1,0,15590,6.6,17002,169,60,-1870,-1572,22.9,1559.0,11,1,0,5,6,4,0,0,0,0,17460,7.0,18574,261,60,1870,1572,32.1,1746.0
4857878238,1,15,1,1,9,5,13,0,0,0,0,18564,7.2,18198,202,60,2278,1080,26.2,1856.4,11,0,0,5,9,5,0,0,0,0,16286,6.8,17118,209,44,-2278,-1080,25.3,1628.6
4857858250,1,16,1,0,8,8,6,1,1,0,0,17654,7.0,18335,195,64,-64,612,25.9,1765.4,10,0,1,8,8,8,0,0,0,0,17718,6.6,17723,220,48,64,-612,26.8,1771.8
4857831333,0,15,1,0,4,5,6,0,0,0,0,15311,6.4,16195,168,60,-1993,-2382,22.8,1531.1,17,3,1,5,4,6,1,1,0,0,17304,7.2,18577,221,76,1993,2382,29.7,1730.4
4857819048,0,14,2,1,2,5,2,0,0,0,0,15655,7.2,18833,226,60,-1440,-103,28.6,1565.5,12,0,0,5,2,6,1,1,0,0,17095,7.2,18936,208,68,1440,103,27.6,1709.5
4857799007,1,13,2,1,8,3,11,0,0,0,0,17930,7.4,19188,222,76,2449,1080,29.8,1793.0,14,0,0,3,8,1,1,1,0,0,15481,7.0,18108,216,62,-2449,-1080,27.8,1548.1
4857780762,0,11,0,0,8,4,3,0,0,0,0,17810,7.2,19350,222,74,2110,1471,29.6,1781.0,14,0,1,4,8,1,1,1,0,0,15700,6.8,17879,221,57,-2110,-1471,27.8,1570.0
4856986230,1,11,2,1,2,0,0,1,1,0,0,15679,7.2,19076,218,68,412,-37,28.6,1567.9,15,2,0,0,2,0,0,0,0,0,15267,7.0,19113,231,72,-412,37,30.3,1526.7
4856961487,1,12,0,1,8,8,7,1,1,0,0,18705,6.8,17737,217,43,2715,-2,26.0,1870.5,9,0,0,7,7,3,0,0,0,0,15990,7.0,17739,226,44,-2715,2,27.0,1599.0
4856944504,0,9,0,0,5,3,5,1,1,0,0,15049,6.6,16481,185,44,-706,-1011,22.9,1504.9,12,0,1,3,5,6,0,0,0,0,15755,6.8,17492,189,56,706,1011,24.5,1575.5
4856859797,0,20,1,0,5,9,3,0,0,0,0,15180,6.8,16260,161,60,-3149,-1417,22.1,1518.0,14,2,1,9,5,9,1,1,0,0,18329,6.8,17677,204,68,3149,1417,27.2,1832.9
4856836053,1,82,12,1,5,3,5,1,1,0,0,17361,7.4,19671,254,64,1634,942,31.8,1736.1,34,0,0,3,5,2,0,0,0,0,15727,7.2,18729,222,76,-1634,-942,29.8,1572.7
4856811525,0,11,1,0,2,5,2,0,0,0,0,13062,6.6,16784,154,44,-2462,-1293,19.8,1306.2,14,0,1,5,2,2,0,0,0,0,15524,7.0,18077,191,59,2462,1293,25.0,1552.4
4855954703,1,0,1,0,23,18,28,0,0,0,0,65160,12.0,55000,1,0,29010,22000,0.1,6516.0,20,0,1,9,14,6,0,0,0,0,36150,7.2,33000,0,0,-29010,-22000,0.0,3615.0
4855946873,1,0,0,1,18,21,18,0,0,0,0,63369,12.0,55000,0,0,25079,22000,0.0,6336.9,16,0,0,12,9,12,0,0,0,0,38290,7.2,33000,0,0,-25079,-22000,0.0,3829.0
4855928104,1,0,0,1,24,25,19,0,0,0,0,63400,13.0,62500,2,0,24800,25000,0.2,6340.0,0,0,0,10,9,14,0,0,0,0,38600,7.8,37500,1,0,-24800,-25000,0.1,3860.0
4844395011,0,10,13,1,38,32,107,0,0,0,2,42886,12.2,46813,113,0,3163,1817,11.3,4288.6,22,0,0,32,38,75,0,0,0,0,39723,11.8,44996,70,0,-3163,-1817,7.0,3972.3
4844369357,0,0,0,0,22,24,63,0,0,0,0,36822,10.8,39348,76,0,-21,-1054,7.6,3682.2,0,0,1,24,22,60,0,0,0,0,36843,11.2,40402,79,0,21,1054,7.9,3684.3
4844354276,1,1,0,0,27,29,58,0,0,0,0,38558,11.8,43789,94,0,-1553,-961,9.4,3855.8,79,0,1,29,27,75,0,0,0,0,40111,11.6,44750,102,0,1553,961,10.2,4011.1
4838458238,0,28,6,0,14,13,16,0,0,0,0,30717,10.8,36718,97,51,-4870,-4861,14.8,3071.7,17,0,1,13,14,23,0,0,0,0,35587,11.2,41579,95,71,4870,4861,16.6,3558.7
4838447845,0,14,0,0,12,26,25,0,0,0,0,35061,11.2,39054,94,55,-610,-1137,14.9,3506.1,18,0,1,26,12,48,0,0,0,0,35671,11.0,40191,74,67,610,1137,14.1,3567.1
4837265835,1,16,0,0,18,20,20,0,0,0,0,32970,10.8,38418,77,51,-5377,-1368,12.8,3297.0,30,0,1,20,18,45,0,0,0,0,38347,10.8,39786,84,55,5377,1368,13.9,3834.7
4837222782,0,10,0,1,12,13,24,0,0,0,0,33917,11.2,38900,103,59,136,-3206,16.2,3391.7,15,0,0,12,11,15,0,0,0,0,33781,11.4,42106,99,79,-136,3206,17.8,3378.1
4836888695,1,17,0,1,17,13,33,0,0,0,0,37601,11.2,40322,82,68,6829,6860,15.0,3760.1,17,0,0,13,17,25,0,0,0,0,30772,10.4,33462,68,43,-6829,-6860,11.1,3077.2
4836122948,1,11,0,0,12,19,29,0,0,0,0,40115,11.6,41854,111,64,4073,2016,17.5,4011.5,11,0,1,19,12,37,0,0,0,0,36042,11.0,39838,102,52,-4073,-2016,15.4,3604.2
4829878097,0,11,0,1,16,24,36,0,0,0,1,35504,11.0,39554,49,55,270,2693,10.4,3550.4,15,0,0,23,15,49,0,0,0,0,35234,10.8,36861,82,55,-270,-2693,13.7,3523.4
4829867787,0,11,0,1,14,21,26,0,0,0,0,35316,10.6,37708,99,51,-1978,-5381,15.0,3531.6,156,0,0,20,13,45,0,0,0,0,37294,11.4,43089,76,70,1978,5381,14.6,3729.4
4829854019,0,142,0,1,18,23,36,0,0,0,0,34887,10.2,35982,57,43,-1937,-946,10.0,3488.7,19,0,0,22,17,48,0,0,0,0,36824,11.0,36928,48,58,1937,946,10.6,3682.4
4829839207,1,17,5,0,15,12,26,0,0,0,0,31097,10.4,34481,72,43,802,975,11.5,3109.7,31,0,1,12,15,14,0,0,0,0,30295,10.2,33506,69,43,-802,-975,11.2,3029.5
4829825335,0,10,0,0,26,17,64,0,0,0,1,38295,10.8,37276,80,36,-2184,-2698,11.6,3829.5,57,0,1,17,26,45,0,0,0,0,40479,11.0,39974,73,53,2184,2698,12.6,4047.9
4829817767,1,14,1,1,29,13,61,0,0,0,0,41548,11.8,45173,85,79,7971,11438,16.4,4154.8,14,0,0,13,29,22,0,0,0,0,33577,10.2,33735,90,52,-7971,-11438,14.2,3357.7
4822122770,0,6,0,0,16,14,47,0,0,0,0,31290,10.6,36608,69,51,-5267,-2971,12.0,3129.0,10,0,1,14,16,32,0,0,0,0,36557,11.0,39579,67,64,5267,2971,13.1,3655.7
4821263815,0,15,0,0,15,21,40,0,0,0,2,35492,11.0,39441,76,47,-4916,-3813,12.3,3549.2,17,0,1,21,15,61,0,0,0,0,40408,11.6,43254,97,56,4916,3813,15.3,4040.8
4821255992,0,13,1,1,4,18,6,0,0,0,1,26946,10.0,32748,99,40,-12428,-11937,13.9,2694.6,10,0,0,18,4,53,0,0,0,0,39374,11.6,44685,97,86,12428,11937,18.3,3937.4
4821240637,0,17,1,0,18,15,49,0,0,0,0,31024,11.2,38622,90,47,838,4223,13.7,3102.4,23,0,1,14,17,43,0,0,0,0,30186,10.2,34399,72,51,-838,-4223,12.3,3018.6
4858067310,1,85,0,1,2,4,3,0,0,0,0,14529,6.8,17363,185,64,-1848,-881,24.9,1452.9,213,0,0,4,2,6,0,0,0,0,16377,6.8,18244,208,48,1848,881,25.6,1637.7
4858036664,0,16,1,1,11,4,9,0,0,0,0,17771,6.8,17317,225,40,2028,-734,26.5,1777.1,15,0,0,4,11,2,1,1,0,0,15743,7.0,18051,207,70,-2028,734,27.7,1574.3
4857979856,0,11,0,0,6,2,4,0,0,0,0,16692,6.8,18351,183,55,1660,1363,23.8,1669.2,9,0,1,2,6,2,1,1,0,0,15032,6.6,16988,217,56,-1660,-1363,27.3,1503.2
4857817766,1,154,0,1,3,0,0,1,1,0,0,15556,6.8,18376,218,64,2959,1767,28.2,1555.6,10,1,0,0,3,0,0,0,0,0,12597,6.8,16609,182,43,-2959,-1767,22.5,1259.7
4856892716,1,9,0,0,9,4,7,0,0,0,0,16386,7.0,18355,180,52,993,23,23.2,1638.6,7,0,1,4,9,1,0,0,0,0,15393,7.0,18332,215,70,-993,-23,28.5,1539.3
4856852272,1,7,1,1,12,10,11,1,1,0,0,19622,7.2,18671,231,55,1878,279,28.6,1962.2,11,0,0,10,12,5,0,0,0,0,17744,7.0,18392,188,59,-1878,-279,24.7,1774.4
4856582138,1,7,0,0,3,3,2,0,0,0,0,14929,6.6,17602,167,52,-1238,-1545,21.9,1492.9,16,0,1,3,3,2,1,1,0,0,16167,7.4,19147,193,80,1238,1545,27.3,1616.7
4856555850,0,8,0,1,3,4,3,1,0,1,0,17012,6.8,18358,203,48,1254,629,25.1,1701.2,13,1,0,4,3,0,0,0,0,0,15758,7.0,17729,194,44,-1254,-629,23.8,1575.8
4856517695,1,9,0,0,2,4,1,1,1,0,0,16147,7.2,19237,225,84,84,480,30.9,1614.7,7,1,1,4,2,3,0,0,0,0,16063,7.2,18757,241,60,-84,-480,30.1,1606.3
4856481486,0,12,1,0,6,9,5,0,0,0,0,14668,6.4,15300,156,34,-2657,-2497,19.0,1466.8,14,1,1,8,5,6,0,0,0,0,17325,7.0,17797,189,66,2657,2497,25.5,1732.5
4856087463,1,14,2,1,5,3,3,1,1,0,0,15490,6.8,18001,197,60,-382,-831,25.7,1549.0,11,2,0,3,5,1,0,0,0,0,15872,7.2,18832,223,60,382,831,28.3,1587.2
4856036521,0,25,0,1,6,5,3,0,0,0,0,16884,7.0,18039,220,40,269,1899,26.0,1688.4,18,0,0,5,6,6,0,0,0,0,16615,6.2,16140,185,53,-269,-1899,23.8,1661.5
4856014983,1,12,0,0,10,5,9,0,0,0,0,20437,7.4,19359,224,44,5019,2384,26.8,2043.7,12,0,1,5,10,4,0,0,0,0,15418,6.8,16975,180,40,-5019,-2384,22.0,1541.8
4855976041,1,88,0,1,7,5,8,1,1,0,0,17018,7.0,17105,181,44,278,-2362,22.5,1701.8,11,0,0,4,6,2,0,0,0,0,16740,7.2,19467,215,58,-278,2362,27.3,1674.0
4855964867,0,13,4,0,5,13,5,0,0,0,0,16571,6.4,15484,187,46,-2835,-3446,23.3,1657.1,13,2,1,13,5,16,0,0,0,0,19406,7.2,18930,218,57,2835,3446,27.5,1940.6
4855932875,0,9,1,0,3,5,2,0,0,0,0,14818,6.8,17149,198,42,-2185,-1561,24.0,1481.8,12,1,1,5,3,5,0,0,0,0,17003,6.8,18710,204,59,2185,1561,26.3,1700.3
4855886202,1,13,1,1,12,6,6,1,1,0,0,19574,7.2,19827,229,48,2228,2980,27.7,1957.4,30,0,0,6,12,7,0,0,0,0,17346,6.6,16847,207,40,-2228,-2980,24.7,1734.6
4855700272,0,13,5,0,2,8,4,0,0,0,0,14098,6.6,16707,193,44,-2957,-1481,23.7,1409.8,12,2,1,8,2,10,1,1,0,0,17055,6.8,18188,198,62,2957,1481,26.0,1705.5
4855686617,0,12,0,0,3,7,1,0,0,0,0,14294,6.6,17333,175,55,-2937,-2403,23.0,1429.4,14,0,1,7,3,3,1,1,0,0,17231,7.0,19736,208,57,2937,2403,26.5,1723.1
4752857992,0,12,0,0,5,7,6,0,0,0,0,16348,6.6,17325,205,72,-1877,-733,27.7,1634.8,12,4,1,7,5,9,1,1,0,0,18225,7.0,18058,215,56,1877,733,27.1,1822.5
4735555554,0,55,2,1,3,9,3,0,0,0,0,16304,7.4,19123,201,43,-2891,-509,24.4,1630.4,13,0,0,9,3,10,1,1,0,0,19195,7.2,19632,255,72,2891,509,32.7,1919.5
4735522611,1,9,1,1,14,10,23,1,1,0,0,20999,7.2,18085,209,48,2677,2666,25.7,2099.9,146,1,0,10,14,15,0,0,0,0,18322,6.2,15419,213,36,-2677,-2666,24.9,1832.2
4735500212,1,14,0,1,7,2,6,1,1,0,0,19619,7.4,19800,229,72,3456,1034,30.1,1961.9,11,0,0,2,7,1,0,0,0,0,16163,7.0,18766,255,48,-3456,-1034,30.3,1616.3
4735455492,0,9,2,1,9,2,11,0,0,0,0,18539,7.4,19772,232,58,3067,2293,29.0,1853.9,11,1,0,2,9,2,0,0,0,0,15472,6.6,17479,250,52,-3067,-2293,30.2,1547.2
4735425258,1,12,1,1,8,10,6,1,1,0,0,17824,7.0,17513,223,60,-45,824,28.3,1782.4,74,4,0,10,8,8,0,0,0,0,17869,6.8,16689,190,32,45,-824,22.2,1786.9
4735407860,0,8,3,0,6,11,5,1,0,1,0,17132,6.6,16443,198,56,-2014,-2135,25.4,1713.2,21,1,1,11,6,9,0,0,0,0,19146,7.0,18578,253,49,2014,2135,30.2,1914.6
4735363433,0,121,4,1,6,4,5,0,0,0,0,16664,6.6,17257,194,51,-1158,-1801,24.5,1666.4,17,3,0,4,6,7,0,0,0,0,17822,7.0,19058,227,76,1158,1801,30.3,1782.2
4734977569,1,25,2,0,6,5,13,1,1,0,0,18832,7.0,18164,227,56,1090,-44,28.3,1883.2,16,0,1,5,6,10,0,0,0,0,17742,7.0,18208,230,60,-1090,44,29.0,1774.2
4734959662,1,11,2,1,4,2,4,1,1,0,0,16419,7.2,18703,243,62,-108,-521,30.5,1641.9,33,1,0,2,4,2,0,0,0,0,16527,7.2,19224,238,65,108,521,30.3,1652.7
4734945029,1,25,3,0,5,6,7,0,0,0,0,16554,7.0,17659,206,46,-1569,-1180,25.2,1655.4,9,0,1,6,5,1,1,0,1,0,18123,7.0,18839,205,60,1569,1180,26.5,1812.3
4733934842,1,13,2,1,7,3,9,1,1,0,0,16894,7.0,18609,236,56,1529,852,29.2,1689.4,15,1,0,2,6,2,1,0,1,0,15365,7.0,17757,212,56,-1529,-852,26.8,1536.5
4733545081,0,13,0,0,8,10,7,0,0,0,0,18110,6.4,17033,211,52,-381,-217,26.3,1811.0,12,1,1,10,8,7,0,0,0,0,18491,6.8,17250,207,50,381,217,25.7,1849.1
4733488036,1,34,2,0,5,7,2,0,0,0,0,16305,6.8,17964,244,63,-1795,-278,30.7,1630.5,14,12,1,7,5,11,1,1,0,0,18100,7.0,18242,226,59,1795,278,28.5,1810.0
4733452326,0,14,3,1,6,7,9,0,0,0,0,16663,6.8,17669,214,48,-1147,-684,26.2,1666.3,67,4,0,7,6,7,1,1,0,0,17810,7.0,18353,204,56,1147,684,26.0,1781.0
4732890627,0,17,3,1,5,8,9,0,0,0,0,17148,6.8,17357,199,56,-703,406,25.5,1714.8,10,0,0,8,5,11,1,1,0,0,17851,6.8,16951,206,59,703,-406,26.5,1785.1
4732876300,0,12,1,1,11,16,6,0,0,0,0,19894,6.8,17829,217,44,-1614,-860,26.1,1989.4,11,0,0,16,11,17,0,0,0,0,21508,7.0,18689,230,44,1614,860,27.4,2150.8
4732844580,1,36,3,1,5,4,7,1,0,1,0,16584,6.8,17764,233,68,163,-605,30.1,1658.4,39,5,0,4,5,4,1,1,0,0,16421,7.2,18369,228,55,-163,605,28.3,1642.1
4727763159,0,12,1,1,10,9,9,0,0,0,0,18613,6.8,17449,227,48,550,105,27.5,1861.3,14,1,0,9,10,6,0,0,0,0,18063,6.8,17344,193,56,-550,-105,24.9,1806.3
4727734650,0,12,2,0,2,6,3,1,1,0,0,15785,7.0,18050,233,67,-1498,-1345,30.0,1578.5,12,1,1,6,2,6,0,0,0,0,17283,7.0,19395,217,64,1498,1345,28.1,1728.3
4855274932,1,0,0,1,7,17,13,0,0,0,0,43850,10.0,47500,0,0,14600,19000,0.0,4385.0,0,0,0,13,3,9,0,0,0,0,29250,6.0,28500,0,0,-14600,-19000,0.0,2925.0
4855241483,1,0,0,0,15,24,17,0,0,0,0,61775,12.0,55000,0,0,23505,22000,0.0,6177.5,0,0,1,15,6,14,0,0,0,0,38270,7.2,33000,0,0,-23505,-22000,0.0,3827.0
4855220797,1,0,0,1,18,11,16,0,0,0,0,47700,10.0,47500,0,0,19000,16000,0.0,4770.0,3,0,0,6,13,7,0,0,0,0,28700,6.6,31500,0,0,-19000,-16000,0.0,2870.0
4855185382,1,0,0,0,12,19,14,0,0,0,0,45950,10.0,47500,0,0,17400,16000,0.0,4595.0,0,0,1,13,6,7,0,0,0,0,28550,6.6,31500,0,0,-17400,-16000,0.0,2855.0
4855143542,1,1,0,1,27,19,24,0,0,0,0,64500,12.8,59000,1,0,27650,26000,0.1,6450.0,0,0,0,9,17,8,0,0,0,0,36850,7.2,33000,0,0,-27650,-26000,0.0,3685.0
4855103152,1,0,0,0,14,18,19,0,0,0,0,46440,10.0,47500,0,0,18738,19000,0.0,4644.0,0,0,1,12,8,7,0,0,0,0,27702,6.0,28500,4,0,-18738,-19000,0.4,2770.2
4854951526,1,0,0,0,15,20,15,0,0,0,0,49650,12.0,55000,0,0,17900,22000,0.0,4965.0,0,0,1,13,8,12,0,0,0,0,31750,7.2,33000,0,0,-17900,-22000,0.0,3175.0
4854929447,1,0,0,1,20,16,16,0,0,0,0,45950,10.0,47500,0,0,18800,19000,0.0,4595.0,0,0,0,7,11,11,0,0,0,0,27150,6.0,28500,0,0,-18800,-19000,0.0,2715.0
4854906273,1,0,0,0,16,15,16,0,0,0,0,61300,12.8,59000,0,0,24800,26000,0.0,6130.0,0,0,1,9,10,8,0,0,0,0,36500,7.2,33000,0,0,-24800,-26000,0.0,3650.0
4845263037,0,68,0,1,21,24,59,0,0,0,0,36319,11.0,40790,95,0,-909,-1718,9.5,3631.9,0,0,0,24,21,62,0,0,0,0,37228,11.4,42508,99,0,909,1718,9.9,3722.8
4834890926,1,18,1,1,15,12,43,0,0,0,0,36640,11.2,42722,100,67,5435,4669,16.7,3664.0,10,0,0,12,15,20,0,0,0,0,31205,10.8,38053,103,59,-5435,-4669,16.2,3120.5
4832951131,0,18,0,1,12,17,23,0,0,0,0,31581,10.2,33618,86,47,287,-1333,13.3,3158.1,18,0,0,17,12,19,0,0,0,0,31294,10.2,34951,80,55,-287,1333,13.5,3129.4
4832933172,0,13,0,1,12,6,26,0,0,0,1,33138,11.0,38934,98,71,-2315,-2482,16.9,3313.8,17,0,0,6,12,11,0,0,0,0,35453,11.2,41416,123,65,2315,2482,18.8,3545.3
4832908287,1,13,1,0,18,28,31,0,0,0,1,38276,10.4,36295,86,48,-3074,-5797,13.4,3827.6,13,0,1,28,18,71,0,0,0,0,41350,11.4,42092,101,67,3074,5797,16.8,4135.0
4832886474,1,13,0,1,10,17,12,0,0,0,0,36324,11.2,40985,111,51,3373,2832,16.2,3632.4,12,1,0,17,10,26,0,0,0,0,32951,10.8,38153,99,49,-3373,-2832,14.8,3295.1
4832875998,1,16,0,1,27,17,53,0,0,0,1,39476,11.8,45659,89,67,6677,6515,15.6,3947.6,45,0,0,17,27,33,0,0,0,0,32799,11.2,39144,95,55,-6677,-6515,15.0,3279.9
4832777827,0,15,1,1,8,11,7,0,0,0,0,17123,6.8,17341,190,55,-757,133,24.5,1712.3,15,0,0,11,8,6,1,1,0,0,17880,6.8,17208,173,64,757,-133,23.7,1788.0
4773031948,1,0,0,1,31,24,77,0,0,0,0,38730,11.8,43781,107,0,1465,3014,10.7,3873.0,0,0,0,24,31,41,0,0,0,0,37265,11.4,40767,101,0,-1465,-3014,10.1,3726.5
4760415542,1,11,2,1,5,8,2,0,0,0,0,16154,6.8,18594,210,52,-2221,-222,26.2,1615.4,80,1,0,8,5,5,1,1,0,0,18375,7.0,18816,207,56,2221,222,26.3,1837.5
4755645284,1,0,0,1,17,17,18,0,0,0,0,62010,13.8,66500,0,0,24110,29000,0.0,6201.0,73,0,0,10,10,10,0,0,0,0,37900,7.8,37500,0,0,-24110,-29000,0.0,3790.0
4857935102,1,52,2,1,8,5,7,1,1,0,0,17780,7.0,17998,191,56,1153,-180,24.7,1778.0,13,1,0,5,8,3,0,0,0,0,16627,6.8,18178,217,56,-1153,180,27.3,1662.7
4857916211,1,19,1,0,4,7,1,0,0,0,0,14968,6.8,17169,202,58,-1823,-11,26.0,1496.8,53,0,1,7,4,7,0,0,0,0,16791,6.6,17180,185,47,1823,11,23.2,1679.1
4857893801,1,229,3,0,7,8,8,0,0,0,0,17952,6.6,17594,226,52,1316,361,27.8,1795.2,12,0,1,8,7,7,0,0,0,0,16636,6.6,17233,189,48,-1316,-361,23.7,1663.6
4857807660,1,0,0,0,17,18,18,0,0,0,0,47135,10.4,49000,1,0,17350,20500,0.1,4713.5,18,1,1,13,12,14,0,0,0,0,29785,6.0,28500,4,0,-17350,-20500,0.4,2978.5
4857804930,1,1,0,1,22,13,22,0,0,0,0,47769,10.0,47500,0,0,20966,19000,0.0,4776.9,32,0,0,8,17,6,0,0,0,0,26803,6.0,28500,0,0,-20966,-19000,0.0,2680.3
4857796879,1,27,3,0,24,16,23,0,0,0,0,48115,10.0,47500,2,0,21495,19000,0.2,4811.5,0,0,1,9,17,6,0,0,0,0,26620,6.0,28500,0,0,-21495,-19000,0.0,2662.0
4857782197,1,0,0,1,17,15,22,0,0,0,0,62700,12.0,55000,0,0,27600,22000,0.0,6270.0,12,0,0,8,10,3,0,0,0,0,35100,7.2,33000,0,0,-27600,-22000,0.0,3510.0
4857775272,1,0,0,1,15,15,17,0,0,0,0,57675,12.0,55000,0,0,22215,22000,0.0,5767.5,0,0,0,8,8,9,0,0,0,0,35460,7.2,33000,0,0,-22215,-22000,0.0,3546.0
4857766510,1,32,5,1,20,10,16,0,0,0,0,67432,12.0,55000,4,0,31952,22000,0.4,6743.2,0,6,0,3,13,5,0,0,0,0,35480,7.2,33000,0,0,-31952,-22000,0.0,3548.0
4857762101,1,0,0,1,13,14,13,0,0,0,0,63037,12.0,55000,0,0,25837,22000,0.0,6303.7,0,0,0,11,10,8,0,0,0,0,37200,7.2,33000,0,0,-25837,-22000,0.0,3720.0
4857756184,1,0,0,0,20,15,18,0,0,0,0,47350,10.0,47500,0,0,20200,19000,0.0,4735.0,0,0,1,8,13,5,0,0,0,0,27150,6.0,28500,0,0,-20200,-19000,0.0,2715.0
4857746537,1,105,0,1,19,16,15,0,0,0,0,46710,10.0,47500,0,0,17439,19000,0.0,4671.0,78,0,0,10,13,13,0,0,0,0,29271,6.0,28500,0,0,-17439,-19000,0.0,2927.1
4857741319,1,0,0,1,17,12,13,0,0,0,0,47350,10.0,47500,0,0,20200,19000,0.0,4735.0,3,0,0,4,9,8,0,0,0,0,27150,6.0,28500,0,0,-20200,-19000,0.0,2715.0
4857733550,1,0,0,0,18,17,21,0,0,0,0,62732,12.0,55000,0,0,24782,22000,0.0,6273.2,40,0,1,10,11,9,0,0,0,0,37950,7.2,33000,0,0,-24782,-22000,0.0,3795.0
4856673861,1,0,0,1,15,20,13,0,0,0,0,62350,12.0,55000,0,0,23400,22000,0.0,6235.0,0,0,0,13,8,14,0,0,0,0,38950,7.2,33000,0,0,-23400,-22000,0.0,3895.0
4856668781,1,0,0,0,14,20,17,0,0,0,0,40350,10.0,47500,0,0,11800,19000,0.0,4035.0,0,0,1,14,8,10,0,0,0,0,28550,6.0,28500,0,0,-11800,-19000,0.0,2855.0
4856641930,1,0,0,1,20,15,22,0,0,0,0,63050,12.0,55000,0,0,26200,22000,0.0,6305.0,5,0,0,7,12,8,0,0,0,0,36850,7.2,33000,0,0,-26200,-22000,0.0,3685.0
4856635902,1,47,3,1,20,17,17,0,0,0,0,62030,12.0,55000,3,0,24820,22000,0.3,6203.0,0,1,0,8,11,11,0,0,0,0,37210,7.2,33000,1,0,-24820,-22000,0.1,3721.0
4856620532,1,22,3,1,17,11,17,0,0,0,0,62474,12.0,55000,6,0,26934,22000,0.6,6247.4,43,9,0,7,13,2,0,0,0,0,35540,7.2,33000,9,0,-26934,-22000,0.9,3554.0
4856612302,1,16,0,0,15,18,14,0,0,0,0,46300,10.0,47500,0,0,17400,19000,0.0,4630.0,0,0,1,12,9,11,0,0,0,0,28900,6.0,28500,0,0,-17400,-19000,0.0,2890.0
4842679325,1,12,0,1,8,2,9,0,0,0,0,17434,7.2,18680,176,64,2179,835,24.0,1743.4,13,0,0,2,8,1,0,0,0,0,15255,6.8,17845,231,44,-2179,-835,27.5,1525.5
4842660913,1,9,0,1,7,1,8,0,0,0,0,18152,7.2,19347,207,56,4306,3031,26.3,1815.2,12,0,0,1,7,2,0,0,0,0,13846,6.4,16316,166,36,-4306,-3031,20.2,1384.6
4842630678,0,9,2,1,6,2,3,1,1,0,0,16407,7.2,18739,220,60,1791,1178,28.0,1640.7,19,0,0,2,6,2,0,0,0,0,14616,6.8,17561,205,52,-1791,-1178,25.7,1461.6
4842623090,0,8,1,0,0,9,0,0,0,0,0,13097,6.6,16118,176,76,-5233,-2842,25.2,1309.7,15,3,1,9,0,9,0,0,0,0,18330,7.0,18960,237,51,5233,2842,28.8,1833.0
4842596309,0,10,1,1,4,2,3,0,0,0,0,15263,7.0,18242,205,52,-345,485,25.7,1526.3,9,1,0,2,4,1,0,0,0,0,15608,7.0,17757,220,52,345,-485,27.2,1560.8
4841615766,0,68,0,0,11,10,29,0,0,0,0,34518,10.6,37974,108,0,628,1789,10.8,3451.8,0,0,1,10,11,25,0,0,0,0,33890,10.4,36185,114,0,-628,-1789,11.4,3389.0
4841589940,0,12,0,1,8,5,7,0,0,0,0,19021,7.4,19593,219,60,3553,2583,27.9,1902.1,11,0,0,5,8,2,0,0,0,0,15468,6.6,17010,176,56,-3553,-2583,23.2,1546.8
4841566960,1,13,0,0,8,5,9,0,0,0,0,17505,7.0,18317,231,60,1439,1035,29.1,1750.5,13,0,1,5,8,6,0,0,0,0,16066,6.8,17282,189,52,-1439,-1035,24.1,1606.6
4841531142,0,12,3,1,5,10,3,0,0,0,0,15932,6.8,18120,218,52,-2373,407,27.0,1593.2,17,2,0,10,5,12,0,0,0,0,18305,6.8,17713,208,46,2373,-407,25.4,1830.5
4841499883,0,19,1,1,6,4,4,0,0,0,0,15936,7.2,18319,221,52,1148,565,27.3,1593.6,13,0,0,4,6,3,1,1,0,0,14788,6.8,17754,192,56,-1148,-565,24.8,1478.8
4841467367,1,1,0,0,30,28,71,0,0,0,1,38723,11.6,43982,93,0,271,479,9.3,3872.3,0,0,1,28,30,48,0,0,0,0,38452,11.6,43503,107,0,-271,-479,10.7,3845.2
4841424062,1,12,0,1,8,9,6,0,0,0,0,15620,6.2,14986,137,59,-2540,-2037,19.6,1562.0,11,0,0,9,8,7,0,0,0,0,18160,6.6,17023,181,48,2540,2037,22.9,1816.0
4841388405,0,17,0,0,28,31,62,0,0,0,1,37127,11.2,41676,88,0,-5323,-5041,8.8,3712.7,0,0,1,31,28,59,0,0,0,0,42450,12.0,46717,97,0,5323,5041,9.7,4245.0
4840538447,1,89,0,1,15,18,41,0,0,0,0,35198,10.6,36545,109,0,774,-635,10.9,3519.8,0,0,0,18,15,36,0,0,0,0,34424,10.6,37180,118,0,-774,635,11.8,3442.4
4840523679,0,13,3,0,2,7,1,0,0,0,0,14352,6.6,17754,214,40,-2252,-666,25.4,1435.2,11,3,1,7,2,6,1,1,0,0,16604,7.0,18420,203,60,2252,666,26.3,1660.4
4840501438,1,11,1,0,7,10,5,0,0,0,0,17311,7.0,17731,181,48,-720,-144,22.9,1731.1,6,0,1,10,7,11,0,0,0,0,18031,6.8,17875,197,40,720,144,23.7,1803.1
4840482070,0,12,0,0,4,4,3,0,0,0,0,17164,6.8,18124,210,44,2121,496,25.4,1716.4,85,0,1,4,4,2,0,0,0,0,15043,6.6,17628,182,56,-2121,-496,23.8,1504.3
4840445464,1,13,0,1,6,2,6,0,0,0,0,16824,7.0,17975,193,51,2687,-223,24.4,1682.4,10,0,0,2,6,2,0,0,0,0,14137,6.8,18198,193,60,-2687,223,25.3,1413.7
4840418355,0,0,0,0,25,17,65,0,0,0,1,40036,11.4,42707,99,0,4414,3562,9.9,4003.6,0,0,1,17,25,26,0,0,0,0,35622,11.0,39145,95,0,-4414,-3562,9.5,3562.2
4840283951,1,14,0,1,8,0,9,1,1,0,0,16281,7.0,18136,212,43,1067,567,25.5,1628.1,10,0,0,0,8,0,0,0,0,0,15214,6.6,17569,225,56,-1067,-567,28.1,1521.4
4856547758,1,0,0,0,21,17,20,0,0,0,0,64156,12.0,55000,0,0,26956,22000,0.0,6415.6,0,0,1,11,15,8,0,0,0,0,37200,7.2,33000,0,0,-26956,-22000,0.0,3720.0
4856515275,1,11,1,1,9,11,7,1,0,1,0,18945,7.0,17953,202,59,-44,-996,26.1,1894.5,13,0,0,11,9,8,1,1,0,0,18989,7.2,18949,191,68,44,996,25.9,1898.9
4855387162,0,10,0,0,6,9,5,0,0,0,0,15329,6.4,15957,155,49,-2576,-1202,20.4,1532.9,8,0,1,9,6,8,0,0,0,0,17905,7.0,17159,205,48,2576,1202,25.3,1790.5
4855336538,1,8,1,1,7,7,8,1,1,0,0,16609,7.0,17516,207,64,703,-47,27.1,1660.9,8,0,0,6,6,3,0,0,0,0,15906,6.8,17563,189,48,-703,47,23.7,1590.6
4855312917,1,0,0,1,20,18,22,0,0,0,0,48050,10.0,47500,0,0,20900,19000,0.0,4805.0,0,0,0,10,12,5,0,0,0,0,27150,6.0,28500,0,0,-20900,-19000,0.0,2715.0
4855286366,1,0,0,1,17,13,17,0,0,0,0,45630,10.0,47500,0,0,19322,16000,0.0,4563.0,0,0,0,7,11,6,0,0,0,0,26308,6.6,31500,0,0,-19322,-16000,0.0,2630.8
4855266003,1,0,0,1,18,17,21,0,0,0,0,62700,13.0,62500,0,0,24800,25000,0.0,6270.0,5,0,0,11,12,8,0,0,0,0,37900,7.8,37500,0,0,-24800,-25000,0.0,3790.0
4855190632,1,48,0,1,8,4,8,0,0,0,0,18050,7.2,19920,183,56,2566,1616,23.9,1805.0,63,0,0,4,8,4,1,1,0,0,15484,7.0,18304,194,56,-2566,-1616,25.0,1548.4
4855164906,0,9,0,1,9,6,5,0,0,0,0,16318,7.0,17658,149,64,-1523,-1349,21.3,1631.8,17,1,0,6,9,4,1,1,0,0,17841,7.2,19007,213,60,1523,1349,27.3,1784.1
4855125555,1,6,0,1,25,15,30,0,0,0,0,66200,13.0,62500,0,0,30400,28000,0.0,6620.0,6,0,0,7,17,5,0,0,0,0,35800,7.4,34500,0,0,-30400,-28000,0.0,3580.0
4855090839,0,3,0,0,26,34,52,0,0,0,1,39596,11.4,42799,99,0,-328,-2302,9.9,3959.6,15,0,1,34,26,96,0,0,0,0,39924,11.8,45101,112,0,328,2302,11.2,3992.4
4855061459,0,0,0,1,26,33,70,0,0,0,0,37307,11.4,41828,67,0,-1185,-2315,6.7,3730.7,3,0,0,33,26,83,0,0,0,0,38492,11.6,44143,111,0,1185,2315,11.1,3849.2
4854061004,1,22,1,0,9,7,8,0,0,0,0,17318,6.4,15311,136,52,997,-1473,18.8,1731.8,9,1,1,7,9,5,1,1,0,0,16321,6.6,16784,192,52,-997,1473,24.4,1632.1
4852845290,1,13,1,1,12,7,6,0,0,0,0,17947,7.2,19052,226,44,2425,1701,27.0,1794.7,10,1,0,7,12,4,0,0,0,0,15522,6.8,17351,185,48,-2425,-1701,23.3,1552.2
4852792873,0,119,0,1,3,8,2,0,0,0,0,14574,6.6,15600,178,52,-3158,-3294,23.0,1457.4,12,1,0,8,3,2,1,1,0,0,17732,7.2,18894,229,52,3158,3294,28.1,1773.2
4852453729,1,14,3,1,11,6,11,0,0,0,0,18822,7.2,18326,219,48,3108,230,26.7,1882.2,14,1,0,6,11,1,0,0,0,0,15714,7.0,18096,196,48,-3108,-230,24.4,1571.4
4848933477,1,0,0,1,32,22,74,0,0,0,1,40430,11.8,43335,116,0,2966,2647,11.6,4043.0,0,0,0,22,32,50,0,0,0,0,37464,11.0,40688,103,0,-2966,-2647,10.3,3746.4
4848906225,0,0,0,1,28,26,68,0,0,0,0,39146,11.4,43021,91,0,1551,563,9.1,3914.6,0,0,0,26,28,62,0,0,0,0,37595,11.4,42458,116,0,-1551,-563,11.6,3759.5
4848877999,0,35,0,0,27,29,90,0,0,0,2,37566,11.0,39963,94,0,-730,-2589,9.4,3756.6,0,0,1,29,27,73,0,0,0,0,38296,11.6,42552,90,0,730,2589,9.0,3829.6
4848586506,0,29,2,1,3,2,3,0,0,0,0,15364,6.8,17460,228,52,408,-405,28.0,1536.4,14,1,0,2,3,1,1,1,0,0,14956,7.0,17865,231,56,-408,405,28.7,1495.6
4849715475,0,33,2,1,4,6,8,1,1,0,0,17218,6.8,17520,214,64,-497,-1198,27.8,1721.8,54,3,0,6,4,10,0,0,0,0,17715,6.8,18718,210,56,497,1198,26.6,1771.5
4849693848,1,11,1,0,1,7,1,0,0,0,0,14296,6.6,17121,188,72,-2319,-1021,26.0,1429.6,12,0,1,7,1,6,0,0,0,0,16615,7.0,18142,205,68,2319,1021,27.3,1661.5
4843080657,1,12,0,0,6,5,4,2,1,1,0,17159,7.4,19826,217,80,1437,2036,29.7,1715.9,15,0,1,5,6,8,0,0,0,0,15722,6.8,17790,175,64,-1437,-2036,23.9,1572.2
4843057615,1,9,3,0,10,4,10,0,0,0,0,18258,7.0,18809,185,64,2521,1894,24.9,1825.8,10,1,1,4,10,4,0,0,0,0,15737,6.6,16915,231,48,-2521,-1894,27.9,1573.7
4843041308,1,13,2,1,8,3,6,1,1,0,0,16960,7.0,17882,178,72,2575,338,25.0,1696.0,15,0,0,2,7,1,0,0,0,0,14385,6.8,17544,219,48,-2575,-338,26.7,1438.5
4842364539,0,37,0,1,7,5,6,0,0,0,0,17451,6.8,18017,216,55,1945,668,27.1,1745.1,13,12,0,5,7,4,0,0,0,0,15506,6.8,17349,199,44,-1945,-668,24.3,1550.6
4842315703,0,12,0,0,6,8,1,0,0,0,0,18300,7.2,19326,275,38,-189,1299,31.3,1830.0,9,1,1,8,6,6,0,0,0,0,18489,6.8,18027,227,53,189,-1299,28.0,1848.9
4842276121,1,12,3,0,8,7,6,0,0,0,0,18488,7.2,18392,210,54,876,-7,26.4,1848.8,14,3,1,7,8,7,0,0,0,0,17612,7.0,18399,226,49,-876,7,27.5,1761.2
4841739918,0,14,2,0,5,9,7,0,0,0,0,15841,6.6,16146,184,52,-2939,-4025,23.6,1584.1,13,3,1,9,5,4,0,0,0,0,18780,7.4,20171,214,83,2939,4025,29.7,1878.0
4841726364,1,12,0,1,5,0,7,1,1,0,0,17816,7.0,18129,232,62,4185,1551,29.4,1781.6,14,0,0,0,5,0,0,0,0,0,13631,6.6,16578,217,31,-4185,-1551,24.8,1363.1
4841323694,1,16,2,1,7,0,12,1,0,1,0,18778,7.2,19038,267,59,4811,913,32.6,1877.8,13,1,0,0,7,0,1,1,0,0,13967,7.0,18125,226,64,-4811,-913,29.0,1396.7
4841280170,1,14,1,1,6,3,4,1,1,0,0,16825,7.0,18346,240,67,984,303,30.7,1682.5,7,0,0,3,6,2,0,0,0,0,15841,6.8,18043,212,44,-984,-303,25.6,1584.1
4841111286,1,17,0,1,6,13,5,1,1,0,0,17772,7.0,18311,234,72,-1183,-109,30.6,1777.2,6,1,0,12,5,10,0,0,0,0,18955,7.0,18420,202,52,1183,109,25.4,1895.5
4841078925,1,12,2,1,7,7,8,1,1,0,0,17050,7.0,17956,212,51,682,1562,26.3,1705.0,15,0,0,7,7,6,0,0,0,0,16368,6.8,16394,179,40,-682,-1562,21.9,1636.8
4841029499,0,8,0,0,1,2,0,0,0,0,0,13907,6.8,18404,221,48,-922,106,26.9,1390.7,13,1,1,2,1,0,0,0,0,0,14829,7.0,18298,243,56,922,-106,29.9,1482.9
4841007065,0,10,0,1,6,5,9,0,0,0,0,17605,7.0,18391,256,48,1190,-1027,30.4,1760.5,11,0,0,5,6,2,1,1,0,0,16415,7.2,19418,228,76,-1190,1027,30.4,1641.5
4840960393,1,15,0,1,12,4,12,0,0,0,0,19377,6.6,17117,208,65,3317,1090,27.3,1937.7,11,2,0,4,12,4,1,1,0,0,16060,6.6,16027,196,48,-3317,-1090,24.4,1606.0
4840701049,1,18,5,1,9,3,8,1,1,0,0,19328,7.0,19144,224,50,3037,995,27.4,1932.8,14,1,0,3,9,2,0,0,0,0,16291,6.8,18149,215,49,-3037,-995,26.4,1629.1
4840676274,1,13,3,1,10,2,8,0,0,0,0,17464,6.8,17008,210,46,2206,-531,25.6,1746.4,15,1,0,1,9,1,0,0,0,0,15258,6.8,17539,195,64,-2206,531,25.9,1525.8
4840666779,0,38,0,0,4,6,6,0,0,0,0,15563,6.6,16682,179,48,-2453,-2644,22.7,1556.3,30,1,1,6,4,6,1,1,0,0,18016,7.4,19326,224,64,2453,2644,28.8,1801.6
4743571565,1,12,4,0,10,5,10,1,1,0,0,18650,7.4,19468,242,64,3694,4419,30.6,1865.0,11,2,1,5,10,6,0,0,0,0,14956,6.2,15049,179,36,-3694,-4419,21.5,1495.6
4743537005,0,12,1,0,6,10,2,0,0,0,0,16310,7.0,17518,206,60,-3572,-851,26.6,1631.0,14,1,1,10,6,10,1,1,0,0,19882,7.0,18369,218,68,3572,851,28.6,1988.2
4743489531,0,8,1,0,7,6,6,0,0,0,0,18622,7.2,18891,234,66,2002,2318,30.0,1862.2,15,1,1,6,7,7,1,1,0,0,16620,6.6,16573,214,61,-2002,-2318,27.5,1662.0
4743454181,0,15,4,0,2,7,4,0,0,0,0,16356,7.0,17672,243,56,-1637,-820,29.9,1635.6,15,3,1,7,2,12,0,0,0,0,17993,7.0,18492,226,67,1637,820,29.3,1799.3
4743420328,0,14,1,0,5,5,7,0,0,0,0,16489,7.2,18634,236,64,-585,504,30.0,1648.9,11,1,1,5,5,4,1,1,0,0,17074,7.0,18130,270,52,585,-504,32.2,1707.4
4743328702,0,12,1,0,6,8,4,0,0,0,0,17036,6.8,17741,202,43,-1025,-194,24.5,1703.6,11,2,1,8,6,10,1,1,0,0,18061,7.2,17935,204,52,1025,194,25.6,1806.1
4743307311,0,15,3,0,7,8,5,1,1,0,0,17574,7.2,18010,235,52,-297,-17,28.7,1757.4,14,0,1,8,7,6,0,0,0,0,17871,7.0,18027,172,63,297,17,23.5,1787.1
4743280984,0,14,0,0,5,8,4,0,0,0,0,16591,7.0,17383,214,56,-1554,-1231,27.0,1659.1,14,0,1,8,5,6,0,0,0,0,18145,7.2,18614,253,52,1554,1231,30.5,1814.5
4713043538,1,11,2,1,9,4,5,1,1,0,0,18815,7.2,18853,255,52,2741,2126,30.7,1881.5,7,1,0,4,9,3,0,0,0,0,16074,6.6,16727,209,40,-2741,-2126,24.9,1607.4
4713017746,1,15,5,1,8,3,6,0,0,0,0,17199,6.6,16957,227,44,2660,161,27.1,1719.9,16,0,0,3,8,2,0,0,0,0,14539,6.8,16796,183,64,-2660,-161,24.7,1453.9
4698963118,1,9,1,1,6,6,4,0,0,0,0,17851,7.2,18767,230,59,1680,1592,28.9,1785.1,12,0,0,6,6,7,0,0,0,0,16171,6.6,17175,198,40,-1680,-1592,23.8,1617.1
4698945268,0,13,0,1,6,3,9,1,0,1,0,17278,6.8,17647,247,56,1080,-1245,30.3,1727.8,12,0,0,3,6,1,1,1,0,0,16198,7.0,18892,231,72,-1080,1245,30.3,1619.8
4698025297,1,11,1,1,9,6,9,0,0,0,0,17860,6.6,17233,210,46,1372,-265,25.6,1786.0,15,0,0,6,9,5,0,0,0,0,16488,6.8,17498,235,49,-1372,265,28.4,1648.8
4698008962,1,11,4,1,8,5,7,1,1,0,0,17668,7.2,19351,204,56,1809,852,26.0,1766.8,11,4,0,5,8,5,0,0,0,0,15859,7.0,18499,196,48,-1809,-852,24.4,1585.9
4697987746,1,12,2,1,1,6,1,0,0,0,0,15307,6.8,17427,218,60,-1619,-2061,27.8,1530.7,10,0,0,6,1,4,0,0,0,0,16926,7.4,19488,239,67,1619,2061,30.6,1692.6
4697964611,0,36,1,0,3,7,1,1,1,0,0,14837,6.6,16319,198,52,-2158,-1112,25.0,1483.7,12,1,1,7,3,6,0,0,0,0,16995,6.8,17431,208,40,2158,1112,24.8,1699.5
4697948127,0,13,2,0,5,8,3,1,1,0,0,15968,6.6,17466,225,43,-2687,-285,26.8,1596.8,26,2,1,8,5,12,0,0,0,0,18655,6.8,17751,236,52,2687,285,28.8,1865.5
4692055164,1,14,1,1,7,4,4,0,0,0,0,18195,7.0,17949,222,51,1762,390,27.3,1819.5,10,0,0,4,7,4,0,0,0,0,16433,7.0,17559,197,46,-1762,-390,24.3,1643.3
4692039427,1,28,2,1,3,6,1,0,0,0,0,16482,7.4,19912,256,71,873,2772,32.7,1648.2,13,15,0,6,3,10,1,1,0,0,15609,6.8,17140,179,65,-873,-2772,24.4,1560.9
4692026096,1,15,1,1,6,5,5,2,1,1,0,18073,7.2,19612,226,66,1806,1665,29.2,1807.3,73,4,0,5,6,7,0,0,0,0,16267,7.0,17947,189,48,-1806,-1665,23.7,1626.7
