gameId,blueWins,blueWardsPlaced,blueWardsDestroyed,blueFirstBlood,blueKills,blueDeaths,blueAssists,blueEliteMonsters,blueDragons,blueHeralds,blueTowersDestroyed,blueTotalGold,blueAvgLevel,blueTotalExperience,blueTotalMinionsKilled,blueTotalJungleMinionsKilled,blueGoldDiff,blueExperienceDiff,blueCSPerMin,blueGoldPerMin,redWardsPlaced,redWardsDestroyed,redFirstBlood,redKills,redDeaths,redAssists,redEliteMonsters,redDragons,redHeralds,redTowersDestroyed,redTotalGold,redAvgLevel,redTotalExperience,redTotalMinionsKilled,redTotalJungleMinionsKilled,redGoldDiff,redExperienceDiff,redCSPerMin,redGoldPerMin
4856414431,1,15,0,1,15,12,18,0,0,0,0,33670,9.0,40000,6,0,15170,16000,0.6,3367.0,1,0,0,7,10,3,0,0,0,0,18500,5.4,24000,0,0,-15170,-16000,0.0,1850.0
4856393837,1,292,3,1,18,17,20,0,0,0,0,47864,10.0,47500,1,0,19426,19000,0.1,4786.4,118,0,0,8,9,6,0,0,0,0,28438,6.0,28500,7,0,-19426,-19000,0.7,2843.8
4856362453,1,0,0,0,14,22,10,0,0,0,0,46916,10.0,47500,0,0,17666,19000,0.0,4691.6,0,0,1,13,5,14,0,0,0,0,29250,6.0,28500,0,0,-17666,-19000,0.0,2925.0
4856334686,1,0,0,1,15,14,19,0,0,0,0,48135,10.6,50500,1,0,20960,22000,0.1,4813.5,0,0,0,10,11,7,0,0,0,0,27175,6.0,28500,0,0,-20960,-22000,0.0,2717.5
4856301648,1,0,0,0,18,19,20,0,0,0,0,63050,12.0,55000,0,0,24800,22000,0.0,6305.0,0,0,1,10,9,12,0,0,0,0,38250,7.2,33000,0,0,-24800,-22000,0.0,3825.0
4855198934,1,0,0,0,14,20,14,0,0,0,0,46424,10.0,47500,0,0,17480,19000,0.0,4642.4,0,0,1,11,5,12,0,0,0,0,28944,6.0,28500,0,0,-17480,-19000,0.0,2894.4
4855168560,1,3,0,0,12,25,17,0,0,0,0,62000,12.6,59500,16,0,22700,22000,1.6,6200.0,13,0,1,19,6,16,0,0,0,0,39300,7.8,37500,9,0,-22700,-22000,0.9,3930.0
4855149891,1,29,1,1,18,13,14,0,0,0,0,46910,10.0,47500,1,0,19385,19000,0.1,4691.0,0,0,0,8,13,9,0,0,0,0,27525,6.0,28500,1,0,-19385,-19000,0.1,2752.5
4855117025,1,246,1,0,18,18,18,0,0,0,0,56255,12.0,55000,8,0,18945,22000,0.8,5625.5,176,2,1,10,10,12,0,0,0,0,37310,7.2,33000,2,0,-18945,-22000,0.2,3731.0
4854380949,1,176,0,1,18,22,14,0,0,0,0,62400,12.8,59000,2,0,21150,26000,0.2,6240.0,176,0,0,11,7,10,0,0,0,0,41250,7.2,33000,0,0,-21150,-26000,0.0,4125.0
4854371130,1,27,2,0,20,21,15,0,0,0,0,48435,10.0,47500,1,0,19595,19000,0.1,4843.5,0,6,1,10,9,12,0,0,0,0,28840,6.0,28500,0,0,-19595,-19000,0.0,2884.0
4854359585,1,0,0,0,17,17,19,0,0,0,0,47393,10.0,47500,2,0,17126,19000,0.2,4739.3,0,0,1,12,12,10,0,0,0,0,30267,6.0,28500,2,0,-17126,-19000,0.2,3026.7
4854351354,1,58,0,0,16,17,20,0,0,0,0,62609,12.8,61000,0,0,26103,25000,0.0,6260.9,2,0,1,11,10,10,0,0,0,0,36506,7.6,36000,0,0,-26103,-25000,0.0,3650.6
4854344890,1,0,3,1,21,16,25,0,0,0,0,64285,12.0,55000,2,0,27560,22000,0.2,6428.5,35,0,0,10,15,10,0,0,0,0,36725,7.2,33000,7,0,-27560,-22000,0.7,3672.5
4854321654,1,6,1,0,10,13,9,0,0,0,0,45255,10.0,47500,0,0,17270,19000,0.0,4525.5,29,2,1,10,7,8,0,0,0,0,27985,6.0,28500,5,0,-17270,-19000,0.5,2798.5
4854308580,1,252,0,0,15,15,12,0,0,0,0,48470,10.0,47500,0,0,20575,17820,0.0,4847.0,36,0,1,8,8,10,0,0,0,0,27895,6.2,29680,0,0,-20575,-17820,0.0,2789.5
4854299343,1,6,0,0,20,13,22,0,0,0,0,46300,10.0,47500,0,0,18800,19000,0.0,4630.0,0,0,1,6,13,5,0,0,0,0,27500,6.0,28500,0,0,-18800,-19000,0.0,2750.0
4854284882,1,0,0,1,21,13,19,0,0,0,0,53847,12.0,55000,0,0,22607,22000,0.0,5384.7,0,0,0,6,14,6,0,0,0,0,31240,7.2,33000,0,0,-22607,-22000,0.0,3124.0
4854259637,1,0,0,1,24,17,18,0,0,0,0,65225,12.0,55000,0,0,27598,22000,0.0,6522.5,0,0,0,6,13,11,0,0,0,0,37627,7.2,33000,1,0,-27598,-22000,0.1,3762.7
4854247818,1,3,0,0,11,19,8,0,0,0,0,30950,10.0,47500,0,0,10675,19000,0.0,3095.0,0,0,1,12,4,13,0,0,0,0,20275,6.0,28500,1,0,-10675,-19000,0.1,2027.5
4840882530,0,16,0,1,6,4,6,1,1,0,0,16287,6.8,18388,213,56,516,578,26.9,1628.7,14,0,0,4,6,3,0,0,0,0,15771,7.0,17810,168,60,-516,-578,22.8,1577.1
4840163975,1,102,3,1,6,4,4,0,0,0,0,16480,7.0,17909,231,56,937,-141,28.7,1648.0,10,15,0,4,6,3,0,0,0,0,15543,6.8,18050,174,56,-937,141,23.0,1554.3
4840113632,0,45,0,0,0,2,0,0,0,0,0,14609,7.0,17802,208,56,-117,-192,26.4,1460.9,15,0,1,2,0,0,2,1,1,0,14726,6.8,17994,212,46,117,192,25.8,1472.6
4839851610,0,8,1,1,7,6,6,1,0,1,0,17502,7.2,18859,199,60,1120,1089,25.9,1750.2,16,0,0,6,7,4,0,0,0,0,16382,6.8,17770,195,52,-1120,-1089,24.7,1638.2
4839823271,1,10,1,0,5,4,0,2,1,1,0,15259,7.0,18558,207,60,759,949,26.7,1525.9,12,1,1,4,5,3,0,0,0,0,14500,6.8,17609,188,52,-759,-949,24.0,1450.0
4839789947,1,11,0,1,4,3,1,0,0,0,0,14203,7.0,18286,210,48,-651,847,25.8,1420.3,12,2,0,2,3,2,0,0,0,0,14854,6.8,17439,177,68,651,-847,24.5,1485.4
4839303688,0,67,0,0,12,21,27,0,0,0,1,32937,10.4,35523,87,0,-2295,-3055,8.7,3293.7,2,0,1,21,12,45,0,0,0,0,35232,10.8,38578,85,0,2295,3055,8.5,3523.2
4839285317,1,18,0,1,36,26,78,0,0,0,0,39635,11.8,45401,110,0,2200,4159,11.0,3963.5,18,0,0,26,36,55,0,0,0,0,37435,11.2,41242,131,0,-2200,-4159,13.1,3743.5
4837993766,1,10,1,1,3,1,2,0,0,0,0,13380,7.0,17402,160,40,-188,704,20.0,1338.0,101,0,0,1,3,2,0,0,0,0,13568,6.6,16698,190,44,188,-704,23.4,1356.8
4828150082,0,187,16,0,5,3,3,0,0,0,0,14351,6.6,16522,153,60,-779,-1230,21.3,1435.1,31,3,1,3,5,2,0,0,0,0,15130,6.8,17752,179,44,779,1230,22.3,1513.0
4828109756,1,20,3,0,8,5,8,0,0,0,0,17102,6.6,16639,172,50,2139,144,22.2,1710.2,17,3,1,5,8,6,0,0,0,0,14963,6.6,16495,181,42,-2139,-144,22.3,1496.3
4827372375,1,121,2,1,14,16,32,0,0,0,0,35818,10.8,37805,94,44,707,-378,13.8,3581.8,13,1,0,15,13,38,0,0,0,0,35111,10.8,38183,75,66,-707,378,14.1,3511.1
4827355521,1,18,0,1,19,11,38,0,0,0,0,38773,11.4,42092,111,68,5311,4284,17.9,3877.3,12,1,0,10,18,21,0,0,0,0,33462,10.8,37808,93,59,-5311,-4284,15.2,3346.2
4826814179,0,279,0,1,7,21,24,0,0,0,2,29116,10.0,33018,91,39,-11660,-10603,13.0,2911.6,12,0,0,21,7,49,0,0,0,0,40776,11.6,43621,135,59,11660,10603,19.4,4077.6
4826737948,1,99,0,1,13,6,21,0,0,0,0,35401,11.0,40598,97,63,5683,5614,16.0,3540.1,22,0,0,6,13,10,0,0,0,0,29718,10.4,34984,64,63,-5683,-5614,12.7,2971.8
4826706927,1,226,0,0,13,25,23,0,0,0,1,36513,10.8,38562,79,67,-487,-3546,14.6,3651.3,244,0,1,25,13,50,0,0,0,0,37000,11.4,42108,95,43,487,3546,13.8,3700.0
4807941498,0,223,0,0,2,7,2,0,0,0,0,14351,6.8,17238,161,44,-3155,-2220,20.5,1435.1,12,0,1,7,2,4,0,0,0,0,17506,7.2,19458,195,68,3155,2220,26.3,1750.6
4807919922,0,22,4,0,3,6,5,0,0,0,0,14723,6.4,16234,180,40,-760,-48,22.0,1472.3,11,2,1,6,3,9,1,1,0,0,15483,6.6,16282,148,64,760,48,21.2,1548.3
4806615439,1,1,0,0,21,18,53,0,0,0,0,35869,11.0,39226,100,0,1164,2981,10.0,3586.9,27,0,1,18,21,48,0,0,0,0,34705,10.6,36245,100,0,-1164,-2981,10.0,3470.5
4806596298,0,1,1,1,32,22,87,0,0,0,1,39398,11.4,42335,104,0,2892,1649,10.4,3939.8,50,0,0,22,32,61,0,0,0,0,36506,11.4,40686,91,0,-2892,-1649,9.1,3650.6
4747295102,0,15,2,0,4,4,3,0,0,0,0,16089,7.0,18153,210,52,54,1093,26.2,1608.9,9,2,1,4,4,4,0,0,0,0,16035,6.6,17060,208,59,-54,-1093,26.7,1603.5
4746402594,1,10,0,0,2,2,1,1,0,1,0,14584,7.0,17921,214,68,301,117,28.2,1458.4,13,3,1,2,2,1,0,0,0,0,14283,6.6,17804,214,52,-301,-117,26.6,1428.3
4745286309,1,13,2,1,4,8,2,0,0,0,0,15314,6.6,15949,206,48,-2802,-3347,25.4,1531.4,10,1,0,8,4,8,1,1,0,0,18116,7.2,19296,214,68,2802,3347,28.2,1811.6
4732192505,0,13,0,1,2,7,2,0,0,0,0,14678,6.6,16269,172,47,-3011,-1917,21.9,1467.8,11,1,0,7,2,5,1,1,0,0,17689,6.8,18186,213,60,3011,1917,27.3,1768.9
4731376573,0,8,0,0,3,5,5,0,0,0,0,13587,6.4,14727,149,50,-1922,-591,19.9,1358.7,14,0,1,5,3,3,0,0,0,0,15509,6.2,15318,150,38,1922,591,18.8,1550.9
4730939003,0,10,0,0,0,3,0,0,0,0,0,15018,6.8,18206,199,56,-1317,-54,25.5,1501.8,10,0,1,3,0,3,1,1,0,0,16335,7.0,18260,184,60,1317,54,24.4,1633.5
4730793756,1,10,3,1,8,2,5,1,1,0,0,17963,7.0,17682,200,48,4017,1774,24.8,1796.3,10,1,0,2,8,1,0,0,0,0,13946,6.4,15908,172,52,-4017,-1774,22.4,1394.6
4729929004,1,22,2,1,3,4,3,0,0,0,0,15059,6.6,16086,192,36,-235,-757,22.8,1505.9,14,1,0,4,3,6,0,0,0,0,15294,6.8,16843,175,64,235,757,23.9,1529.4
4729871466,1,20,0,0,2,7,0,0,0,0,0,16449,6.8,17567,194,56,85,488,25.0,1644.9,11,2,1,7,2,8,0,0,0,0,16364,6.6,17079,201,36,-85,-488,23.7,1636.4
4729841408,1,11,8,1,7,2,6,0,0,0,0,17970,7.0,18930,211,36,2892,1107,24.7,1797.0,30,0,0,2,7,2,1,1,0,0,15078,6.8,17823,181,79,-2892,-1107,26.0,1507.8
4727730990,1,8,1,1,4,8,3,0,0,0,0,14804,6.6,16197,169,35,-4611,-2968,20.4,1480.4,14,0,0,8,4,7,1,1,0,0,19415,7.2,19165,231,55,4611,2968,28.6,1941.5
4718370490,1,17,2,0,2,3,2,1,1,0,0,15308,7.2,18278,220,58,370,400,27.8,1530.8,10,0,1,3,2,2,0,0,0,0,14938,7.0,17878,193,55,-370,-400,24.8,1493.8
4701222311,1,11,0,1,8,3,3,1,1,0,0,17911,7.2,19400,197,68,4177,3532,26.5,1791.1,12,1,0,3,8,4,0,0,0,0,13734,6.6,15868,166,48,-4177,-3532,21.4,1373.4
4687734228,0,68,1,0,5,5,4,0,0,0,0,15775,7.4,18461,197,56,-1277,451,25.3,1577.5,12,2,1,5,5,3,1,1,0,0,17052,6.8,18010,199,56,1277,-451,25.5,1705.2
4659337044,0,13,1,1,2,4,2,1,1,0,0,15323,7.0,17807,174,52,265,26,22.6,1532.3,10,1,0,4,2,1,0,0,0,0,15058,6.6,17781,186,48,-265,-26,23.4,1505.8
4657864431,1,0,0,0,24,16,62,0,0,0,1,39401,11.6,43913,118,0,5390,8013,11.8,3940.1,133,0,1,16,24,38,0,0,0,0,34011,10.4,35900,85,0,-5390,-8013,8.5,3401.1
4657842405,0,11,0,0,21,26,49,0,0,0,1,35888,10.8,38140,84,0,-3853,-5060,8.4,3588.8,1,1,1,26,21,47,0,0,0,0,39741,11.6,43200,112,0,3853,5060,11.2,3974.1
4657814754,1,15,1,1,4,2,4,1,1,0,0,14535,6.4,15568,140,48,1146,-18,18.8,1453.5,217,0,0,2,4,0,0,0,0,0,13389,6.2,15586,149,40,-1146,18,18.9,1338.9
4657748919,1,104,3,1,8,4,9,1,1,0,0,17626,7.0,17187,162,52,2918,794,21.4,1762.6,15,0,0,4,8,2,0,0,0,0,14708,6.6,16393,184,40,-2918,-794,22.4,1470.8
4656760764,1,29,0,0,5,6,5,0,0,0,0,16233,6.8,17826,212,42,701,1027,25.4,1623.3,12,10,1,6,5,4,0,0,0,0,15532,6.4,16799,172,57,-701,-1027,22.9,1553.2
4830061665,0,15,2,1,10,24,23,0,0,0,2,34258,10.8,37719,77,59,-7777,-7743,13.6,3425.8,30,1,0,24,10,49,0,0,0,0,42035,11.8,45462,103,67,7777,7743,17.0,4203.5
4827364716,0,12,0,1,16,14,38,0,0,0,0,36423,11.2,40693,101,52,1250,1387,15.3,3642.3,20,1,0,13,15,28,0,0,0,0,35173,11.0,39306,107,55,-1250,-1387,16.2,3517.3
4827355978,1,14,1,1,23,11,51,0,0,0,1,37202,11.6,42613,96,67,908,4582,16.3,3720.2,13,0,0,11,23,22,0,0,0,0,36294,10.8,38031,85,71,-908,-4582,15.6,3629.4
4826237454,0,9,1,1,14,23,24,0,0,0,1,37207,11.2,41205,85,60,-902,1397,14.5,3720.7,14,0,0,23,14,42,0,0,0,0,38109,10.8,39808,74,59,902,-1397,13.3,3810.9
4818779063,0,15,0,0,7,22,14,0,0,0,0,28467,10.2,33677,67,55,-1689,-4157,12.2,2846.7,13,0,1,22,7,40,0,0,0,0,30156,10.8,37834,86,59,1689,4157,14.5,3015.6
4818713765,1,12,2,1,22,12,45,0,0,0,2,41360,12.2,48175,122,79,8247,9125,20.1,4136.0,13,0,0,12,22,17,0,0,0,0,33113,11.2,39050,102,63,-8247,-9125,16.5,3311.3
4818503869,0,12,0,1,18,23,28,0,0,0,1,37905,11.0,39886,101,47,839,-417,14.8,3790.5,12,0,0,23,18,44,0,0,0,0,37066,11.0,40303,82,71,-839,417,15.3,3706.6
4818492501,1,112,1,1,22,2,48,0,0,0,3,39142,11.2,43907,93,67,6292,5706,16.0,3914.2,31,0,0,2,22,4,0,0,0,0,32850,11.0,38201,88,55,-6292,-5706,14.3,3285.0
4816884856,0,12,1,1,20,15,32,0,0,0,0,33914,10.6,36687,68,60,1402,810,12.8,3391.4,29,1,0,15,20,35,0,0,0,0,32512,10.4,35877,63,40,-1402,-810,10.3,3251.2
4816870426,1,16,1,1,25,9,37,0,0,0,1,43230,11.8,44948,98,64,11815,10322,16.2,4323.0,89,0,0,9,25,10,0,0,0,0,31415,10.2,34626,82,43,-11815,-10322,12.5,3141.5
4816851645,1,18,1,0,16,10,34,0,0,0,0,37420,11.6,44358,74,71,2194,5030,14.5,3742.0,12,0,1,10,16,26,0,0,0,0,35226,11.0,39328,60,47,-2194,-5030,10.7,3522.6
4816838233,0,14,0,0,14,18,23,0,0,0,0,32703,10.4,36067,87,64,-1652,-216,15.1,3270.3,12,0,1,18,14,29,0,0,0,0,34355,10.4,36283,44,55,1652,216,9.9,3435.5
4816750650,0,9,0,0,8,24,6,0,0,0,1,29957,10.0,31839,65,37,-7833,-8091,10.2,2995.7,15,1,1,24,8,51,0,0,0,0,37790,11.2,39930,70,63,7833,8091,13.3,3779.0
4816744092,0,23,0,0,19,18,48,0,0,0,1,35919,11.2,40376,86,55,2322,2998,14.1,3591.9,13,0,1,18,19,47,0,0,0,0,33597,10.8,37378,77,43,-2322,-2998,12.0,3359.7
4813785856,1,14,2,0,19,13,43,0,0,0,1,40433,11.8,44122,108,80,2686,4069,18.8,4043.3,8,1,1,13,19,18,0,0,0,0,37747,11.2,40053,84,67,-2686,-4069,15.1,3774.7
4813772417,1,46,1,0,14,21,37,0,0,0,0,39612,11.6,44257,99,71,4693,6222,17.0,3961.2,13,1,1,21,14,56,0,0,0,0,34919,10.8,38035,89,63,-4693,-6222,15.2,3491.9
4813764853,0,12,0,1,19,8,35,0,0,0,0,37106,12.2,47469,89,75,4448,7448,16.4,3710.6,13,0,0,8,19,15,0,0,0,0,32658,11.0,40021,82,55,-4448,-7448,13.7,3265.8
4813755859,1,12,1,0,20,13,29,0,0,0,1,40819,12.4,48265,129,75,5381,7219,20.4,4081.9,13,0,1,13,20,22,0,0,0,0,35438,11.4,41046,110,67,-5381,-7219,17.7,3543.8
4844842053,1,34,5,0,21,17,44,0,0,0,0,35842,11.2,40940,111,0,546,1545,11.1,3584.2,48,0,1,17,21,48,0,0,0,0,35296,11.0,39395,89,0,-546,-1545,8.9,3529.6
4844825678,1,0,0,0,32,21,94,0,0,0,1,40301,11.6,44561,108,0,4900,5888,10.8,4030.1,0,0,1,21,32,52,0,0,0,0,35401,10.8,38673,79,0,-4900,-5888,7.9,3540.1
4844810434,0,25,0,1,16,25,35,0,0,0,1,34884,10.8,37643,101,0,-1363,-3179,10.1,3488.4,0,18,0,25,16,56,0,0,0,0,36247,11.2,40822,91,0,1363,3179,9.1,3624.7
4844803755,1,0,0,1,30,22,69,0,0,0,1,39541,11.4,42495,99,0,3961,3286,9.9,3954.1,0,0,0,22,30,57,0,0,0,0,35580,11.0,39209,75,0,-3961,-3286,7.5,3558.0
4844784218,0,91,0,0,22,26,54,0,0,0,0,35224,11.0,39959,110,0,-3077,-2497,11.0,3522.4,0,3,1,26,22,64,0,0,0,0,38301,11.4,42456,108,0,3077,2497,10.8,3830.1
4836190604,0,0,0,0,26,25,62,0,0,0,1,37595,11.2,42182,104,0,607,1169,10.4,3759.5,0,0,1,25,26,69,0,0,0,0,36988,11.4,41013,97,0,-607,-1169,9.7,3698.8
4825834532,1,13,11,1,10,16,12,0,0,0,0,33284,10.6,36426,74,49,2927,3089,12.3,3328.4,44,0,0,16,10,36,0,0,0,0,30357,10.2,33337,80,47,-2927,-3089,12.7,3035.7
4825800555,1,50,1,0,18,16,38,0,0,0,1,37509,11.0,39080,78,55,5087,3092,13.3,3750.9,19,14,1,16,18,40,0,0,0,0,32422,10.4,35988,80,63,-5087,-3092,14.3,3242.2
4825784171,0,12,0,0,12,24,19,0,0,0,0,33629,11.0,37353,91,51,-6546,-9065,14.2,3362.9,11,0,1,24,12,43,0,0,0,0,40175,11.8,46418,104,71,6546,9065,17.5,4017.5
4825760457,1,10,0,0,19,6,46,0,0,0,1,36900,11.2,40503,100,67,5282,6042,16.7,3690.0,10,1,1,6,19,15,0,0,0,0,31618,10.2,34461,97,59,-5282,-6042,15.6,3161.8
4821863402,1,26,0,1,6,17,11,0,0,0,1,27379,10.4,33778,105,48,-3317,-4096,15.3,2737.9,10,0,0,16,5,28,0,0,0,0,30696,10.8,37874,92,55,3317,4096,14.7,3069.6
4821844335,0,50,0,1,10,11,12,0,0,0,0,30348,10.8,37837,82,59,-4474,-1737,14.1,3034.8,53,0,0,11,10,22,0,0,0,0,34822,11.0,39574,106,67,4474,1737,17.3,3482.2
4821820975,0,16,0,0,13,14,21,0,0,0,1,29356,10.4,35365,99,55,-6528,-4889,15.4,2935.6,14,1,1,14,13,18,0,0,0,0,35884,11.2,40254,125,65,6528,4889,19.0,3588.4
4821781541,0,12,0,0,11,11,30,0,0,0,1,34681,10.8,38095,107,63,71,222,17.0,3468.1,9,0,1,11,11,24,0,0,0,0,34610,10.8,37873,95,67,-71,-222,16.2,3461.0
4819225169,1,9,1,0,18,7,40,0,0,0,2,40255,11.6,43718,116,59,8121,8890,17.5,4025.5,12,0,1,7,18,12,0,0,0,0,32134,10.4,34828,82,55,-8121,-8890,13.7,3213.4
4819211208,1,10,4,0,14,14,25,0,0,0,0,32015,11.4,42075,96,79,-1774,1926,17.5,3201.5,14,0,1,12,12,33,0,0,0,0,33789,11.0,40149,109,71,1774,-1926,18.0,3378.9
4816508046,0,22,0,1,9,15,12,0,0,0,0,31557,10.4,36177,72,63,-3345,-5288,13.5,3155.7,13,2,0,15,9,16,0,0,0,0,34902,11.4,41465,95,71,3345,5288,16.6,3490.2
4816492875,1,13,0,1,18,7,31,0,0,0,2,38258,11.8,46220,135,81,8838,6427,21.6,3825.8,11,0,0,7,18,14,0,0,0,0,29420,11.4,39793,128,41,-8838,-6427,16.9,2942.0
4816482104,0,16,1,0,11,10,12,0,0,0,0,31658,10.6,35107,91,52,-615,-911,14.3,3165.8,19,0,1,10,11,13,0,0,0,0,32273,10.8,36018,77,50,615,911,12.7,3227.3
4856624212,1,0,0,1,9,22,17,0,0,0,0,45250,10.0,47500,0,0,16700,19000,0.0,4525.0,0,0,0,17,4,13,0,0,0,0,28550,6.0,28500,0,0,-16700,-19000,0.0,2855.0
4856611337,1,0,0,0,16,17,16,0,0,0,0,45950,10.0,47500,0,0,18100,19000,0.0,4595.0,0,0,1,10,9,10,0,0,0,0,27850,6.0,28500,0,0,-18100,-19000,0.0,2785.0
4856599383,1,0,0,1,18,13,18,0,0,0,0,47350,10.0,47500,0,0,20900,19000,0.0,4735.0,13,0,0,7,12,6,0,0,0,0,26450,6.0,28500,0,0,-20900,-19000,0.0,2645.0
4856584856,1,11,2,1,8,2,8,0,0,0,0,18235,7.2,18830,178,60,3567,1630,23.8,1823.5,21,0,0,2,8,2,0,0,0,0,14668,6.8,17200,232,49,-3567,-1630,28.1,1466.8
4856556221,1,11,4,0,2,1,0,1,1,0,0,14810,7.0,19286,211,64,610,597,27.5,1481.0,14,0,1,1,2,0,0,0,0,0,14200,7.2,18689,210,68,-610,-597,27.8,1420.0
4856530678,0,186,1,0,4,6,1,1,1,0,0,14644,6.8,17642,175,48,-2555,-956,22.3,1464.4,10,1,1,6,4,5,0,0,0,0,17199,7.2,18598,175,51,2555,956,22.6,1719.9
4856287369,1,16,2,0,1,1,1,0,0,0,0,14774,7.2,18076,212,60,1080,189,27.2,1477.4,24,1,1,1,1,0,0,0,0,0,13694,6.8,17887,168,52,-1080,-189,22.0,1369.4
4856246796,1,10,0,1,6,5,3,0,0,0,1,16670,6.8,17377,184,42,1948,1280,22.6,1667.0,28,0,0,5,6,7,0,0,0,0,14722,6.4,16097,153,76,-1948,-1280,22.9,1472.2
4856166630,1,10,1,0,0,5,0,0,0,0,0,12716,6.6,16839,191,51,-3548,-1081,24.2,1271.6,9,0,1,5,0,4,0,0,0,0,16264,6.6,17920,217,56,3548,1081,27.3,1626.4
4856139668,1,0,0,1,13,24,16,0,0,0,0,63050,12.0,55000,0,0,24100,22000,0.0,6305.0,6,0,0,16,5,14,0,0,0,0,38950,7.2,33000,0,0,-24100,-22000,0.0,3895.0
4856115476,1,34,5,0,22,18,22,0,0,0,0,63775,12.0,55000,0,0,25520,22000,0.0,6377.5,0,1,1,13,17,9,0,0,0,0,38255,7.2,33000,0,0,-25520,-22000,0.0,3825.5
4856095153,1,0,0,0,17,20,16,0,0,0,0,62599,12.0,55000,0,0,24349,22000,0.0,6259.9,0,0,1,13,10,13,0,0,0,0,38250,7.2,33000,0,0,-24349,-22000,0.0,3825.0
4856064609,1,0,0,0,21,24,16,0,0,0,0,60250,12.0,55000,0,0,22700,18000,0.0,6025.0,0,0,1,11,8,17,0,0,0,0,37550,8.0,37000,0,0,-22700,-18000,0.0,3755.0
4856038704,1,0,0,0,16,21,13,0,0,0,0,61650,12.8,59000,0,0,22700,26000,0.0,6165.0,0,0,1,14,9,16,0,0,0,0,38950,7.2,33000,0,0,-22700,-26000,0.0,3895.0
4856023155,1,6,0,0,17,25,14,0,0,0,0,45600,10.0,47500,0,0,16700,19000,0.0,4560.0,12,0,1,11,3,15,0,0,0,0,28900,6.0,28500,0,0,-16700,-19000,0.0,2890.0
4856002957,1,0,0,0,23,16,25,0,0,0,0,65225,12.0,55000,3,0,29000,22000,0.3,6522.5,0,0,1,8,15,3,0,0,0,0,36225,7.2,33000,1,0,-29000,-22000,0.1,3622.5
4855980561,1,0,0,0,14,17,12,0,0,0,0,45731,10.0,47500,9,0,17381,19000,0.9,4573.1,270,0,1,12,9,12,0,0,0,0,28350,6.0,28500,8,0,-17381,-19000,0.8,2835.0
4855554311,1,48,1,0,1,5,1,0,0,0,0,15297,6.8,17138,179,56,45,1266,23.5,1529.7,13,2,1,5,1,5,0,0,0,0,15252,6.4,15872,179,60,-45,-1266,23.9,1525.2
4855531474,1,10,0,1,7,5,5,0,0,0,0,16391,6.6,17459,189,51,1349,100,24.0,1639.1,7,0,0,5,7,3,1,1,0,0,15042,6.8,17359,168,64,-1349,-100,23.2,1504.2
4839299665,1,11,0,1,28,15,44,0,0,0,0,37164,11.0,41033,82,63,1057,3751,14.5,3716.4,12,0,0,15,28,21,0,0,0,0,36107,10.6,37282,61,47,-1057,-3751,10.8,3610.7
4749850735,1,0,0,1,21,13,56,0,0,0,0,36682,11.0,39670,108,0,4283,4537,10.8,3668.2,0,0,0,13,21,35,0,0,0,0,32399,10.2,35133,75,0,-4283,-4537,7.5,3239.9
4749657838,1,4,0,1,28,1,6,0,0,0,1,22479,7.0,18859,176,64,12079,9289,24.0,2247.9,0,0,0,0,27,0,0,0,0,0,10400,4.8,9570,53,0,-12079,-9289,5.3,1040.0
4749651764,1,15,0,1,33,2,12,0,0,0,2,28478,7.8,21592,256,12,18667,11437,26.8,2847.8,0,0,0,2,33,1,0,0,0,0,9811,5.0,10155,36,0,-18667,-11437,3.6,981.1
4749617813,0,0,21,1,20,37,56,0,0,0,1,35333,11.0,38767,85,0,-7142,-9003,8.5,3533.3,30,0,0,37,20,100,0,0,0,0,42475,12.2,47770,106,0,7142,9003,10.6,4247.5
4748851264,0,0,0,1,17,12,43,0,0,0,1,34875,10.8,37951,96,0,-148,3414,9.6,3487.5,7,0,0,12,17,21,0,0,0,0,35023,10.2,34537,103,0,148,-3414,10.3,3502.3
4748144804,1,14,1,0,5,7,7,0,0,0,0,15443,6.4,16040,179,50,-826,-1891,22.9,1544.3,47,0,1,7,5,3,1,1,0,0,16269,7.0,17931,169,52,826,1891,22.1,1626.9
4748102543,1,17,4,1,6,7,4,0,0,0,0,15615,6.6,16662,190,52,-419,1234,24.2,1561.5,20,2,0,7,6,6,0,0,0,0,16034,6.4,15428,157,48,419,-1234,20.5,1603.4
4747869282,0,11,1,0,4,3,3,0,0,0,0,14780,6.6,16188,209,36,-796,-2292,24.5,1478.0,13,0,1,3,4,6,0,0,0,0,15576,7.0,18480,214,67,796,2292,28.1,1557.6
4747856114,1,11,2,1,3,2,3,1,1,0,0,15824,6.8,17641,213,52,984,-61,26.5,1582.4,9,0,0,2,3,1,0,0,0,0,14840,7.0,17702,179,56,-984,61,23.5,1484.0
4747350757,1,14,2,1,6,4,3,0,0,0,0,16806,6.8,17752,184,48,968,1160,23.2,1680.6,14,0,0,4,6,3,1,1,0,0,15838,6.6,16592,199,44,-968,-1160,24.3,1583.8
4747316772,1,0,0,1,18,19,18,0,0,0,0,63656,12.6,59500,2,0,24261,22000,0.2,6365.6,0,0,0,11,10,12,0,0,0,0,39395,7.8,37500,3,0,-24261,-22000,0.3,3939.5
4747225451,0,11,1,1,5,3,5,0,0,0,0,16256,7.0,18060,184,48,170,499,23.2,1625.6,12,1,0,3,5,3,1,1,0,0,16086,6.8,17561,196,52,-170,-499,24.8,1608.6
4747203861,1,20,3,1,5,5,4,1,1,0,0,16354,7.0,17752,189,60,937,1142,24.9,1635.4,16,0,0,5,5,6,0,0,0,0,15417,6.8,16610,178,64,-937,-1142,24.2,1541.7
4747170460,0,10,0,1,6,4,2,0,0,0,0,15647,6.8,17402,189,64,-603,-1736,25.3,1564.7,12,0,0,4,6,4,1,1,0,0,16250,7.2,19138,195,76,603,1736,27.1,1625.0
4747110885,0,11,1,0,4,3,6,1,1,0,0,14955,6.6,16327,189,40,-1536,-2662,22.9,1495.5,14,0,1,3,4,2,0,0,0,0,16491,7.2,18989,216,72,1536,2662,28.8,1649.1
4747073722,0,15,1,0,5,9,6,0,0,0,0,16248,6.8,17318,207,48,-1086,-294,25.5,1624.8,13,1,1,9,5,6,1,1,0,0,17334,6.6,17612,197,60,1086,294,25.7,1733.4
4746047423,0,14,2,0,2,4,3,0,0,0,0,15427,7.0,18163,207,56,-1854,-629,26.3,1542.7,15,6,1,4,2,5,1,1,0,0,17281,6.8,18792,233,56,1854,629,28.9,1728.1
4746030139,0,10,0,1,3,5,2,0,0,0,0,15234,6.6,16845,201,48,-2569,-2490,24.9,1523.4,12,0,0,5,3,3,0,0,0,0,17803,7.0,19335,227,60,2569,2490,28.7,1780.3
4745567070,1,18,3,1,3,5,1,0,0,0,0,14610,6.6,16363,143,44,-1506,-1280,18.7,1461.0,17,3,0,5,3,5,0,0,0,0,16116,6.8,17643,190,56,1506,1280,24.6,1611.6
4856750198,0,11,1,0,1,7,1,0,0,0,0,13532,6.6,16498,182,46,-3879,-1990,22.8,1353.2,25,3,1,7,1,6,1,1,0,0,17411,7.0,18488,208,52,3879,1990,26.0,1741.1
4856493229,1,18,3,0,7,4,8,1,1,0,0,17195,6.6,17336,201,52,1326,1355,25.3,1719.5,13,1,1,4,7,5,0,0,0,0,15869,6.4,15981,182,48,-1326,-1355,23.0,1586.9
4856428669,0,12,0,1,10,4,8,0,0,0,0,17017,6.8,17231,170,48,2199,518,21.8,1701.7,23,1,0,4,10,2,0,0,0,0,14818,6.6,16713,156,60,-2199,-518,21.6,1481.8
4856384414,1,13,0,0,3,6,1,0,0,0,0,14564,6.4,16196,156,56,477,2809,21.2,1456.4,13,0,1,6,3,2,0,0,0,0,14087,5.6,13387,142,15,-477,-2809,15.7,1408.7
4855347901,1,67,1,0,5,5,7,0,0,0,0,15767,7.2,18807,166,68,482,981,23.4,1576.7,14,1,1,5,5,2,0,0,0,0,15285,6.8,17826,186,56,-482,-981,24.2,1528.5
4855307412,0,9,0,1,4,3,2,1,1,0,0,14995,6.8,17498,197,56,561,867,25.3,1499.5,14,0,0,3,4,3,0,0,0,0,14434,6.8,16631,180,48,-561,-867,22.8,1443.4
4855256554,0,16,0,0,7,8,1,0,0,0,0,15783,6.6,17100,179,41,-1912,-1144,22.0,1578.3,14,1,1,8,7,4,0,0,0,0,17695,7.2,18244,181,52,1912,1144,23.3,1769.5
4854679565,0,14,0,1,3,5,3,0,0,0,0,15128,6.6,16973,158,48,-138,-503,20.6,1512.8,13,1,0,5,3,3,0,0,0,0,15266,6.8,17476,163,56,138,503,21.9,1526.6
4854649258,1,16,0,1,6,1,4,0,0,0,0,17144,7.2,19117,229,59,4372,1924,28.8,1714.4,17,0,0,1,6,0,0,0,0,0,12772,6.8,17193,153,57,-4372,-1924,21.0,1277.2
4854626911,0,12,0,1,7,2,3,0,0,0,0,16948,7.0,18473,234,60,2010,220,29.4,1694.8,19,2,0,2,7,0,0,0,0,0,14938,6.8,18253,224,52,-2010,-220,27.6,1493.8
4854591638,0,15,0,1,10,4,6,0,0,0,0,16379,6.8,17102,156,38,1888,2636,19.4,1637.9,12,0,0,4,10,3,0,0,0,0,14491,6.2,14466,150,44,-1888,-2636,19.4,1449.1
4851208973,1,12,0,1,9,6,17,0,0,0,0,17192,6.8,17840,190,52,2477,1310,24.2,1719.2,11,1,0,6,9,6,1,1,0,0,14715,6.6,16530,156,48,-2477,-1310,20.4,1471.5
4850376468,0,20,1,0,6,3,5,1,1,0,0,16165,7.2,18909,170,68,2032,1332,23.8,1616.5,25,2,1,3,6,2,0,0,0,0,14133,6.8,17577,168,48,-2032,-1332,21.6,1413.3
4850364965,1,14,0,0,5,10,5,0,0,0,0,15264,6.6,16059,155,44,-3939,-3314,19.9,1526.4,11,2,1,10,5,12,0,0,0,0,19203,7.2,19373,207,72,3939,3314,27.9,1920.3
4848864516,1,11,1,0,6,4,5,0,0,0,0,16084,6.8,17789,181,48,-151,-690,22.9,1608.4,10,2,1,4,6,5,1,1,0,0,16235,6.8,18479,202,56,151,690,25.8,1623.5
4848034278,0,16,2,1,7,7,12,0,0,0,0,14893,6.4,15221,138,46,-2017,-806,18.4,1489.3,13,1,0,7,7,2,1,1,0,0,16910,6.8,16027,185,52,2017,806,23.7,1691.0
4847734181,0,20,3,1,4,0,5,0,0,0,0,14580,6.4,15920,183,40,1642,-1380,22.3,1458.0,17,2,0,0,4,0,1,1,0,0,12938,6.8,17300,175,64,-1642,1380,23.9,1293.8
4847713246,1,33,2,1,7,2,7,0,0,0,0,16677,6.8,17045,145,50,3047,192,19.5,1667.7,13,0,0,2,7,1,0,0,0,0,13630,6.6,16853,164,48,-3047,-192,21.2,1363.0
4847677049,0,13,2,0,5,8,5,0,0,0,0,16806,7.0,17795,195,48,757,-58,24.3,1680.6,16,3,1,8,5,2,1,1,0,0,16049,7.0,17853,143,64,-757,58,20.7,1604.9
4846548108,1,11,0,0,2,3,2,0,0,0,0,14203,7.0,18039,196,56,402,1069,25.2,1420.3,16,0,1,3,2,4,0,0,0,0,13801,6.8,16970,156,48,-402,-1069,20.4,1380.1
4847586534,1,99,3,0,3,2,12,0,0,0,0,15666,6.6,16728,199,56,386,-592,25.5,1566.6,21,3,1,2,3,4,1,1,0,0,15280,6.8,17320,204,64,-386,592,26.8,1528.0
4832939279,1,16,1,0,4,5,6,0,0,0,0,15488,7.0,17988,206,56,555,758,26.2,1548.8,12,3,1,5,4,1,0,0,0,0,14933,6.6,17230,203,44,-555,-758,24.7,1493.3
4831550672,1,195,0,0,22,9,33,0,0,0,0,36360,11.6,43258,78,63,1318,3646,14.1,3636.0,7,0,1,9,22,13,0,0,0,0,35042,11.2,39612,115,67,-1318,-3646,18.2,3504.2
4829349267,0,14,1,0,0,2,0,1,1,0,0,14676,7.0,18225,232,56,-549,-480,28.8,1467.6,34,0,1,2,0,2,0,0,0,0,15225,7.2,18705,202,60,549,480,26.2,1522.5
4829327859,1,20,0,0,8,1,3,0,0,0,0,17676,7.4,20153,237,56,4604,4595,29.3,1767.6,9,0,1,1,8,0,0,0,0,0,13072,6.2,15558,171,66,-4604,-4595,23.7,1307.2
4827935099,1,8,2,0,5,3,2,0,0,0,0,15991,7.0,17499,214,60,775,233,27.4,1599.1,12,1,1,3,5,3,0,0,0,0,15216,6.8,17266,212,60,-775,-233,27.2,1521.6
4827906568,1,15,2,1,8,1,11,0,0,0,0,17721,7.0,18314,211,56,2722,1212,26.7,1772.1,19,3,0,1,8,0,0,0,0,0,14999,6.6,17102,218,52,-2722,-1212,27.0,1499.9
4827387623,1,12,2,0,2,5,1,0,0,0,0,14262,6.4,16570,179,52,-1315,-635,23.1,1426.2,82,1,1,5,2,3,0,0,0,0,15577,6.8,17205,177,64,1315,635,24.1,1557.7
4825420846,1,10,0,0,9,20,21,0,0,0,1,32779,11.4,40825,103,51,-4529,-3382,15.4,3277.9,9,0,1,20,9,35,0,0,0,0,37308,11.8,44207,73,83,4529,3382,15.6,3730.8
4825049801,1,25,0,1,16,16,24,0,0,0,0,33790,10.8,37292,82,51,-1516,-3726,13.3,3379.0,13,0,0,16,16,30,0,0,0,0,35306,11.0,41018,75,64,1516,3726,13.9,3530.6
4824773581,1,10,0,1,22,15,58,0,0,0,0,38463,11.2,41220,77,75,2669,1811,15.2,3846.3,16,0,0,15,22,35,0,0,0,0,35794,11.2,39409,105,43,-2669,-1811,14.8,3579.4
4824756284,0,14,1,0,6,14,14,0,0,0,1,32837,10.8,38146,92,55,-7940,-2939,14.7,3283.7,23,0,1,14,6,33,0,0,0,0,40777,11.4,41085,134,60,7940,2939,19.4,4077.7
4824730112,0,11,0,0,13,26,23,0,0,0,1,34681,10.6,38030,59,43,-8602,-8080,10.2,3468.1,13,0,1,26,13,42,0,0,0,0,43283,12.0,46110,101,68,8602,8080,16.9,4328.3
4824706635,1,16,0,1,23,11,56,0,0,0,0,38106,11.4,43500,97,66,6457,5026,16.3,3810.6,15,0,0,11,23,15,0,0,0,0,31649,10.8,38474,91,67,-6457,-5026,15.8,3164.9
4824691913,1,13,0,1,15,3,33,0,0,0,0,33917,11.2,40790,117,43,3606,5422,16.0,3391.7,212,0,0,3,15,3,0,0,0,0,30311,10.4,35368,134,60,-3606,-5422,19.4,3031.1
4824652039,1,11,4,1,7,10,14,0,0,0,0,31355,11.2,39958,111,63,-1749,471,17.4,3135.5,12,0,0,10,7,17,0,0,0,0,33104,11.2,39487,121,67,1749,-471,18.8,3310.4
4824618691,0,31,1,1,13,22,29,0,0,0,1,35872,11.0,39934,122,43,-7025,-5124,16.5,3587.2,10,0,0,22,13,39,0,0,0,0,42897,11.6,45058,91,76,7025,5124,16.7,4289.7
4823630728,1,0,0,0,16,15,45,0,0,0,1,36966,10.8,38446,128,0,1743,1148,12.8,3696.6,0,0,1,15,16,40,0,0,0,0,35223,10.6,37298,94,0,-1743,-1148,9.4,3522.3
4823610602,1,8,0,0,16,27,38,0,0,0,1,34633,10.2,36770,95,0,-4029,-4514,9.5,3463.3,0,0,1,27,16,84,0,0,0,0,38662,11.2,41284,107,0,4029,4514,10.7,3866.2
4857223224,0,9,0,0,5,6,5,0,0,0,0,14853,6.2,14715,133,40,-1428,-3259,17.3,1485.3,8,0,1,6,5,1,0,0,0,0,16281,6.8,17974,188,63,1428,3259,25.1,1628.1
4857128880,1,28,0,0,1,3,1,0,0,0,0,14648,7.0,18480,215,67,-617,316,28.2,1464.8,23,0,1,3,1,3,1,1,0,0,15265,6.8,18164,205,59,617,-316,26.4,1526.5
4857083607,1,300,4,1,8,5,5,0,0,0,0,17250,7.0,17905,168,60,10,461,22.8,1725.0,78,2,0,5,8,6,0,0,0,0,17240,6.8,17444,188,39,-10,-461,22.7,1724.0
4856989165,1,23,0,1,8,3,5,0,0,0,0,16335,6.8,17092,211,48,2202,126,25.9,1633.5,12,2,0,3,8,3,0,0,0,0,14133,6.8,16966,170,60,-2202,-126,23.0,1413.3
4856959902,1,25,1,1,2,4,2,0,0,0,0,14338,6.8,17118,201,56,-1799,-2169,25.7,1433.8,12,3,0,4,2,4,0,0,0,0,16137,7.2,19287,199,60,1799,2169,25.9,1613.7
4856939592,1,14,1,1,7,3,5,1,1,0,0,16298,6.6,16614,195,56,1451,-508,25.1,1629.8,10,0,0,3,7,1,0,0,0,0,14847,6.6,17122,174,56,-1451,508,23.0,1484.7
4855743953,1,18,3,1,6,2,4,0,0,0,0,15809,7.0,18104,175,52,597,932,22.7,1580.9,66,1,0,2,6,2,0,0,0,0,15212,6.6,17172,206,28,-597,-932,23.4,1521.2
4840949692,0,15,1,0,3,4,1,0,0,0,0,14894,7.0,17782,185,44,-1017,462,22.9,1489.4,20,1,1,4,3,6,1,1,0,0,15911,6.8,17320,176,63,1017,-462,23.9,1591.1
4840928831,0,24,1,1,4,2,6,0,0,0,0,14458,6.8,16983,181,46,146,-705,22.7,1445.8,19,1,0,2,4,6,1,1,0,0,14312,6.8,17688,197,60,-146,705,25.7,1431.2
4840869947,1,22,1,1,1,2,1,0,0,0,0,14243,7.0,17465,217,60,-514,-1393,27.7,1424.3,11,0,0,2,1,0,0,0,0,0,14757,7.0,18858,197,52,514,1393,24.9,1475.7
4840494613,0,52,0,0,4,6,6,0,0,0,0,15274,7.2,18870,188,60,-1483,951,24.8,1527.4,25,1,1,6,4,6,0,0,0,0,16757,6.8,17919,225,48,1483,-951,27.3,1675.7
4840481055,0,7,0,0,0,7,0,1,1,0,0,11881,6.8,17212,162,44,-4685,-2374,20.6,1188.1,21,0,1,7,0,4,0,0,0,0,16566,7.4,19586,185,72,4685,2374,25.7,1656.6
4840447418,1,21,0,0,5,8,3,0,0,0,0,16107,6.8,17214,204,44,-830,12,24.8,1610.7,10,2,1,8,5,4,0,0,0,0,16937,6.8,17202,180,48,830,-12,22.8,1693.7
4840403974,0,13,1,1,7,5,6,0,0,0,0,16345,7.0,17693,137,48,261,437,18.5,1634.5,10,1,0,5,7,3,1,0,1,0,16084,6.6,17256,201,52,-261,-437,25.3,1608.4
4840363934,0,9,1,1,5,5,1,0,0,0,0,14227,6.8,16981,184,32,-1906,-1529,21.6,1422.7,13,1,0,4,4,3,1,1,0,0,16133,7.0,18510,228,56,1906,1529,28.4,1613.3
4840329228,0,14,1,1,2,4,2,0,0,0,0,13914,6.6,16495,186,32,-965,-1699,21.8,1391.4,74,1,0,4,2,2,0,0,0,0,14879,7.0,18194,189,51,965,1699,24.0,1487.9
4840029348,0,25,1,1,3,2,4,0,0,0,0,15109,6.8,18116,191,51,1140,62,24.2,1510.9,11,0,0,2,3,3,0,0,0,0,13969,6.8,18054,164,60,-1140,-62,22.4,1396.9
4839988696,0,13,0,0,2,7,2,0,0,0,0,15428,6.8,17640,189,72,-641,-65,26.1,1542.8,7,1,1,7,2,7,0,0,0,0,16069,6.6,17705,183,48,641,65,23.1,1606.9
4857109667,1,32,0,0,18,11,22,0,0,0,0,47400,10.0,47500,1,0,20900,16000,0.1,4740.0,0,0,1,8,15,6,0,0,0,0,26500,6.6,31500,1,0,-20900,-16000,0.1,2650.0
4857092266,1,32,0,1,19,15,23,0,0,0,0,63550,12.0,55000,3,0,27734,22000,0.3,6355.0,0,0,0,6,10,6,0,0,0,0,35816,7.2,33000,0,0,-27734,-22000,0.0,3581.6
4857077921,1,0,0,0,17,23,20,0,0,0,0,62383,12.0,55000,0,0,23783,20000,0.0,6238.3,33,0,1,17,11,15,0,0,0,0,38600,7.6,35000,0,0,-23783,-20000,0.0,3860.0
4856952640,1,0,0,0,13,16,16,0,0,0,0,30950,9.0,40000,0,0,11400,16000,0.0,3095.0,1,0,1,10,7,8,0,0,0,0,19550,5.4,24000,0,0,-11400,-16000,0.0,1955.0
4856939193,1,0,0,1,13,20,19,0,0,0,0,45600,10.0,47500,0,0,16000,19000,0.0,4560.0,0,0,0,16,9,10,0,0,0,0,29600,6.0,28500,0,0,-16000,-19000,0.0,2960.0
4856917617,1,0,0,0,11,25,19,0,0,0,0,46650,10.0,47500,0,0,16700,19000,0.0,4665.0,0,0,1,21,7,11,0,0,0,0,29950,6.0,28500,0,0,-16700,-19000,0.0,2995.0
4856903190,1,0,0,0,7,20,18,0,0,0,0,60600,12.0,55000,0,0,23400,21000,0.0,6060.0,0,0,1,18,5,7,0,0,0,0,37200,7.4,34000,0,0,-23400,-21000,0.0,3720.0
4856892203,1,0,8,1,29,18,30,0,0,0,0,65540,12.0,55000,0,0,28315,22000,0.0,6554.0,26,0,0,7,18,7,0,0,0,0,37225,7.2,33000,1,0,-28315,-22000,0.1,3722.5
4856876129,0,0,0,0,23,22,59,0,0,0,0,36488,11.4,40940,108,0,-530,-1159,10.8,3648.8,0,0,1,22,23,46,0,0,0,0,37018,11.4,42099,96,0,530,1159,9.6,3701.8
4856863149,1,0,0,1,30,24,72,0,0,0,1,38473,11.6,44100,95,0,-131,953,9.5,3847.3,0,0,0,24,30,60,0,0,0,0,38604,11.6,43147,100,0,131,-953,10.0,3860.4
4856848402,1,5,0,0,21,15,12,0,0,0,0,47151,10.0,47500,8,0,19636,19000,0.8,4715.1,0,0,1,4,10,12,0,0,0,0,27515,6.0,28500,5,0,-19636,-19000,0.5,2751.5
4856839068,0,15,0,0,14,13,40,0,0,0,0,34513,10.8,38346,104,0,1415,2638,10.4,3451.3,2,0,1,13,14,26,0,0,0,0,33098,10.4,35708,96,0,-1415,-2638,9.6,3309.8
4856823437,1,0,0,1,27,31,65,0,0,0,2,39817,11.4,41801,105,0,251,-1976,10.5,3981.7,0,0,0,31,27,89,0,0,0,0,39566,11.6,43777,98,0,-251,1976,9.8,3956.6
4856808620,0,0,8,1,31,20,78,0,0,0,1,39962,11.6,42670,117,0,4799,4549,11.7,3996.2,16,0,0,20,31,52,0,0,0,0,35163,10.8,38121,82,0,-4799,-4549,8.2,3516.3
4856304751,1,4,0,0,20,16,9,0,0,0,0,46710,10.0,47500,0,0,18857,19000,0.0,4671.0,68,0,1,4,8,13,0,0,0,0,27853,6.0,28500,0,0,-18857,-19000,0.0,2785.3
4856271383,1,82,2,0,16,17,18,0,0,0,0,63885,12.0,55000,5,0,27020,22000,0.5,6388.5,0,3,1,10,9,9,0,0,0,0,36865,7.2,33000,0,0,-27020,-22000,0.0,3686.5
4856257788,1,288,0,1,23,15,22,0,0,0,0,64820,13.0,60000,4,0,28608,27000,0.4,6482.0,0,0,0,5,13,6,0,0,0,0,36212,7.2,33000,0,0,-28608,-27000,0.0,3621.2
4856209019,1,8,0,0,17,17,29,0,0,0,0,47700,10.0,47500,0,0,20200,17820,0.0,4770.0,0,0,1,15,15,4,0,0,0,0,27500,6.2,29680,0,0,-20200,-17820,0.0,2750.0
4856167242,0,82,0,0,15,20,39,0,0,0,1,34247,10.8,37370,84,0,-2091,-2057,8.4,3424.7,0,0,1,20,15,45,0,0,0,0,36338,11.0,39427,118,0,2091,2057,11.8,3633.8
4856112533,0,20,0,0,12,16,21,0,0,0,0,32499,10.2,35139,91,0,-1669,-1197,9.1,3249.9,0,24,1,16,12,36,0,0,0,0,34168,10.4,36336,98,0,1669,1197,9.8,3416.8
4855388108,0,12,0,0,23,19,73,0,0,0,0,36638,10.8,38733,122,0,1819,769,12.2,3663.8,0,0,1,19,23,54,0,0,0,0,34819,10.8,37964,100,0,-1819,-769,10.0,3481.9
4855347467,0,0,0,0,22,17,50,0,0,0,1,36701,11.0,39230,101,0,185,-282,10.1,3670.1,0,0,1,17,22,38,0,0,0,0,36516,10.8,39512,107,0,-185,282,10.7,3651.6
4855313227,1,101,1,0,1,1,1,0,0,0,0,13165,6.6,17413,166,48,-852,620,21.4,1316.5,81,1,1,1,1,0,1,1,0,0,14017,6.8,16793,188,52,852,-620,24.0,1401.7
4855275479,0,13,13,1,5,6,1,1,1,0,0,15780,6.8,17942,185,60,-1068,-246,24.5,1578.0,27,0,0,6,5,8,0,0,0,0,16848,6.8,18188,204,56,1068,246,26.0,1684.8
4851139129,0,13,0,0,1,7,1,0,0,0,0,14053,6.4,16188,194,52,-2167,-2592,24.6,1405.3,13,1,1,7,1,8,1,1,0,0,16220,7.2,18780,196,64,2167,2592,26.0,1622.0
4848966477,1,20,2,0,23,19,48,0,0,0,0,37708,11.4,42344,111,0,1189,3530,11.1,3770.8,38,4,1,19,23,41,0,0,0,0,36519,10.8,38814,115,0,-1189,-3530,11.5,3651.9
4848940978,0,14,0,0,32,27,81,0,0,0,0,40680,11.8,45229,114,0,2868,2491,11.4,4068.0,0,2,1,27,32,49,0,0,0,0,37812,11.4,42738,98,0,-2868,-2491,9.8,3781.2
4848912850,1,64,0,0,22,25,53,0,0,0,1,36645,11.0,39593,89,0,-2667,-2866,8.9,3664.5,0,0,1,25,22,55,0,0,0,0,39312,11.4,42459,115,0,2667,2866,11.5,3931.2
4848861140,1,253,2,0,6,5,4,1,1,0,0,16936,6.6,17722,197,60,825,-265,25.7,1693.6,12,12,1,5,6,8,0,0,0,0,16111,6.8,17987,205,48,-825,265,25.3,1611.1
4848788674,1,13,0,1,6,9,5,0,0,0,0,16178,7.0,18146,207,40,-728,-282,24.7,1617.8,11,0,0,9,6,6,0,0,0,0,16906,7.0,18428,187,56,728,282,24.3,1690.6
4848755534,1,30,9,1,7,2,3,2,1,1,0,17994,7.2,19477,210,64,3208,1538,27.4,1799.4,53,1,0,2,7,2,0,0,0,0,14786,6.8,17939,174,59,-3208,-1538,23.3,1478.6
4848637210,0,29,0,1,24,25,47,0,0,0,0,37836,11.6,42243,109,0,-47,1061,10.9,3783.6,0,4,0,25,24,50,0,0,0,0,37883,11.4,41182,121,0,47,-1061,12.1,3788.3
4848623202,1,1,0,1,28,18,77,0,0,0,1,39221,11.4,42873,105,0,3219,4356,10.5,3922.1,25,0,0,18,28,30,0,0,0,0,36002,10.8,38517,76,0,-3219,-4356,7.6,3600.2
4848597643,1,0,0,1,17,31,41,0,0,0,1,36359,11.0,38842,113,0,-3038,-3887,11.3,3635.9,0,0,0,31,17,73,0,0,0,0,39397,11.6,42729,115,0,3038,3887,11.5,3939.7
4848537998,1,0,0,0,27,22,79,0,0,0,0,39078,11.0,40946,106,0,3511,2213,10.6,3907.8,0,0,1,22,27,53,0,0,0,0,35567,10.8,38733,73,0,-3511,-2213,7.3,3556.7
4848525127,0,0,0,0,15,25,36,0,0,0,1,33923,10.6,36502,86,0,-5195,-4672,8.6,3392.3,0,0,1,25,15,74,0,0,0,0,39118,11.2,41174,100,0,5195,4672,10.0,3911.8
4848499023,1,0,0,1,21,22,48,0,0,0,2,37451,11.2,40567,121,0,949,-1197,12.1,3745.1,13,0,0,22,21,56,0,0,0,0,36502,11.2,41764,91,0,-949,1197,9.1,3650.2
4848487047,1,19,0,1,35,18,91,0,0,0,1,40757,11.8,44570,105,0,6739,6421,10.5,4075.7,0,0,0,18,35,37,0,0,0,0,34018,10.6,38149,83,0,-6739,-6421,8.3,3401.8
4848004543,1,0,0,0,29,21,75,0,0,0,1,39080,11.6,44142,113,0,2799,4753,11.3,3908.0,0,0,1,21,29,51,0,0,0,0,36281,11.0,39389,87,0,-2799,-4753,8.7,3628.1
4855033710,1,11,1,1,6,4,3,0,0,0,0,15247,6.6,16432,146,56,-280,-2610,20.2,1524.7,7,1,0,3,5,1,0,0,0,0,15527,7.2,19042,230,72,280,2610,30.2,1552.7
4854988223,1,156,1,1,11,8,5,1,1,0,0,18828,7.4,19146,213,52,2088,2435,26.5,1882.8,155,0,0,8,11,7,0,0,0,0,16740,6.6,16711,159,60,-2088,-2435,21.9,1674.0
4854519225,1,77,2,1,4,0,7,1,1,0,0,16362,6.8,18209,213,58,4607,2443,27.1,1636.2,13,1,0,0,4,0,0,0,0,0,11755,6.4,15766,145,44,-4607,-2443,18.9,1175.5
4854495427,1,17,0,1,3,2,3,1,1,0,0,14699,6.8,17769,195,52,64,293,24.7,1469.9,12,1,0,2,3,6,0,0,0,0,14635,6.8,17476,176,58,-64,-293,23.4,1463.5
4854137296,1,10,0,0,2,5,2,0,0,0,0,14765,6.8,17341,190,56,-736,402,24.6,1476.5,144,2,1,5,2,8,1,1,0,0,15501,6.8,16939,159,40,736,-402,19.9,1550.1
4854084617,1,14,0,1,10,3,11,0,0,0,0,18309,7.0,18585,182,52,3079,1259,23.4,1830.9,10,1,0,3,10,4,0,0,0,0,15230,7.0,17326,164,57,-3079,-1259,22.1,1523.0
4854043362,0,5,2,0,3,7,4,0,0,0,0,13601,6.4,15174,139,52,-2499,-1794,19.1,1360.1,19,0,1,7,3,7,1,1,0,0,16100,6.8,16968,196,56,2499,1794,25.2,1610.0
4853987784,1,9,22,1,5,1,5,0,0,0,0,17072,7.4,19336,214,64,3189,1114,27.8,1707.2,34,1,0,1,5,2,1,1,0,0,13883,7.0,18222,180,63,-3189,-1114,24.3,1388.3
4852756441,1,9,0,1,11,4,3,0,0,0,0,17546,7.2,18878,216,60,2937,3101,27.6,1754.6,10,0,0,4,11,2,0,0,0,0,14609,6.4,15777,164,60,-2937,-3101,22.4,1460.9
4852692877,0,17,0,1,7,4,3,1,1,0,0,16113,6.6,17190,200,62,344,97,26.2,1611.3,74,2,0,4,7,8,0,0,0,0,15769,6.8,17093,197,48,-344,-97,24.5,1576.9
4852655846,0,11,13,0,1,4,1,0,0,0,0,13958,6.8,17558,214,44,-2598,-1177,25.8,1395.8,32,2,1,4,1,7,0,0,0,0,16556,7.2,18735,230,60,2598,1177,29.0,1655.6
4851766140,1,12,2,0,2,4,0,0,0,0,0,13549,6.2,15692,181,44,-1289,-1280,22.5,1354.9,14,2,1,4,2,9,1,1,0,0,14838,6.8,16972,160,68,1289,1280,22.8,1483.8
4849563078,0,16,4,0,6,5,4,1,1,0,0,16784,6.8,17926,214,61,1668,1251,27.5,1678.4,15,2,1,5,6,4,0,0,0,0,15116,6.6,16675,145,56,-1668,-1251,20.1,1511.6
4849532446,1,11,0,1,4,3,3,0,0,0,0,14776,6.8,17527,182,60,-118,-289,24.2,1477.6,15,0,0,3,4,1,0,0,0,0,14894,7.0,17816,192,61,118,289,25.3,1489.4
4848790877,1,13,0,1,12,1,9,1,1,0,0,21002,7.2,18649,236,44,8039,2652,28.0,2100.2,10,1,0,1,12,2,0,0,0,0,12963,6.4,15997,148,56,-8039,-2652,20.4,1296.3
4848626840,1,13,1,0,6,4,2,1,1,0,0,16776,6.6,18043,193,64,2216,1565,25.7,1677.6,14,0,1,4,6,1,0,0,0,0,14560,6.6,16478,175,52,-2216,-1565,22.7,1456.0
4848431752,1,9,0,0,1,6,0,0,0,0,0,13731,6.6,16935,202,48,-2618,-715,25.0,1373.1,9,2,1,6,1,6,0,0,0,0,16349,6.8,17650,190,64,2618,715,25.4,1634.9
4848378515,0,98,2,0,4,6,1,0,0,0,0,14555,6.6,17222,155,52,-2269,-814,20.7,1455.5,19,2,1,6,4,3,1,1,0,0,16824,6.8,18036,212,56,2269,814,26.8,1682.4
4847892828,0,10,2,0,4,8,8,2,1,1,0,15930,6.8,16641,135,52,-2210,-1341,18.7,1593.0,11,1,1,8,4,5,0,0,0,0,18140,7.0,17982,194,52,2210,1341,24.6,1814.0
4847756629,1,21,0,1,5,0,3,0,0,0,0,15976,7.2,19448,218,59,3141,1956,27.7,1597.6,21,0,0,0,5,0,0,0,0,0,12835,6.8,17492,179,48,-3141,-1956,22.7,1283.5
4834523728,0,11,1,1,4,4,5,0,0,0,0,14803,6.8,16488,182,48,-694,-313,23.0,1480.3,26,1,0,4,4,5,0,0,0,0,15497,6.6,16801,180,44,694,313,22.4,1549.7
4834520781,1,13,1,1,8,2,6,0,0,0,0,16629,7.2,18563,170,52,3313,1813,22.2,1662.9,10,2,0,2,8,1,0,0,0,0,13316,6.6,16750,143,52,-3313,-1813,19.5,1331.6
4829192670,0,15,0,0,3,3,5,0,0,0,0,14158,6.6,16050,177,40,-682,-1931,21.7,1415.8,15,1,1,3,3,1,0,0,0,0,14840,6.8,17981,185,52,682,1931,23.7,1484.0
4807923286,1,13,1,0,1,4,0,0,0,0,0,14006,6.8,17652,223,54,-2315,-480,27.7,1400.6,14,0,1,4,1,2,1,0,1,0,16321,7.0,18132,236,50,2315,480,28.6,1632.1
4806464899,0,13,0,1,5,3,1,0,0,0,0,15398,6.6,16623,158,39,12,-183,19.7,1539.8,13,0,0,3,5,3,0,0,0,0,15386,6.4,16806,203,39,-12,183,24.2,1538.6
4806412023,0,13,0,1,4,2,0,0,0,0,0,15774,6.8,17130,185,48,-86,357,23.3,1577.4,81,0,0,2,4,0,0,0,0,0,15860,6.8,16773,202,52,86,-357,25.4,1586.0
4806156990,1,101,0,0,6,6,6,0,0,0,0,16865,7.2,18984,220,48,139,1153,26.8,1686.5,10,0,1,6,6,5,0,0,0,0,16726,6.8,17831,187,48,-139,-1153,23.5,1672.6
4806119605,1,154,1,0,6,3,2,1,1,0,0,16474,6.8,18196,168,52,1075,1046,22.0,1647.4,11,1,1,3,6,3,1,0,1,0,15399,7.0,17150,184,48,-1075,-1046,23.2,1539.9
4804468267,1,15,1,1,4,3,4,0,0,0,0,16822,7.0,19137,215,64,2678,2353,27.9,1682.2,12,0,0,3,4,1,0,0,0,0,14144,6.8,16784,193,48,-2678,-2353,24.1,1414.4
4803494594,1,16,2,1,11,5,7,0,0,0,0,18109,7.0,18063,179,49,2644,2036,22.8,1810.9,13,2,0,5,11,5,0,0,0,0,15465,6.6,16027,171,56,-2644,-2036,22.7,1546.5
4802721934,1,86,0,1,10,10,10,0,0,0,0,18166,6.6,17063,168,40,741,778,20.8,1816.6,12,1,0,10,10,9,1,1,0,0,17425,6.6,16285,150,36,-741,-778,18.6,1742.5
4802561529,1,14,2,0,2,6,1,0,0,0,0,15038,7.0,18267,181,52,78,45,23.3,1503.8,14,2,1,6,2,5,0,0,0,0,14960,6.8,18222,141,44,-78,-45,18.5,1496.0
4802534625,1,100,2,1,6,3,3,0,0,0,0,15778,6.8,17632,171,52,851,766,22.3,1577.8,14,1,0,3,6,2,1,1,0,0,14927,6.6,16866,159,60,-851,-766,21.9,1492.7
4802504841,0,10,1,1,4,4,4,0,0,0,0,15615,6.8,18416,226,56,272,-116,28.2,1561.5,11,0,0,4,4,3,0,0,0,0,15343,7.0,18532,223,56,-272,116,27.9,1534.3
4802466401,1,13,1,1,2,4,2,0,0,0,0,14972,6.8,17591,180,52,-2272,-1866,23.2,1497.2,14,1,0,4,2,4,0,0,0,0,17244,7.4,19457,250,52,2272,1866,30.2,1724.4
4802391460,0,13,0,0,2,2,2,0,0,0,0,14783,6.6,16904,195,47,-1113,-2837,24.2,1478.3,9,0,1,2,2,0,0,0,0,0,15896,7.2,19741,211,55,1113,2837,26.6,1589.6
4802361488,0,11,0,0,2,5,0,1,0,1,0,12988,6.8,16791,177,43,-3659,-1863,22.0,1298.8,16,1,1,5,2,2,0,0,0,0,16647,7.0,18654,220,56,3659,1863,27.6,1664.7
4802341077,0,18,2,1,9,5,10,1,1,0,0,18228,7.0,18144,208,56,2245,837,26.4,1822.8,15,0,0,5,9,5,0,0,0,0,15983,6.8,17307,215,40,-2245,-837,25.5,1598.3
4799362395,0,13,1,1,7,9,9,0,0,0,0,16326,7.0,18666,164,52,-2696,258,21.6,1632.6,229,2,0,9,7,8,2,1,1,0,19022,7.2,18408,228,56,2696,-258,28.4,1902.2
4853260611,0,7,0,0,2,6,3,0,0,0,0,14009,6.8,17938,201,40,-2846,-1255,24.1,1400.9,10,0,1,6,2,3,1,1,0,0,16855,7.2,19193,223,72,2846,1255,29.5,1685.5
4853252982,0,14,1,0,8,8,7,0,0,0,0,15988,6.4,15646,191,41,-1815,-1796,23.2,1598.8,11,0,1,7,7,7,1,1,0,0,17803,6.8,17442,172,66,1815,1796,23.8,1780.3
4853243851,1,10,1,1,9,2,6,1,1,0,0,17535,6.8,17172,214,28,2148,393,24.2,1753.5,10,0,0,2,9,1,0,0,0,0,15387,6.6,16779,175,60,-2148,-393,23.5,1538.7
4853222246,1,18,1,0,3,5,2,1,0,1,0,14659,6.8,17215,178,52,-2241,-1134,23.0,1465.9,12,3,1,5,3,5,1,1,0,0,16900,7.0,18349,209,55,2241,1134,26.4,1690.0
4853208669,0,12,1,1,6,10,5,0,0,0,0,15704,6.6,16627,183,44,-3031,-3188,22.7,1570.4,4,0,0,10,6,8,1,1,0,0,18735,7.0,19815,205,76,3031,3188,28.1,1873.5
4853192716,0,16,2,0,4,15,2,1,1,0,0,14390,6.6,15949,144,52,-6961,-4221,19.6,1439.0,22,2,1,15,4,14,0,0,0,0,21351,7.6,20170,213,44,6961,4221,25.7,2135.1
4853173058,0,11,5,0,3,4,0,1,0,1,0,15187,6.8,18170,208,60,1496,1930,26.8,1518.7,18,2,1,4,3,4,1,1,0,0,13691,6.6,16240,159,40,-1496,-1930,19.9,1369.1
4641394819,1,15,0,0,23,25,72,0,0,0,0,36974,11.2,40491,97,0,-1842,-2126,9.7,3697.4,0,0,1,25,23,68,0,0,0,0,38816,11.6,42617,107,0,1842,2126,10.7,3881.6
4641373849,0,32,0,1,25,25,63,0,0,0,1,37716,11.2,41809,78,0,56,-350,7.8,3771.6,0,0,0,25,25,60,0,0,0,0,37660,11.2,42159,88,0,-56,350,8.8,3766.0
4640402503,0,6,1,1,8,9,5,0,0,0,0,16814,6.8,17416,185,40,-1073,-825,22.5,1681.4,11,0,0,9,8,7,0,0,0,0,17887,7.0,18241,200,60,1073,825,26.0,1788.7
4640344972,1,104,2,0,7,6,9,0,0,0,0,16172,6.4,15376,136,56,1122,-627,19.2,1617.2,13,1,1,6,7,1,1,1,0,0,15050,6.6,16003,148,48,-1122,627,19.6,1505.0
4640310308,0,12,3,0,6,5,9,0,0,0,0,16599,6.6,16121,213,36,503,-660,24.9,1659.9,13,1,1,5,6,6,0,0,0,0,16096,6.6,16781,197,52,-503,660,24.9,1609.6
4640283915,1,15,1,1,9,5,8,1,1,0,0,18236,7.0,18030,209,56,1816,508,26.5,1823.6,12,2,0,5,9,4,0,0,0,0,16420,6.8,17522,175,44,-1816,-508,21.9,1642.0
4640258868,0,12,0,0,10,6,8,0,0,0,0,17461,6.8,16890,138,52,1305,1725,19.0,1746.1,11,1,1,6,10,6,1,1,0,0,16156,6.2,15165,141,56,-1305,-1725,19.7,1615.6
4639707692,1,14,3,0,6,5,6,0,0,0,0,15355,6.8,17210,179,56,647,1355,23.5,1535.5,16,1,1,5,6,4,0,0,0,0,14708,6.4,15855,157,50,-647,-1355,20.7,1470.8
4639253385,1,11,0,1,8,7,3,0,0,0,0,15797,6.6,17013,168,44,532,-26,21.2,1579.7,20,2,0,6,7,5,0,0,0,0,15265,6.8,17039,178,55,-532,26,23.3,1526.5
4638960975,1,10,1,0,6,9,3,0,0,0,0,15380,6.4,15605,161,48,-2055,-770,20.9,1538.0,13,0,1,9,6,8,1,1,0,0,17435,6.6,16375,152,52,2055,770,20.4,1743.5
4638383493,1,13,5,0,3,7,4,1,1,0,0,13616,6.4,16126,142,40,-2592,-2337,18.2,1361.6,16,2,1,7,3,2,0,0,0,0,16208,7.0,18463,199,64,2592,2337,26.3,1620.8
4637878850,1,12,0,1,3,2,4,1,1,0,0,13981,6.4,15185,165,44,-1356,-2724,20.9,1398.1,14,0,0,2,3,2,0,0,0,0,15337,7.0,17909,224,60,1356,2724,28.4,1533.7
4637203845,1,8,1,1,8,8,5,1,1,0,0,17250,7.0,17924,170,64,-576,-463,23.4,1725.0,14,1,0,8,8,6,0,0,0,0,17826,7.0,18387,198,40,576,463,23.8,1782.6
4829900203,0,11,1,0,6,9,1,0,0,0,0,14509,6.8,16311,153,48,-3444,-2414,20.1,1450.9,15,3,1,9,6,9,1,1,0,0,17953,7.0,18725,211,56,3444,2414,26.7,1795.3
4829883891,0,19,1,1,7,3,7,0,0,0,0,16283,6.6,15814,176,46,1018,-2014,22.2,1628.3,182,0,0,3,7,0,1,0,1,0,15265,7.0,17828,182,49,-1018,2014,23.1,1526.5
4829860516,0,14,1,0,4,8,5,0,0,0,0,15045,6.4,15883,188,40,-2250,-2747,22.8,1504.5,13,2,1,8,4,3,1,1,0,0,17295,7.2,18630,184,68,2250,2747,25.2,1729.5
4829839444,0,12,4,0,3,2,0,0,0,0,0,13217,6.4,16264,162,44,-2061,-2766,20.6,1321.7,22,1,1,2,3,3,0,0,0,0,15278,7.0,19030,207,55,2061,2766,26.2,1527.8
4829790767,1,9,0,1,8,5,5,0,0,0,0,16864,6.8,18543,209,48,1681,910,25.7,1686.4,10,0,0,4,7,2,0,0,0,0,15183,6.8,17633,184,52,-1681,-910,23.6,1518.3
4829745420,1,11,3,0,3,4,5,0,0,0,0,15122,6.8,17913,182,64,-502,-321,24.6,1512.2,18,0,1,4,3,2,0,0,0,0,15624,6.8,18234,218,56,502,321,27.4,1562.4
4829705328,0,52,0,1,8,1,6,0,0,0,0,17399,7.0,19062,181,51,3304,2132,23.2,1739.9,11,1,0,1,8,1,0,0,0,0,14095,6.6,16930,185,72,-3304,-2132,25.7,1409.5
4829578105,1,12,3,1,12,5,11,1,1,0,0,18002,6.6,16673,155,57,3966,2412,21.2,1800.2,62,1,0,5,12,2,0,0,0,0,14036,6.0,14261,131,48,-3966,-2412,17.9,1403.6
4829520529,0,11,0,0,4,5,3,0,0,0,0,13689,6.4,15581,107,60,-2863,-2719,16.7,1368.9,9,2,1,5,4,1,0,0,0,0,16552,7.0,18300,200,45,2863,2719,24.5,1655.2
4829469391,1,14,0,0,4,4,3,0,0,0,0,14952,6.4,16118,182,56,-8,-1063,23.8,1495.2,68,1,1,4,4,2,0,0,0,0,14960,6.8,17181,182,60,8,1063,24.2,1496.0
4829021556,1,14,1,1,7,5,7,0,0,0,0,17574,6.8,18015,162,52,2385,-780,21.4,1757.4,11,2,0,5,7,2,0,0,0,0,15189,7.0,18795,187,56,-2385,780,24.3,1518.9
4828900366,0,55,1,0,4,5,4,0,0,0,0,15826,6.4,15934,196,44,-1913,-2420,24.0,1582.6,10,3,1,5,4,4,0,0,0,0,17739,7.2,18354,196,60,1913,2420,25.6,1773.9
4828861390,1,21,4,0,3,3,4,0,0,0,0,15516,7.2,19362,194,68,-57,769,26.2,1551.6,76,5,1,3,3,2,0,0,0,0,15573,6.8,18593,204,60,57,-769,26.4,1557.3
4828839989,1,15,1,0,4,5,4,0,0,0,0,14925,6.8,16762,149,56,-766,-387,20.5,1492.5,20,2,1,5,4,4,0,0,0,0,15691,6.8,17149,199,56,766,387,25.5,1569.1
4826018863,0,49,2,0,4,5,2,1,1,0,0,14675,7.0,18290,166,60,-1341,-1016,22.6,1467.5,15,0,1,5,4,1,0,0,0,0,16016,7.2,19306,226,71,1341,1016,29.7,1601.6
4826004014,1,61,1,0,4,6,3,0,0,0,0,15786,6.8,17170,178,48,-365,-690,22.6,1578.6,15,0,1,6,4,5,1,1,0,0,16151,6.6,17860,179,44,365,690,22.3,1615.1
4825980089,1,13,1,1,11,6,17,0,0,0,0,18292,6.8,17268,189,52,2720,508,24.1,1829.2,14,1,0,6,11,4,0,0,0,0,15572,6.6,16760,195,53,-2720,-508,24.8,1557.2
4825961916,1,11,1,0,6,3,5,1,1,0,0,16200,6.6,17913,210,48,1886,545,25.8,1620.0,17,0,1,3,6,2,0,0,0,0,14314,6.6,17368,157,60,-1886,-545,21.7,1431.4
4843359052,1,6,2,0,7,4,5,1,1,0,0,15874,7.0,18412,171,54,1367,2541,22.5,1587.4,7,0,1,4,7,3,0,0,0,0,14507,6.4,15871,143,57,-1367,-2541,20.0,1450.7
4818577598,0,17,0,0,20,23,39,0,0,0,0,31808,10.0,33658,61,47,-8725,-8673,10.8,3180.8,10,1,1,23,20,48,0,0,0,0,40533,11.6,42331,98,59,8725,8673,15.7,4053.3
4818561509,1,15,0,1,21,14,31,0,0,0,2,37533,11.0,39800,88,47,3842,4586,13.5,3753.3,14,0,0,14,21,23,0,0,0,0,33691,10.6,35214,53,51,-3842,-4586,10.4,3369.1
4815374837,1,29,0,0,17,12,25,0,0,0,0,37628,11.4,42301,104,67,6903,5370,17.1,3762.8,10,0,1,12,17,18,0,0,0,0,30725,10.6,36931,88,47,-6903,-5370,13.5,3072.5
4811454673,1,8,0,1,25,20,60,0,0,0,1,38114,11.2,40545,88,39,3453,2811,12.7,3811.4,10,1,0,20,25,37,0,0,0,0,34661,10.8,37734,69,54,-3453,-2811,12.3,3466.1
4811425629,1,9,2,0,23,25,35,0,0,0,0,34066,10.6,36193,76,43,-6042,-2353,11.9,3406.6,9,0,1,25,23,41,0,0,0,0,40108,10.8,38546,83,36,6042,2353,11.9,4010.8
4811407350,1,9,0,1,24,25,42,0,0,0,3,47242,11.6,43235,114,57,6011,4846,17.1,4724.2,9,0,0,24,23,48,0,0,0,0,41231,10.8,38389,74,50,-6011,-4846,12.4,4123.1
4811387307,1,10,0,1,22,12,49,0,0,0,1,40679,12.0,46191,125,67,9793,8087,19.2,4067.9,15,1,0,12,22,20,0,0,0,0,30886,10.6,38104,65,59,-9793,-8087,12.4,3088.6
4810507715,0,12,0,0,2,3,0,0,0,0,0,13129,6.8,17142,171,44,-1744,370,21.5,1312.9,15,0,1,3,2,3,0,0,0,0,14873,6.8,16772,149,44,1744,-370,19.3,1487.3
4806695571,1,13,0,1,3,2,4,0,0,0,0,14429,6.4,15688,199,36,-402,-1848,23.5,1442.9,12,1,0,2,3,2,0,0,0,0,14831,6.6,17536,219,56,402,1848,27.5,1483.1
4806682893,1,14,2,1,7,5,5,0,0,0,0,16248,6.6,16678,200,44,2181,786,24.4,1624.8,18,4,0,5,7,4,0,0,0,0,14067,6.6,15892,152,40,-2181,-786,19.2,1406.7
4806668062,1,10,0,0,3,3,2,0,0,0,0,15145,6.8,16941,204,45,771,-1018,24.9,1514.5,14,0,1,3,3,0,0,0,0,0,14374,6.8,17959,153,63,-771,1018,21.6,1437.4
4802756915,0,15,2,0,3,8,1,0,0,0,0,15007,6.8,17806,202,60,-2637,-762,26.2,1500.7,13,0,1,8,3,11,0,0,0,0,17644,7.2,18568,216,44,2637,762,26.0,1764.4
4802720489,1,12,0,1,8,2,7,1,1,0,0,18363,7.0,19237,222,44,4523,2113,26.6,1836.3,12,1,0,2,8,1,0,0,0,0,13840,7.0,17124,186,52,-4523,-2113,23.8,1384.0
4802663377,0,10,2,1,2,3,1,0,0,0,0,15576,7.0,18449,241,51,291,-169,29.2,1557.6,113,0,0,3,2,3,0,0,0,0,15285,7.2,18618,206,60,-291,169,26.6,1528.5
4802630840,0,14,0,1,7,6,6,0,0,0,0,16329,6.8,17820,199,48,20,1358,24.7,1632.9,6,0,0,6,7,8,0,0,0,0,16309,6.4,16462,172,52,-20,-1358,22.4,1630.9
4802580099,0,11,0,1,5,3,4,0,0,0,0,16158,7.0,18051,211,51,1093,978,26.2,1615.8,14,0,0,3,5,2,0,0,0,0,15065,6.8,17073,180,40,-1093,-978,22.0,1506.5
4802545841,1,12,2,1,4,7,2,1,1,0,0,15091,6.6,17571,178,56,-1711,-987,23.4,1509.1,23,5,0,7,4,7,0,0,0,0,16802,7.2,18558,210,60,1711,987,27.0,1680.2
4802522277,0,11,0,0,4,4,3,0,0,0,0,16376,7.2,18516,168,68,686,1644,23.6,1637.6,229,0,1,4,4,5,1,1,0,0,15690,6.8,16872,175,51,-686,-1644,22.6,1569.0
4845976806,1,18,0,1,3,4,5,0,0,0,0,14245,6.8,16839,171,47,189,-915,21.8,1424.5,10,2,0,4,3,4,0,0,0,0,14056,6.8,17754,178,44,-189,915,22.2,1405.6
4845911649,0,9,0,0,3,9,2,0,0,0,0,15434,6.8,17753,201,59,-1357,-12,26.0,1543.4,9,0,1,9,3,8,1,0,1,0,16791,6.6,17765,149,56,1357,12,20.5,1679.1
4833159494,0,11,1,1,4,0,2,1,1,0,0,12735,6.2,15633,131,44,-1073,-1659,17.5,1273.5,9,0,0,0,4,0,0,0,0,0,13808,6.8,17292,204,52,1073,1659,25.6,1380.8
4833116768,0,34,0,0,4,3,5,1,1,0,0,13655,6.4,15684,142,44,-2238,-2099,18.6,1365.5,9,13,1,3,4,2,0,0,0,0,15893,7.0,17783,179,44,2238,2099,22.3,1589.3
4832951924,0,13,14,1,2,10,1,0,0,0,0,12391,6.2,15702,122,56,-4898,-1609,17.8,1239.1,32,2,0,10,2,8,0,0,0,0,17289,6.6,17311,203,40,4898,1609,24.3,1728.9
4832754434,1,9,0,1,8,5,2,1,0,1,0,15957,7.2,18370,156,52,2588,2986,20.8,1595.7,6,0,0,5,8,2,0,0,0,0,13369,6.2,15384,112,40,-2588,-2986,15.2,1336.9
4827748406,0,13,0,1,1,2,0,0,0,0,0,14385,7.0,17819,219,40,1387,2398,25.9,1438.5,11,0,0,2,1,1,1,1,0,0,12998,6.4,15421,115,60,-1387,-2398,17.5,1299.8
4826811664,0,14,1,1,3,5,2,0,0,0,0,14127,6.6,16455,165,52,-2302,-962,21.7,1412.7,162,3,0,5,3,6,0,0,0,0,16429,6.8,17417,172,40,2302,962,21.2,1642.9
4820760180,1,12,0,0,4,2,6,1,1,0,0,14188,6.6,17348,161,54,-786,-809,21.5,1418.8,19,1,1,2,4,1,0,0,0,0,14974,6.8,18157,212,60,786,809,27.2,1497.4
4820701325,0,8,0,1,2,4,0,0,0,0,0,12434,6.6,17172,156,28,-1737,-715,18.4,1243.4,13,0,0,4,2,2,0,0,0,0,14171,6.8,17887,152,56,1737,715,20.8,1417.1
4820676056,1,12,2,1,6,6,3,0,0,0,0,16832,6.8,18535,183,48,1035,700,23.1,1683.2,13,0,0,6,6,4,0,0,0,0,15797,7.0,17835,153,47,-1035,-700,20.0,1579.7
4819056136,0,8,1,0,3,8,3,0,0,0,0,13296,5.8,14738,129,56,-3628,-4354,18.5,1329.6,11,0,1,8,3,7,1,1,0,0,16924,7.2,19092,207,60,3628,4354,26.7,1692.4
4818994530,0,30,7,0,1,6,0,0,0,0,0,12811,6.6,16381,147,39,-3557,-4142,18.6,1281.1,27,1,1,6,1,2,1,1,0,0,16368,7.2,20523,180,76,3557,4142,25.6,1636.8
4813850226,1,143,1,1,7,2,9,1,1,0,0,15576,6.8,17244,167,48,1529,-305,21.5,1557.6,14,1,0,2,7,0,0,0,0,0,14047,6.6,17549,194,52,-1529,305,24.6,1404.7
4813824315,0,10,0,0,0,5,0,1,1,0,0,12941,7.2,19563,175,52,-1864,1038,22.7,1294.1,12,0,1,5,0,3,0,0,0,0,14805,7.0,18525,180,60,1864,-1038,24.0,1480.5
4812401204,0,155,0,0,16,20,44,0,0,0,0,33082,11.0,39547,47,56,-2158,-799,10.3,3308.2,6,0,1,20,16,42,0,0,0,0,35240,11.2,40346,87,39,2158,799,12.6,3524.0
4812372746,0,5,0,0,11,21,29,0,0,0,0,30731,10.2,34816,77,43,-5028,-7120,12.0,3073.1,12,0,1,21,11,49,0,0,0,0,35759,11.4,41936,67,59,5028,7120,12.6,3575.9
4812339363,0,10,1,1,9,17,13,0,0,0,1,30461,10.0,31864,52,39,-5469,-8182,9.1,3046.1,13,0,0,17,9,29,0,0,0,0,35930,11.0,40046,95,48,5469,8182,14.3,3593.0
4812303220,0,35,0,1,2,4,0,0,0,0,0,13299,6.8,16886,168,48,-166,-73,21.6,1329.9,7,0,0,4,2,3,1,1,0,0,13465,6.8,16959,142,48,166,73,19.0,1346.5
4810373175,1,13,0,1,5,0,3,0,0,0,0,15924,7.0,18216,166,52,2234,1175,21.8,1592.4,13,0,0,0,5,0,0,0,0,0,13690,6.6,17041,175,48,-2234,-1175,22.3,1369.0
4831646003,0,12,1,0,12,9,13,1,1,0,0,18782,6.2,15488,132,52,2374,-865,18.4,1878.2,12,0,1,9,12,12,0,0,0,0,16408,6.6,16353,190,36,-2374,865,22.6,1640.8
4830300890,1,11,1,1,11,5,13,1,1,0,0,18300,6.6,17234,173,48,3583,1674,22.1,1830.0,13,0,0,5,11,3,0,0,0,0,14717,6.4,15560,156,28,-3583,-1674,18.4,1471.7
4828862522,1,12,1,1,5,1,4,1,1,0,0,17168,7.4,19431,237,64,4068,2799,30.1,1716.8,21,0,0,1,5,1,0,0,0,0,13100,6.4,16632,167,52,-4068,-2799,21.9,1310.0
4828403240,0,89,3,1,5,3,4,0,0,0,0,17392,7.0,18230,214,48,1713,714,26.2,1739.2,12,1,0,3,5,2,1,1,0,0,15679,7.0,17516,210,60,-1713,-714,27.0,1567.9
4828362366,1,14,2,0,7,6,2,0,0,0,0,15502,6.8,16614,183,37,706,609,22.0,1550.2,11,2,1,6,7,1,0,0,0,0,14796,6.6,16005,180,30,-706,-609,21.0,1479.6
4828319310,0,11,2,1,6,7,5,1,1,0,0,15394,6.4,16310,185,52,-2272,-1790,23.7,1539.4,14,0,0,7,6,5,0,0,0,0,17666,7.2,18100,195,47,2272,1790,24.2,1766.6
4828295981,1,10,0,0,6,4,6,1,1,0,0,17726,7.0,18168,215,60,1647,689,27.5,1772.6,9,0,1,4,6,3,0,0,0,0,16079,6.8,17479,177,56,-1647,-689,23.3,1607.9
4826950008,1,14,0,1,4,0,3,0,0,0,0,15718,6.8,18437,198,56,3166,2323,25.4,1571.8,10,1,0,0,4,0,1,1,0,0,12552,6.4,16114,174,54,-3166,-2323,22.8,1255.2
4826915931,1,12,2,1,5,3,3,1,1,0,0,16750,7.2,18975,233,66,1792,1446,29.9,1675.0,12,0,0,3,5,3,0,0,0,0,14958,6.8,17529,196,64,-1792,-1446,26.0,1495.8
4826874585,0,13,0,0,2,4,1,0,0,0,0,14945,7.0,18236,216,48,-92,86,26.4,1494.5,79,1,1,4,2,3,1,1,0,0,15037,6.8,18150,206,48,92,-86,25.4,1503.7
4590724816,1,11,1,1,5,2,4,0,0,0,0,15891,6.8,17868,180,50,2057,567,23.0,1589.1,14,2,0,2,5,1,0,0,0,0,13834,6.8,17301,179,64,-2057,-567,24.3,1383.4
4588773118,1,10,0,0,15,5,16,1,1,0,0,20250,7.2,19526,199,56,4926,3212,25.5,2025.0,7,0,1,5,15,7,0,0,0,0,15324,6.4,16314,190,48,-4926,-3212,23.8,1532.4
4588766183,0,14,0,0,4,10,6,0,0,0,0,14057,6.2,15632,156,52,-3321,-2784,20.8,1405.7,9,1,1,10,4,4,0,0,0,0,17378,7.0,18416,212,56,3321,2784,26.8,1737.8
4381449460,1,30,0,0,2,5,2,0,0,0,0,14834,6.6,16950,165,52,-834,-1809,21.7,1483.4,232,0,1,5,2,5,1,1,0,0,15668,7.0,18759,169,52,834,1809,22.1,1566.8
4379953148,1,15,1,0,3,4,3,0,0,0,0,14354,6.6,16976,184,37,320,-524,22.1,1435.4,11,0,1,4,3,2,0,0,0,0,14034,6.8,17500,151,44,-320,524,19.5,1403.4
4855994427,0,20,3,0,5,11,4,0,0,0,0,14238,6.6,15990,144,47,-3614,-3361,19.1,1423.8,16,1,1,10,4,3,1,1,0,0,17852,7.2,19351,197,72,3614,3361,26.9,1785.2
4855963528,1,14,4,1,15,3,15,0,0,0,0,20482,7.2,19565,192,56,4531,2550,24.8,2048.2,11,2,0,3,15,1,1,1,0,0,15951,7.0,17015,161,56,-4531,-2550,21.7,1595.1
4855538295,0,9,13,1,7,5,6,0,0,0,0,15870,6.8,17396,185,35,341,1415,22.0,1587.0,38,1,0,5,7,5,1,1,0,0,15529,6.6,15981,155,32,-341,-1415,18.7,1552.9
4855530053,0,162,0,1,8,9,7,1,1,0,0,16219,6.4,16214,185,40,-2862,-2869,22.5,1621.9,14,0,0,9,8,3,0,0,0,0,19081,7.2,19083,245,44,2862,2869,28.9,1908.1
4855516766,1,14,5,1,7,5,7,1,0,1,0,17597,7.2,18764,207,50,1941,2888,25.7,1759.7,43,2,0,5,7,5,0,0,0,0,15656,6.4,15876,200,48,-1941,-2888,24.8,1565.6
4855485943,1,33,0,1,11,8,11,0,0,0,0,19490,6.6,16972,162,36,4421,1387,19.8,1949.0,154,1,0,8,11,2,1,1,0,0,15069,6.2,15585,136,40,-4421,-1387,17.6,1506.9
4855460119,1,16,0,0,6,9,5,1,0,1,0,16553,6.6,16463,152,55,-1215,-1260,20.7,1655.3,14,0,1,9,6,7,0,0,0,0,17768,6.8,17723,190,42,1215,1260,23.2,1776.8
4855428551,1,9,0,1,9,6,5,1,0,1,0,18072,7.0,18589,174,64,1252,894,23.8,1807.2,11,0,0,6,9,4,1,1,0,0,16820,7.0,17695,135,64,-1252,-894,19.9,1682.0
4855394069,0,10,0,0,2,7,0,0,0,0,0,13294,6.6,15805,165,44,-2714,-1738,20.9,1329.4,14,1,1,7,2,3,1,1,0,0,16008,6.8,17543,165,56,2714,1738,22.1,1600.8
4854355657,1,19,2,1,6,3,4,0,0,0,0,15450,6.8,17152,157,48,789,144,20.5,1545.0,11,0,0,3,6,2,0,0,0,0,14661,6.8,17008,201,56,-789,-144,25.7,1466.1
4854353921,1,10,0,1,32,23,84,0,0,0,1,40044,12.0,44199,96,0,2831,4562,9.6,4004.4,0,3,0,23,32,49,0,0,0,0,37213,11.0,39637,96,0,-2831,-4562,9.6,3721.3
4854342751,1,0,0,1,23,22,57,0,0,0,0,37794,11.0,41419,95,0,1747,3008,9.5,3779.4,0,0,0,22,23,71,0,0,0,0,36047,11.0,38411,96,0,-1747,-3008,9.6,3604.7
4854321678,1,81,6,0,21,20,57,0,0,0,1,35352,11.0,40017,96,0,-756,1720,9.6,3535.2,25,2,1,20,21,51,0,0,0,0,36108,10.8,38297,95,0,756,-1720,9.5,3610.8
4853254682,1,19,1,1,6,8,4,1,1,0,0,15677,6.6,16654,173,40,-2023,-378,21.3,1567.7,13,1,0,8,6,12,0,0,0,0,17700,6.6,17032,178,51,2023,378,22.9,1770.0
4853247963,1,13,1,0,8,3,8,0,0,0,0,17260,7.2,18630,197,56,3316,2092,25.3,1726.0,19,4,1,3,8,3,0,0,0,0,13944,6.6,16538,173,52,-3316,-2092,22.5,1394.4
4853226576,1,17,4,0,3,7,1,0,0,0,0,13967,6.4,16245,183,51,-1880,865,23.4,1396.7,16,3,1,7,3,8,1,1,0,0,15847,6.6,15380,156,44,1880,-865,20.0,1584.7
4853215835,0,16,2,1,5,2,2,0,0,0,0,15739,6.6,17681,187,44,394,-653,23.1,1573.9,11,2,0,2,5,1,2,1,1,0,15345,6.6,18334,219,60,-394,653,27.9,1534.5
4853181457,1,223,1,0,10,7,7,1,1,0,0,18052,7.0,18851,149,52,415,1923,20.1,1805.2,17,2,1,7,10,7,0,0,0,0,17637,6.6,16928,165,56,-415,-1923,22.1,1763.7
4852135661,0,20,0,0,14,14,20,0,0,0,0,34972,10.6,38306,103,0,1215,1569,10.3,3497.2,0,7,1,14,14,36,0,0,0,0,33757,10.6,36737,103,0,-1215,-1569,10.3,3375.7
4852131968,0,0,2,1,28,24,62,0,0,0,0,37491,10.8,39648,92,0,-1123,-2533,9.2,3749.1,19,0,0,24,28,62,0,0,0,0,38614,11.4,42181,110,0,1123,2533,11.0,3861.4
4850983004,0,12,1,0,3,1,1,0,0,0,0,14838,6.8,17996,160,60,944,1267,22.0,1483.8,14,2,1,1,3,3,1,1,0,0,13894,6.6,16729,175,60,-944,-1267,23.5,1389.4
4850934656,0,9,3,0,5,6,4,1,1,0,0,15202,6.6,15976,152,52,-1916,-2658,20.4,1520.2,86,0,1,6,5,3,0,0,0,0,17118,7.0,18634,206,52,1916,2658,25.8,1711.8
4849827541,1,9,2,0,4,3,6,1,1,0,0,15599,6.6,16909,213,51,1227,-720,26.4,1559.9,11,0,1,3,4,1,0,0,0,0,14372,6.8,17629,185,48,-1227,720,23.3,1437.2
4848204311,1,13,1,1,1,2,1,0,0,0,0,14300,7.0,18389,217,52,-522,312,26.9,1430.0,10,3,0,2,1,1,1,1,0,0,14822,6.8,18077,226,52,522,-312,27.8,1482.2
4848177716,1,15,2,0,1,3,1,0,0,0,0,14030,6.6,16949,229,36,-525,566,26.5,1403.0,12,1,1,3,1,2,0,0,0,0,14555,6.4,16383,169,48,525,-566,21.7,1455.5
4848154176,1,6,0,0,3,5,2,0,0,0,0,15487,6.8,18218,239,60,-1231,-408,29.9,1548.7,10,0,1,5,3,6,1,1,0,0,16718,7.2,18626,207,64,1231,408,27.1,1671.8
4848128743,0,138,1,0,2,5,2,0,0,0,0,13915,6.6,16265,202,44,-1872,-963,24.6,1391.5,11,1,1,5,2,4,1,1,0,0,15787,7.0,17228,175,60,1872,963,23.5,1578.7
4848082869,1,11,1,1,2,1,2,0,0,0,0,16126,6.8,17904,230,52,2449,521,28.2,1612.6,13,1,0,1,2,1,1,1,0,0,13677,6.6,17383,179,44,-2449,-521,22.3,1367.7
4848033674,0,23,2,1,2,2,2,0,0,0,0,14781,6.6,17639,177,55,201,628,23.2,1478.1,9,1,0,2,2,2,0,0,0,0,14580,6.8,17011,204,44,-201,-628,24.8,1458.0
4847013555,1,8,0,1,3,1,1,0,0,0,0,14897,6.8,17561,188,48,1024,-565,23.6,1489.7,12,1,0,1,3,0,0,0,0,0,13873,7.0,18126,204,56,-1024,565,26.0,1387.3
4846962125,0,30,1,1,2,0,6,0,0,0,0,14258,6.6,17687,200,56,1450,976,25.6,1425.8,17,0,0,0,2,0,0,0,0,0,12808,6.8,16711,192,52,-1450,-976,24.4,1280.8
4846090948,0,23,1,0,5,8,5,0,0,0,0,14795,6.4,15923,133,48,-2626,-1337,18.1,1479.5,8,2,1,8,5,4,0,0,0,0,17421,6.8,17260,186,36,2626,1337,22.2,1742.1
4822112884,1,12,0,1,18,12,35,0,0,0,1,33660,10.8,38662,101,50,3999,4456,15.1,3366.0,7,0,0,12,18,24,0,0,0,0,29661,10.2,34206,90,47,-3999,-4456,13.7,2966.1
4821099314,1,32,0,1,11,16,19,0,0,0,0,31362,10.8,37427,83,59,-4126,-4411,14.2,3136.2,101,1,0,16,11,35,0,0,0,0,35488,11.4,41838,99,59,4126,4411,15.8,3548.8
4821080311,1,11,0,0,10,13,24,0,0,0,0,34897,11.4,41450,103,59,3676,4868,16.2,3489.7,10,0,1,13,10,18,0,0,0,0,31221,10.6,36582,74,57,-3676,-4868,13.1,3122.1
4821062616,0,11,1,0,7,26,14,0,0,0,1,32463,10.2,33583,75,43,-6373,-9778,11.8,3246.3,12,0,1,26,7,56,0,0,0,0,38836,11.6,43361,93,69,6373,9778,16.2,3883.6
4821038618,0,174,0,1,15,18,32,0,0,0,0,32409,10.8,37960,87,59,-3752,-1447,14.6,3240.9,9,2,0,18,15,23,0,0,0,0,36161,11.0,39407,91,60,3752,1447,15.1,3616.1
4818071086,1,14,3,1,6,0,4,0,0,0,0,15464,6.8,18003,205,52,1873,826,25.7,1546.4,11,2,0,0,6,0,0,0,0,0,13591,6.8,17177,178,36,-1873,-826,21.4,1359.1
4814305714,0,19,1,0,0,3,0,0,0,0,0,15654,7.2,18803,229,60,608,1795,28.9,1565.4,9,2,1,3,0,3,1,1,0,0,15046,6.8,17008,205,52,-608,-1795,25.7,1504.6
4854048498,0,9,0,1,3,13,5,1,1,0,0,14088,6.4,15222,157,44,-7036,-4534,20.1,1408.8,17,2,0,13,3,12,0,0,0,0,21124,7.2,19756,200,56,7036,4534,25.6,2112.4
4853988793,0,37,0,1,3,3,0,1,0,1,0,15367,7.2,18596,191,64,-21,396,25.5,1536.7,8,11,0,3,3,3,1,1,0,0,15388,7.0,18200,225,43,21,-396,26.8,1538.8
4842020037,0,10,0,1,7,2,6,0,0,0,0,16574,6.8,18063,152,60,2197,528,21.2,1657.4,14,0,0,2,7,1,0,0,0,0,14377,6.8,17535,214,48,-2197,-528,26.2,1437.7
4841986788,1,13,2,1,7,1,9,1,1,0,0,16358,6.8,18415,180,64,3467,2048,24.4,1635.8,12,3,0,1,7,0,0,0,0,0,12891,6.6,16367,161,48,-3467,-2048,20.9,1289.1
4841961921,1,2,0,0,21,20,44,0,0,0,0,35746,10.8,37960,108,0,365,36,10.8,3574.6,92,0,1,20,21,46,0,0,0,0,35381,10.6,37924,111,0,-365,-36,11.1,3538.1
4841419680,0,26,1,0,3,5,4,0,0,0,0,15655,6.6,17096,209,60,-1807,-1829,26.9,1565.5,19,15,1,5,3,5,0,0,0,0,17462,7.0,18925,218,52,1807,1829,27.0,1746.2
4841376187,1,13,0,1,9,6,12,0,0,0,0,16846,6.8,17812,175,52,-345,-271,22.7,1684.6,14,2,0,6,9,6,0,0,0,0,17191,7.2,18083,216,48,345,271,26.4,1719.1
4841343507,1,14,1,1,6,2,1,1,0,1,1,18111,7.2,19290,235,56,5134,3473,29.1,1811.1,28,1,0,2,6,0,0,0,0,0,12977,6.4,15817,160,48,-5134,-3473,20.8,1297.7
4841306902,1,13,2,1,3,0,3,1,1,0,0,15416,7.0,18414,205,51,3151,2129,25.6,1541.6,14,3,0,0,3,0,0,0,0,0,12265,6.6,16285,174,44,-3151,-2129,21.8,1226.5
4841260979,0,12,0,1,9,4,2,0,0,0,0,16180,7.0,18196,175,45,977,1843,22.0,1618.0,23,2,0,4,9,6,0,0,0,0,15203,6.6,16353,166,40,-977,-1843,20.6,1520.3
4841186228,0,10,2,1,5,3,2,1,1,0,0,15646,7.0,18295,177,64,768,481,24.1,1564.6,13,0,0,3,5,0,0,0,0,0,14878,6.8,17814,183,68,-768,-481,25.1,1487.8
4840981691,0,75,2,0,3,4,1,0,0,0,0,13897,6.4,15897,149,52,-1701,-1854,20.1,1389.7,22,0,1,4,3,3,0,0,0,0,15598,7.0,17751,193,48,1701,1854,24.1,1559.8
4840378833,0,9,0,1,3,5,3,0,0,0,0,14444,6.6,16404,152,44,-1566,-1415,19.6,1444.4,12,0,0,5,3,2,0,0,0,0,16010,6.8,17819,194,46,1566,1415,24.0,1601.0
4840346180,0,19,0,1,3,6,3,0,0,0,0,14698,6.6,16211,165,52,-2494,-1563,21.7,1469.8,13,0,0,6,3,7,0,0,0,0,17192,7.0,17774,200,40,2494,1563,24.0,1719.2
4839309645,1,11,2,1,5,2,6,0,0,0,0,15827,7.0,17503,202,48,2063,2113,25.0,1582.7,15,2,0,2,5,3,1,1,0,0,13764,6.2,15390,162,48,-2063,-2113,21.0,1376.4
4839275067,1,7,1,1,3,3,4,0,0,0,0,16223,6.8,17949,188,52,2488,750,24.0,1622.3,9,0,0,3,3,4,0,0,0,0,13735,6.8,17199,152,56,-2488,-750,20.8,1373.5
4839243228,1,52,2,0,7,6,4,0,0,0,0,17173,7.0,18472,207,53,1230,122,26.0,1717.3,12,3,1,6,7,6,0,0,0,0,15943,7.2,18350,200,63,-1230,-122,26.3,1594.3
4838877894,1,25,13,0,13,5,11,0,0,0,0,18561,7.2,18044,211,36,4048,2019,24.7,1856.1,29,2,1,5,13,2,1,1,0,0,14513,6.4,16025,193,44,-4048,-2019,23.7,1451.3
4856927090,1,15,0,0,1,6,0,0,0,0,0,13431,6.6,16516,184,36,-2295,390,22.0,1343.1,12,0,1,6,1,11,1,1,0,0,15726,6.6,16126,161,60,2295,-390,22.1,1572.6
4856012286,1,13,2,0,3,4,3,1,1,0,0,14559,6.8,17593,190,60,71,270,25.0,1455.9,11,2,1,4,3,5,0,0,0,0,14488,6.8,17323,175,48,-71,-270,22.3,1448.8
4855967178,1,27,0,1,3,4,0,0,0,0,0,15583,6.8,18305,214,46,1248,1079,26.0,1558.3,8,6,0,4,3,1,1,1,0,0,14335,6.6,17226,189,54,-1248,-1079,24.3,1433.5
4855183053,1,13,2,1,4,5,1,0,0,0,0,15807,7.0,18248,207,55,-6,534,26.2,1580.7,14,3,0,5,4,5,1,1,0,0,15813,7.0,17714,197,56,6,-534,25.3,1581.3
4855125622,0,14,2,1,2,3,2,0,0,0,0,13916,6.4,15744,152,40,-1425,-1725,19.2,1391.6,171,1,0,3,2,3,0,0,0,0,15341,6.8,17469,182,56,1425,1725,23.8,1534.1
4854734467,1,13,4,1,3,2,1,1,0,1,0,14588,7.2,18247,198,49,863,-231,24.7,1458.8,11,0,0,2,3,0,0,0,0,0,13725,7.2,18478,180,58,-863,231,23.8,1372.5
4853660156,1,12,0,0,6,3,4,0,0,0,0,15840,6.6,17106,159,48,1057,269,20.7,1584.0,14,0,1,3,6,1,1,1,0,0,14783,6.8,16837,204,52,-1057,-269,25.6,1478.3
4852988659,1,13,1,0,3,6,1,0,0,0,0,14397,6.6,16768,170,48,-988,-1227,21.8,1439.7,10,0,1,6,3,2,2,1,1,0,15385,6.8,17995,201,52,988,1227,25.3,1538.5
4852936411,1,29,3,1,5,4,6,0,0,0,0,16529,6.8,17766,217,50,552,738,26.7,1652.9,13,1,0,4,5,11,1,1,0,0,15977,6.4,17028,183,60,-552,-738,24.3,1597.7
4852329296,1,9,1,0,4,4,4,0,0,0,0,14994,6.6,16103,168,50,-2103,-1895,21.8,1499.4,14,0,1,4,4,3,2,1,1,0,17097,7.0,17998,209,62,2103,1895,27.1,1709.7
4850815795,0,11,1,1,12,3,8,1,1,0,0,18765,7.0,17957,199,49,3272,1871,24.8,1876.5,13,0,0,3,12,1,0,0,0,0,15493,6.6,16086,155,54,-3272,-1871,20.9,1549.3
4850456782,0,12,1,1,5,4,4,1,1,0,0,16177,7.0,18266,211,64,1465,893,27.5,1617.7,14,0,0,4,5,4,0,0,0,0,14712,6.8,17373,164,52,-1465,-893,21.6,1471.2
4849791752,0,19,1,1,6,2,4,0,0,0,0,16251,7.0,18418,204,66,2707,149,27.0,1625.1,13,1,0,2,6,2,1,1,0,0,13544,7.0,18269,179,52,-2707,-149,23.1,1354.4
4849505647,0,18,1,1,6,1,4,1,1,0,0,16096,7.2,18580,182,52,2096,708,23.4,1609.6,12,1,0,1,6,0,1,0,1,0,14000,7.0,17872,188,56,-2096,-708,24.4,1400.0
4849497394,0,14,0,0,1,5,1,0,0,0,0,13647,6.6,16289,172,59,-2894,-1556,23.1,1364.7,124,2,1,5,1,4,1,1,0,0,16541,6.8,17845,180,52,2894,1556,23.2,1654.1
4846501797,1,12,2,1,7,0,10,1,1,0,0,17588,6.8,17260,198,54,4438,1630,25.2,1758.8,15,3,0,0,7,0,0,0,0,0,13150,6.4,15630,197,57,-4438,-1630,25.4,1315.0
4844245561,0,13,0,1,3,5,4,1,1,0,0,16147,6.8,17709,224,60,887,830,28.4,1614.7,11,0,0,5,3,2,0,0,0,0,15260,6.6,16879,165,44,-887,-830,20.9,1526.0
4843027861,0,12,0,0,9,8,9,0,0,0,0,17243,6.4,15811,167,40,226,-76,20.7,1724.3,10,1,1,8,9,8,0,0,0,0,17017,6.4,15887,175,48,-226,76,22.3,1701.7
4838822240,1,14,1,0,6,5,4,0,0,0,0,16140,6.6,17134,209,37,866,-572,24.6,1614.0,11,0,1,5,6,3,0,0,0,0,15274,6.6,17706,196,55,-866,572,25.1,1527.4
4838230327,0,14,0,0,2,1,2,0,0,0,0,15956,6.8,17791,229,52,577,-546,28.1,1595.6,7,0,1,1,2,1,0,0,0,0,15379,7.0,18337,248,56,-577,546,30.4,1537.9
4857086285,1,7,0,1,18,11,24,0,0,0,0,45950,10.4,49000,0,0,18100,20500,0.0,4595.0,0,0,0,9,16,6,0,0,0,0,27850,6.0,28500,0,0,-18100,-20500,0.0,2785.0
4857069425,1,5,0,1,17,23,14,0,0,0,0,65315,12.0,55000,0,0,26815,22000,0.0,6531.5,0,0,0,13,7,13,0,0,0,0,38500,7.2,33000,0,0,-26815,-22000,0.0,3850.0
4857054105,1,0,0,1,19,22,16,0,0,0,0,63750,12.0,55000,0,0,26200,22000,0.0,6375.0,0,0,0,11,8,14,0,0,0,0,37550,7.2,33000,0,0,-26200,-22000,0.0,3755.0
4857032525,1,0,0,0,16,12,18,0,0,0,0,63122,12.0,55000,0,0,27672,22000,0.0,6312.2,19,0,1,7,11,5,0,0,0,0,35450,7.2,33000,0,0,-27672,-22000,0.0,3545.0
4857015666,1,0,0,1,17,22,20,0,0,0,0,63445,12.0,55000,0,0,24821,22000,0.0,6344.5,0,0,0,15,10,10,0,0,0,0,38624,7.2,33000,0,0,-24821,-22000,0.0,3862.4
4857004979,1,18,1,0,18,24,10,0,0,0,0,47010,10.0,47500,1,0,16710,16000,0.1,4701.0,29,0,1,13,7,17,0,0,0,0,30300,6.6,31500,0,0,-16710,-16000,0.0,3030.0
4856985606,1,67,1,0,18,14,22,0,0,0,0,62070,12.0,55000,1,0,25863,22000,0.1,6207.0,17,0,1,8,12,7,0,0,0,0,36207,7.2,33000,0,0,-25863,-22000,0.0,3620.7
4856483385,1,4,0,1,21,14,21,0,0,0,0,50375,10.0,47500,3,0,23875,19000,0.3,5037.5,0,0,0,7,14,5,0,0,0,0,26500,6.0,28500,0,0,-23875,-19000,0.0,2650.0
4856463542,1,5,0,0,15,16,13,0,0,0,0,46659,10.0,47500,0,0,18109,19000,0.0,4665.9,0,0,1,10,9,10,0,0,0,0,28550,6.0,28500,0,0,-18109,-19000,0.0,2855.0
4856437111,1,24,0,1,17,24,23,0,0,0,0,49988,10.6,50500,0,0,20738,22000,0.0,4998.8,0,0,0,15,8,12,0,0,0,0,29250,6.0,28500,0,0,-20738,-22000,0.0,2925.0
4856413586,1,9,0,1,24,16,24,0,0,0,0,65150,13.0,62500,0,0,28300,25000,0.0,6515.0,0,0,0,9,17,10,0,0,0,0,36850,7.8,37500,0,0,-28300,-25000,0.0,3685.0
4856390159,1,5,0,1,19,14,19,0,0,0,0,46945,10.0,47500,3,0,16295,19000,0.3,4694.5,0,0,0,7,12,8,0,0,0,0,30650,6.0,28500,0,0,-16295,-19000,0.0,3065.0
4855953213,1,5,0,0,20,15,18,0,0,0,0,47000,10.0,47500,0,0,19500,19000,0.0,4700.0,0,0,1,9,14,10,0,0,0,0,27500,6.0,28500,0,0,-19500,-19000,0.0,2750.0
4855941041,1,0,0,1,23,19,21,0,0,0,0,64270,12.0,55000,2,0,25875,22000,0.2,6427.0,0,0,0,10,14,7,0,0,0,0,38395,7.2,33000,1,0,-25875,-22000,0.1,3839.5
4855925901,1,0,0,1,19,18,18,0,0,0,0,62716,12.0,55000,0,0,21716,22000,0.0,6271.6,0,0,0,9,10,11,0,0,0,0,41000,7.2,33000,0,0,-21716,-22000,0.0,4100.0
4855905205,1,85,0,1,19,14,19,0,0,0,0,48125,10.0,47500,0,0,20251,19000,0.0,4812.5,0,0,0,9,14,8,0,0,0,0,27874,6.0,28500,0,0,-20251,-19000,0.0,2787.4
4855812909,1,1,0,1,23,22,25,0,0,0,0,48400,10.0,47500,0,0,19500,19000,0.0,4840.0,39,0,0,11,12,13,0,0,0,0,28900,6.0,28500,0,0,-19500,-19000,0.0,2890.0
4855802788,1,0,0,0,20,16,16,0,0,0,0,62600,12.0,55000,0,0,25400,22000,0.0,6260.0,0,0,1,8,12,11,0,0,0,0,37200,7.2,33000,0,0,-25400,-22000,0.0,3720.0
4855788991,1,0,0,1,14,21,16,0,0,0,0,48066,10.0,47500,0,0,18116,19000,0.0,4806.6,0,0,0,12,5,8,0,0,0,0,29950,6.0,28500,0,0,-18116,-19000,0.0,2995.0
4855770979,1,0,0,0,19,17,21,0,0,0,0,48053,10.0,47500,0,0,20203,19000,0.0,4805.3,0,0,1,10,12,7,0,0,0,0,27850,6.0,28500,0,0,-20203,-19000,0.0,2785.0
4844842053,1,34,5,0,21,17,44,0,0,0,0,35842,11.2,40940,111,0,546,1545,11.1,3584.2,48,0,1,17,21,48,0,0,0,0,35296,11.0,39395,89,0,-546,-1545,8.9,3529.6
4844825678,1,0,0,0,32,21,94,0,0,0,1,40301,11.6,44561,108,0,4900,5888,10.8,4030.1,0,0,1,21,32,52,0,0,0,0,35401,10.8,38673,79,0,-4900,-5888,7.9,3540.1
4844810434,0,25,0,1,16,25,35,0,0,0,1,34884,10.8,37643,101,0,-1363,-3179,10.1,3488.4,0,18,0,25,16,56,0,0,0,0,36247,11.2,40822,91,0,1363,3179,9.1,3624.7
4844803755,1,0,0,1,30,22,69,0,0,0,1,39541,11.4,42495,99,0,3961,3286,9.9,3954.1,0,0,0,22,30,57,0,0,0,0,35580,11.0,39209,75,0,-3961,-3286,7.5,3558.0
4844784218,0,91,0,0,22,26,54,0,0,0,0,35224,11.0,39959,110,0,-3077,-2497,11.0,3522.4,0,3,1,26,22,64,0,0,0,0,38301,11.4,42456,108,0,3077,2497,10.8,3830.1
4836190604,0,0,0,0,26,25,62,0,0,0,1,37595,11.2,42182,104,0,607,1169,10.4,3759.5,0,0,1,25,26,69,0,0,0,0,36988,11.4,41013,97,0,-607,-1169,9.7,3698.8
4825834532,1,13,11,1,10,16,12,0,0,0,0,33284,10.6,36426,74,49,2927,3089,12.3,3328.4,44,0,0,16,10,36,0,0,0,0,30357,10.2,33337,80,47,-2927,-3089,12.7,3035.7
4825800555,1,50,1,0,18,16,38,0,0,0,1,37509,11.0,39080,78,55,5087,3092,13.3,3750.9,19,14,1,16,18,40,0,0,0,0,32422,10.4,35988,80,63,-5087,-3092,14.3,3242.2
4825784171,0,12,0,0,12,24,19,0,0,0,0,33629,11.0,37353,91,51,-6546,-9065,14.2,3362.9,11,0,1,24,12,43,0,0,0,0,40175,11.8,46418,104,71,6546,9065,17.5,4017.5
4825760457,1,10,0,0,19,6,46,0,0,0,1,36900,11.2,40503,100,67,5282,6042,16.7,3690.0,10,1,1,6,19,15,0,0,0,0,31618,10.2,34461,97,59,-5282,-6042,15.6,3161.8
4821863402,1,26,0,1,6,17,11,0,0,0,1,27379,10.4,33778,105,48,-3317,-4096,15.3,2737.9,10,0,0,16,5,28,0,0,0,0,30696,10.8,37874,92,55,3317,4096,14.7,3069.6
4821844335,0,50,0,1,10,11,12,0,0,0,0,30348,10.8,37837,82,59,-4474,-1737,14.1,3034.8,53,0,0,11,10,22,0,0,0,0,34822,11.0,39574,106,67,4474,1737,17.3,3482.2
4821820975,0,16,0,0,13,14,21,0,0,0,1,29356,10.4,35365,99,55,-6528,-4889,15.4,2935.6,14,1,1,14,13,18,0,0,0,0,35884,11.2,40254,125,65,6528,4889,19.0,3588.4
4821781541,0,12,0,0,11,11,30,0,0,0,1,34681,10.8,38095,107,63,71,222,17.0,3468.1,9,0,1,11,11,24,0,0,0,0,34610,10.8,37873,95,67,-71,-222,16.2,3461.0
4819225169,1,9,1,0,18,7,40,0,0,0,2,40255,11.6,43718,116,59,8121,8890,17.5,4025.5,12,0,1,7,18,12,0,0,0,0,32134,10.4,34828,82,55,-8121,-8890,13.7,3213.4
4819211208,1,10,4,0,14,14,25,0,0,0,0,32015,11.4,42075,96,79,-1774,1926,17.5,3201.5,14,0,1,12,12,33,0,0,0,0,33789,11.0,40149,109,71,1774,-1926,18.0,3378.9
4816508046,0,22,0,1,9,15,12,0,0,0,0,31557,10.4,36177,72,63,-3345,-5288,13.5,3155.7,13,2,0,15,9,16,0,0,0,0,34902,11.4,41465,95,71,3345,5288,16.6,3490.2
4816492875,1,13,0,1,18,7,31,0,0,0,2,38258,11.8,46220,135,81,8838,6427,21.6,3825.8,11,0,0,7,18,14,0,0,0,0,29420,11.4,39793,128,41,-8838,-6427,16.9,2942.0
4816482104,0,16,1,0,11,10,12,0,0,0,0,31658,10.6,35107,91,52,-615,-911,14.3,3165.8,19,0,1,10,11,13,0,0,0,0,32273,10.8,36018,77,50,615,911,12.7,3227.3
4856206366,0,1,0,0,18,37,36,0,0,0,1,37048,11.2,40422,117,0,-4449,-5196,11.7,3704.8,127,0,1,37,18,111,0,0,0,0,41497,12.0,45618,120,0,4449,5196,12.0,4149.7
4856161669,0,76,0,1,14,11,48,0,0,0,2,34424,10.6,36633,109,0,1201,2952,10.9,3442.4,0,0,0,11,14,22,0,0,0,0,33223,9.8,33681,119,0,-1201,-2952,11.9,3322.3
4856121192,0,0,0,0,12,13,31,0,0,0,1,33305,10.0,35422,115,0,-1688,-1941,11.5,3330.5,0,0,1,13,12,35,0,0,0,0,34993,10.6,37363,122,0,1688,1941,12.2,3499.3
4855240260,1,3,0,0,17,19,13,0,0,0,0,62436,12.6,59500,0,0,23464,22000,0.0,6243.6,0,0,1,13,11,14,0,0,0,0,38972,7.8,37500,0,0,-23464,-22000,0.0,3897.2
4855213637,1,359,0,0,24,22,19,0,0,0,0,50261,10.0,47500,2,0,20983,19000,0.2,5026.1,0,0,1,10,12,13,0,0,0,0,29278,6.0,28500,0,0,-20983,-19000,0.0,2927.8
4855192129,1,2,0,1,16,13,14,0,0,0,0,61140,12.0,55000,2,0,24180,22000,0.2,6114.0,0,0,0,7,10,8,0,0,0,0,36960,7.2,33000,1,0,-24180,-22000,0.1,3696.0
4855160183,1,48,3,1,19,14,22,0,0,0,0,64285,12.0,55000,6,0,27080,22000,0.6,6428.5,0,1,0,8,13,6,0,0,0,0,37205,7.2,33000,0,0,-27080,-22000,0.0,3720.5
4855138872,1,0,0,0,18,13,16,0,0,0,0,61677,12.0,55000,0,0,25494,22000,0.0,6167.7,4,0,1,6,11,6,0,0,0,0,36183,7.2,33000,0,0,-25494,-22000,0.0,3618.3
4855096718,1,0,0,0,17,19,43,0,0,0,1,35385,10.8,37995,98,0,1715,918,9.8,3538.5,0,0,1,17,15,39,0,0,0,0,33670,10.6,37077,108,0,-1715,-918,10.8,3367.0
4855063974,1,0,0,1,23,16,75,0,0,0,0,37407,10.8,40231,120,0,2706,1649,12.0,3740.7,0,0,0,16,23,39,0,0,0,0,34701,11.0,38582,92,0,-2706,-1649,9.2,3470.1
4855018580,0,16,1,0,1,6,0,1,1,0,0,13886,6.8,17951,219,56,-2180,-289,27.5,1388.6,93,3,1,6,1,5,0,0,0,0,16066,6.8,18240,194,52,2180,289,24.6,1606.6
4854063227,0,12,3,1,4,1,4,0,0,0,0,15408,7.0,18801,215,60,-271,339,27.5,1540.8,14,1,0,1,4,1,0,0,0,0,15679,7.0,18462,218,60,271,-339,27.8,1567.9
4853991906,0,10,1,0,2,6,2,0,0,0,0,15026,7.6,19605,231,60,-1259,1505,29.1,1502.6,12,0,1,6,2,9,1,1,0,0,16285,6.8,18100,218,60,1259,-1505,27.8,1628.5
4853916571,1,10,2,0,2,4,1,0,0,0,0,16220,7.0,18792,242,56,660,369,29.8,1622.0,14,2,1,4,2,3,1,1,0,0,15560,7.0,18423,208,56,-660,-369,26.4,1556.0
4853849378,0,12,2,0,4,4,4,1,1,0,0,16193,7.0,18798,239,56,132,744,29.5,1619.3,11,1,1,4,4,6,0,0,0,0,16061,6.8,18054,207,55,-132,-744,26.2,1606.1
4853788760,0,15,0,0,3,2,3,0,0,0,0,15316,7.0,18118,216,68,1384,2034,28.4,1531.6,10,1,1,2,3,2,1,1,0,0,13932,6.4,16084,188,56,-1384,-2034,24.4,1393.2
4853736094,0,8,1,0,2,6,2,0,0,0,0,14113,6.6,17172,192,48,-2347,-156,24.0,1411.3,19,0,1,6,2,5,0,0,0,0,16460,6.6,17328,191,40,2347,156,23.1,1646.0
4853005113,1,7,0,0,11,17,11,0,0,0,0,56100,12.0,55000,0,0,20900,22000,0.0,5610.0,0,0,1,15,9,12,0,0,0,0,35200,7.2,33000,0,0,-20900,-22000,0.0,3520.0
4852980869,1,18,0,1,25,17,28,0,0,0,0,64100,12.0,55000,7,0,26900,22000,0.7,6410.0,7,0,0,9,17,9,0,0,0,0,37200,7.2,33000,1,0,-26900,-22000,0.1,3720.0
4852945038,1,0,0,1,16,13,17,0,0,0,0,46300,10.0,47500,7,0,19500,19000,0.7,4630.0,0,0,0,7,10,6,0,0,0,0,26800,6.0,28500,8,0,-19500,-19000,0.8,2680.0
4841549063,1,11,2,0,2,5,0,0,0,0,0,15764,6.8,18196,207,56,701,920,26.3,1576.4,17,2,1,5,2,4,0,0,0,0,15063,6.8,17276,152,51,-701,-920,20.3,1506.3
4841529196,1,23,3,1,9,2,10,1,1,0,0,17496,6.8,17866,189,44,3325,993,23.3,1749.6,17,1,0,2,9,2,0,0,0,0,14171,6.8,16873,174,48,-3325,-993,22.2,1417.1
4840435526,1,52,1,1,6,4,4,1,1,0,0,17122,7.0,18216,200,52,476,-48,25.2,1712.2,12,1,0,4,6,1,0,0,0,0,16646,7.2,18264,192,68,-476,48,26.0,1664.6
4840406068,0,9,2,0,3,3,3,0,0,0,0,14491,6.6,15990,184,44,-1197,-1154,22.8,1449.1,20,1,1,3,3,4,0,0,0,0,15688,6.6,17144,195,52,1197,1154,24.7,1568.8
4832163777,0,11,1,0,1,6,1,0,0,0,0,14642,6.6,16691,214,52,-1001,-880,26.6,1464.2,120,1,1,6,1,2,1,1,0,0,15643,7.0,17571,198,48,1001,880,24.6,1564.3
4829186719,0,14,1,0,11,34,16,0,0,0,0,33270,10.4,35954,95,51,-5826,-8899,14.6,3327.0,24,0,1,34,11,60,0,0,0,0,39096,11.8,44853,82,63,5826,8899,14.5,3909.6
4829180476,1,11,0,0,17,13,38,0,0,0,1,36098,11.4,40645,112,55,3691,5923,16.7,3609.8,13,2,1,12,16,25,0,0,0,0,32407,10.2,34722,89,49,-3691,-5923,13.8,3240.7
4829173015,1,33,2,0,15,15,28,0,0,0,0,35543,11.2,41571,112,78,1352,7875,19.0,3554.3,9,17,1,15,15,28,0,0,0,0,34191,10.0,33696,82,42,-1352,-7875,12.4,3419.1
4829158530,1,15,2,1,9,14,22,0,0,0,1,37184,11.4,41640,93,67,7023,4635,16.0,3718.4,8,3,0,13,8,35,0,0,0,0,30161,10.6,37005,91,40,-7023,-4635,13.1,3016.1
4829153855,1,63,1,1,10,13,17,0,0,0,0,33374,11.0,39711,123,67,-480,-2293,19.0,3337.4,63,1,0,13,10,30,0,0,0,0,33854,11.4,42004,96,59,480,2293,15.5,3385.4
4829145788,0,14,0,1,9,12,12,0,0,0,0,28883,10.4,35306,89,59,-4666,-1751,14.8,2888.3,98,0,0,12,9,22,0,0,0,0,33549,10.6,37057,108,51,4666,1751,15.9,3354.9
4829126935,0,14,1,0,3,4,5,0,0,0,0,15540,6.8,17967,147,60,60,5,20.7,1554.0,25,3,1,4,3,3,0,0,0,0,15480,7.0,17962,234,36,-60,-5,27.0,1548.0
4829112142,0,12,2,1,2,7,3,0,0,0,0,14438,6.8,17525,180,48,-3715,-1563,22.8,1443.8,14,0,0,7,2,6,0,0,0,0,18153,7.4,19088,213,68,3715,1563,28.1,1815.3
4826811626,0,12,0,0,19,20,24,0,0,0,0,35249,10.4,35816,78,52,-47,-6654,13.0,3524.9,19,2,1,19,18,32,0,0,0,0,35296,11.4,42470,84,59,47,6654,14.3,3529.6
4826768857,0,15,0,0,3,6,3,1,1,0,0,15051,7.0,17841,192,60,-1891,-941,25.2,1505.1,12,0,1,6,3,5,0,0,0,0,16942,7.0,18782,192,54,1891,941,24.6,1694.2
4826718522,1,18,2,0,10,8,4,2,1,1,0,17948,7.0,18209,188,56,1513,552,24.4,1794.8,256,0,1,8,10,5,0,0,0,0,16435,6.8,17657,167,39,-1513,-552,20.6,1643.5
4826684763,1,11,1,1,3,2,2,1,1,0,0,15861,6.8,18177,218,56,1479,761,27.4,1586.1,12,0,0,2,3,1,0,0,0,0,14382,6.6,17416,189,52,-1479,-761,24.1,1438.2
4826537975,0,12,0,1,2,3,1,1,1,0,0,15717,7.0,18222,202,52,2095,2734,25.4,1571.7,11,0,0,3,2,2,0,0,0,0,13622,6.4,15488,158,51,-2095,-2734,20.9,1362.2
4825690973,0,11,0,1,26,13,41,0,0,0,0,39712,11.4,42236,76,63,4854,1817,13.9,3971.2,9,1,0,13,26,35,0,0,0,0,34858,11.2,40419,73,51,-4854,-1817,12.4,3485.8
4825316633,1,12,1,1,8,5,7,1,1,0,0,17832,6.8,17902,186,60,1849,1225,24.6,1783.2,21,2,0,5,8,7,0,0,0,0,15983,6.6,16677,172,56,-1849,-1225,22.8,1598.3
4857056693,1,28,0,1,19,16,19,0,0,0,0,63710,12.0,55000,6,0,24965,22000,0.6,6371.0,5,0,0,8,11,10,0,0,0,0,38745,7.2,33000,2,0,-24965,-22000,0.2,3874.5
4857043516,1,21,0,1,16,22,14,0,0,0,0,60250,12.0,55000,0,0,22000,22000,0.0,6025.0,0,0,0,13,7,14,0,0,0,0,38250,7.2,33000,0,0,-22000,-22000,0.0,3825.0
4857027510,1,0,0,1,16,20,15,0,0,0,0,62042,12.0,55000,0,0,24808,22000,0.0,6204.2,7,0,0,12,8,11,0,0,0,0,37234,7.2,33000,0,0,-24808,-22000,0.0,3723.4
4857013322,1,396,0,1,21,14,17,0,0,0,0,41163,10.0,47500,2,0,12337,19000,0.2,4116.3,13,0,0,7,14,6,0,0,0,0,28826,6.0,28500,4,0,-12337,-19000,0.4,2882.6
4856990672,1,10,0,1,17,17,11,0,0,0,0,45400,10.6,50500,3,0,17400,22000,0.3,4540.0,0,0,0,7,7,12,0,0,0,0,28000,6.0,28500,3,0,-17400,-22000,0.3,2800.0
4856976036,1,0,0,0,14,18,19,0,0,0,0,62045,12.0,55000,0,0,23415,22000,0.0,6204.5,0,0,1,15,11,11,0,0,0,0,38630,7.2,33000,0,0,-23415,-22000,0.0,3863.0
4856961990,1,8,0,1,17,24,15,0,0,0,0,62700,12.2,56000,0,0,22700,23000,0.0,6270.0,0,0,0,15,8,16,0,0,0,0,40000,7.2,33000,0,0,-22700,-23000,0.0,4000.0
4856950013,1,45,0,0,17,18,17,0,0,0,0,47400,10.0,47500,3,0,19500,19000,0.3,4740.0,0,0,1,10,9,8,0,0,0,0,27900,6.0,28500,9,0,-19500,-19000,0.9,2790.0
4856929567,1,0,0,1,18,17,19,0,0,0,0,64100,12.0,55000,0,0,36200,22000,0.0,6410.0,4,0,0,11,12,10,0,0,0,0,27900,7.2,33000,0,0,-36200,-22000,0.0,2790.0
4856915432,1,30,2,0,13,14,19,0,0,0,0,62135,12.0,55000,5,0,24925,22000,0.5,6213.5,86,2,1,10,9,5,0,0,0,0,37210,7.2,33000,0,0,-24925,-22000,0.0,3721.0
4856908047,1,396,0,1,19,25,20,0,0,0,0,62778,12.0,55000,1,0,23742,22000,0.1,6277.8,1,0,0,18,12,13,0,0,0,0,39036,7.2,33000,1,0,-23742,-22000,0.1,3903.6
4856891161,1,0,0,0,11,22,12,0,0,0,0,58176,12.0,55000,0,0,19168,22000,0.0,5817.6,0,0,1,14,3,16,0,0,0,0,39008,7.2,33000,0,0,-19168,-22000,0.0,3900.8
4856876691,1,3,0,1,29,14,21,0,0,0,0,49570,10.0,47500,0,0,22770,19000,0.0,4957.0,0,0,0,1,16,11,0,0,0,0,26800,6.0,28500,0,0,-22770,-19000,0.0,2680.0
4856480200,1,0,4,1,20,18,14,0,0,0,0,46670,10.0,47500,0,0,18045,17820,0.0,4667.0,28,0,0,8,10,13,0,0,0,0,28625,6.2,29680,3,0,-18045,-17820,0.3,2862.5
4856466763,1,5,0,0,16,16,21,0,0,0,0,61330,12.0,55000,0,0,24830,22000,0.0,6133.0,0,0,1,10,10,9,0,0,0,0,36500,7.2,33000,0,0,-24830,-22000,0.0,3650.0
4856435890,1,3,0,1,15,17,18,0,0,0,0,47700,10.0,47500,0,0,17754,19000,0.0,4770.0,5,0,0,11,9,8,0,0,0,0,29946,6.0,28500,0,0,-17754,-19000,0.0,2994.6
4856371967,1,0,0,1,17,13,19,0,0,0,0,45600,10.0,47500,0,0,18100,19000,0.0,4560.0,0,0,0,8,12,7,0,0,0,0,27500,6.0,28500,0,0,-18100,-19000,0.0,2750.0
4856324834,1,0,0,0,15,17,12,0,0,0,0,46471,10.0,47500,0,0,18971,19000,0.0,4647.1,0,0,1,10,8,11,0,0,0,0,27500,6.0,28500,0,0,-18971,-19000,0.0,2750.0
4856285247,1,0,0,1,18,21,18,0,0,0,0,61766,12.0,55000,0,0,23166,22000,0.0,6176.6,0,0,0,12,9,12,0,0,0,0,38600,7.2,33000,0,0,-23166,-22000,0.0,3860.0
4856253361,1,0,0,1,16,22,15,0,0,0,0,44200,10.0,47500,0,0,13836,19000,0.0,4420.0,0,0,0,12,6,14,0,0,0,0,30364,6.0,28500,0,0,-13836,-19000,0.0,3036.4
4856976704,0,13,1,0,1,7,2,1,0,1,0,14354,6.8,17709,197,51,-1971,70,24.8,1435.4,15,0,1,7,1,4,1,1,0,0,16325,6.8,17639,178,60,1971,-70,23.8,1632.5
4856162804,0,29,0,1,27,27,63,0,0,0,2,38463,10.8,40017,120,0,208,-987,12.0,3846.3,0,15,0,26,26,67,0,0,0,0,38255,11.2,41004,92,0,-208,987,9.2,3825.5
4856125392,0,1,0,0,15,25,41,0,0,0,2,35309,10.8,37329,99,0,-5820,-5801,9.9,3530.9,27,0,1,25,15,73,0,0,0,0,41129,11.6,43130,118,0,5820,5801,11.8,4112.9
4855444936,1,0,0,0,14,20,28,0,0,0,0,35013,10.4,36363,123,0,-128,-3080,12.3,3501.3,0,0,1,20,14,42,0,0,0,0,35141,11.0,39443,104,0,128,3080,10.4,3514.1
4855417618,1,0,3,0,19,14,61,0,0,0,0,37352,10.8,38261,117,0,4435,3763,11.7,3735.2,16,0,1,14,19,38,0,0,0,0,32917,10.0,34498,97,0,-4435,-3763,9.7,3291.7
4855078405,0,0,0,0,24,26,61,0,0,0,2,38892,11.4,43074,113,0,-149,-2184,11.3,3889.2,0,0,1,26,24,69,0,0,0,0,39041,11.6,45258,112,0,149,2184,11.2,3904.1
4855050938,0,0,0,0,27,33,70,0,0,0,1,37729,11.4,42716,65,0,-3237,-3831,6.5,3772.9,0,0,1,33,27,73,0,0,0,0,40966,12.0,46547,89,0,3237,3831,8.9,4096.6
4855009691,1,0,0,1,27,30,74,0,0,0,0,38653,11.6,42756,95,0,-692,-1450,9.5,3865.3,0,0,0,30,27,78,0,0,0,0,39345,11.6,44206,76,0,692,1450,7.6,3934.5
4847851895,1,0,0,1,26,28,70,0,0,0,0,38811,11.8,43096,98,0,323,727,9.8,3881.1,0,0,0,28,26,68,0,0,0,0,38488,11.4,42369,83,0,-323,-727,8.3,3848.8
4847832827,0,0,0,0,17,24,42,0,0,0,1,35394,10.6,36982,96,0,-1612,-3706,9.6,3539.4,0,0,1,24,17,58,0,0,0,0,37006,11.2,40688,102,0,1612,3706,10.2,3700.6
4847810965,1,13,0,1,24,21,62,0,0,0,1,38244,11.4,42091,117,0,2647,3805,11.7,3824.4,0,0,0,21,24,54,0,0,0,0,35597,10.8,38286,79,0,-2647,-3805,7.9,3559.7
4847787589,0,2,0,0,24,29,68,0,0,0,0,39163,11.4,41729,87,0,763,-1192,8.7,3916.3,0,0,1,29,24,76,0,0,0,0,38400,11.6,42921,96,0,-763,1192,9.6,3840.0
4847764528,0,1,0,0,13,29,36,0,0,0,1,33201,10.2,34975,86,0,-5905,-6497,8.6,3320.1,0,0,1,29,13,92,0,0,0,0,39106,11.0,41472,103,0,5905,6497,10.3,3910.6
4844462556,0,20,0,0,18,17,51,0,0,0,0,35153,10.6,37090,101,0,-1162,-852,10.1,3515.3,0,4,1,17,18,38,0,0,0,0,36315,10.6,37942,99,0,1162,852,9.9,3631.5
4844451098,0,4,0,1,21,32,48,0,0,0,1,36369,10.8,38012,103,0,-3128,-3642,10.3,3636.9,0,2,0,32,21,80,0,0,0,0,39497,11.2,41654,112,0,3128,3642,11.2,3949.7
4844434191,1,0,0,1,42,20,123,0,0,0,1,42319,12.2,47366,121,0,5366,5085,12.1,4231.9,0,0,0,20,42,46,0,0,0,0,36953,11.2,42281,81,0,-5366,-5085,8.1,3695.3
4844405656,1,0,0,0,15,28,33,0,0,0,0,36719,11.0,41080,111,0,-183,-586,11.1,3671.9,0,0,1,28,15,47,0,0,0,0,36902,11.0,41666,88,0,183,586,8.8,3690.2
4843613388,1,22,0,0,22,21,66,0,0,0,1,37161,10.8,39214,113,0,-488,-790,11.3,3716.1,0,20,1,21,22,54,0,0,0,0,37649,11.2,40004,90,0,488,790,9.0,3764.9
4843603778,0,0,2,1,20,22,49,0,0,0,0,37339,11.2,40895,102,0,-1702,-2224,10.2,3733.9,19,0,0,22,20,50,0,0,0,0,39041,11.4,43119,114,0,1702,2224,11.4,3904.1
4831142795,0,9,0,0,3,11,3,0,0,0,0,14822,6.6,17122,167,36,-4083,-4118,20.3,1482.2,8,1,1,11,3,6,0,0,0,0,18905,7.6,21240,216,52,4083,4118,26.8,1890.5
4855033710,1,11,1,1,6,4,3,0,0,0,0,15247,6.6,16432,146,56,-280,-2610,20.2,1524.7,7,1,0,3,5,1,0,0,0,0,15527,7.2,19042,230,72,280,2610,30.2,1552.7
4854988223,1,156,1,1,11,8,5,1,1,0,0,18828,7.4,19146,213,52,2088,2435,26.5,1882.8,155,0,0,8,11,7,0,0,0,0,16740,6.6,16711,159,60,-2088,-2435,21.9,1674.0
4854519225,1,77,2,1,4,0,7,1,1,0,0,16362,6.8,18209,213,58,4607,2443,27.1,1636.2,13,1,0,0,4,0,0,0,0,0,11755,6.4,15766,145,44,-4607,-2443,18.9,1175.5
4854495427,1,17,0,1,3,2,3,1,1,0,0,14699,6.8,17769,195,52,64,293,24.7,1469.9,12,1,0,2,3,6,0,0,0,0,14635,6.8,17476,176,58,-64,-293,23.4,1463.5
4854137296,1,10,0,0,2,5,2,0,0,0,0,14765,6.8,17341,190,56,-736,402,24.6,1476.5,144,2,1,5,2,8,1,1,0,0,15501,6.8,16939,159,40,736,-402,19.9,1550.1
4854084617,1,14,0,1,10,3,11,0,0,0,0,18309,7.0,18585,182,52,3079,1259,23.4,1830.9,10,1,0,3,10,4,0,0,0,0,15230,7.0,17326,164,57,-3079,-1259,22.1,1523.0
4854043362,0,5,2,0,3,7,4,0,0,0,0,13601,6.4,15174,139,52,-2499,-1794,19.1,1360.1,19,0,1,7,3,7,1,1,0,0,16100,6.8,16968,196,56,2499,1794,25.2,1610.0
4853987784,1,9,22,1,5,1,5,0,0,0,0,17072,7.4,19336,214,64,3189,1114,27.8,1707.2,34,1,0,1,5,2,1,1,0,0,13883,7.0,18222,180,63,-3189,-1114,24.3,1388.3
4852756441,1,9,0,1,11,4,3,0,0,0,0,17546,7.2,18878,216,60,2937,3101,27.6,1754.6,10,0,0,4,11,2,0,0,0,0,14609,6.4,15777,164,60,-2937,-3101,22.4,1460.9
4852692877,0,17,0,1,7,4,3,1,1,0,0,16113,6.6,17190,200,62,344,97,26.2,1611.3,74,2,0,4,7,8,0,0,0,0,15769,6.8,17093,197,48,-344,-97,24.5,1576.9
4852655846,0,11,13,0,1,4,1,0,0,0,0,13958,6.8,17558,214,44,-2598,-1177,25.8,1395.8,32,2,1,4,1,7,0,0,0,0,16556,7.2,18735,230,60,2598,1177,29.0,1655.6
4851766140,1,12,2,0,2,4,0,0,0,0,0,13549,6.2,15692,181,44,-1289,-1280,22.5,1354.9,14,2,1,4,2,9,1,1,0,0,14838,6.8,16972,160,68,1289,1280,22.8,1483.8
4849563078,0,16,4,0,6,5,4,1,1,0,0,16784,6.8,17926,214,61,1668,1251,27.5,1678.4,15,2,1,5,6,4,0,0,0,0,15116,6.6,16675,145,56,-1668,-1251,20.1,1511.6
4849532446,1,11,0,1,4,3,3,0,0,0,0,14776,6.8,17527,182,60,-118,-289,24.2,1477.6,15,0,0,3,4,1,0,0,0,0,14894,7.0,17816,192,61,118,289,25.3,1489.4
4848790877,1,13,0,1,12,1,9,1,1,0,0,21002,7.2,18649,236,44,8039,2652,28.0,2100.2,10,1,0,1,12,2,0,0,0,0,12963,6.4,15997,148,56,-8039,-2652,20.4,1296.3
4848626840,1,13,1,0,6,4,2,1,1,0,0,16776,6.6,18043,193,64,2216,1565,25.7,1677.6,14,0,1,4,6,1,0,0,0,0,14560,6.6,16478,175,52,-2216,-1565,22.7,1456.0
4848431752,1,9,0,0,1,6,0,0,0,0,0,13731,6.6,16935,202,48,-2618,-715,25.0,1373.1,9,2,1,6,1,6,0,0,0,0,16349,6.8,17650,190,64,2618,715,25.4,1634.9
4848378515,0,98,2,0,4,6,1,0,0,0,0,14555,6.6,17222,155,52,-2269,-814,20.7,1455.5,19,2,1,6,4,3,1,1,0,0,16824,6.8,18036,212,56,2269,814,26.8,1682.4
4847892828,0,10,2,0,4,8,8,2,1,1,0,15930,6.8,16641,135,52,-2210,-1341,18.7,1593.0,11,1,1,8,4,5,0,0,0,0,18140,7.0,17982,194,52,2210,1341,24.6,1814.0
4847756629,1,21,0,1,5,0,3,0,0,0,0,15976,7.2,19448,218,59,3141,1956,27.7,1597.6,21,0,0,0,5,0,0,0,0,0,12835,6.8,17492,179,48,-3141,-1956,22.7,1283.5
4856118105,1,14,1,1,21,18,21,0,0,0,0,50860,10.0,47500,1,0,23690,19000,0.1,5086.0,34,0,0,11,14,10,0,0,0,0,27170,6.0,28500,2,0,-23690,-19000,0.2,2717.0
4856084688,1,17,0,1,20,11,22,0,0,0,0,48380,10.0,47500,2,0,21205,19000,0.2,4838.0,0,0,0,6,15,6,0,0,0,0,27175,6.0,28500,1,0,-21205,-19000,0.1,2717.5
4856062682,1,56,0,1,18,17,24,0,0,0,0,46910,10.0,47500,5,0,19635,19000,0.5,4691.0,0,0,0,12,13,6,0,0,0,0,27275,6.0,28500,3,0,-19635,-19000,0.3,2727.5
4851981456,1,13,2,1,8,6,7,0,0,0,0,16499,6.8,17301,155,52,489,198,20.7,1649.9,9,0,0,6,8,9,0,0,0,0,16010,6.8,17103,184,52,-489,-198,23.6,1601.0
4851942048,0,73,0,0,0,4,0,0,0,0,0,14245,6.8,17457,213,51,-546,1111,26.4,1424.5,12,1,1,4,0,3,0,0,0,0,14791,6.6,16346,183,43,546,-1111,22.6,1479.1
4851876194,0,35,0,1,8,4,6,0,0,0,0,16247,6.8,17235,154,56,1801,972,21.0,1624.7,18,0,0,4,8,2,0,0,0,0,14446,6.8,16263,147,44,-1801,-972,19.1,1444.6
4851815452,0,17,1,0,5,10,4,0,0,0,0,14007,6.4,15686,155,40,-3634,-2287,19.5,1400.7,13,0,1,10,5,8,1,1,0,0,17641,6.8,17973,182,72,3634,2287,25.4,1764.1
4846810990,1,12,1,0,5,8,1,0,0,0,0,14692,6.6,16018,151,51,-3757,-2584,20.2,1469.2,8,0,1,8,5,5,1,1,0,0,18449,6.8,18602,202,56,3757,2584,25.8,1844.9
4846772905,1,32,0,0,3,4,5,0,0,0,0,14657,6.8,16678,183,60,-2067,-1637,24.3,1465.7,38,1,1,4,3,5,0,0,0,0,16724,7.0,18315,197,56,2067,1637,25.3,1672.4
4842744313,1,12,2,0,4,6,4,0,0,0,0,15341,6.6,17415,168,52,-50,-1059,22.0,1534.1,12,1,1,6,4,7,0,0,0,0,15391,7.0,18474,172,44,50,1059,21.6,1539.1
4842740756,1,9,1,1,5,3,1,0,0,0,0,15374,6.8,17859,185,60,772,42,24.5,1537.4,11,2,0,3,5,2,0,0,0,0,14602,6.8,17817,190,52,-772,-42,24.2,1460.2
4837059651,1,9,1,0,7,9,6,0,0,0,0,16865,6.8,17809,211,41,-1298,-149,25.2,1686.5,11,3,1,9,7,8,1,1,0,0,18163,7.0,17958,186,42,1298,149,22.8,1816.3
4836973591,1,15,15,1,5,5,5,1,1,0,0,14965,6.8,17692,177,56,-1519,495,23.3,1496.5,30,0,0,4,4,6,0,0,0,0,16484,6.6,17197,193,48,1519,-495,24.1,1648.4
4836091542,0,13,3,0,5,3,7,1,1,0,0,16552,7.0,18177,211,56,1880,784,26.7,1655.2,139,1,1,3,5,2,0,0,0,0,14672,6.6,17393,213,51,-1880,-784,26.4,1467.2
4836031557,0,9,0,0,6,6,3,0,0,0,0,15717,6.4,16629,159,48,382,1607,20.7,1571.7,77,0,1,6,6,5,0,0,0,0,15335,6.2,15022,143,49,-382,-1607,19.2,1533.5
4835990788,0,12,1,1,5,1,0,0,0,0,0,14486,6.8,17084,158,37,878,116,19.5,1448.6,10,1,0,1,5,1,1,1,0,0,13608,6.4,16968,179,59,-878,-116,23.8,1360.8
4835939328,1,15,0,1,7,1,8,0,0,0,0,18406,6.8,18260,212,56,3851,-286,26.8,1840.6,11,1,0,1,7,0,1,1,0,0,14555,7.0,18546,200,60,-3851,286,26.0,1455.5
4835887670,1,87,1,1,4,1,2,0,0,0,0,14443,7.2,18460,159,76,435,126,23.5,1444.3,14,1,0,1,4,0,0,0,0,0,14008,7.0,18334,211,48,-435,-126,25.9,1400.8
4835465048,0,19,1,0,5,8,3,0,0,0,0,15679,6.4,16064,188,32,-1013,-1535,22.0,1567.9,14,2,1,8,5,7,0,0,0,0,16692,6.8,17599,165,44,1013,1535,20.9,1669.2
4771305041,1,25,10,0,6,6,8,0,0,0,0,16940,6.6,16879,182,56,-161,-909,23.8,1694.0,33,1,1,6,6,8,1,0,1,0,17101,6.8,17788,190,44,161,909,23.4,1710.1
4763156606,0,13,2,1,11,14,13,1,0,1,0,18280,6.4,15430,145,48,-970,-377,19.3,1828.0,8,1,0,14,11,23,1,1,0,0,19250,6.6,15807,171,44,970,377,21.5,1925.0
4763128721,0,10,0,1,1,3,0,0,0,0,0,13109,6.4,16136,171,48,-3507,-1582,21.9,1310.9,11,1,0,3,1,3,0,0,0,0,16616,6.8,17718,219,52,3507,1582,27.1,1661.6
4762170731,1,9,3,1,17,0,10,0,0,0,0,19137,7.2,19447,171,56,5100,2745,22.7,1913.7,10,2,0,0,17,0,0,0,0,0,14037,6.6,16702,186,48,-5100,-2745,23.4,1403.7
4762119349,1,14,0,1,4,2,1,0,0,0,0,14440,6.8,17565,161,48,869,692,20.9,1444.0,12,1,0,2,4,0,0,0,0,0,13571,6.6,16873,174,48,-869,-692,22.2,1357.1
4759707211,1,8,2,1,5,7,3,0,0,0,0,14300,6.6,16383,154,36,-2132,-1114,19.0,1430.0,23,0,0,7,5,5,0,0,0,0,16432,6.8,17497,162,44,2132,1114,20.6,1643.2
4759678410,1,11,1,1,6,4,6,0,0,0,0,16732,6.8,17762,175,48,2839,1201,22.3,1673.2,10,1,0,4,6,0,1,1,0,0,13893,6.4,16561,159,44,-2839,-1201,20.3,1389.3
4759653746,1,11,4,1,9,5,9,0,0,0,0,16987,6.6,16763,165,42,314,65,20.7,1698.7,21,2,0,5,9,8,0,0,0,0,16673,6.6,16698,173,42,-314,-65,21.5,1667.3
4757344684,1,155,1,1,2,6,2,0,0,0,0,14293,6.4,16286,155,43,-1219,-1453,19.8,1429.3,12,1,0,6,2,5,1,1,0,0,15512,6.8,17739,184,52,1219,1453,23.6,1551.2
4757320960,1,13,0,0,2,5,2,1,1,0,0,14640,6.8,17075,204,44,-822,-1629,24.8,1464.0,10,0,1,5,2,3,0,0,0,0,15462,7.0,18704,204,48,822,1629,25.2,1546.2
4757279026,1,13,0,1,7,2,3,1,1,0,0,16182,6.6,17251,175,48,2458,1182,22.3,1618.2,9,1,0,2,7,1,0,0,0,0,13724,6.6,16069,162,40,-2458,-1182,20.2,1372.4
4756412815,1,11,1,1,8,5,9,0,0,0,0,17701,7.0,18070,193,52,1853,280,24.5,1770.1,11,1,0,5,8,3,1,1,0,0,15848,6.6,17790,184,44,-1853,-280,22.8,1584.8
4756375767,1,16,3,1,5,4,1,0,0,0,0,14733,7.2,18784,185,48,-1066,681,23.3,1473.3,15,1,0,4,5,2,0,0,0,0,15799,6.8,18103,209,50,1066,-681,25.9,1579.9
4755564514,0,21,13,1,2,2,1,0,0,0,0,13588,6.6,17525,151,52,-1883,-970,20.3,1358.8,29,0,0,2,2,3,0,0,0,0,15471,7.2,18495,205,52,1883,970,25.7,1547.1
4755533325,1,12,0,1,1,0,1,1,1,0,0,14910,6.8,17623,176,44,2150,180,22.0,1491.0,11,0,0,0,1,0,0,0,0,0,12760,6.6,17443,171,48,-2150,-180,21.9,1276.0
4755501603,0,14,1,1,5,3,1,1,1,0,0,15716,7.2,18762,205,48,1116,1101,25.3,1571.6,14,1,0,3,5,2,0,0,0,0,14600,6.8,17661,172,72,-1116,-1101,24.4,1460.0
4755477838,1,10,0,1,6,2,3,1,1,0,0,15590,6.8,18190,185,60,1710,1537,24.5,1559.0,13,1,0,2,6,1,0,0,0,0,13880,6.4,16653,169,48,-1710,-1537,21.7,1388.0
4753804545,0,11,6,1,4,2,4,0,0,0,0,15544,6.8,17730,218,44,55,-1202,26.2,1554.4,15,3,0,2,4,2,0,0,0,0,15489,7.0,18932,220,56,-55,1202,27.6,1548.9
4753191827,0,9,1,0,1,5,0,0,0,0,0,13112,6.6,16503,186,60,-5257,-2994,24.6,1311.2,12,1,1,5,1,0,1,1,0,0,18369,7.4,19497,238,52,5257,2994,29.0,1836.9
4753167389,0,8,0,0,5,4,0,0,0,0,0,14594,7.0,18863,164,56,-1342,378,22.0,1459.4,14,0,1,4,5,3,1,1,0,0,15936,7.2,18485,206,68,1342,-378,27.4,1593.6
4796913530,1,14,2,0,7,6,6,0,0,0,0,14956,6.0,14950,139,24,-513,-2783,16.3,1495.6,293,2,1,6,7,2,0,0,0,0,15469,7.0,17733,185,52,513,2783,23.7,1546.9
4796877177,0,17,0,0,2,3,1,0,0,0,0,14025,6.8,17602,191,44,-1289,-590,23.5,1402.5,6,0,1,3,2,1,0,0,0,0,15314,7.0,18192,198,72,1289,590,27.0,1531.4
4796167152,0,8,18,0,2,5,2,0,0,0,0,12551,6.2,15974,145,36,-3738,-2121,18.1,1255.1,29,0,1,5,2,5,0,0,0,0,16289,6.8,18095,208,79,3738,2121,28.7,1628.9
4796092957,0,11,1,0,2,5,1,0,0,0,0,15247,6.8,18059,187,52,-553,-259,23.9,1524.7,15,2,1,5,2,6,0,0,0,0,15800,7.2,18318,184,52,553,259,23.6,1580.0
4795106550,0,12,0,0,0,7,0,0,0,0,0,13282,6.8,16879,159,52,-3207,-1378,21.1,1328.2,13,0,1,7,0,5,0,0,0,0,16489,7.2,18257,176,64,3207,1378,24.0,1648.9
4795069419,1,15,1,1,4,0,4,1,0,1,0,15512,7.0,18657,188,60,3363,1569,24.8,1551.2,11,1,0,0,4,0,0,0,0,0,12149,6.8,17088,171,36,-3363,-1569,20.7,1214.9
4791614605,1,10,8,1,9,4,7,1,1,0,0,17408,6.8,18184,204,40,951,-129,24.4,1740.8,196,1,0,4,9,0,0,0,0,0,16457,7.0,18313,181,52,-951,129,23.3,1645.7
4791593641,1,14,0,0,9,6,1,2,1,1,0,17645,7.0,18757,166,56,2039,2854,22.2,1764.5,12,0,1,6,9,7,0,0,0,0,15606,6.6,15903,169,32,-2039,-2854,20.1,1560.6
4791399186,0,9,1,1,8,8,14,0,0,0,0,17656,6.4,16311,165,60,-353,-1812,22.5,1765.6,11,0,0,8,8,5,1,1,0,0,18009,7.0,18123,156,57,353,1812,21.3,1800.9
4791369611,1,9,1,1,11,5,8,0,0,0,0,17661,6.6,17653,182,48,1560,643,23.0,1766.1,240,0,0,5,11,4,1,1,0,0,16101,7.0,17010,157,52,-1560,-643,20.9,1610.1
4790539609,0,20,0,0,0,2,0,0,0,0,0,12784,6.8,16842,168,52,-1364,-2172,22.0,1278.4,10,1,1,2,0,2,0,0,0,0,14148,7.2,19014,196,52,1364,2172,24.8,1414.8
4790501551,0,10,1,1,3,3,2,0,0,0,0,14193,6.8,17445,168,56,-1213,-1173,22.4,1419.3,25,0,0,3,3,1,1,0,1,0,15406,7.0,18618,181,64,1213,1173,24.5,1540.6
4789824909,1,14,2,1,10,3,10,0,0,0,0,16973,6.8,17744,153,48,2297,803,20.1,1697.3,10,2,0,3,10,2,0,0,0,0,14676,6.8,16941,199,46,-2297,-803,24.5,1467.6
4789710188,1,28,1,1,3,0,1,0,0,0,0,16242,7.4,19685,203,68,2999,2685,27.1,1624.2,9,8,0,0,3,0,0,0,0,0,13243,6.8,17000,181,52,-2999,-2685,23.3,1324.3
4789667783,1,9,3,1,5,5,2,1,1,0,0,13846,7.0,17187,178,52,-1506,-84,23.0,1384.6,10,0,0,4,4,4,0,0,0,0,15352,6.8,17271,197,49,1506,84,24.6,1535.2
4788969890,1,8,0,0,7,5,1,0,0,0,0,15969,6.8,17783,148,51,-567,1111,19.9,1596.9,68,2,1,5,7,5,0,0,0,0,16536,6.6,16672,188,56,567,-1111,24.4,1653.6
4788926036,1,12,0,0,7,8,5,0,0,0,0,16866,6.8,16972,150,48,-259,-750,19.8,1686.6,8,0,1,8,7,6,0,0,0,0,17125,7.0,17722,173,56,259,750,22.9,1712.5
4788044628,0,15,1,1,2,5,3,0,0,0,0,15591,6.8,17689,175,56,1028,585,23.1,1559.1,11,1,0,5,2,3,1,1,0,0,14563,6.8,17104,176,60,-1028,-585,23.6,1456.3
4788020355,0,167,1,0,2,8,0,0,0,0,0,13815,6.4,16000,164,43,-3130,-1987,20.7,1381.5,12,1,1,8,2,4,1,1,0,0,16945,7.0,17987,172,64,3130,1987,23.6,1694.5
4787977471,1,12,0,0,5,3,4,0,0,0,0,14629,6.4,16104,163,48,613,-144,21.1,1462.9,15,0,1,3,5,5,0,0,0,0,14016,6.6,16248,163,48,-613,144,21.1,1401.6
4856577339,0,10,0,1,3,0,4,0,0,0,0,15453,7.0,18045,217,52,1607,530,26.9,1545.3,13,0,0,0,3,0,0,0,0,0,13846,6.8,17515,219,60,-1607,-530,27.9,1384.6
4856532375,0,22,1,1,4,4,2,1,1,0,0,15485,6.6,16550,203,60,39,-1925,26.3,1548.5,10,0,0,4,4,2,0,0,0,0,15446,7.0,18475,166,64,-39,1925,23.0,1544.6
4856485441,1,13,1,0,2,5,1,0,0,0,0,14502,6.8,17011,177,48,-841,-664,22.5,1450.2,78,1,1,5,2,2,1,1,0,0,15343,6.8,17675,190,48,841,664,23.8,1534.3
4855181290,0,13,0,0,3,7,1,0,0,0,0,13585,6.6,16178,129,48,-3435,-1937,17.7,1358.5,10,0,1,7,3,6,0,0,0,0,17020,6.8,18115,204,52,3435,1937,25.6,1702.0
4855003447,1,37,0,0,19,21,50,0,0,0,1,35510,10.4,36398,103,0,136,-886,10.3,3551.0,0,4,1,20,18,64,0,0,0,0,35374,10.6,37284,110,0,-136,886,11.0,3537.4
4854983835,0,19,0,0,29,30,54,0,0,0,3,39964,11.6,44851,112,0,-2072,-190,11.2,3996.4,0,18,1,30,29,64,0,0,0,0,42036,12.0,45041,110,0,2072,190,11.0,4203.6
4854948491,1,0,0,1,29,23,87,0,0,0,1,39343,11.4,42304,130,0,2221,3252,13.0,3934.3,0,0,0,23,29,55,0,0,0,0,37122,10.8,39052,111,0,-2221,-3252,11.1,3712.2
4853169885,1,0,0,0,13,18,14,0,0,0,0,45000,10.0,47500,2,0,16050,19000,0.2,4500.0,0,0,1,14,9,8,0,0,0,0,28950,6.0,28500,1,0,-16050,-19000,0.1,2895.0
4853155923,1,10,0,0,12,18,10,0,0,0,0,46710,10.0,47500,2,0,17430,19000,0.2,4671.0,0,0,1,12,6,10,0,0,0,0,29280,6.0,28500,0,0,-17430,-19000,0.0,2928.0
4853137308,1,0,0,0,17,13,16,0,0,0,0,46650,10.0,47500,0,0,19500,19000,0.0,4665.0,0,0,1,6,10,6,0,0,0,0,27150,6.0,28500,0,0,-19500,-19000,0.0,2715.0
4852037114,1,12,2,0,6,6,5,1,0,1,0,16783,7.2,19370,197,60,-174,764,25.7,1678.3,67,2,1,6,6,6,0,0,0,0,16957,6.8,18606,211,67,174,-764,27.8,1695.7
4851998896,0,10,1,0,6,9,3,0,0,0,0,16578,7.2,19086,200,55,-2362,-47,25.5,1657.8,15,1,1,9,6,7,0,0,0,0,18940,7.2,19133,210,66,2362,47,27.6,1894.0
4851140525,1,9,2,0,5,8,6,0,0,0,0,16259,7.0,18453,220,63,-513,962,28.3,1625.9,14,2,1,8,5,6,0,0,0,0,16772,6.8,17491,182,52,513,-962,23.4,1677.2
4851119102,0,11,1,0,2,2,2,1,1,0,0,15282,6.8,17904,244,56,571,-1151,30.0,1528.2,11,0,1,2,2,0,0,0,0,0,14711,7.0,19055,208,72,-571,1151,28.0,1471.1
4851097650,0,12,0,0,7,12,10,0,0,0,0,17106,6.8,16887,182,51,-3499,-2237,23.3,1710.6,8,2,1,12,7,13,0,0,0,0,20605,7.0,19124,208,48,3499,2237,25.6,2060.5
4851063151,1,11,0,1,4,3,2,0,0,0,0,16907,7.4,19216,215,64,2401,2216,27.9,1690.7,10,1,0,3,4,0,0,0,0,0,14506,6.6,17000,184,66,-2401,-2216,25.0,1450.6
4850146791,1,9,3,1,6,6,6,0,0,0,0,16320,7.0,17835,204,48,-1074,-1492,25.2,1632.0,8,0,0,6,6,3,0,0,0,0,17394,7.2,19327,229,60,1074,1492,28.9,1739.4
4850106681,1,18,1,1,2,8,1,0,0,0,0,14625,6.8,17677,192,56,-2226,-654,24.8,1462.5,43,2,0,8,2,8,0,0,0,0,16851,7.2,18331,192,64,2226,654,25.6,1685.1
4850053914,1,10,2,1,5,4,3,0,0,0,0,15874,6.4,16675,205,46,-1738,-784,25.1,1587.4,13,2,0,4,5,6,1,1,0,0,17612,6.8,17459,218,57,1738,784,27.5,1761.2
4849877749,0,15,1,1,5,5,3,1,1,0,0,16632,6.6,16588,172,52,1081,259,22.4,1663.2,16,1,0,5,5,3,0,0,0,0,15551,6.6,16329,167,48,-1081,-259,21.5,1555.1
4857137656,1,11,1,1,4,4,5,0,0,0,0,14967,6.8,17106,170,44,334,332,21.4,1496.7,14,0,0,4,4,2,1,1,0,0,14633,6.6,16774,181,48,-334,-332,22.9,1463.3
4856982719,1,13,1,1,1,3,1,0,0,0,0,14466,6.8,17558,205,60,-1000,-528,26.5,1446.6,18,2,0,3,1,2,1,1,0,0,15466,6.8,18086,202,56,1000,528,25.8,1546.6
4856512707,1,11,1,0,5,3,3,0,0,0,0,15699,7.4,19679,197,72,1596,2009,26.9,1569.9,13,0,1,3,5,2,1,1,0,0,14103,7.0,17670,182,52,-1596,-2009,23.4,1410.3
4856493191,0,16,1,0,2,3,1,0,0,0,0,14189,7.0,17850,174,68,-1179,-747,24.2,1418.9,13,1,1,3,2,2,0,0,0,0,15368,7.2,18597,201,45,1179,747,24.6,1536.8
4856436319,1,158,0,0,2,5,1,1,1,0,0,14743,6.8,18026,197,55,-1523,-607,25.2,1474.3,14,0,1,5,2,2,0,0,0,0,16266,7.0,18633,201,52,1523,607,25.3,1626.6
4856355426,0,163,1,0,1,4,1,0,0,0,0,12786,6.8,16592,154,47,-3231,-559,20.1,1278.6,18,2,1,4,1,3,0,0,0,0,16017,6.8,17151,191,40,3231,559,23.1,1601.7
4856317004,1,0,0,0,28,15,74,0,0,0,1,37764,11.4,43237,107,0,3120,6112,10.7,3776.4,11,0,1,15,28,41,0,0,0,0,34644,10.8,37125,63,0,-3120,-6112,6.3,3464.4
4856279763,1,1,0,0,12,16,34,0,0,0,0,32854,10.0,34686,102,0,-1232,-1364,10.2,3285.4,0,0,1,16,12,42,0,0,0,0,34086,10.2,36050,112,0,1232,1364,11.2,3408.6
4856234973,0,0,0,0,22,20,58,0,0,0,1,36453,10.8,38108,95,0,1742,328,9.5,3645.3,0,0,1,20,22,41,0,0,0,0,34711,10.8,37780,101,0,-1742,-328,10.1,3471.1
4856164815,1,2,0,0,22,24,53,0,0,0,2,38715,11.4,41077,98,0,1088,366,9.8,3871.5,0,0,1,24,22,60,0,0,0,0,37627,11.0,40711,100,0,-1088,-366,10.0,3762.7
4856129415,1,0,0,0,21,18,74,0,0,0,1,37527,11.2,38934,92,0,-142,-252,9.2,3752.7,0,0,1,18,21,44,0,0,0,0,37669,10.8,39186,119,0,142,252,11.9,3766.9
4856082930,1,0,2,1,27,13,58,0,0,0,1,36854,11.0,40037,107,0,2572,3964,10.7,3685.4,16,0,0,13,27,26,0,0,0,0,34282,10.4,36073,81,0,-2572,-3964,8.1,3428.2
4856055684,0,0,0,0,16,24,35,0,0,0,2,33978,10.2,35926,90,0,-3926,-4722,9.0,3397.8,0,0,1,24,16,46,0,0,0,0,37904,11.2,40648,116,0,3926,4722,11.6,3790.4
4856037091,0,0,0,1,15,28,37,0,0,0,1,34019,10.4,35490,84,0,-4611,-7075,8.4,3401.9,0,0,0,28,15,70,0,0,0,0,38630,11.4,42565,118,0,4611,7075,11.8,3863.0
4855479152,0,17,2,0,3,3,3,0,0,0,0,14675,7.2,18605,191,64,336,58,25.5,1467.5,11,2,1,3,3,5,0,0,0,0,14339,6.8,18547,181,52,-336,-58,23.3,1433.9
4855458008,0,11,0,1,6,4,6,0,0,0,0,15566,6.6,17869,175,52,619,158,22.7,1556.6,13,1,0,4,6,2,1,1,0,0,14947,6.8,17711,196,60,-619,-158,25.6,1494.7
4855439250,0,41,0,1,1,6,2,0,0,0,0,12953,6.6,16549,164,48,-2881,-1335,21.2,1295.3,8,12,0,6,1,0,0,0,0,0,15834,6.8,17884,211,48,2881,1335,25.9,1583.4
4855415125,1,0,0,0,18,17,16,0,0,0,0,47003,10.0,47500,0,0,19500,19000,0.0,4700.3,0,0,1,8,9,11,0,0,0,0,27503,6.0,28500,0,0,-19500,-19000,0.0,2750.3
4854118983,1,11,10,1,3,1,0,0,0,0,0,14654,7.2,18279,180,48,1186,-274,22.8,1465.4,29,0,0,1,3,0,0,0,0,0,13468,7.0,18553,182,44,-1186,274,22.6,1346.8
4853763704,1,15,0,0,1,3,2,0,0,0,0,13459,6.6,16901,188,44,-2031,-1268,23.2,1345.9,14,2,1,3,1,2,0,0,0,0,15490,7.0,18169,199,51,2031,1268,25.0,1549.0
4855878384,1,17,1,0,8,4,7,1,0,1,0,18268,7.2,18957,209,56,2877,1933,26.5,1826.8,10,0,1,4,8,3,0,0,0,0,15391,6.8,17024,176,68,-2877,-1933,24.4,1539.1
4855719965,1,201,0,0,4,6,4,0,0,0,0,14960,6.6,16850,153,48,-1795,-1507,20.1,1496.0,10,1,1,6,4,3,0,0,0,0,16755,6.8,18357,207,24,1795,1507,23.1,1675.5
4855353462,0,46,0,0,2,13,1,0,0,0,0,12663,6.0,14518,133,40,-6893,-4712,17.3,1266.3,94,0,1,13,2,9,1,1,0,0,19556,7.0,19230,182,68,6893,4712,25.0,1955.6
4855272938,0,15,2,1,6,3,8,1,1,0,0,15692,6.8,17233,201,52,1401,-194,25.3,1569.2,13,0,0,3,6,2,0,0,0,0,14291,6.6,17427,190,52,-1401,194,24.2,1429.1
4855223043,1,13,1,0,11,8,10,0,0,0,0,18716,7.2,18858,201,60,1498,3051,26.1,1871.6,24,0,1,8,11,13,1,1,0,0,17218,6.4,15807,149,52,-1498,-3051,20.1,1721.8
4855170383,0,11,1,0,5,7,1,0,0,0,0,14509,6.6,17162,192,44,-2754,-763,23.6,1450.9,15,0,1,7,5,8,1,1,0,0,17263,7.0,17925,178,60,2754,763,23.8,1726.3
4855119761,0,13,2,1,4,2,4,0,0,0,0,15198,6.4,15794,198,36,84,-1018,23.4,1519.8,14,0,0,2,4,2,0,0,0,0,15114,6.8,16812,195,56,-84,1018,25.1,1511.4
4854986458,1,10,0,1,4,4,7,0,0,0,0,15062,7.0,18174,209,52,1071,549,26.1,1506.2,21,0,0,4,4,4,0,0,0,0,13991,6.8,17625,168,44,-1071,-549,21.2,1399.1
4854950098,0,28,1,1,4,3,4,2,1,1,0,16313,7.0,18346,190,68,758,-46,25.8,1631.3,11,0,0,3,4,1,0,0,0,0,15555,7.0,18392,218,48,-758,46,26.6,1555.5
4854885141,1,54,2,0,4,4,3,0,0,0,0,15325,6.6,16975,170,48,-1100,-1399,21.8,1532.5,18,1,1,4,4,3,1,1,0,0,16425,7.2,18374,169,60,1100,1399,22.9,1642.5
4854841757,1,16,3,1,2,1,1,0,0,0,0,13017,6.6,16484,146,60,-1843,-824,20.6,1301.7,17,2,0,1,2,1,0,0,0,0,14860,6.8,17308,194,48,1843,824,24.2,1486.0
4854008712,0,34,0,1,3,3,1,0,0,0,0,16317,6.8,17367,184,40,892,276,22.4,1631.7,200,3,0,3,3,2,0,0,0,0,15425,6.8,17091,202,52,-892,-276,25.4,1542.5
4853821232,0,160,0,1,7,7,4,0,0,0,0,16671,7.0,18071,197,52,-44,-113,24.9,1667.1,11,1,0,7,7,9,0,0,0,0,16715,6.8,18184,201,52,44,113,25.3,1671.5
4853771382,0,44,1,1,4,6,7,0,0,0,0,15123,6.8,17155,208,46,-642,-1104,25.4,1512.3,13,2,0,6,4,7,0,0,0,0,15765,6.8,18259,192,64,642,1104,25.6,1576.5
4852698259,1,87,1,1,4,4,4,1,1,0,0,14733,6.8,17704,163,50,-527,-4,21.3,1473.3,10,0,0,4,4,1,1,0,1,0,15260,6.8,17708,183,56,527,4,23.9,1526.0
4852524578,1,11,1,1,8,3,3,0,0,0,0,16412,6.8,17460,233,36,1693,260,26.9,1641.2,67,0,0,3,8,3,0,0,0,0,14719,6.8,17200,194,48,-1693,-260,24.2,1471.9
4851939893,0,12,1,1,6,9,2,0,0,0,0,14905,6.6,16389,162,40,-2085,-1693,20.2,1490.5,6,1,0,9,6,5,0,0,0,0,16990,7.0,18082,208,48,2085,1693,25.6,1699.0
4851717675,1,11,0,0,4,3,3,0,0,0,0,15617,6.4,17052,225,44,683,-294,26.9,1561.7,10,0,1,3,4,2,0,0,0,0,14934,6.6,17346,204,52,-683,294,25.6,1493.4
4818405032,0,8,1,0,3,7,0,0,0,0,0,15096,6.6,17968,205,60,-2416,698,26.5,1509.6,13,0,1,7,3,13,1,1,0,0,17512,6.8,17270,209,60,2416,-698,26.9,1751.2
4817740398,1,68,0,1,3,3,1,0,0,0,0,16061,7.0,18166,208,56,1444,52,26.4,1606.1,10,3,0,3,3,1,0,0,0,0,14617,7.0,18114,172,56,-1444,-52,22.8,1461.7
4749513449,1,18,1,0,7,7,6,1,1,0,0,17440,6.8,17405,164,56,626,-615,22.0,1744.0,11,1,1,7,7,5,0,0,0,0,16814,6.8,18020,192,48,-626,615,24.0,1681.4
4749506291,0,8,1,0,1,5,0,0,0,0,0,13760,6.6,16071,203,36,-1848,-1686,23.9,1376.0,11,0,1,5,1,5,0,0,0,0,15608,7.0,17757,163,60,1848,1686,22.3,1560.8
4735062814,0,21,1,0,4,6,4,0,0,0,0,13805,6.6,15878,146,44,-1596,-492,19.0,1380.5,13,1,1,6,4,2,0,0,0,0,15401,6.6,16370,167,48,1596,492,21.5,1540.1
4735052987,1,8,0,0,6,5,5,0,0,0,0,16199,6.4,16970,142,44,1430,1256,18.6,1619.9,83,0,1,5,6,5,1,1,0,0,14769,6.4,15714,157,48,-1430,-1256,20.5,1476.9
4735036524,0,9,0,0,0,9,0,0,0,0,0,10291,5.8,13208,128,0,-8319,-4857,12.8,1029.1,14,0,1,9,0,7,1,1,0,0,18610,6.8,18065,158,60,8319,4857,21.8,1861.0
4735017571,1,14,1,0,6,7,3,0,0,0,0,15544,7.0,17839,140,40,-725,-1806,18.0,1554.4,13,0,1,6,5,4,0,0,0,0,16269,7.4,19645,182,76,725,1806,25.8,1626.9
4734884431,1,17,3,1,7,3,6,2,1,1,0,17661,7.2,18575,207,67,3485,1054,27.4,1766.1,10,1,0,3,7,2,0,0,0,0,14176,7.0,17521,185,51,-3485,-1054,23.6,1417.6
4734840676,1,15,1,0,2,5,1,0,0,0,0,13825,6.8,17826,199,60,-2355,-106,25.9,1382.5,13,1,1,5,2,5,1,1,0,0,16180,7.0,17932,181,56,2355,106,23.7,1618.0
4734803806,0,9,2,1,6,9,4,0,0,0,0,15658,6.4,16419,148,48,-3500,-2818,19.6,1565.8,9,1,0,9,6,6,1,1,0,0,19158,7.2,19237,186,56,3500,2818,24.2,1915.8
4734592271,0,10,0,0,11,9,5,1,1,0,0,17530,6.8,17104,174,44,553,468,21.8,1753.0,10,1,1,9,11,6,0,0,0,0,16977,6.8,16636,174,55,-553,-468,22.9,1697.7
4734528551,0,15,0,0,4,4,1,1,1,0,0,14620,7.0,18088,195,55,-1308,457,25.0,1462.0,14,0,1,4,4,2,0,0,0,0,15928,6.8,17631,197,42,1308,-457,23.9,1592.8
4734494422,1,15,0,1,3,5,2,0,0,0,0,17296,7.2,19277,223,52,2196,2046,27.5,1729.6,11,1,0,5,3,5,1,1,0,0,15100,6.8,17231,189,60,-2196,-2046,24.9,1510.0
4734454314,0,12,0,1,5,4,3,0,0,0,0,15084,6.6,16170,184,56,346,-1334,24.0,1508.4,15,1,0,4,5,0,1,1,0,0,14738,6.6,17504,195,60,-346,1334,25.5,1473.8
4733809656,0,25,0,0,5,4,2,0,0,0,0,15848,7.0,18706,225,60,590,785,28.5,1584.8,11,2,1,4,5,3,0,0,0,0,15258,6.8,17921,191,56,-590,-785,24.7,1525.8
4733782326,0,16,1,0,3,7,2,0,0,0,0,15387,6.8,17952,171,72,-1675,-598,24.3,1538.7,13,3,1,7,3,1,2,1,1,0,17062,7.0,18550,207,64,1675,598,27.1,1706.2
4733408314,0,11,1,0,4,6,3,0,0,0,0,15099,6.4,15634,160,53,-2123,-1511,21.3,1509.9,14,0,1,6,4,3,0,0,0,0,17222,6.6,17145,197,50,2123,1511,24.7,1722.2
4733378175,1,80,2,1,2,4,0,2,1,1,0,14739,6.8,17360,195,44,-569,-301,23.9,1473.9,13,2,0,4,2,3,0,0,0,0,15308,6.8,17661,194,64,569,301,25.8,1530.8
4733343067,1,36,1,1,4,4,2,0,0,0,0,14992,6.8,17314,186,52,467,1465,23.8,1499.2,36,1,0,4,4,3,0,0,0,0,14525,6.4,15849,151,49,-467,-1465,20.0,1452.5
4732819780,0,174,1,0,6,7,8,0,0,0,0,14947,6.8,17215,163,36,-1504,-375,19.9,1494.7,13,2,1,7,6,6,0,0,0,0,16451,7.0,17590,199,56,1504,375,25.5,1645.1
4732784027,1,13,1,1,10,5,13,0,0,0,0,16923,6.6,16601,131,52,1755,662,18.3,1692.3,16,1,0,5,10,5,1,0,1,0,15168,6.4,15939,176,40,-1755,-662,21.6,1516.8
4855341844,0,25,2,1,1,2,0,0,0,0,0,13173,6.8,17151,191,42,-1796,-789,23.3,1317.3,12,0,0,2,1,2,0,0,0,0,14969,6.8,17940,195,52,1796,789,24.7,1496.9
4855280699,1,18,0,0,7,5,6,0,0,0,0,16189,7.0,18016,208,47,1716,1771,25.5,1618.9,119,0,1,5,7,7,0,0,0,0,14473,6.6,16245,183,40,-1716,-1771,22.3,1447.3
4855234468,1,0,0,1,23,22,63,0,0,0,0,37244,11.0,40370,85,0,-47,288,8.5,3724.4,0,0,0,22,23,47,0,0,0,0,37291,11.2,40082,102,0,47,-288,10.2,3729.1
4853733314,1,13,1,0,2,7,2,0,0,0,0,14034,6.4,15511,180,44,-1499,-1098,22.4,1403.4,24,0,1,7,2,6,1,1,0,0,15533,6.8,16609,165,40,1499,1098,20.5,1553.3
4853698761,1,16,1,1,9,2,10,1,1,0,0,18252,6.8,18065,184,48,4806,2232,23.2,1825.2,10,0,0,2,9,1,0,0,0,0,13446,6.4,15833,156,52,-4806,-2232,20.8,1344.6
4852966152,0,55,0,0,2,3,3,0,0,0,0,14203,6.8,17488,197,56,-1544,-763,25.3,1420.3,122,0,1,3,2,3,0,0,0,0,15747,7.0,18251,191,56,1544,763,24.7,1574.7
4852928997,0,14,0,1,1,1,1,0,0,0,0,13392,6.8,16681,186,42,-674,-1569,22.8,1339.2,211,0,0,1,1,0,1,1,0,0,14066,7.0,18250,195,56,674,1569,25.1,1406.6
4852904173,0,15,18,0,21,34,60,0,0,0,1,34889,11.2,39227,59,0,-6141,-6947,5.9,3488.9,43,0,1,34,21,85,0,0,0,0,41030,12.0,46174,123,0,6141,6947,12.3,4103.0
4852031276,0,213,0,0,1,5,1,0,0,0,0,13476,6.6,17217,201,44,-1501,-1592,24.5,1347.6,12,0,1,5,1,3,0,0,0,0,14977,7.2,18809,183,68,1501,1592,25.1,1497.7
4851993186,1,10,0,0,0,1,0,1,1,0,0,13614,6.8,18275,181,56,-64,1382,23.7,1361.4,8,0,1,1,0,2,0,0,0,0,13678,6.8,16893,165,56,64,-1382,22.1,1367.8
4851954472,0,9,0,0,2,10,1,0,0,0,0,14527,6.8,17264,193,55,-2901,308,24.8,1452.7,145,1,1,10,2,10,1,1,0,0,17428,6.8,16956,175,24,2901,-308,19.9,1742.8
4851559161,0,26,2,1,9,3,8,0,0,0,0,17814,7.0,18645,227,56,2940,1620,28.3,1781.4,14,1,0,3,9,3,0,0,0,0,14874,6.6,17025,181,50,-2940,-1620,23.1,1487.4
4851541846,0,9,1,1,5,5,6,0,0,0,0,15346,6.6,16781,156,59,-268,-838,21.5,1534.6,66,1,0,5,5,5,0,0,0,0,15614,6.8,17619,186,44,268,838,23.0,1561.4
4850153184,1,0,0,1,26,32,74,0,0,0,0,37449,11.6,43203,82,0,-3937,-2610,8.2,3744.9,0,0,0,32,26,85,0,0,0,0,41386,11.8,45813,114,0,3937,2610,11.4,4138.6
4850130434,1,36,2,1,3,2,2,1,1,0,0,15159,7.2,18528,203,56,843,1722,25.9,1515.9,8,2,0,2,3,2,0,0,0,0,14316,6.6,16806,170,56,-843,-1722,22.6,1431.6
4850086571,1,10,0,1,11,6,2,0,0,0,0,17939,7.0,18309,184,48,2504,2988,23.2,1793.9,12,0,0,6,11,5,0,0,0,0,15435,6.2,15321,173,47,-2504,-2988,22.0,1543.5
4850054994,1,11,2,1,11,3,8,1,1,0,0,18373,6.8,18278,202,50,3367,2607,25.2,1837.3,13,1,0,3,11,2,0,0,0,0,15006,6.4,15671,169,46,-3367,-2607,21.5,1500.6
4849241783,1,117,0,1,11,3,9,0,0,0,0,18131,6.8,18206,196,43,1805,1072,23.9,1813.1,10,1,0,3,11,3,1,1,0,0,16326,6.6,17134,176,52,-1805,-1072,22.8,1632.6
4849199561,0,8,0,0,9,5,3,0,0,0,0,18358,7.0,18244,160,48,2589,2172,20.8,1835.8,12,0,1,5,9,5,0,0,0,0,15769,6.6,16072,135,52,-2589,-2172,18.7,1576.9
4854638635,1,54,0,1,23,10,17,0,0,0,0,47350,10.0,47500,0,0,22300,16000,0.0,4735.0,0,0,0,1,14,3,0,0,0,0,25050,6.6,31500,0,0,-22300,-16000,0.0,2505.0
4854515680,1,0,0,0,13,15,12,0,0,0,0,32800,10.2,48680,6,0,12700,20180,0.6,3280.0,0,0,1,10,8,10,0,0,0,0,20100,6.0,28500,8,0,-12700,-20180,0.8,2010.0
4842880800,1,0,0,1,22,24,55,0,0,0,0,37491,11.4,41994,91,0,-262,1312,9.1,3749.1,0,0,0,24,22,74,0,0,0,0,37753,11.4,40682,91,0,262,-1312,9.1,3775.3
4840752620,1,0,5,0,17,19,41,0,0,0,1,35892,10.6,37935,125,0,933,679,12.5,3589.2,14,0,1,18,16,50,0,0,0,0,34959,10.8,37256,102,0,-933,-679,10.2,3495.9
4839760450,0,0,0,0,18,22,49,0,0,0,0,34199,10.8,37816,108,0,-1505,-1404,10.8,3419.9,21,0,1,22,18,69,0,0,0,0,35704,11.0,39220,106,0,1505,1404,10.6,3570.4
4839747901,1,0,0,0,25,22,58,0,0,0,0,36029,11.2,41808,105,0,-556,1469,10.5,3602.9,3,0,1,22,25,59,0,0,0,0,36585,11.2,40339,92,0,556,-1469,9.2,3658.5
4839731742,0,0,0,1,24,30,66,0,0,0,0,36614,11.2,40603,73,0,-4154,-3361,7.3,3661.4,0,0,0,30,24,76,0,0,0,0,40768,11.6,43964,120,0,4154,3361,12.0,4076.8
4839713404,0,0,0,0,22,31,51,0,0,0,1,35616,10.8,37377,95,0,-3978,-6755,9.5,3561.6,0,0,1,31,22,77,0,0,0,0,39594,11.8,44132,115,0,3978,6755,11.5,3959.4
4835583739,0,1,0,0,23,30,40,0,0,0,1,35698,11.2,40084,109,0,-2948,-3368,10.9,3569.8,0,0,1,30,23,70,0,0,0,0,38646,11.6,43452,115,0,2948,3368,11.5,3864.6
4835566146,0,1,0,0,20,22,43,0,0,0,0,37170,11.4,42343,105,0,697,1061,10.5,3717.0,23,0,1,22,20,47,0,0,0,0,36473,11.2,41282,98,0,-697,-1061,9.8,3647.3
4835550455,1,0,0,0,30,28,81,0,0,0,1,38053,11.2,41601,90,0,-1879,257,9.0,3805.3,0,0,1,28,30,79,0,0,0,0,39932,11.0,41344,119,0,1879,-257,11.9,3993.2
4835541289,0,23,0,0,25,25,64,0,0,0,1,39057,12.0,45491,123,0,2253,5755,12.3,3905.7,0,13,1,25,25,69,0,0,0,0,36804,11.0,39736,96,0,-2253,-5755,9.6,3680.4
4835526471,0,16,0,1,25,21,73,0,0,0,0,37153,11.4,42321,84,0,-2253,598,8.4,3715.3,0,2,0,21,25,44,0,0,0,0,39406,11.2,41723,117,0,2253,-598,11.7,3940.6
4835513628,1,17,4,1,38,30,106,0,0,0,1,42004,12.0,47875,124,0,1323,5353,12.4,4200.4,23,1,0,30,38,77,0,0,0,0,40681,11.4,42522,103,0,-1323,-5353,10.3,4068.1
4835440767,1,107,0,1,40,25,105,0,0,0,0,40724,12.0,46644,117,0,3243,5204,11.7,4072.4,0,0,0,25,40,59,0,0,0,0,37481,11.2,41440,112,0,-3243,-5204,11.2,3748.1
4834826718,1,0,0,0,26,26,64,0,0,0,0,36639,11.4,41826,107,0,-543,193,10.7,3663.9,0,0,1,26,26,58,0,0,0,0,37182,11.4,41633,99,0,543,-193,9.9,3718.2
4831425782,0,0,0,1,25,26,70,0,0,0,0,36182,11.2,41275,94,0,-1086,777,9.4,3618.2,0,0,0,26,25,71,0,0,0,0,37268,11.2,40498,102,0,1086,-777,10.2,3726.8
4830078472,0,0,0,1,29,31,75,0,0,0,1,39261,11.2,41452,94,0,1577,-1672,9.4,3926.1,0,0,0,31,29,85,0,0,0,0,37684,11.4,43124,111,0,-1577,1672,11.1,3768.4
4830073877,1,3,0,1,28,31,80,0,0,0,2,41891,11.8,43791,103,0,1430,-1988,10.3,4189.1,15,0,0,31,28,93,0,0,0,0,40461,11.8,45779,102,0,-1430,1988,10.2,4046.1
4830064150,1,0,0,1,29,28,72,0,0,0,1,40435,11.6,42891,126,0,3277,1947,12.6,4043.5,16,0,0,28,29,75,0,0,0,0,37158,11.2,40944,73,0,-3277,-1947,7.3,3715.8
4834523728,0,11,1,1,4,4,5,0,0,0,0,14803,6.8,16488,182,48,-694,-313,23.0,1480.3,26,1,0,4,4,5,0,0,0,0,15497,6.6,16801,180,44,694,313,22.4,1549.7
4834520781,1,13,1,1,8,2,6,0,0,0,0,16629,7.2,18563,170,52,3313,1813,22.2,1662.9,10,2,0,2,8,1,0,0,0,0,13316,6.6,16750,143,52,-3313,-1813,19.5,1331.6
4829192670,0,15,0,0,3,3,5,0,0,0,0,14158,6.6,16050,177,40,-682,-1931,21.7,1415.8,15,1,1,3,3,1,0,0,0,0,14840,6.8,17981,185,52,682,1931,23.7,1484.0
4807923286,1,13,1,0,1,4,0,0,0,0,0,14006,6.8,17652,223,54,-2315,-480,27.7,1400.6,14,0,1,4,1,2,1,0,1,0,16321,7.0,18132,236,50,2315,480,28.6,1632.1
4806464899,0,13,0,1,5,3,1,0,0,0,0,15398,6.6,16623,158,39,12,-183,19.7,1539.8,13,0,0,3,5,3,0,0,0,0,15386,6.4,16806,203,39,-12,183,24.2,1538.6
4806412023,0,13,0,1,4,2,0,0,0,0,0,15774,6.8,17130,185,48,-86,357,23.3,1577.4,81,0,0,2,4,0,0,0,0,0,15860,6.8,16773,202,52,86,-357,25.4,1586.0
4806156990,1,101,0,0,6,6,6,0,0,0,0,16865,7.2,18984,220,48,139,1153,26.8,1686.5,10,0,1,6,6,5,0,0,0,0,16726,6.8,17831,187,48,-139,-1153,23.5,1672.6
4806119605,1,154,1,0,6,3,2,1,1,0,0,16474,6.8,18196,168,52,1075,1046,22.0,1647.4,11,1,1,3,6,3,1,0,1,0,15399,7.0,17150,184,48,-1075,-1046,23.2,1539.9
4804468267,1,15,1,1,4,3,4,0,0,0,0,16822,7.0,19137,215,64,2678,2353,27.9,1682.2,12,0,0,3,4,1,0,0,0,0,14144,6.8,16784,193,48,-2678,-2353,24.1,1414.4
4803494594,1,16,2,1,11,5,7,0,0,0,0,18109,7.0,18063,179,49,2644,2036,22.8,1810.9,13,2,0,5,11,5,0,0,0,0,15465,6.6,16027,171,56,-2644,-2036,22.7,1546.5
4802721934,1,86,0,1,10,10,10,0,0,0,0,18166,6.6,17063,168,40,741,778,20.8,1816.6,12,1,0,10,10,9,1,1,0,0,17425,6.6,16285,150,36,-741,-778,18.6,1742.5
4802561529,1,14,2,0,2,6,1,0,0,0,0,15038,7.0,18267,181,52,78,45,23.3,1503.8,14,2,1,6,2,5,0,0,0,0,14960,6.8,18222,141,44,-78,-45,18.5,1496.0
4802534625,1,100,2,1,6,3,3,0,0,0,0,15778,6.8,17632,171,52,851,766,22.3,1577.8,14,1,0,3,6,2,1,1,0,0,14927,6.6,16866,159,60,-851,-766,21.9,1492.7
4802504841,0,10,1,1,4,4,4,0,0,0,0,15615,6.8,18416,226,56,272,-116,28.2,1561.5,11,0,0,4,4,3,0,0,0,0,15343,7.0,18532,223,56,-272,116,27.9,1534.3
4802466401,1,13,1,1,2,4,2,0,0,0,0,14972,6.8,17591,180,52,-2272,-1866,23.2,1497.2,14,1,0,4,2,4,0,0,0,0,17244,7.4,19457,250,52,2272,1866,30.2,1724.4
4802391460,0,13,0,0,2,2,2,0,0,0,0,14783,6.6,16904,195,47,-1113,-2837,24.2,1478.3,9,0,1,2,2,0,0,0,0,0,15896,7.2,19741,211,55,1113,2837,26.6,1589.6
4802361488,0,11,0,0,2,5,0,1,0,1,0,12988,6.8,16791,177,43,-3659,-1863,22.0,1298.8,16,1,1,5,2,2,0,0,0,0,16647,7.0,18654,220,56,3659,1863,27.6,1664.7
4802341077,0,18,2,1,9,5,10,1,1,0,0,18228,7.0,18144,208,56,2245,837,26.4,1822.8,15,0,0,5,9,5,0,0,0,0,15983,6.8,17307,215,40,-2245,-837,25.5,1598.3
4799362395,0,13,1,1,7,9,9,0,0,0,0,16326,7.0,18666,164,52,-2696,258,21.6,1632.6,229,2,0,9,7,8,2,1,1,0,19022,7.2,18408,228,56,2696,-258,28.4,1902.2
4856296822,1,0,0,0,16,18,18,0,0,0,0,46650,10.0,47500,0,0,17031,19000,0.0,4665.0,1,0,1,12,10,10,0,0,0,0,29619,6.0,28500,0,0,-17031,-19000,0.0,2961.9
4856253272,1,3,0,0,22,18,19,0,0,0,0,48050,10.0,47500,0,0,18979,19000,0.0,4805.0,0,0,1,13,17,14,0,0,0,0,29071,6.0,28500,0,0,-18979,-19000,0.0,2907.1
4856224557,1,52,0,1,20,23,24,0,0,0,0,63490,12.0,55000,0,0,25940,22000,0.0,6349.0,14,0,0,13,10,10,0,0,0,0,37550,7.2,33000,0,0,-25940,-22000,0.0,3755.0
4856191193,1,0,0,1,15,20,23,0,0,0,0,64425,12.0,55000,1,0,26525,22000,0.1,6442.5,5,0,0,14,9,9,0,0,0,0,37900,7.2,33000,0,0,-26525,-22000,0.0,3790.0
4849257848,1,28,0,0,22,28,47,0,0,0,1,35458,11.2,39102,83,0,-3172,-2769,8.3,3545.8,0,0,1,28,22,70,0,0,0,0,38630,11.4,41871,110,0,3172,2769,11.0,3863.0
4845510816,1,7,0,1,2,0,1,1,1,0,0,14655,6.8,18554,185,52,2360,1678,23.7,1465.5,30,0,0,0,2,0,0,0,0,0,12295,6.8,16876,163,48,-2360,-1678,21.1,1229.5
4845500102,0,9,0,0,7,9,5,0,0,0,0,15617,6.2,15482,177,32,-1022,-2040,20.9,1561.7,19,0,1,9,7,5,0,0,0,0,16639,6.6,17522,166,56,1022,2040,22.2,1663.9
4821879712,1,12,0,0,7,7,15,0,0,0,0,27686,10.4,34671,91,42,-306,-828,13.3,2768.6,10,0,1,7,7,15,0,0,0,0,27992,10.4,35499,73,53,306,828,12.6,2799.2
4821861763,0,29,0,1,19,14,51,0,0,0,0,31872,10.4,36401,63,42,623,679,10.5,3187.2,11,0,0,14,19,31,0,0,0,0,31249,10.6,35722,73,63,-623,-679,13.6,3124.9
4821825316,0,11,0,1,18,8,44,0,0,0,0,32696,10.4,36723,81,47,2084,3908,12.8,3269.6,94,0,0,8,18,19,0,0,0,0,30612,10.0,32815,81,42,-2084,-3908,12.3,3061.2
4821807175,0,15,0,0,4,15,6,0,0,0,0,26787,10.2,34212,82,50,-8214,-5180,13.2,2678.7,119,1,1,15,4,31,0,0,0,0,35001,10.8,39392,109,68,8214,5180,17.7,3500.1
4821786857,1,11,1,0,21,11,43,0,0,0,1,40047,11.4,42946,116,63,9230,6890,17.9,4004.7,13,1,1,10,20,15,0,0,0,0,30817,10.4,36056,76,52,-9230,-6890,12.8,3081.7
4821763769,1,15,1,0,6,18,14,0,0,0,1,31038,10.6,37197,106,59,-3854,-5273,16.5,3103.8,13,0,1,18,6,42,0,0,0,0,34892,11.2,42470,99,50,3854,5273,14.9,3489.2
4821741739,0,10,0,0,15,15,33,0,0,0,1,36677,11.0,39482,123,60,-3255,-3181,18.3,3667.7,6,2,1,15,15,27,0,0,0,0,39932,11.4,42663,95,75,3255,3181,17.0,3993.2
4821306543,1,45,1,1,24,10,40,0,0,0,0,38311,11.2,41493,87,62,7528,7890,14.9,3831.1,9,19,0,8,22,17,0,0,0,0,30783,10.2,33603,79,55,-7528,-7890,13.4,3078.3
4821306762,1,12,1,0,10,11,23,0,0,0,0,34427,11.6,43729,92,67,1536,6955,15.9,3442.7,11,1,1,10,9,15,0,0,0,0,32891,10.6,36774,88,51,-1536,-6955,13.9,3289.1
4812523282,0,8,1,1,23,21,59,0,0,0,0,32646,11.0,37784,76,49,-7213,-5152,12.5,3264.6,9,0,0,21,23,54,0,0,0,0,39859,11.6,42936,77,79,7213,5152,15.6,3985.9
4812501697,1,31,1,0,18,2,34,0,0,0,1,35817,11.2,40884,76,83,9533,9744,15.9,3581.7,26,0,1,2,18,3,0,0,0,0,26284,10.0,31140,85,51,-9533,-9744,13.6,2628.4
4856077446,0,0,6,1,26,19,58,0,0,0,1,37146,11.0,40148,111,0,1091,814,11.1,3714.6,23,0,0,19,26,42,0,0,0,0,36055,11.0,39334,92,0,-1091,-814,9.2,3605.5
4856055545,1,6,2,1,28,15,71,0,0,0,1,39295,11.2,41233,116,0,5150,4356,11.6,3929.5,4,0,0,15,28,29,0,0,0,0,34145,10.6,36877,59,0,-5150,-4356,5.9,3414.5
4805366309,1,12,1,0,6,2,7,1,1,0,0,15451,6.8,17038,166,59,1201,447,22.5,1545.1,13,1,1,2,6,2,0,0,0,0,14250,6.6,16591,173,62,-1201,-447,23.5,1425.0
4804806391,1,14,0,1,12,4,13,1,1,0,0,19573,7.2,18389,214,52,5916,2460,26.6,1957.3,11,0,0,4,12,4,0,0,0,0,13657,6.4,15929,146,44,-5916,-2460,19.0,1365.7
4796370504,0,11,1,0,6,4,1,0,0,0,0,15274,6.8,17484,179,60,538,1119,23.9,1527.4,12,2,1,4,6,3,0,0,0,0,14736,6.6,16365,204,44,-538,-1119,24.8,1473.6
4791074964,0,9,1,1,6,10,3,0,0,0,0,16581,6.6,16863,192,45,-1267,-1770,23.7,1658.1,14,0,0,10,6,5,1,1,0,0,17848,7.2,18633,209,54,1267,1770,26.3,1784.8
4790574482,0,29,2,1,7,8,6,0,0,0,0,15861,6.6,17176,162,53,-1785,-619,21.5,1586.1,88,2,0,8,7,6,1,1,0,0,17646,7.0,17795,178,53,1785,619,23.1,1764.6
4790526287,0,14,1,1,4,3,0,0,0,0,0,15612,6.6,17056,180,49,504,569,22.9,1561.2,23,1,0,3,4,2,0,0,0,0,15108,6.6,16487,192,53,-504,-569,24.5,1510.8
4790484935,1,10,0,0,2,7,0,0,0,0,0,14729,6.6,17344,216,44,-1955,49,26.0,1472.9,9,2,1,7,2,4,1,1,0,0,16684,6.6,17295,194,64,1955,-49,25.8,1668.4
4790249417,1,29,1,0,7,9,6,1,1,0,0,16394,6.6,17167,182,48,-180,-204,23.0,1639.4,12,12,1,9,7,5,0,0,0,0,16574,6.6,17371,170,56,180,204,22.6,1657.4
4790230803,0,11,2,1,9,7,3,0,0,0,0,16753,6.6,16876,168,34,-755,-338,20.2,1675.3,69,1,0,7,9,2,0,0,0,0,17508,6.6,17214,180,52,755,338,23.2,1750.8
4790218964,1,13,0,1,10,2,8,0,0,0,0,20470,7.0,19252,203,61,7328,4019,26.4,2047.0,13,1,0,2,10,2,0,0,0,0,13142,6.2,15233,157,56,-7328,-4019,21.3,1314.2
4789441822,0,12,2,0,1,4,0,0,0,0,0,13411,6.8,16719,175,52,-2219,122,22.7,1341.1,15,0,1,4,1,2,0,0,0,0,15630,6.6,16597,204,52,2219,-122,25.6,1563.0
4789415088,0,14,1,0,4,6,2,1,0,1,0,16321,6.8,17772,190,56,-1429,-708,24.6,1632.1,17,1,1,6,4,5,1,1,0,0,17750,7.0,18480,186,76,1429,708,26.2,1775.0
4789086004,0,15,1,1,5,6,2,0,0,0,0,14508,6.4,16325,169,44,-1732,-1926,21.3,1450.8,18,0,0,6,5,4,1,1,0,0,16240,7.0,18251,167,64,1732,1926,23.1,1624.0
4789061039,0,14,1,1,4,4,3,0,0,0,0,15434,6.6,16823,171,52,-438,-1165,22.3,1543.4,45,1,0,4,4,4,0,0,0,0,15872,7.0,17988,193,52,438,1165,24.5,1587.2
4786613598,0,15,2,1,8,6,6,0,0,0,0,16083,6.8,17475,188,39,39,1542,22.7,1608.3,11,1,0,6,8,10,0,0,0,0,16044,6.4,15933,182,44,-39,-1542,22.6,1604.4
4786598843,0,18,1,1,2,4,1,0,0,0,0,13949,6.6,16306,138,59,-2087,-2939,19.7,1394.9,13,2,0,4,2,2,0,0,0,0,16036,7.0,19245,190,56,2087,2939,24.6,1603.6
4786569306,1,16,0,1,4,1,2,1,1,0,0,16607,6.6,18254,188,56,2870,1280,24.4,1660.7,15,3,0,1,4,0,0,0,0,0,13737,6.8,16974,171,68,-2870,-1280,23.9,1373.7
4784052974,0,27,1,0,3,3,4,1,1,0,0,15089,6.8,18268,172,56,-922,265,22.8,1508.9,14,0,1,3,3,0,0,0,0,0,16011,6.8,18003,202,60,922,-265,26.2,1601.1
4830061665,0,15,2,1,10,24,23,0,0,0,2,34258,10.8,37719,77,59,-7777,-7743,13.6,3425.8,30,1,0,24,10,49,0,0,0,0,42035,11.8,45462,103,67,7777,7743,17.0,4203.5
4827364716,0,12,0,1,16,14,38,0,0,0,0,36423,11.2,40693,101,52,1250,1387,15.3,3642.3,20,1,0,13,15,28,0,0,0,0,35173,11.0,39306,107,55,-1250,-1387,16.2,3517.3
4827355978,1,14,1,1,23,11,51,0,0,0,1,37202,11.6,42613,96,67,908,4582,16.3,3720.2,13,0,0,11,23,22,0,0,0,0,36294,10.8,38031,85,71,-908,-4582,15.6,3629.4
4826237454,0,9,1,1,14,23,24,0,0,0,1,37207,11.2,41205,85,60,-902,1397,14.5,3720.7,14,0,0,23,14,42,0,0,0,0,38109,10.8,39808,74,59,902,-1397,13.3,3810.9
4818779063,0,15,0,0,7,22,14,0,0,0,0,28467,10.2,33677,67,55,-1689,-4157,12.2,2846.7,13,0,1,22,7,40,0,0,0,0,30156,10.8,37834,86,59,1689,4157,14.5,3015.6
4818713765,1,12,2,1,22,12,45,0,0,0,2,41360,12.2,48175,122,79,8247,9125,20.1,4136.0,13,0,0,12,22,17,0,0,0,0,33113,11.2,39050,102,63,-8247,-9125,16.5,3311.3
4818503869,0,12,0,1,18,23,28,0,0,0,1,37905,11.0,39886,101,47,839,-417,14.8,3790.5,12,0,0,23,18,44,0,0,0,0,37066,11.0,40303,82,71,-839,417,15.3,3706.6
4818492501,1,112,1,1,22,2,48,0,0,0,3,39142,11.2,43907,93,67,6292,5706,16.0,3914.2,31,0,0,2,22,4,0,0,0,0,32850,11.0,38201,88,55,-6292,-5706,14.3,3285.0
4816884856,0,12,1,1,20,15,32,0,0,0,0,33914,10.6,36687,68,60,1402,810,12.8,3391.4,29,1,0,15,20,35,0,0,0,0,32512,10.4,35877,63,40,-1402,-810,10.3,3251.2
4816870426,1,16,1,1,25,9,37,0,0,0,1,43230,11.8,44948,98,64,11815,10322,16.2,4323.0,89,0,0,9,25,10,0,0,0,0,31415,10.2,34626,82,43,-11815,-10322,12.5,3141.5
4816851645,1,18,1,0,16,10,34,0,0,0,0,37420,11.6,44358,74,71,2194,5030,14.5,3742.0,12,0,1,10,16,26,0,0,0,0,35226,11.0,39328,60,47,-2194,-5030,10.7,3522.6
4816838233,0,14,0,0,14,18,23,0,0,0,0,32703,10.4,36067,87,64,-1652,-216,15.1,3270.3,12,0,1,18,14,29,0,0,0,0,34355,10.4,36283,44,55,1652,216,9.9,3435.5
4816750650,0,9,0,0,8,24,6,0,0,0,1,29957,10.0,31839,65,37,-7833,-8091,10.2,2995.7,15,1,1,24,8,51,0,0,0,0,37790,11.2,39930,70,63,7833,8091,13.3,3779.0
4816744092,0,23,0,0,19,18,48,0,0,0,1,35919,11.2,40376,86,55,2322,2998,14.1,3591.9,13,0,1,18,19,47,0,0,0,0,33597,10.8,37378,77,43,-2322,-2998,12.0,3359.7
4813785856,1,14,2,0,19,13,43,0,0,0,1,40433,11.8,44122,108,80,2686,4069,18.8,4043.3,8,1,1,13,19,18,0,0,0,0,37747,11.2,40053,84,67,-2686,-4069,15.1,3774.7
4813772417,1,46,1,0,14,21,37,0,0,0,0,39612,11.6,44257,99,71,4693,6222,17.0,3961.2,13,1,1,21,14,56,0,0,0,0,34919,10.8,38035,89,63,-4693,-6222,15.2,3491.9
4813764853,0,12,0,1,19,8,35,0,0,0,0,37106,12.2,47469,89,75,4448,7448,16.4,3710.6,13,0,0,8,19,15,0,0,0,0,32658,11.0,40021,82,55,-4448,-7448,13.7,3265.8
4813755859,1,12,1,0,20,13,29,0,0,0,1,40819,12.4,48265,129,75,5381,7219,20.4,4081.9,13,0,1,13,20,22,0,0,0,0,35438,11.4,41046,110,67,-5381,-7219,17.7,3543.8
4855852800,1,1,0,1,22,12,48,0,0,0,1,38216,11.0,41317,116,0,3672,4992,11.6,3821.6,0,0,0,12,22,19,0,0,0,0,34544,10.4,36325,96,0,-3672,-4992,9.6,3454.4
4855828557,1,34,2,0,14,17,11,0,0,0,0,46235,10.0,47500,11,0,25300,19000,1.1,4623.5,5,7,1,9,6,12,0,0,0,0,20935,6.0,28500,2,0,-25300,-19000,0.2,2093.5
4855594203,0,77,0,0,19,36,43,0,0,0,1,37951,11.2,40948,101,0,-4077,-1575,10.1,3795.1,0,0,1,36,19,111,0,0,0,0,42028,11.4,42523,108,0,4077,1575,10.8,4202.8
4855580729,1,0,5,1,19,19,18,0,0,0,0,63775,12.0,55000,0,0,25050,22000,0.0,6377.5,50,0,0,11,11,9,0,0,0,0,38725,7.2,33000,19,0,-25050,-22000,1.9,3872.5
4854982403,1,1,4,1,24,16,17,0,0,0,0,48467,10.0,47500,3,0,18564,19000,0.3,4846.7,29,5,0,7,15,11,0,0,0,0,29903,6.0,28500,11,0,-18564,-19000,1.1,2990.3
4854965807,1,0,1,0,17,25,18,0,0,0,0,61060,12.2,56000,2,0,21880,23000,0.2,6106.0,39,2,1,16,8,17,0,0,0,0,39180,7.2,33000,7,0,-21880,-23000,0.7,3918.0
4854334462,1,0,0,1,14,15,18,0,0,0,0,62096,12.0,55000,1,0,25586,21000,0.1,6209.6,342,0,0,10,9,7,0,0,0,0,36510,7.4,34000,0,0,-25586,-21000,0.0,3651.0
4853338728,1,23,0,0,23,22,69,0,0,0,1,38066,11.2,41839,111,0,-190,-558,11.1,3806.6,0,2,1,22,23,59,0,0,0,0,38256,11.4,42397,116,0,190,558,11.6,3825.6
4853322181,0,10,1,0,5,9,4,0,0,0,0,16395,6.8,17161,185,52,-692,-631,23.7,1639.5,14,1,1,9,5,7,0,0,0,0,17087,7.0,17792,180,48,692,631,22.8,1708.7
4853309047,0,193,1,1,6,4,5,1,1,0,0,16430,6.8,17479,209,52,1519,670,26.1,1643.0,13,0,0,4,6,4,0,0,0,0,14911,6.4,16809,180,52,-1519,-670,23.2,1491.1
4853300183,1,0,0,0,12,21,12,0,0,0,0,60632,12.0,55000,0,0,21950,22000,0.0,6063.2,21,0,1,15,6,13,0,0,0,0,38682,7.2,33000,0,0,-21950,-22000,0.0,3868.2
4853295398,1,0,0,1,11,22,16,0,0,0,0,59900,12.0,55000,0,0,21775,21000,0.0,5990.0,0,0,0,17,6,13,0,0,0,0,38125,7.4,34000,1,0,-21775,-21000,0.1,3812.5
4853290054,1,0,0,0,17,12,20,0,0,0,0,62350,12.0,55000,0,0,26900,22000,0.0,6235.0,0,0,1,6,11,5,0,0,0,0,35450,7.2,33000,0,0,-26900,-22000,0.0,3545.0
4853287923,1,0,0,0,14,15,17,0,0,0,0,62874,12.0,55000,0,0,26374,22000,0.0,6287.4,0,0,1,11,10,5,0,0,0,0,36500,7.2,33000,0,0,-26374,-22000,0.0,3650.0
4852267869,0,13,0,0,5,4,2,0,0,0,0,16368,6.8,18460,175,60,824,1938,23.5,1636.8,11,1,1,4,5,3,0,0,0,0,15544,6.6,16522,188,36,-824,-1938,22.4,1554.4
4852249792,0,22,1,1,1,4,0,0,0,0,0,14021,6.6,16914,176,56,-1500,-385,23.2,1402.1,13,2,0,4,1,6,0,0,0,0,15521,6.6,17299,172,52,1500,385,22.4,1552.1
4852239833,0,13,13,0,1,6,1,1,1,0,0,12381,6.4,16116,144,48,-4488,-2960,19.2,1238.1,32,1,1,6,1,2,0,0,0,0,16869,7.4,19076,251,40,4488,2960,29.1,1686.9
4852228229,1,12,3,1,3,2,2,0,0,0,0,15339,7.2,18866,228,44,1956,1698,27.2,1533.9,13,2,0,2,3,1,0,0,0,0,13383,6.8,17168,190,48,-1956,-1698,23.8,1338.3
4852220388,1,104,0,1,12,2,7,1,1,0,0,19435,6.8,18555,209,40,6349,4460,24.9,1943.5,4,0,0,2,12,0,0,0,0,0,13086,6.0,14095,119,60,-6349,-4460,17.9,1308.6
4856624212,1,0,0,1,9,22,17,0,0,0,0,45250,10.0,47500,0,0,16700,19000,0.0,4525.0,0,0,0,17,4,13,0,0,0,0,28550,6.0,28500,0,0,-16700,-19000,0.0,2855.0
4856611337,1,0,0,0,16,17,16,0,0,0,0,45950,10.0,47500,0,0,18100,19000,0.0,4595.0,0,0,1,10,9,10,0,0,0,0,27850,6.0,28500,0,0,-18100,-19000,0.0,2785.0
4856599383,1,0,0,1,18,13,18,0,0,0,0,47350,10.0,47500,0,0,20900,19000,0.0,4735.0,13,0,0,7,12,6,0,0,0,0,26450,6.0,28500,0,0,-20900,-19000,0.0,2645.0
4856584856,1,11,2,1,8,2,8,0,0,0,0,18235,7.2,18830,178,60,3567,1630,23.8,1823.5,21,0,0,2,8,2,0,0,0,0,14668,6.8,17200,232,49,-3567,-1630,28.1,1466.8
4856556221,1,11,4,0,2,1,0,1,1,0,0,14810,7.0,19286,211,64,610,597,27.5,1481.0,14,0,1,1,2,0,0,0,0,0,14200,7.2,18689,210,68,-610,-597,27.8,1420.0
4856530678,0,186,1,0,4,6,1,1,1,0,0,14644,6.8,17642,175,48,-2555,-956,22.3,1464.4,10,1,1,6,4,5,0,0,0,0,17199,7.2,18598,175,51,2555,956,22.6,1719.9
4856287369,1,16,2,0,1,1,1,0,0,0,0,14774,7.2,18076,212,60,1080,189,27.2,1477.4,24,1,1,1,1,0,0,0,0,0,13694,6.8,17887,168,52,-1080,-189,22.0,1369.4
4856246796,1,10,0,1,6,5,3,0,0,0,1,16670,6.8,17377,184,42,1948,1280,22.6,1667.0,28,0,0,5,6,7,0,0,0,0,14722,6.4,16097,153,76,-1948,-1280,22.9,1472.2
4856166630,1,10,1,0,0,5,0,0,0,0,0,12716,6.6,16839,191,51,-3548,-1081,24.2,1271.6,9,0,1,5,0,4,0,0,0,0,16264,6.6,17920,217,56,3548,1081,27.3,1626.4
4856139668,1,0,0,1,13,24,16,0,0,0,0,63050,12.0,55000,0,0,24100,22000,0.0,6305.0,6,0,0,16,5,14,0,0,0,0,38950,7.2,33000,0,0,-24100,-22000,0.0,3895.0
4856115476,1,34,5,0,22,18,22,0,0,0,0,63775,12.0,55000,0,0,25520,22000,0.0,6377.5,0,1,1,13,17,9,0,0,0,0,38255,7.2,33000,0,0,-25520,-22000,0.0,3825.5
4856095153,1,0,0,0,17,20,16,0,0,0,0,62599,12.0,55000,0,0,24349,22000,0.0,6259.9,0,0,1,13,10,13,0,0,0,0,38250,7.2,33000,0,0,-24349,-22000,0.0,3825.0
4856064609,1,0,0,0,21,24,16,0,0,0,0,60250,12.0,55000,0,0,22700,18000,0.0,6025.0,0,0,1,11,8,17,0,0,0,0,37550,8.0,37000,0,0,-22700,-18000,0.0,3755.0
4856038704,1,0,0,0,16,21,13,0,0,0,0,61650,12.8,59000,0,0,22700,26000,0.0,6165.0,0,0,1,14,9,16,0,0,0,0,38950,7.2,33000,0,0,-22700,-26000,0.0,3895.0
4856023155,1,6,0,0,17,25,14,0,0,0,0,45600,10.0,47500,0,0,16700,19000,0.0,4560.0,12,0,1,11,3,15,0,0,0,0,28900,6.0,28500,0,0,-16700,-19000,0.0,2890.0
4856002957,1,0,0,0,23,16,25,0,0,0,0,65225,12.0,55000,3,0,29000,22000,0.3,6522.5,0,0,1,8,15,3,0,0,0,0,36225,7.2,33000,1,0,-29000,-22000,0.1,3622.5
4855980561,1,0,0,0,14,17,12,0,0,0,0,45731,10.0,47500,9,0,17381,19000,0.9,4573.1,270,0,1,12,9,12,0,0,0,0,28350,6.0,28500,8,0,-17381,-19000,0.8,2835.0
4855554311,1,48,1,0,1,5,1,0,0,0,0,15297,6.8,17138,179,56,45,1266,23.5,1529.7,13,2,1,5,1,5,0,0,0,0,15252,6.4,15872,179,60,-45,-1266,23.9,1525.2
4855531474,1,10,0,1,7,5,5,0,0,0,0,16391,6.6,17459,189,51,1349,100,24.0,1639.1,7,0,0,5,7,3,1,1,0,0,15042,6.8,17359,168,64,-1349,-100,23.2,1504.2
4829900203,0,11,1,0,6,9,1,0,0,0,0,14509,6.8,16311,153,48,-3444,-2414,20.1,1450.9,15,3,1,9,6,9,1,1,0,0,17953,7.0,18725,211,56,3444,2414,26.7,1795.3
4829883891,0,19,1,1,7,3,7,0,0,0,0,16283,6.6,15814,176,46,1018,-2014,22.2,1628.3,182,0,0,3,7,0,1,0,1,0,15265,7.0,17828,182,49,-1018,2014,23.1,1526.5
4829860516,0,14,1,0,4,8,5,0,0,0,0,15045,6.4,15883,188,40,-2250,-2747,22.8,1504.5,13,2,1,8,4,3,1,1,0,0,17295,7.2,18630,184,68,2250,2747,25.2,1729.5
4829839444,0,12,4,0,3,2,0,0,0,0,0,13217,6.4,16264,162,44,-2061,-2766,20.6,1321.7,22,1,1,2,3,3,0,0,0,0,15278,7.0,19030,207,55,2061,2766,26.2,1527.8
4829790767,1,9,0,1,8,5,5,0,0,0,0,16864,6.8,18543,209,48,1681,910,25.7,1686.4,10,0,0,4,7,2,0,0,0,0,15183,6.8,17633,184,52,-1681,-910,23.6,1518.3
4829745420,1,11,3,0,3,4,5,0,0,0,0,15122,6.8,17913,182,64,-502,-321,24.6,1512.2,18,0,1,4,3,2,0,0,0,0,15624,6.8,18234,218,56,502,321,27.4,1562.4
4829705328,0,52,0,1,8,1,6,0,0,0,0,17399,7.0,19062,181,51,3304,2132,23.2,1739.9,11,1,0,1,8,1,0,0,0,0,14095,6.6,16930,185,72,-3304,-2132,25.7,1409.5
4829578105,1,12,3,1,12,5,11,1,1,0,0,18002,6.6,16673,155,57,3966,2412,21.2,1800.2,62,1,0,5,12,2,0,0,0,0,14036,6.0,14261,131,48,-3966,-2412,17.9,1403.6
4829520529,0,11,0,0,4,5,3,0,0,0,0,13689,6.4,15581,107,60,-2863,-2719,16.7,1368.9,9,2,1,5,4,1,0,0,0,0,16552,7.0,18300,200,45,2863,2719,24.5,1655.2
4829469391,1,14,0,0,4,4,3,0,0,0,0,14952,6.4,16118,182,56,-8,-1063,23.8,1495.2,68,1,1,4,4,2,0,0,0,0,14960,6.8,17181,182,60,8,1063,24.2,1496.0
4829021556,1,14,1,1,7,5,7,0,0,0,0,17574,6.8,18015,162,52,2385,-780,21.4,1757.4,11,2,0,5,7,2,0,0,0,0,15189,7.0,18795,187,56,-2385,780,24.3,1518.9
4828900366,0,55,1,0,4,5,4,0,0,0,0,15826,6.4,15934,196,44,-1913,-2420,24.0,1582.6,10,3,1,5,4,4,0,0,0,0,17739,7.2,18354,196,60,1913,2420,25.6,1773.9
4828861390,1,21,4,0,3,3,4,0,0,0,0,15516,7.2,19362,194,68,-57,769,26.2,1551.6,76,5,1,3,3,2,0,0,0,0,15573,6.8,18593,204,60,57,-769,26.4,1557.3
4828839989,1,15,1,0,4,5,4,0,0,0,0,14925,6.8,16762,149,56,-766,-387,20.5,1492.5,20,2,1,5,4,4,0,0,0,0,15691,6.8,17149,199,56,766,387,25.5,1569.1
4826018863,0,49,2,0,4,5,2,1,1,0,0,14675,7.0,18290,166,60,-1341,-1016,22.6,1467.5,15,0,1,5,4,1,0,0,0,0,16016,7.2,19306,226,71,1341,1016,29.7,1601.6
4826004014,1,61,1,0,4,6,3,0,0,0,0,15786,6.8,17170,178,48,-365,-690,22.6,1578.6,15,0,1,6,4,5,1,1,0,0,16151,6.6,17860,179,44,365,690,22.3,1615.1
4825980089,1,13,1,1,11,6,17,0,0,0,0,18292,6.8,17268,189,52,2720,508,24.1,1829.2,14,1,0,6,11,4,0,0,0,0,15572,6.6,16760,195,53,-2720,-508,24.8,1557.2
4825961916,1,11,1,0,6,3,5,1,1,0,0,16200,6.6,17913,210,48,1886,545,25.8,1620.0,17,0,1,3,6,2,0,0,0,0,14314,6.6,17368,157,60,-1886,-545,21.7,1431.4
4854303163,1,20,0,0,5,5,7,0,0,0,0,15151,6.8,17840,173,52,-29,-93,22.5,1515.1,16,1,1,5,5,3,1,1,0,0,15180,7.0,17933,179,52,29,93,23.1,1518.0
4854260182,0,8,0,0,2,5,1,0,0,0,0,15076,6.6,16761,178,48,-999,-922,22.6,1507.6,15,1,1,5,2,5,0,0,0,0,16075,6.6,17683,203,52,999,922,25.5,1607.5
4853504793,1,65,0,1,4,4,0,0,0,0,0,15435,7.0,17724,210,44,639,290,25.4,1543.5,8,0,0,4,4,3,0,0,0,0,14796,6.8,17434,137,80,-639,-290,21.7,1479.6
4853126637,0,7,1,1,3,4,0,0,0,0,0,14812,6.8,18666,199,60,-43,824,25.9,1481.2,10,0,0,4,3,1,1,1,0,0,14855,6.8,17842,166,68,43,-824,23.4,1485.5
4852385345,1,13,3,1,7,6,6,1,1,0,0,16630,6.6,18123,203,60,-233,1031,26.3,1663.0,159,3,0,6,7,5,0,0,0,0,16863,6.6,17092,211,39,233,-1031,25.0,1686.3
4852361266,0,8,0,1,3,5,2,0,0,0,0,15510,6.8,17523,165,64,-477,-664,22.9,1551.0,14,0,0,5,3,4,1,1,0,0,15987,7.0,18187,196,48,477,664,24.4,1598.7
4852144322,0,10,1,1,6,6,6,0,0,0,0,16087,6.8,17857,207,60,265,-624,26.7,1608.7,10,1,0,6,6,3,1,1,0,0,15822,6.8,18481,218,52,-265,624,27.0,1582.2
4852135093,0,12,2,0,2,8,1,0,0,0,0,12579,6.6,16422,164,44,-5579,-3010,20.8,1257.9,14,3,1,8,2,5,0,0,0,0,18158,7.2,19432,231,44,5579,3010,27.5,1815.8
4851166926,0,8,1,1,4,1,1,1,1,0,0,14150,6.4,16616,194,52,-198,-1452,24.6,1415.0,11,0,0,1,4,0,0,0,0,0,14348,7.0,18068,183,44,198,1452,22.7,1434.8
4851140249,1,18,0,1,4,4,4,0,0,0,0,15908,6.8,18448,189,44,2127,1677,23.3,1590.8,10,0,0,4,4,1,0,0,0,0,13781,6.8,16771,171,44,-2127,-1677,21.5,1378.1
4850517712,0,14,4,1,2,2,1,0,0,0,0,14522,7.0,17252,176,56,166,-169,23.2,1452.2,16,2,0,2,2,0,1,0,1,0,14356,6.8,17421,147,72,-166,169,21.9,1435.6
4850213669,0,80,0,0,6,4,2,0,0,0,0,16453,6.8,17138,149,48,705,631,19.7,1645.3,13,0,1,4,6,2,0,0,0,0,15748,6.4,16507,161,36,-705,-631,19.7,1574.8
4849245068,0,10,1,0,4,9,4,1,1,0,0,15179,6.8,17117,168,56,-2400,-1281,22.4,1517.9,216,0,1,9,4,7,0,0,0,0,17579,7.2,18398,167,43,2400,1281,21.0,1757.9
4849223003,1,14,1,0,7,3,2,1,0,1,0,16893,7.2,19513,196,64,3209,3837,26.0,1689.3,7,2,1,3,7,3,0,0,0,0,13684,6.2,15676,166,48,-3209,-3837,21.4,1368.4
4847876756,0,12,0,0,4,8,3,0,0,0,0,15237,6.6,16770,156,60,-2568,-1058,21.6,1523.7,9,1,1,8,4,4,0,0,0,0,17805,6.6,17828,198,36,2568,1058,23.4,1780.5
4846535452,0,9,1,0,9,9,5,0,0,0,0,16967,6.8,16690,167,48,850,709,21.5,1696.7,15,1,1,9,9,3,0,0,0,0,16117,6.6,15981,173,40,-850,-709,21.3,1611.7
4846509662,0,8,0,1,9,3,6,0,0,0,0,16933,6.8,17310,199,48,2808,1569,24.7,1693.3,11,0,0,3,9,2,0,0,0,0,14125,6.4,15741,160,48,-2808,-1569,20.8,1412.5
4846283288,1,10,0,0,6,3,5,0,0,0,0,15225,6.8,16778,162,56,390,-1859,21.8,1522.5,11,0,1,3,6,0,1,1,0,0,14835,7.0,18637,163,64,-390,1859,22.7,1483.5
4845620062,0,15,1,1,2,5,2,0,0,0,0,13964,6.8,16896,188,52,-2371,-1185,24.0,1396.4,9,2,0,5,2,5,1,1,0,0,16335,6.6,18081,173,56,2371,1185,22.9,1633.5
4845607040,0,18,1,1,3,2,3,1,1,0,0,14406,6.6,17432,181,52,992,-298,23.3,1440.6,9,0,0,2,3,0,0,0,0,0,13414,6.8,17730,197,40,-992,298,23.7,1341.4
4855171642,0,9,3,1,8,3,3,0,0,0,0,17221,7.4,19490,212,68,3068,1846,28.0,1722.1,9,3,0,3,8,3,0,0,0,0,14153,6.8,17644,144,52,-3068,-1846,19.6,1415.3
4855115427,1,12,0,0,6,6,6,0,0,0,0,15742,6.6,16601,175,40,588,-387,21.5,1574.2,10,1,1,6,6,4,1,1,0,0,15154,6.6,16988,161,36,-588,387,19.7,1515.4
4855057946,0,8,0,1,6,11,5,0,0,0,0,15961,6.6,17053,201,48,-2360,-1478,24.9,1596.1,11,0,0,11,6,12,1,1,0,0,18321,7.0,18531,170,52,2360,1478,22.2,1832.1
4855004983,0,14,3,1,6,1,6,0,0,0,0,15665,6.6,17457,183,52,1614,-486,23.5,1566.5,15,0,0,1,6,0,0,0,0,0,14051,6.8,17943,228,52,-1614,486,28.0,1405.1
4854962298,1,20,1,0,9,10,8,0,0,0,0,17838,6.8,18135,215,48,-772,-1421,26.3,1783.8,10,2,1,10,9,6,1,1,0,0,18610,7.2,19556,205,60,772,1421,26.5,1861.0
4854927631,0,0,1,1,17,20,45,0,0,0,0,34515,10.8,37848,112,0,-2446,-575,11.2,3451.5,15,0,0,20,17,44,0,0,0,0,36961,11.0,38423,127,0,2446,575,12.7,3696.1
4850020004,1,9,0,1,6,2,3,0,0,0,0,15460,6.6,16210,197,48,1014,1318,24.5,1546.0,34,0,0,2,6,2,0,0,0,0,14446,6.2,14892,165,52,-1014,-1318,21.7,1444.6
4849972247,1,8,0,1,5,1,7,1,1,0,0,16433,7.0,17698,212,40,2392,1175,25.2,1643.3,16,0,0,1,5,1,0,0,0,0,14041,6.6,16523,189,56,-2392,-1175,24.5,1404.1
4843480838,0,11,0,0,8,22,23,0,0,0,0,35523,10.8,39086,79,64,-5042,-6527,14.3,3552.3,9,0,1,22,8,53,0,0,0,0,40565,11.8,45613,99,71,5042,6527,17.0,4056.5
4842036126,0,20,1,1,22,5,52,0,0,0,1,37051,11.2,40954,70,74,4139,2558,14.4,3705.1,15,1,0,5,22,10,0,0,0,0,32912,10.8,38396,109,51,-4139,-2558,16.0,3291.2
4833787471,0,14,1,0,2,4,0,0,0,0,0,14419,6.8,17449,203,48,-2429,-1403,25.1,1441.9,72,0,1,4,2,3,1,1,0,0,16848,7.2,18852,214,68,2429,1403,28.2,1684.8
4833753341,1,10,0,1,8,2,9,0,0,0,0,17213,6.8,17509,214,48,4272,1020,26.2,1721.3,12,0,0,2,8,3,1,1,0,0,12941,6.4,16489,119,56,-4272,-1020,17.5,1294.1
4833738259,1,12,14,0,6,6,6,1,0,1,0,16338,6.8,17671,193,56,427,-53,24.9,1633.8,31,2,1,6,6,3,0,0,0,0,15911,7.0,17724,229,40,-427,53,26.9,1591.1
4831508193,0,17,1,1,8,5,5,0,0,0,0,16731,6.6,17264,177,40,1345,-79,21.7,1673.1,15,1,0,5,8,4,1,1,0,0,15386,7.0,17343,190,40,-1345,79,23.0,1538.6
4831479633,1,12,0,0,7,4,1,0,0,0,0,16381,7.2,19181,208,56,2242,3380,26.4,1638.1,11,0,1,4,7,4,0,0,0,0,14139,6.4,15801,133,52,-2242,-3380,18.5,1413.9
4829794924,0,17,1,1,7,4,3,1,1,0,0,16904,6.8,17671,209,48,1993,929,25.7,1690.4,10,1,0,4,7,3,0,0,0,0,14911,6.8,16742,181,48,-1993,-929,22.9,1491.1
4829739563,1,82,1,0,9,7,3,0,0,0,0,16235,6.8,16977,149,40,-1666,-662,18.9,1623.5,87,0,1,7,9,6,0,0,0,0,17901,7.0,17639,199,44,1666,662,24.3,1790.1
4828944082,1,88,1,1,4,3,2,0,0,0,0,14424,6.8,16699,182,56,128,-1563,23.8,1442.4,11,1,0,3,4,1,1,1,0,0,14296,6.8,18262,171,64,-128,1563,23.5,1429.6
4828912245,0,75,2,1,8,8,11,1,1,0,0,17383,6.2,15070,147,44,-1434,-3542,19.1,1738.3,13,0,0,8,8,9,0,0,0,0,18817,7.0,18612,208,28,1434,3542,23.6,1881.7
4856962934,1,32,0,0,0,3,0,1,1,0,0,14568,6.8,17925,196,60,287,989,25.6,1456.8,29,0,1,3,0,3,0,0,0,0,14281,6.8,16936,151,44,-287,-989,19.5,1428.1
4856843085,1,9,2,0,5,6,1,1,1,0,0,14884,6.6,17321,175,60,229,-437,23.5,1488.4,8,1,1,6,5,3,0,0,0,0,14655,7.0,17758,157,48,-229,437,20.5,1465.5
4856822847,1,14,17,0,2,2,2,1,1,0,0,15329,7.2,19266,203,64,1147,1607,26.7,1532.9,34,5,1,2,2,2,0,0,0,0,14182,6.8,17659,197,58,-1147,-1607,25.5,1418.2
4856568074,1,13,12,1,7,6,6,0,0,0,0,17369,6.8,17797,175,48,-358,-903,22.3,1736.9,24,1,0,6,7,4,0,0,0,0,17727,7.0,18700,201,52,358,903,25.3,1772.7
4856378481,0,13,1,0,3,7,1,2,1,1,0,15275,7.0,18245,194,56,-1601,946,25.0,1527.5,13,0,1,7,3,6,0,0,0,0,16876,6.6,17299,201,56,1601,-946,25.7,1687.6
4856348832,0,0,0,0,16,29,43,0,0,0,1,34958,10.6,37427,82,0,-3874,-7276,8.2,3495.8,0,0,1,29,16,47,0,0,0,0,38832,12.0,44703,110,0,3874,7276,11.0,3883.2
4856306442,0,0,0,0,24,29,50,0,0,0,2,37159,11.0,39399,105,0,-2027,-3874,10.5,3715.9,0,0,1,29,24,74,0,0,0,0,39186,11.6,43273,111,0,2027,3874,11.1,3918.6
4855969537,0,14,1,1,3,5,2,0,0,0,0,15570,7.0,17892,204,60,-325,-325,26.4,1557.0,11,1,0,5,3,3,0,0,0,0,15895,7.0,18217,192,56,325,325,24.8,1589.5
4855866497,0,0,0,0,19,39,39,0,0,0,1,38508,11.4,42073,83,0,-3332,-2566,8.3,3850.8,0,0,1,39,19,105,0,0,0,0,41840,11.8,44639,100,0,3332,2566,10.0,4184.0
4855851776,1,0,3,0,25,19,68,0,0,0,0,37152,11.0,41630,107,0,210,1348,10.7,3715.2,22,0,1,19,25,36,0,0,0,0,36942,11.2,40282,93,0,-210,-1348,9.3,3694.2
4855815616,0,12,0,1,3,3,3,1,1,0,0,15371,6.8,17645,244,44,841,-786,28.8,1537.1,10,0,0,3,3,1,0,0,0,0,14530,7.0,18431,174,64,-841,786,23.8,1453.0
4855786289,0,10,1,1,1,7,0,0,0,0,0,13961,6.8,16876,173,56,-2656,-2185,22.9,1396.1,13,2,0,7,1,3,0,0,0,0,16617,7.2,19061,194,60,2656,2185,25.4,1661.7
4855752183,0,14,1,1,5,3,4,0,0,0,0,15029,6.6,16987,165,50,304,-234,21.5,1502.9,12,0,0,3,5,2,0,0,0,0,14725,6.8,17221,176,48,-304,234,22.4,1472.5
4855483667,0,0,0,0,29,29,59,0,0,0,0,39428,11.4,43943,104,0,1563,2021,10.4,3942.8,14,0,1,29,29,66,0,0,0,0,37865,11.6,41922,105,0,-1563,-2021,10.5,3786.5
4855449667,0,11,0,0,0,5,0,0,0,0,0,13416,7.2,18020,186,44,-2582,-219,23.0,1341.6,11,1,1,5,0,8,0,0,0,0,15998,6.8,18239,206,68,2582,219,27.4,1599.8
4855415556,0,146,0,0,10,6,9,0,0,0,0,16748,6.6,16598,161,38,1290,-987,19.9,1674.8,70,1,1,6,10,2,1,1,0,0,15458,6.8,17585,194,64,-1290,987,25.8,1545.8
4855379401,1,18,0,1,4,3,5,0,0,0,0,15112,6.8,16548,182,45,512,-497,22.7,1511.2,13,0,0,3,4,2,0,0,0,0,14600,6.6,17045,214,58,-512,497,27.2,1460.0
4855294308,0,19,1,1,6,8,3,0,0,0,0,16272,7.0,18533,187,56,863,1100,24.3,1627.2,13,1,0,7,5,4,0,0,0,0,15409,6.8,17433,167,40,-863,-1100,20.7,1540.9
4855211539,1,159,1,0,3,2,1,1,1,0,0,13743,7.0,18689,176,56,-697,858,23.2,1374.3,12,1,1,2,3,2,0,0,0,0,14440,6.8,17831,201,56,697,-858,25.7,1444.0
4855055803,0,14,2,1,4,4,1,0,0,0,0,15577,7.0,18453,191,64,82,155,25.5,1557.7,13,1,0,4,4,2,0,0,0,0,15495,6.8,18298,227,56,-82,-155,28.3,1549.5
4857260374,1,12,3,1,8,4,7,1,1,0,0,17360,6.8,17603,187,56,1737,1053,24.3,1736.0,18,1,0,4,8,1,0,0,0,0,15623,6.6,16550,180,51,-1737,-1053,23.1,1562.3
4857171140,1,14,0,1,7,8,2,0,0,0,0,16923,6.6,16504,170,44,402,-261,21.4,1692.3,136,2,0,8,7,5,0,0,0,0,16521,6.6,16765,177,32,-402,261,20.9,1652.1
4857077633,1,12,5,1,13,7,11,1,1,0,0,18548,6.8,17712,164,63,2042,2266,22.7,1854.8,10,0,0,7,13,9,0,0,0,0,16506,6.4,15446,149,36,-2042,-2266,18.5,1650.6
4857040408,1,13,0,1,9,6,7,2,1,1,0,18226,6.8,18187,179,56,1775,795,23.5,1822.6,14,0,0,6,9,5,0,0,0,0,16451,6.8,17392,194,60,-1775,-795,25.4,1645.1
4856054111,0,21,2,1,6,4,5,0,0,0,0,16037,6.6,16821,184,48,953,77,23.2,1603.7,14,2,0,4,6,3,0,0,0,0,15084,6.8,16744,189,52,-953,-77,24.1,1508.4
4855996341,1,16,2,1,8,5,5,0,0,0,0,16845,7.2,18029,191,44,-233,-622,23.5,1684.5,15,1,0,5,8,7,0,0,0,0,17078,7.0,18651,164,80,233,622,24.4,1707.8
4855972083,0,69,0,0,1,5,0,0,0,0,0,13495,6.6,16922,190,52,-3379,-1470,24.2,1349.5,13,0,1,5,1,7,0,0,0,0,16874,7.2,18392,215,56,3379,1470,27.1,1687.4
4855025867,1,105,2,1,12,8,10,0,0,0,0,19339,7.0,17811,199,40,2172,1662,23.9,1933.9,11,1,0,8,12,9,0,0,0,0,17167,6.6,16149,173,52,-2172,-1662,22.5,1716.7
4854964420,1,21,1,1,2,2,3,0,0,0,0,14855,6.8,17175,204,44,775,-432,24.8,1485.5,13,1,0,2,2,2,0,0,0,0,14080,6.8,17607,203,52,-775,432,25.5,1408.0
4854745239,0,0,2,0,13,18,32,0,0,0,1,34723,10.2,35540,101,0,-574,-2332,10.1,3472.3,16,0,1,18,13,41,0,0,0,0,35297,10.8,37872,105,0,574,2332,10.5,3529.7
4852438789,0,12,0,1,7,4,2,1,1,0,0,15811,6.8,18437,189,60,-368,650,24.9,1581.1,10,0,0,4,7,3,1,0,1,0,16179,6.8,17787,181,62,368,-650,24.3,1617.9
4852406290,1,27,2,1,3,1,2,1,1,0,0,15312,6.8,17562,226,59,1248,-403,28.5,1531.2,13,2,0,1,3,1,0,0,0,0,14064,6.8,17965,204,55,-1248,403,25.9,1406.4
4851427764,0,51,1,0,6,5,4,0,0,0,0,16621,7.0,17941,203,52,1,-111,25.5,1662.1,11,1,1,5,6,5,1,1,0,0,16620,7.2,18052,213,48,-1,111,26.1,1662.0
4851325531,0,51,1,0,2,3,1,0,0,0,0,14970,6.6,16604,168,44,777,600,21.2,1497.0,32,2,1,3,2,2,0,0,0,0,14193,6.4,16004,156,50,-777,-600,20.6,1419.3
4850650125,1,13,0,0,2,3,0,0,0,0,0,14474,7.0,18585,199,56,-448,519,25.5,1447.4,12,0,1,3,2,3,0,0,0,0,14922,6.8,18066,194,48,448,-519,24.2,1492.2
4850615497,0,23,1,0,2,4,0,0,0,0,0,13402,6.2,16162,183,42,-2420,-2071,22.5,1340.2,75,4,1,4,2,3,1,1,0,0,15822,7.0,18233,171,70,2420,2071,24.1,1582.2
4850579307,1,13,1,1,7,4,8,0,0,0,0,16901,6.6,17261,169,48,868,-163,21.7,1690.1,11,1,0,4,7,4,0,0,0,0,16033,6.8,17424,205,46,-868,163,25.1,1603.3
4850407064,1,16,1,1,6,4,12,1,1,0,0,15721,6.8,17058,174,56,888,-120,23.0,1572.1,12,0,0,4,6,2,0,0,0,0,14833,6.8,17178,203,48,-888,120,25.1,1483.3
4849805002,0,10,2,0,2,5,1,0,0,0,0,14747,7.0,17519,212,44,-2807,-476,25.6,1474.7,24,3,1,5,2,4,1,1,0,0,17554,7.0,17995,213,48,2807,476,26.1,1755.4
4849472652,0,13,2,0,2,5,1,0,0,0,0,14247,6.8,17651,186,52,-1951,-1460,23.8,1424.7,12,1,1,5,2,3,1,1,0,0,16198,7.0,19111,179,68,1951,1460,24.7,1619.8
4761939089,1,13,0,1,26,39,72,0,0,0,1,39217,11.4,42965,107,0,-4702,-6250,10.7,3921.7,7,0,0,39,26,112,0,0,0,0,43919,12.4,49215,115,0,4702,6250,11.5,4391.9
4761916583,0,18,0,1,17,15,43,0,0,0,0,36665,10.8,39628,98,0,1147,3067,9.8,3666.5,81,1,0,15,17,46,0,0,0,0,35518,10.4,36561,97,0,-1147,-3067,9.7,3551.8
4761899643,0,0,0,0,22,21,70,0,0,0,1,37686,11.2,40795,107,0,1372,3637,10.7,3768.6,0,0,1,21,22,67,0,0,0,0,36314,10.6,37158,114,0,-1372,-3637,11.4,3631.4
4761890830,0,68,0,0,23,19,59,0,0,0,0,35822,10.8,38809,95,0,-684,-547,9.5,3582.2,0,0,1,18,22,52,0,0,0,0,36506,11.0,39356,105,0,684,547,10.5,3650.6
4761872205,0,18,0,0,25,25,63,0,0,0,1,38106,11.4,41761,102,0,87,-1469,10.2,3810.6,0,4,1,25,25,57,0,0,0,0,38019,11.6,43230,86,0,-87,1469,8.6,3801.9
4759158988,0,1,0,1,30,31,74,0,0,0,1,39881,11.4,42075,109,0,-885,-1067,10.9,3988.1,0,0,0,31,30,75,0,0,0,0,40766,11.6,43142,112,0,885,1067,11.2,4076.6
4759147783,0,4,0,0,8,13,24,0,0,0,0,32927,10.0,33023,100,0,-1604,-3856,10.0,3292.7,88,0,1,13,8,39,0,0,0,0,34531,10.6,36879,111,0,1604,3856,11.1,3453.1
4759129538,0,0,0,1,27,37,65,0,0,0,1,38358,11.4,43073,102,0,-2755,-4588,10.2,3835.8,0,0,0,37,27,87,0,0,0,0,41113,12.2,47661,111,0,2755,4588,11.1,4111.3
4759114482,0,0,0,0,31,33,66,0,0,0,2,39375,12.0,45890,123,0,-2066,-371,12.3,3937.5,0,0,1,33,31,94,0,0,0,0,41441,12.2,46261,122,0,2066,371,12.2,4144.1
4759104799,1,6,0,1,16,9,47,0,0,0,0,34865,11.0,38547,103,0,2246,4479,10.3,3486.5,0,0,0,9,16,28,0,0,0,0,32619,10.0,34068,107,0,-2246,-4479,10.7,3261.9
4759085292,1,0,0,0,36,30,88,0,0,0,0,40958,12.2,47234,108,0,1126,2855,10.8,4095.8,0,0,1,30,36,75,0,0,0,0,39832,11.6,44379,110,0,-1126,-2855,11.0,3983.2
4759074799,1,0,0,1,27,15,87,0,0,0,3,41727,11.2,42245,122,0,4948,4296,12.2,4172.7,0,0,0,15,27,39,0,0,0,0,36779,10.6,37949,96,0,-4948,-4296,9.6,3677.9
4758612166,0,100,0,1,20,20,53,0,0,0,1,37032,11.0,39411,96,0,-329,533,9.6,3703.2,1,0,0,20,20,49,0,0,0,0,37361,11.0,38878,98,0,329,-533,9.8,3736.1
4758594315,1,0,2,1,29,16,63,0,0,0,0,38011,11.6,43099,123,0,2105,6719,12.3,3801.1,18,0,0,16,29,38,0,0,0,0,35906,10.4,36380,114,0,-2105,-6719,11.4,3590.6
4758585831,1,88,0,0,32,23,83,0,0,0,1,40751,11.8,44402,91,0,1959,2044,9.1,4075.1,0,0,1,23,32,54,0,0,0,0,38792,11.4,42358,104,0,-1959,-2044,10.4,3879.2
4758288496,0,0,2,1,18,18,42,0,0,0,1,34718,11.0,38800,115,0,-581,1466,11.5,3471.8,14,0,0,18,18,41,0,0,0,0,35299,10.8,37334,103,0,581,-1466,10.3,3529.9
4758281899,1,0,1,1,29,32,75,0,0,0,1,42088,11.4,44271,107,0,2814,-22,10.7,4208.8,12,0,0,32,29,80,0,0,0,0,39274,11.8,44293,101,0,-2814,22,10.1,3927.4
4758262412,0,0,0,1,29,27,68,0,0,0,2,40448,11.6,42908,121,0,1544,176,12.1,4044.8,0,0,0,27,29,58,0,0,0,0,38904,11.6,42732,97,0,-1544,-176,9.7,3890.4
4758247462,0,0,0,0,30,30,77,0,0,0,0,37309,11.6,42722,100,0,-3163,-1895,10.0,3730.9,0,0,1,30,30,55,0,0,0,0,40472,11.8,44617,117,0,3163,1895,11.7,4047.2
4756995966,1,0,0,0,24,21,69,0,0,0,1,40376,11.8,43120,113,0,4551,5192,11.3,4037.6,10,0,1,21,24,35,0,0,0,0,35825,10.6,37928,105,0,-4551,-5192,10.5,3582.5
4798558996,1,12,0,0,8,3,14,0,0,0,0,16230,5.6,13205,129,41,644,-1685,17.0,1623.0,16,1,1,3,8,2,0,0,0,0,15586,6.2,14890,158,38,-644,1685,19.6,1558.6
4798533994,1,12,2,1,8,2,11,0,0,0,0,16290,6.6,17091,181,52,2215,1350,23.3,1629.0,9,0,0,2,8,3,0,0,0,0,14075,6.4,15741,164,48,-2215,-1350,21.2,1407.5
4798500267,1,14,0,0,2,4,1,0,0,0,0,13879,6.6,17010,160,48,-1826,-726,20.8,1387.9,16,1,1,4,2,3,1,0,1,0,15705,7.0,17736,235,48,1826,726,28.3,1570.5
4798469167,1,13,3,1,5,4,7,0,0,0,0,15616,6.6,16989,191,56,1292,-421,24.7,1561.6,17,3,0,4,5,1,0,0,0,0,14324,6.8,17410,177,48,-1292,421,22.5,1432.4
4798445071,0,15,2,1,7,7,5,0,0,0,0,14929,6.4,15444,129,61,-1611,-1825,19.0,1492.9,14,1,0,7,7,6,0,0,0,0,16540,6.8,17269,157,36,1611,1825,19.3,1654.0
4798413990,1,10,0,0,5,7,8,0,0,0,0,15803,6.6,16449,173,44,-1452,-1541,21.7,1580.3,14,0,1,7,5,5,1,0,1,0,17255,6.8,17990,188,56,1452,1541,24.4,1725.5
4787645778,0,15,0,1,6,2,7,0,0,0,0,15376,6.4,16468,142,46,576,248,18.8,1537.6,12,0,0,2,6,2,0,0,0,0,14800,6.4,16220,164,40,-576,-248,20.4,1480.0
4787607421,0,77,0,1,7,2,15,1,1,0,0,15825,6.6,16844,162,58,1418,-551,22.0,1582.5,14,0,0,2,7,2,0,0,0,0,14407,6.8,17395,214,40,-1418,551,25.4,1440.7
4787579401,0,12,2,0,7,11,5,0,0,0,0,15106,6.6,16109,156,40,-3707,-1811,19.6,1510.6,10,1,1,11,7,10,0,0,0,0,18813,6.8,17920,166,64,3707,1811,23.0,1881.3
4787536206,1,14,1,1,10,10,7,0,0,0,0,19212,7.0,17630,189,44,1387,739,23.3,1921.2,18,2,0,10,10,4,0,0,0,0,17825,6.8,16891,204,48,-1387,-739,25.2,1782.5
4786571837,1,12,2,1,3,3,2,1,1,0,0,15426,6.6,17086,170,56,-66,-620,22.6,1542.6,15,0,0,3,3,1,0,0,0,0,15492,6.8,17706,184,56,66,620,24.0,1549.2
4786547646,1,38,1,1,5,4,3,0,0,0,0,17528,7.0,18299,220,52,3089,1739,27.2,1752.8,14,12,0,4,5,0,0,0,0,0,14439,6.4,16560,164,36,-3089,-1739,20.0,1443.9
4786055053,0,41,1,0,5,8,4,0,0,0,0,13856,6.8,16793,164,50,-2449,-933,21.4,1385.6,16,1,1,7,4,6,0,0,0,0,16305,6.8,17726,175,40,2449,933,21.5,1630.5
4771418192,1,14,1,1,5,4,2,0,0,0,0,15595,6.6,16342,172,44,799,517,21.6,1559.5,16,2,0,4,5,3,1,1,0,0,14796,6.6,15825,177,56,-799,-517,23.3,1479.6
4767979916,0,0,0,0,31,38,64,0,0,0,1,39267,11.8,43369,79,0,-1806,-3310,7.9,3926.7,0,0,1,38,31,89,0,0,0,0,41073,12.2,46679,107,0,1806,3310,10.7,4107.3
4767933908,1,15,0,1,15,4,9,1,1,0,0,20736,7.6,21306,250,64,6636,4425,31.4,2073.6,18,0,0,4,15,1,0,0,0,0,14100,6.6,16881,167,56,-6636,-4425,22.3,1410.0
4767841185,1,12,0,1,3,0,4,0,0,0,0,14296,6.8,17635,181,46,705,82,22.7,1429.6,29,1,0,0,3,0,0,0,0,0,13591,6.8,17553,213,51,-705,-82,26.4,1359.1
4856750198,0,11,1,0,1,7,1,0,0,0,0,13532,6.6,16498,182,46,-3879,-1990,22.8,1353.2,25,3,1,7,1,6,1,1,0,0,17411,7.0,18488,208,52,3879,1990,26.0,1741.1
4856493229,1,18,3,0,7,4,8,1,1,0,0,17195,6.6,17336,201,52,1326,1355,25.3,1719.5,13,1,1,4,7,5,0,0,0,0,15869,6.4,15981,182,48,-1326,-1355,23.0,1586.9
4856428669,0,12,0,1,10,4,8,0,0,0,0,17017,6.8,17231,170,48,2199,518,21.8,1701.7,23,1,0,4,10,2,0,0,0,0,14818,6.6,16713,156,60,-2199,-518,21.6,1481.8
4856384414,1,13,0,0,3,6,1,0,0,0,0,14564,6.4,16196,156,56,477,2809,21.2,1456.4,13,0,1,6,3,2,0,0,0,0,14087,5.6,13387,142,15,-477,-2809,15.7,1408.7
4855347901,1,67,1,0,5,5,7,0,0,0,0,15767,7.2,18807,166,68,482,981,23.4,1576.7,14,1,1,5,5,2,0,0,0,0,15285,6.8,17826,186,56,-482,-981,24.2,1528.5
4855307412,0,9,0,1,4,3,2,1,1,0,0,14995,6.8,17498,197,56,561,867,25.3,1499.5,14,0,0,3,4,3,0,0,0,0,14434,6.8,16631,180,48,-561,-867,22.8,1443.4
4855256554,0,16,0,0,7,8,1,0,0,0,0,15783,6.6,17100,179,41,-1912,-1144,22.0,1578.3,14,1,1,8,7,4,0,0,0,0,17695,7.2,18244,181,52,1912,1144,23.3,1769.5
4854679565,0,14,0,1,3,5,3,0,0,0,0,15128,6.6,16973,158,48,-138,-503,20.6,1512.8,13,1,0,5,3,3,0,0,0,0,15266,6.8,17476,163,56,138,503,21.9,1526.6
4854649258,1,16,0,1,6,1,4,0,0,0,0,17144,7.2,19117,229,59,4372,1924,28.8,1714.4,17,0,0,1,6,0,0,0,0,0,12772,6.8,17193,153,57,-4372,-1924,21.0,1277.2
4854626911,0,12,0,1,7,2,3,0,0,0,0,16948,7.0,18473,234,60,2010,220,29.4,1694.8,19,2,0,2,7,0,0,0,0,0,14938,6.8,18253,224,52,-2010,-220,27.6,1493.8
4854591638,0,15,0,1,10,4,6,0,0,0,0,16379,6.8,17102,156,38,1888,2636,19.4,1637.9,12,0,0,4,10,3,0,0,0,0,14491,6.2,14466,150,44,-1888,-2636,19.4,1449.1
4851208973,1,12,0,1,9,6,17,0,0,0,0,17192,6.8,17840,190,52,2477,1310,24.2,1719.2,11,1,0,6,9,6,1,1,0,0,14715,6.6,16530,156,48,-2477,-1310,20.4,1471.5
4850376468,0,20,1,0,6,3,5,1,1,0,0,16165,7.2,18909,170,68,2032,1332,23.8,1616.5,25,2,1,3,6,2,0,0,0,0,14133,6.8,17577,168,48,-2032,-1332,21.6,1413.3
4850364965,1,14,0,0,5,10,5,0,0,0,0,15264,6.6,16059,155,44,-3939,-3314,19.9,1526.4,11,2,1,10,5,12,0,0,0,0,19203,7.2,19373,207,72,3939,3314,27.9,1920.3
4848864516,1,11,1,0,6,4,5,0,0,0,0,16084,6.8,17789,181,48,-151,-690,22.9,1608.4,10,2,1,4,6,5,1,1,0,0,16235,6.8,18479,202,56,151,690,25.8,1623.5
4848034278,0,16,2,1,7,7,12,0,0,0,0,14893,6.4,15221,138,46,-2017,-806,18.4,1489.3,13,1,0,7,7,2,1,1,0,0,16910,6.8,16027,185,52,2017,806,23.7,1691.0
4847734181,0,20,3,1,4,0,5,0,0,0,0,14580,6.4,15920,183,40,1642,-1380,22.3,1458.0,17,2,0,0,4,0,1,1,0,0,12938,6.8,17300,175,64,-1642,1380,23.9,1293.8
4847713246,1,33,2,1,7,2,7,0,0,0,0,16677,6.8,17045,145,50,3047,192,19.5,1667.7,13,0,0,2,7,1,0,0,0,0,13630,6.6,16853,164,48,-3047,-192,21.2,1363.0
4847677049,0,13,2,0,5,8,5,0,0,0,0,16806,7.0,17795,195,48,757,-58,24.3,1680.6,16,3,1,8,5,2,1,1,0,0,16049,7.0,17853,143,64,-757,58,20.7,1604.9
4846548108,1,11,0,0,2,3,2,0,0,0,0,14203,7.0,18039,196,56,402,1069,25.2,1420.3,16,0,1,3,2,4,0,0,0,0,13801,6.8,16970,156,48,-402,-1069,20.4,1380.1
4856844899,1,0,2,1,32,25,68,0,0,0,0,38427,11.6,43313,104,0,1886,3199,10.4,3842.7,23,0,0,25,32,55,0,0,0,0,36541,11.2,40114,108,0,-1886,-3199,10.8,3654.1
4856822692,0,0,0,0,22,38,50,0,0,0,1,36406,11.2,41729,94,0,-4468,-5463,9.4,3640.6,1,0,1,38,22,94,0,0,0,0,40874,11.8,47192,90,0,4468,5463,9.0,4087.4
4856812384,1,0,0,0,26,31,57,0,0,0,1,40229,11.4,42641,107,0,1358,-1647,10.7,4022.9,0,0,1,31,26,78,0,0,0,0,38871,11.8,44288,90,0,-1358,1647,9.0,3887.1
4856475945,1,18,0,0,33,26,86,0,0,0,1,40612,11.8,44567,109,0,4153,4781,10.9,4061.2,3,0,1,26,33,56,0,0,0,0,36459,10.8,39786,79,0,-4153,-4781,7.9,3645.9
4856451468,1,0,0,1,12,14,42,0,0,0,1,33801,10.0,34834,98,0,-303,86,9.8,3380.1,8,0,0,14,12,44,0,0,0,0,34104,10.2,34748,88,0,303,-86,8.8,3410.4
4856201081,0,2,0,1,26,28,60,0,0,0,1,37878,11.4,42678,108,0,-323,2089,10.8,3787.8,0,0,0,28,26,63,0,0,0,0,38201,10.8,40589,110,0,323,-2089,11.0,3820.1
4855799462,0,18,3,0,16,14,46,0,0,0,0,33281,11.0,37027,92,0,-408,2075,9.2,3328.1,22,3,1,14,16,29,0,0,0,0,33689,10.2,34952,111,0,408,-2075,11.1,3368.9
4855776944,1,134,0,1,20,20,43,0,0,0,0,37952,11.2,40645,118,0,4434,2916,11.8,3795.2,0,0,0,20,20,49,0,0,0,0,33518,10.6,37729,86,0,-4434,-2916,8.6,3351.8
4855760960,1,0,0,1,17,19,41,0,0,0,1,36600,10.6,38133,118,0,2040,1046,11.8,3660.0,0,0,0,19,17,38,0,0,0,0,34560,10.6,37087,99,0,-2040,-1046,9.9,3456.0
4855735083,0,0,0,1,22,26,47,0,0,0,0,36220,11.2,40924,102,0,-1198,-1772,10.2,3622.0,0,0,0,26,22,61,0,0,0,0,37418,11.6,42696,111,0,1198,1772,11.1,3741.8
4855721083,0,0,0,0,15,26,31,0,0,0,0,35551,11.0,40061,103,0,-1300,-243,10.3,3555.1,0,0,1,26,15,65,0,0,0,0,36851,11.0,40304,109,0,1300,243,10.9,3685.1
4855705461,1,0,1,1,24,16,79,0,0,0,1,38848,11.4,43084,106,0,3865,6057,10.6,3884.8,6,0,0,16,24,35,0,0,0,0,34983,10.6,37027,82,0,-3865,-6057,8.2,3498.3
4855228470,1,0,0,1,25,21,63,0,0,0,0,37397,11.2,41177,113,0,2045,2846,11.3,3739.7,0,0,0,21,25,44,0,0,0,0,35352,11.0,38331,104,0,-2045,-2846,10.4,3535.2
4855189979,1,34,0,0,15,15,48,0,0,0,0,34124,10.6,36765,120,0,-610,172,12.0,3412.4,50,0,1,15,15,37,0,0,0,0,34734,10.4,36593,102,0,610,-172,10.2,3473.4
4855150055,1,34,0,0,13,17,30,0,0,0,0,34640,10.8,36899,115,0,181,1174,11.5,3464.0,34,0,1,17,13,42,0,0,0,0,34459,10.4,35725,98,0,-181,-1174,9.8,3445.9
4854631908,1,0,0,1,24,14,56,0,0,0,0,36673,11.2,41000,91,0,1789,4193,9.1,3667.3,0,0,0,14,24,36,0,0,0,0,34884,10.8,36807,88,0,-1789,-4193,8.8,3488.4
4854611500,1,0,0,0,20,25,56,0,0,0,1,37144,10.8,37883,119,0,-157,-2911,11.9,3714.4,0,0,1,25,20,71,0,0,0,0,37301,11.2,40794,103,0,157,2911,10.3,3730.1
4854594107,1,1,0,0,17,20,42,0,0,0,0,36707,11.2,40739,113,0,2396,1574,11.3,3670.7,4,0,1,20,17,41,0,0,0,0,34311,10.8,39165,94,0,-2396,-1574,9.4,3431.1
4854571714,1,0,0,1,29,30,79,0,0,0,0,40594,11.6,43489,100,0,1227,-1891,10.0,4059.4,0,0,0,30,29,77,0,0,0,0,39367,11.8,45380,101,0,-1227,1891,10.1,3936.7
4854561393,1,86,0,0,19,14,50,0,0,0,1,35092,10.6,36559,105,0,813,1234,10.5,3509.2,0,0,1,14,19,31,0,0,0,0,34279,10.2,35325,111,0,-813,-1234,11.1,3427.9
4850969582,1,11,0,1,20,20,54,0,0,0,1,37181,11.0,40704,107,0,816,965,10.7,3718.1,0,1,0,20,20,44,0,0,0,0,36365,11.2,39739,79,0,-816,-965,7.9,3636.5
4850957924,1,0,0,1,44,37,118,0,0,0,2,45114,13.0,52642,107,0,5540,6850,10.7,4511.4,77,0,0,36,43,98,0,0,0,0,39574,12.0,45792,76,0,-5540,-6850,7.6,3957.4
4850923198,0,13,0,0,23,29,44,0,0,0,1,36977,11.4,41748,70,0,-2551,-2785,7.0,3697.7,0,0,1,29,23,64,0,0,0,0,39528,11.6,44533,103,0,2551,2785,10.3,3952.8
4809214135,0,12,1,1,6,2,9,0,0,0,0,16678,6.8,17451,187,48,2097,841,23.5,1667.8,10,0,0,2,6,3,0,0,0,0,14581,6.4,16610,221,56,-2097,-841,27.7,1458.1
4726795934,1,0,0,0,15,18,17,0,0,0,0,48801,10.0,47500,0,0,18827,19000,0.0,4880.1,0,0,1,12,9,9,0,0,0,0,29974,6.0,28500,0,0,-18827,-19000,0.0,2997.4
4726767029,1,0,0,1,11,17,14,0,0,0,0,60600,12.0,55000,0,0,22700,22000,0.0,6060.0,0,0,0,12,6,9,0,0,0,0,37900,7.2,33000,0,0,-22700,-22000,0.0,3790.0
4722006602,1,10,1,1,7,0,7,0,0,0,0,18473,7.4,19587,218,50,5506,4033,26.8,1847.3,14,1,0,0,7,0,0,0,0,0,12967,6.4,15554,170,46,-5506,-4033,21.6,1296.7
4721952792,1,11,2,1,10,6,11,0,0,0,0,17206,6.8,17655,177,36,1643,-197,21.3,1720.6,29,0,0,5,9,2,1,1,0,0,15563,7.0,17852,204,64,-1643,197,26.8,1556.3
4721470156,0,77,2,0,5,3,5,0,0,0,0,16169,7.0,18587,188,76,1363,730,26.4,1616.9,13,0,1,3,5,2,0,0,0,0,14806,6.8,17857,167,64,-1363,-730,23.1,1480.6
4721420964,1,68,2,0,1,4,1,0,0,0,0,14906,7.0,18426,201,60,444,993,26.1,1490.6,12,0,1,4,1,2,1,1,0,0,14462,7.0,17433,175,50,-444,-993,22.5,1446.2
4721343486,1,17,0,0,6,5,4,0,0,0,0,16257,7.0,18034,204,57,150,-69,26.1,1625.7,73,1,1,5,6,3,0,0,0,0,16107,7.0,18103,193,49,-150,69,24.2,1610.7
4721318907,0,13,0,0,2,1,1,0,0,0,0,14461,7.0,17774,194,64,-1460,-526,25.8,1446.1,17,2,1,1,2,1,0,0,0,0,15921,7.2,18300,218,64,1460,526,28.2,1592.1
4714672188,1,14,3,0,6,4,3,0,0,0,0,16552,7.2,18814,199,43,1014,1747,24.2,1655.2,15,2,1,4,6,3,0,0,0,0,15538,6.8,17067,173,48,-1014,-1747,22.1,1553.8
4714587226,1,13,2,0,5,8,3,0,0,0,0,15287,6.6,16301,168,52,-2988,-1034,22.0,1528.7,10,3,1,8,5,5,0,0,0,0,18275,6.8,17335,175,36,2988,1034,21.1,1827.5
4714553421,0,13,3,1,4,10,2,0,0,0,0,13664,6.4,15455,150,48,-4586,-2838,19.8,1366.4,32,3,0,10,4,7,1,1,0,0,18250,7.0,18293,225,48,4586,2838,27.3,1825.0
4713714196,0,13,1,1,6,6,3,1,1,0,0,15322,6.8,17317,167,56,-766,-489,22.3,1532.2,11,2,0,6,6,3,0,0,0,0,16088,6.8,17806,200,60,766,489,26.0,1608.8
4713620200,0,11,2,0,5,13,5,1,1,0,0,15192,6.6,16185,168,52,-5243,-1851,22.0,1519.2,13,2,1,13,5,13,0,0,0,0,20435,7.2,18036,195,51,5243,1851,24.6,2043.5
4706141530,0,19,3,0,6,9,6,0,0,0,0,16651,6.8,17321,195,52,-1492,-657,24.7,1665.1,11,5,1,9,6,7,1,1,0,0,18143,6.8,17978,214,68,1492,657,28.2,1814.3
4702480576,1,12,1,1,6,2,4,1,1,0,0,17868,7.2,19002,233,76,4273,2494,30.9,1786.8,6,1,0,2,6,2,0,0,0,0,13595,6.6,16508,165,56,-4273,-2494,22.1,1359.5
4702433712,1,16,0,1,6,6,5,1,0,1,0,16471,6.6,17592,198,43,-292,-1140,24.1,1647.1,11,0,0,6,6,4,0,0,0,0,16763,7.0,18732,234,56,292,1140,29.0,1676.3
4759805354,1,18,3,1,7,6,8,1,1,0,0,18716,7.0,17955,196,60,2023,581,25.6,1871.6,10,1,0,6,7,4,0,0,0,0,16693,6.4,17374,214,56,-2023,-581,27.0,1669.3
4759777994,0,24,1,1,4,4,3,0,0,0,0,15282,7.0,18493,183,54,-855,538,23.7,1528.2,9,0,0,4,4,9,1,1,0,0,16137,7.0,17955,197,64,855,-538,26.1,1613.7
4759747450,1,11,0,1,4,3,4,1,1,0,0,16289,6.8,18205,187,52,2043,-161,23.9,1628.9,8,0,0,3,4,2,0,0,0,0,14246,7.0,18366,163,64,-2043,161,22.7,1424.6
4759710557,1,14,1,1,7,6,4,0,0,0,0,15854,6.8,16912,165,44,819,-453,20.9,1585.4,13,0,0,6,7,4,0,0,0,0,15035,6.6,17365,142,51,-819,453,19.3,1503.5
4753845428,1,17,14,0,10,5,9,0,0,0,0,18146,6.8,17814,186,56,2359,1272,24.2,1814.6,36,1,1,5,10,5,0,0,0,0,15787,6.6,16542,165,52,-2359,-1272,21.7,1578.7
4753816514,1,10,2,1,3,2,2,1,1,0,0,14517,6.8,17674,186,52,-473,-663,23.8,1451.7,290,0,0,2,3,1,0,0,0,0,14990,7.0,18337,201,56,473,663,25.7,1499.0
4753768533,0,101,3,1,7,5,8,1,1,0,0,17330,7.0,17518,178,52,-68,307,23.0,1733.0,14,0,0,5,7,5,0,0,0,0,17398,6.8,17211,167,52,68,-307,21.9,1739.8
4753738840,1,15,0,1,11,3,7,2,1,1,0,18283,7.4,19833,199,84,3072,2703,28.3,1828.3,11,1,0,3,11,1,0,0,0,0,15211,6.8,17130,200,44,-3072,-2703,24.4,1521.1
4752206023,1,12,0,0,6,4,4,1,1,0,0,15440,6.4,15967,169,46,-2034,-1900,21.5,1544.0,10,0,1,4,6,6,0,0,0,0,17474,6.8,17867,210,32,2034,1900,24.2,1747.4
4752167444,0,12,0,1,7,8,3,1,1,0,0,16388,6.4,16579,151,55,-1990,-891,20.6,1638.8,14,1,0,8,7,5,0,0,0,0,18378,7.0,17470,206,40,1990,891,24.6,1837.8
4752126598,0,81,0,0,4,5,5,0,0,0,0,16023,7.2,18623,227,64,295,1036,29.1,1602.3,12,0,1,5,4,7,1,1,0,0,15728,6.8,17587,202,44,-295,-1036,24.6,1572.8
4743778585,1,14,0,0,4,4,6,0,0,0,0,15901,7.0,17468,199,52,24,674,25.1,1590.1,13,2,1,4,4,6,0,0,0,0,15877,6.6,16794,175,57,-24,-674,23.2,1587.7
4743701284,1,19,1,1,3,0,2,0,0,0,0,16047,6.8,17938,225,56,2142,1527,28.1,1604.7,14,1,0,0,3,0,1,0,1,0,13905,6.6,16411,201,48,-2142,-1527,24.9,1390.5
4743655742,1,34,1,1,3,7,2,1,1,0,0,13842,6.4,15496,173,56,-2749,-1926,22.9,1384.2,12,7,0,7,3,8,1,0,1,0,16591,6.6,17422,179,48,2749,1926,22.7,1659.1
4743593689,1,12,0,1,7,5,8,0,0,0,0,17119,6.8,18263,178,40,1220,291,21.8,1711.9,120,3,0,5,7,5,0,0,0,0,15899,7.0,17972,173,52,-1220,-291,22.5,1589.9
4727190187,0,3,11,1,5,3,3,0,0,0,0,16357,7.0,17907,169,44,618,129,21.3,1635.7,27,0,0,3,5,3,0,0,0,0,15739,6.8,17778,175,59,-618,-129,23.4,1573.9
4727155842,0,12,1,1,4,3,2,1,0,1,0,16998,6.6,17144,182,40,1246,-92,22.2,1699.8,15,3,0,3,4,1,1,1,0,0,15752,6.8,17236,179,55,-1246,92,23.4,1575.2
4727099546,0,10,14,1,5,1,6,0,0,0,0,15869,7.0,18421,185,40,1423,854,22.5,1586.9,33,1,0,1,5,0,1,0,1,0,14446,7.0,17567,201,68,-1423,-854,26.9,1444.6
4727050668,0,17,2,1,6,6,2,1,1,0,0,15436,7.0,18567,195,56,-1749,1497,25.1,1543.6,14,1,0,6,6,8,0,0,0,0,17185,6.8,17070,160,52,1749,-1497,21.2,1718.5
4727013677,1,200,1,1,9,5,5,0,0,0,0,18362,6.8,17696,218,52,2705,803,27.0,1836.2,16,2,0,5,9,2,0,0,0,0,15657,6.6,16893,153,44,-2705,-803,19.7,1565.7
4856019432,0,13,3,1,3,5,3,0,0,0,0,15854,7.0,17551,207,72,7,99,27.9,1585.4,11,3,0,5,3,4,0,0,0,0,15847,6.6,17452,212,44,-7,-99,25.6,1584.7
4855981301,0,13,2,0,3,5,0,0,0,0,0,14956,6.8,17739,182,60,-956,149,24.2,1495.6,10,1,1,5,3,5,0,0,0,0,15912,7.0,17590,200,48,956,-149,24.8,1591.2
4855944601,1,66,1,1,8,2,10,1,1,0,0,17095,6.8,17819,216,52,413,-465,26.8,1709.5,13,1,0,2,8,3,0,0,0,0,16682,7.0,18284,193,44,-413,465,23.7,1668.2
4855388128,0,13,0,1,7,4,3,0,0,0,0,16904,7.0,18478,212,51,1431,688,26.3,1690.4,200,0,0,4,7,2,1,1,0,0,15473,6.8,17790,201,56,-1431,-688,25.7,1547.3
4855346155,1,33,0,1,14,17,15,0,0,0,0,46722,10.0,47500,0,0,17392,16000,0.0,4672.2,0,0,0,12,9,11,0,0,0,0,29330,6.6,31500,1,0,-17392,-16000,0.1,2933.0
4855320942,1,0,0,1,16,15,12,0,0,0,0,46300,10.0,47500,0,0,18585,19000,0.0,4630.0,0,0,0,6,7,11,0,0,0,0,27715,6.0,28500,0,0,-18585,-19000,0.0,2771.5
4855296762,1,0,0,1,22,19,21,0,0,0,0,47700,10.0,47500,0,0,19500,19000,0.0,4770.0,0,0,0,10,13,7,0,0,0,0,28200,6.0,28500,0,0,-19500,-19000,0.0,2820.0
4855270285,1,0,0,0,13,21,13,0,0,0,0,61713,12.0,55000,1,0,22648,22000,0.1,6171.3,0,0,1,16,8,17,0,0,0,0,39065,7.2,33000,3,0,-22648,-22000,0.3,3906.5
4855252412,1,0,0,1,16,19,13,0,0,0,0,63424,12.0,55000,0,0,23624,22000,0.0,6342.4,0,0,0,11,8,16,0,0,0,0,39800,7.2,33000,0,0,-23624,-22000,0.0,3980.0
4854807011,0,18,1,1,2,1,5,0,0,0,0,15259,6.8,17674,221,40,870,288,26.1,1525.9,12,0,0,1,2,2,1,1,0,0,14389,6.6,17386,218,51,-870,-288,26.9,1438.9
4854772834,0,30,0,1,5,3,5,0,0,0,0,16114,6.6,17963,227,56,1596,575,28.3,1611.4,31,1,0,3,5,6,0,0,0,0,14518,6.6,17388,189,56,-1596,-575,24.5,1451.8
4854726050,0,10,1,1,5,2,4,1,0,1,0,15500,7.0,17052,185,56,901,-245,24.1,1550.0,78,2,0,2,5,1,0,0,0,0,14599,6.8,17297,207,44,-901,245,25.1,1459.9
4854704863,1,0,0,0,16,18,19,0,0,0,0,60950,12.0,55000,0,0,22700,22000,0.0,6095.0,0,0,1,11,9,10,0,0,0,0,38250,7.2,33000,0,0,-22700,-22000,0.0,3825.0
4854688098,1,0,0,1,15,14,15,0,0,0,0,60953,12.0,55000,0,0,24094,22000,0.0,6095.3,0,0,0,10,11,8,0,0,0,0,36859,7.2,33000,0,0,-24094,-22000,0.0,3685.9
4854019487,1,13,2,1,4,3,2,1,1,0,0,15723,7.0,18202,203,68,2019,845,27.1,1572.3,15,2,0,3,4,2,0,0,0,0,13704,6.8,17357,147,52,-2019,-845,19.9,1370.4
4853965488,0,16,1,0,6,10,5,0,0,0,0,17026,6.6,17055,153,56,-188,958,20.9,1702.6,13,3,1,10,6,19,1,1,0,0,17214,6.4,16097,184,48,188,-958,23.2,1721.4
4853904157,0,13,3,0,5,6,5,0,0,0,0,15408,6.6,16523,185,52,-1537,-814,23.7,1540.8,10,1,1,6,5,6,0,0,0,0,16945,6.8,17337,194,40,1537,814,23.4,1694.5
4853831912,1,65,0,0,4,3,3,0,0,0,0,15046,7.0,17694,165,60,671,2473,22.5,1504.6,111,2,1,3,4,3,0,0,0,0,14375,6.0,15221,201,32,-671,-2473,23.3,1437.5
4853596838,1,12,0,1,2,0,1,1,1,0,0,14683,7.0,18980,193,64,1789,1920,25.7,1468.3,7,1,0,0,2,0,0,0,0,0,12894,6.8,17060,178,52,-1789,-1920,23.0,1289.4
4857239229,1,0,0,1,20,14,47,0,0,0,2,37258,10.8,40130,113,0,1490,4202,11.3,3725.8,0,0,0,14,20,30,0,0,0,0,35768,10.4,35928,99,0,-1490,-4202,9.9,3576.8
4857202495,1,0,0,0,18,30,46,0,0,0,2,37648,11.0,40468,105,0,-2886,-3841,10.5,3764.8,0,0,1,30,18,80,0,0,0,0,40534,12.0,44309,106,0,2886,3841,10.6,4053.4
4856506261,1,0,0,0,26,15,60,0,0,0,1,38084,11.6,42508,98,0,3050,4909,9.8,3808.4,0,0,1,15,26,33,0,0,0,0,35034,10.8,37599,105,0,-3050,-4909,10.5,3503.4
4855561098,0,0,0,1,19,17,35,0,0,0,0,35310,11.0,38547,92,0,1020,1212,9.2,3531.0,0,0,0,17,19,29,0,0,0,0,34290,10.6,37335,111,0,-1020,-1212,11.1,3429.0
4855554423,0,83,0,0,26,22,61,0,0,0,1,35953,11.0,39621,94,0,-969,1138,9.4,3595.3,11,0,1,22,26,45,0,0,0,0,36922,10.8,38483,118,0,969,-1138,11.8,3692.2
4855552881,1,15,0,1,29,26,62,0,0,0,1,40200,11.8,44389,111,0,3073,3720,11.1,4020.0,0,0,0,26,29,54,0,0,0,0,37127,11.2,40669,106,0,-3073,-3720,10.6,3712.7
4855448941,1,0,0,1,14,14,31,0,0,0,0,32867,10.4,35433,113,0,-492,574,11.3,3286.7,0,0,0,14,14,40,0,0,0,0,33359,10.2,34859,97,0,492,-574,9.7,3335.9
4855369502,1,32,3,1,15,15,13,0,0,0,0,47089,10.0,47500,2,0,18818,19000,0.2,4708.9,0,2,0,9,9,9,0,0,0,0,28271,6.0,28500,0,0,-18818,-19000,0.0,2827.1
4855343631,1,0,0,1,18,15,18,0,0,0,0,46332,10.0,47500,0,0,19532,19000,0.0,4633.2,0,0,0,8,11,5,0,0,0,0,26800,6.0,28500,0,0,-19532,-19000,0.0,2680.0
4855324863,1,0,0,1,17,14,15,0,0,0,0,47035,10.0,47500,0,0,20165,19000,0.0,4703.5,0,0,0,6,9,7,0,0,0,0,26870,6.0,28500,1,0,-20165,-19000,0.1,2687.0
4855298935,1,1,0,1,24,16,25,0,0,0,0,64100,12.8,59000,0,0,26900,26000,0.0,6410.0,0,0,0,10,18,8,0,0,0,0,37200,7.2,33000,0,0,-26900,-26000,0.0,3720.0
4855275447,1,0,0,0,22,17,16,0,0,0,0,46650,10.0,47500,0,0,17400,19000,0.0,4665.0,0,0,1,8,13,15,0,0,0,0,29250,6.0,28500,0,0,-17400,-19000,0.0,2925.0
4855248298,1,2,0,1,17,19,17,0,0,0,0,46910,10.6,50500,0,0,18345,22000,0.0,4691.0,0,0,0,12,10,7,0,0,0,0,28565,6.0,28500,0,0,-18345,-22000,0.0,2856.5
4855136767,1,0,0,1,20,13,55,0,0,0,1,36472,10.8,38133,111,0,2275,2460,11.1,3647.2,0,0,0,13,20,28,0,0,0,0,34197,10.4,35673,78,0,-2275,-2460,7.8,3419.7
4854966499,1,7,0,1,26,24,57,0,0,0,1,39404,11.8,44072,98,0,-211,2479,9.8,3940.4,0,0,0,24,26,61,0,0,0,0,39615,11.2,41593,81,0,211,-2479,8.1,3961.5
4854902346,0,20,2,0,22,18,58,0,0,0,1,37666,11.2,41484,108,0,2579,2271,10.8,3766.6,5,2,1,18,22,49,0,0,0,0,35087,10.8,39213,100,0,-2579,-2271,10.0,3508.7
4853101528,1,0,0,1,14,16,15,0,0,0,0,46300,10.2,48680,0,0,18100,20180,0.0,4630.0,0,0,0,12,10,9,0,0,0,0,28200,6.0,28500,0,0,-18100,-20180,0.0,2820.0
4849687705,1,13,0,0,5,4,5,0,0,0,0,15093,7.0,18147,196,52,-896,-424,24.8,1509.3,10,1,1,3,4,2,0,0,0,0,15989,7.0,18571,216,64,896,424,28.0,1598.9
4848773570,0,14,0,0,6,6,4,0,0,0,0,16998,7.0,18233,187,60,714,-360,24.7,1699.8,9,1,1,6,6,4,1,1,0,0,16284,7.0,18593,178,60,-714,360,23.8,1628.4
4847158307,0,10,1,0,10,9,7,0,0,0,1,19043,6.6,16472,177,48,3029,1808,22.5,1904.3,12,0,1,9,10,8,0,0,0,0,16014,6.2,14664,151,48,-3029,-1808,19.9,1601.4
4856500947,1,13,1,0,4,4,2,0,0,0,0,16755,7.0,18676,200,68,3585,3295,26.8,1675.5,13,1,1,4,4,4,0,0,0,0,13170,6.2,15381,119,32,-3585,-3295,15.1,1317.0
4853047051,1,31,0,1,5,4,3,0,0,0,0,16286,7.0,18389,222,48,1511,1474,27.0,1628.6,10,5,0,4,5,3,1,1,0,0,14775,6.8,16915,172,60,-1511,-1474,23.2,1477.5
4852990020,0,13,0,0,5,4,5,0,0,0,0,16648,7.2,18717,197,60,2355,1484,25.7,1664.8,11,0,1,4,5,3,0,0,0,0,14293,6.8,17233,179,48,-2355,-1484,22.7,1429.3
4852905884,1,0,0,0,22,15,26,0,0,0,0,63400,12.0,55000,0,0,28300,22000,0.0,6340.0,0,0,1,8,15,4,0,0,0,0,35100,7.2,33000,0,0,-28300,-22000,0.0,3510.0
4852864719,1,0,0,1,19,20,25,0,0,0,0,63750,12.0,55000,0,0,24800,22000,0.0,6375.0,0,0,0,13,12,10,0,0,0,0,38950,7.2,33000,0,0,-24800,-22000,0.0,3895.0
4852839254,1,0,0,1,20,14,24,0,0,0,0,65150,12.0,55000,15,0,29000,22000,1.5,6515.0,3,0,0,11,17,5,0,0,0,0,36150,7.2,33000,3,0,-29000,-22000,0.3,3615.0
4852620859,1,0,0,1,23,14,22,0,0,0,0,64250,12.0,55000,3,0,27750,22000,0.3,6425.0,0,0,0,6,15,5,0,0,0,0,36500,7.2,33000,0,0,-27750,-22000,0.0,3650.0
4852599177,1,7,0,1,19,20,22,0,0,0,0,63400,12.8,61000,0,0,24800,25000,0.0,6340.0,0,0,0,15,14,9,0,0,0,0,38600,7.6,36000,0,0,-24800,-25000,0.0,3860.0
4852580051,1,0,0,0,20,17,22,0,0,0,0,63874,12.6,59500,2,0,24724,22000,0.2,6387.4,4,0,1,12,15,7,0,0,0,0,39150,7.8,37500,4,0,-24724,-22000,0.4,3915.0
4851921618,0,34,0,0,3,5,3,0,0,0,0,13304,6.6,17096,176,44,-1730,-1213,22.0,1330.4,35,0,1,4,2,4,0,0,0,0,15034,7.0,18309,176,56,1730,1213,23.2,1503.4
4851895840,0,9,0,0,1,3,0,0,0,0,0,13816,7.0,18629,194,52,-759,572,24.6,1381.6,8,0,1,3,1,3,0,0,0,0,14575,7.0,18057,203,43,759,-572,24.6,1457.5
4850992586,1,14,0,1,31,26,72,0,0,0,0,40159,12.0,46276,84,0,3098,3191,8.4,4015.9,0,1,0,26,31,52,0,0,0,0,37061,11.4,43085,94,0,-3098,-3191,9.4,3706.1
4845440675,0,129,0,0,6,2,5,1,1,0,0,14669,6.6,16848,144,42,352,-1334,18.6,1466.9,31,0,1,2,6,2,1,0,1,0,14317,6.8,18182,179,56,-352,1334,23.5,1431.7
4845434945,1,101,3,1,6,3,10,0,0,0,0,15835,6.6,16707,168,56,1456,-318,22.4,1583.5,15,0,0,3,6,2,1,1,0,0,14379,6.8,17025,207,44,-1456,318,25.1,1437.9
4844539346,1,16,4,0,7,2,4,0,0,0,0,16576,7.4,19223,197,56,2507,3125,25.3,1657.6,165,2,1,2,7,0,0,0,0,0,14069,6.6,16098,160,44,-2507,-3125,20.4,1406.9
4840554710,1,53,1,0,0,1,0,1,1,0,0,13766,7.0,17951,206,64,-231,39,27.0,1376.6,9,0,1,1,0,0,0,0,0,0,13997,6.8,17912,211,52,231,-39,26.3,1399.7
4840550961,0,78,0,1,4,6,3,0,0,0,0,14228,6.6,15641,161,48,-2256,-2935,20.9,1422.8,17,1,0,6,4,2,0,0,0,0,16484,7.0,18576,202,59,2256,2935,26.1,1648.4
4840291143,1,101,2,1,6,2,2,0,0,0,0,15311,6.6,17062,225,26,2121,-142,25.1,1531.1,10,1,0,0,4,0,0,0,0,0,13190,6.8,17204,173,58,-2121,142,23.1,1319.0
4856750685,1,0,0,1,16,11,16,0,0,0,0,32350,9.0,40000,0,0,14200,16000,0.0,3235.0,0,0,0,8,13,7,0,0,0,0,18150,5.4,24000,0,0,-14200,-16000,0.0,1815.0
4855877535,1,22,0,0,20,19,23,0,0,0,0,47580,10.0,47500,5,0,16761,19000,0.5,4758.0,0,0,1,14,15,9,0,0,0,0,30819,6.0,28500,1,0,-16761,-19000,0.1,3081.9
4855377208,0,0,18,1,29,17,83,0,0,0,1,38215,11.6,44029,83,0,667,4334,8.3,3821.5,22,0,0,17,29,36,0,0,0,0,37548,11.0,39695,123,0,-667,-4334,12.3,3754.8
4855339700,1,1,5,1,19,20,40,0,0,0,1,35496,10.6,37691,116,0,-115,-2622,11.6,3549.6,30,0,0,19,18,39,0,0,0,0,35611,11.2,40313,101,0,115,2622,10.1,3561.1
4855317048,1,0,0,1,21,25,52,0,0,0,1,35490,10.6,37967,92,0,-2343,-4224,9.2,3549.0,0,0,0,25,21,65,0,0,0,0,37833,11.4,42191,107,0,2343,4224,10.7,3783.3
4855284735,1,0,0,1,23,14,21,0,0,0,0,63798,12.0,55000,0,0,28275,22000,0.0,6379.8,3,0,0,5,14,5,0,0,0,0,35523,7.2,33000,1,0,-28275,-22000,0.1,3552.3
4855251428,1,0,0,1,21,18,19,0,0,0,0,55150,13.0,62500,0,0,17600,25000,0.0,5515.0,0,0,0,11,14,10,0,0,0,0,37550,7.8,37500,0,0,-17600,-25000,0.0,3755.0
4855220593,1,0,0,1,16,15,17,0,0,0,0,58200,12.0,55000,0,0,24400,22000,0.0,5820.0,0,0,0,9,10,9,0,0,0,0,33800,7.2,33000,0,0,-24400,-22000,0.0,3380.0
4855206939,1,0,0,1,22,15,21,0,0,0,0,63475,12.0,55000,0,0,25551,22000,0.0,6347.5,0,0,0,6,13,9,0,0,0,0,37924,7.2,33000,0,0,-25551,-22000,0.0,3792.4
4855178684,1,6,0,0,25,13,22,0,0,0,0,62700,12.8,59000,0,0,26200,26000,0.0,6270.0,0,0,1,4,16,8,0,0,0,0,36500,7.2,33000,0,0,-26200,-26000,0.0,3650.0
4854805969,1,0,0,1,15,11,13,0,0,0,0,31495,9.0,40000,3,0,14310,16000,0.3,3149.5,0,0,0,5,9,5,0,0,0,0,17185,5.4,24000,1,0,-14310,-16000,0.1,1718.5
4854783878,1,0,0,0,19,20,21,0,0,0,0,48050,10.0,47500,0,0,20200,19000,0.0,4805.0,0,0,1,13,12,10,0,0,0,0,27850,6.0,28500,0,0,-20200,-19000,0.0,2785.0
4854764929,1,0,0,1,16,15,17,0,0,0,0,45950,10.0,47500,0,0,18100,19000,0.0,4595.0,0,0,0,10,11,8,0,0,0,0,27850,6.0,28500,0,0,-18100,-19000,0.0,2785.0
4854618618,1,12,0,1,22,18,20,0,0,0,0,47060,10.0,47500,0,0,20945,19000,0.0,4706.0,0,0,0,6,10,7,0,0,0,0,26115,6.0,28500,0,0,-20945,-19000,0.0,2611.5
4854607395,1,0,0,0,22,13,16,0,0,0,0,47350,10.0,47500,0,0,19500,17820,0.0,4735.0,0,0,1,6,15,9,0,0,0,0,27850,6.2,29680,0,0,-19500,-17820,0.0,2785.0
4854591406,1,13,0,1,15,17,13,0,0,0,0,48530,10.0,47500,2,0,19570,19000,0.2,4853.0,0,0,0,11,9,14,0,0,0,0,28960,6.0,28500,2,0,-19570,-19000,0.2,2896.0
4854553175,1,0,0,0,18,12,17,0,0,0,0,41850,10.2,48680,2,0,17905,20180,0.2,4185.0,0,0,1,6,12,6,0,0,0,0,23945,6.0,28500,1,0,-17905,-20180,0.1,2394.5
4854546750,1,6,0,1,16,15,12,0,0,0,0,61300,12.0,55000,0,0,24075,22000,0.0,6130.0,0,0,0,8,9,12,0,0,0,0,37225,7.2,33000,1,0,-24075,-22000,0.1,3722.5
4854508488,1,289,0,1,22,8,23,0,0,0,0,64220,12.0,55000,2,0,29750,22000,0.2,6422.0,0,0,0,2,16,3,0,0,0,0,34470,7.2,33000,1,0,-29750,-22000,0.1,3447.0
4854501937,1,81,0,1,18,14,18,0,0,0,0,47532,10.6,50500,5,0,26608,22000,0.5,4753.2,0,0,0,9,13,7,0,0,0,0,20924,6.0,28500,2,0,-26608,-22000,0.2,2092.4
