gameId,blueWins,blueWardsPlaced,blueWardsDestroyed,blueFirstBlood,blueKills,blueDeaths,blueAssists,blueEliteMonsters,blueDragons,blueHeralds,blueTowersDestroyed,blueTotalGold,blueAvgLevel,blueTotalExperience,blueTotalMinionsKilled,blueTotalJungleMinionsKilled,blueGoldDiff,blueExperienceDiff,blueCSPerMin,blueGoldPerMin,redWardsPlaced,redWardsDestroyed,redFirstBlood,redKills,redDeaths,redAssists,redEliteMonsters,redDragons,redHeralds,redTowersDestroyed,redTotalGold,redAvgLevel,redTotalExperience,redTotalMinionsKilled,redTotalJungleMinionsKilled,redGoldDiff,redExperienceDiff,redCSPerMin,redGoldPerMin
4855021854,1,0,0,1,17,10,43,0,0,0,0,34535,10.4,36633,107,0,2324,2618,10.7,3453.5,0,0,0,10,17,24,0,0,0,0,32211,10.0,34015,96,0,-2324,-2618,9.6,3221.1
4854961958,1,3,32,1,13,20,36,0,0,0,1,34139,10.4,36339,75,0,-1974,-2197,7.5,3413.9,29,1,0,20,13,52,0,0,0,0,36113,10.6,38536,121,0,1974,2197,12.1,3611.3
4853447799,1,9,0,0,18,19,15,0,0,0,0,51525,12.0,55000,1,0,19900,22000,0.1,5152.5,0,0,1,10,9,13,0,0,0,0,31625,7.2,33000,1,0,-19900,-22000,0.1,3162.5
4853429979,1,0,0,0,15,19,24,0,0,0,0,47350,10.0,47500,0,0,17927,19000,0.0,4735.0,0,0,1,17,13,8,0,0,0,0,29423,6.0,28500,0,0,-17927,-19000,0.0,2942.3
4853420816,1,3,0,1,20,17,26,0,0,0,0,63420,12.0,55000,0,0,26870,22000,0.0,6342.0,0,0,0,12,15,8,0,0,0,0,36550,7.2,33000,0,0,-26870,-22000,0.0,3655.0
4852386581,1,64,0,1,5,4,4,0,0,0,0,16572,6.8,17536,202,52,239,-1527,25.4,1657.2,9,2,0,4,5,2,0,0,0,0,16333,7.2,19063,193,52,-239,1527,24.5,1633.3
4852360591,1,10,1,0,7,3,6,0,0,0,0,16151,6.4,16671,157,56,2092,917,21.3,1615.1,14,1,1,3,7,1,0,0,0,0,14059,6.4,15754,167,52,-2092,-917,21.9,1405.9
4852225652,1,23,1,0,4,4,3,0,0,0,0,14653,6.8,18238,170,44,517,2178,21.4,1465.3,11,1,1,4,4,5,0,0,0,0,14136,6.4,16060,175,32,-517,-2178,20.7,1413.6
4852211579,0,12,1,1,3,2,2,0,0,0,0,13762,6.6,16063,163,48,-669,-1709,21.1,1376.2,10,1,0,2,3,3,1,1,0,0,14431,6.8,17772,207,48,669,1709,25.5,1443.1
4850621796,1,25,4,1,5,5,4,0,0,0,0,16889,7.0,18422,258,44,1151,335,30.2,1688.9,20,2,0,5,5,8,1,1,0,0,15738,7.0,18087,209,55,-1151,-335,26.4,1573.8
4850598696,0,15,1,0,6,7,4,0,0,0,0,15509,6.4,15536,178,44,-1791,-1561,22.2,1550.9,18,2,1,7,6,12,1,1,0,0,17300,6.8,17097,177,50,1791,1561,22.7,1730.0
4850573082,0,13,2,0,8,4,5,0,0,0,0,17076,6.6,17228,211,40,2425,763,25.1,1707.6,9,4,1,4,8,3,1,1,0,0,14651,6.4,16465,174,60,-2425,-763,23.4,1465.1
4850549836,0,13,1,1,7,4,5,1,0,1,0,17260,7.0,18473,220,56,1835,1168,27.6,1726.0,15,1,0,4,7,1,1,1,0,0,15425,6.8,17305,170,48,-1835,-1168,21.8,1542.5
4850515770,0,66,0,0,3,4,3,0,0,0,0,13764,6.8,16624,174,52,-2298,-1682,22.6,1376.4,10,1,1,4,3,3,1,1,0,0,16062,6.8,18306,183,60,2298,1682,24.3,1606.2
4850482508,0,209,1,0,6,5,5,1,1,0,0,15923,6.8,18216,197,56,-290,0,25.3,1592.3,66,1,1,5,6,2,0,0,0,0,16213,7.0,18216,198,60,290,0,25.8,1621.3
4850334543,1,13,0,1,3,1,2,0,0,0,0,14946,7.0,18535,188,60,1298,166,24.8,1494.6,10,0,0,1,3,1,0,0,0,0,13648,7.0,18369,202,52,-1298,-166,25.4,1364.8
4849708514,1,11,0,0,3,10,2,0,0,0,0,14586,6.6,17099,175,50,-4622,-1800,22.5,1458.6,16,2,1,10,3,10,0,0,0,0,19208,7.2,18899,215,60,4622,1800,27.5,1920.8
4849671536,1,15,0,1,3,7,2,0,0,0,0,15884,7.0,18456,196,64,-1922,-1515,26.0,1588.4,6,0,0,7,3,1,1,1,0,0,17806,7.2,19971,221,64,1922,1515,28.5,1780.6
4849466955,1,9,2,0,8,9,10,0,0,0,0,17253,7.2,18057,176,52,538,302,22.8,1725.3,16,1,1,8,7,8,1,1,0,0,16715,6.8,17755,205,64,-538,-302,26.9,1671.5
4849439639,1,10,1,1,8,6,5,0,0,0,0,17774,7.2,18864,186,48,1173,1305,23.4,1777.4,157,2,0,6,8,6,1,1,0,0,16601,6.8,17559,183,52,-1173,-1305,23.5,1660.1
4857098320,1,135,1,0,7,10,10,1,1,0,0,16840,6.4,15844,167,51,-1512,-477,21.8,1684.0,14,5,1,10,7,16,0,0,0,0,18352,6.8,16321,199,44,1512,477,24.3,1835.2
4853334604,1,15,0,1,8,3,4,1,1,0,0,17921,7.0,18688,192,60,2005,1222,25.2,1792.1,8,2,0,3,8,4,0,0,0,0,15916,6.8,17466,160,44,-2005,-1222,20.4,1591.6
4851058443,1,38,0,0,7,2,7,0,0,0,0,15935,6.8,17558,195,39,1297,516,23.4,1593.5,17,0,1,2,7,1,1,1,0,0,14638,6.8,17042,177,68,-1297,-516,24.5,1463.8
4850662245,0,11,0,0,5,9,5,0,0,0,0,14851,6.4,16449,145,36,-3070,-1885,18.1,1485.1,264,0,1,9,5,9,1,1,0,0,17921,7.0,18334,204,52,3070,1885,25.6,1792.1
4849759067,1,1,0,0,29,23,82,0,0,0,1,40904,11.6,43716,109,0,3092,3805,10.9,4090.4,37,0,1,23,29,57,0,0,0,0,37812,10.8,39911,96,0,-3092,-3805,9.6,3781.2
4849076707,1,18,0,0,3,7,2,1,1,0,0,14382,6.2,15242,152,44,-1218,-1525,19.6,1438.2,11,0,1,7,3,6,1,0,1,0,15600,6.4,16767,164,59,1218,1525,22.3,1560.0
4848717258,0,12,0,0,2,7,1,0,0,0,0,15200,6.6,17039,157,56,-500,-1143,21.3,1520.0,11,2,1,7,2,3,0,0,0,0,15700,6.8,18182,177,52,500,1143,22.9,1570.0
4848681486,1,23,2,0,5,5,4,1,1,0,0,16079,7.0,17945,221,52,-33,1431,27.3,1607.9,14,1,1,5,5,3,0,0,0,0,16112,6.6,16514,207,52,33,-1431,25.9,1611.2
4846109441,0,0,0,0,25,26,47,0,0,0,1,38150,11.4,41282,93,0,534,-1787,9.3,3815.0,0,0,1,26,25,63,0,0,0,0,37616,11.6,43069,104,0,-534,1787,10.4,3761.6
4841958447,1,10,2,1,7,3,4,0,0,0,0,15522,6.6,16560,132,56,1068,1060,18.8,1552.2,11,2,0,3,7,4,0,0,0,0,14454,6.4,15500,143,44,-1068,-1060,18.7,1445.4
4841942153,1,12,1,1,8,7,8,0,0,0,0,17099,6.6,16958,186,60,415,28,24.6,1709.9,14,1,0,7,8,3,0,0,0,0,16684,6.8,16930,180,40,-415,-28,22.0,1668.4
4837120333,1,12,1,1,9,4,7,1,1,0,0,17507,6.8,17209,165,54,2307,1192,21.9,1750.7,13,1,0,4,9,5,0,0,0,0,15200,6.6,16017,171,36,-2307,-1192,20.7,1520.0
4836147677,1,12,1,1,5,4,2,0,0,0,0,15298,6.8,18455,157,49,-901,1305,20.6,1529.8,14,1,0,4,5,3,0,0,0,0,16199,6.6,17150,207,54,901,-1305,26.1,1619.9
4836130077,1,8,0,1,5,2,3,0,0,0,0,15842,7.0,18398,204,64,2175,575,26.8,1584.2,6,0,0,2,5,1,1,1,0,0,13667,6.8,17823,195,44,-2175,-575,23.9,1366.7
4835133609,0,13,2,0,2,7,2,0,0,0,0,12700,6.2,15167,145,48,-4305,-3325,19.3,1270.0,15,3,1,7,2,3,0,0,0,0,17005,7.0,18492,219,44,4305,3325,26.3,1700.5
4834737198,0,18,3,0,4,8,2,1,1,0,0,16619,7.0,18197,189,64,-136,601,25.3,1661.9,15,3,1,8,4,2,0,0,0,0,16755,6.6,17596,180,54,136,-601,23.4,1675.5
4834685336,0,132,1,0,2,7,1,0,0,0,0,14217,6.4,15908,188,46,-3069,-1546,23.4,1421.7,11,0,1,7,2,5,0,0,0,0,17286,6.8,17454,218,52,3069,1546,27.0,1728.6
4834298779,1,13,2,1,9,7,5,0,0,0,0,17920,6.8,16437,176,44,1084,575,22.0,1792.0,14,0,0,7,9,4,1,1,0,0,16836,6.2,15862,153,39,-1084,-575,19.2,1683.6
4834245286,1,13,2,0,4,6,5,0,0,0,0,16257,6.6,16583,163,52,-637,-699,21.5,1625.7,17,3,1,6,4,6,1,1,0,0,16894,6.6,17282,187,48,637,699,23.5,1689.4
4834203410,1,72,3,1,10,4,9,0,0,0,0,18528,6.8,18416,179,52,3923,1740,23.1,1852.8,15,1,0,4,10,0,1,0,1,0,14605,6.6,16676,189,52,-3923,-1740,24.1,1460.5
4826355343,1,1,0,0,31,30,64,0,0,0,1,39335,11.8,44884,91,0,260,3342,9.1,3933.5,0,0,1,30,31,83,0,0,0,0,39075,11.2,41542,100,0,-260,-3342,10.0,3907.5
4826334331,1,0,0,0,20,25,53,0,0,0,0,35026,11.2,39563,91,0,-2028,-3381,9.1,3502.6,0,0,1,25,20,72,0,0,0,0,37054,11.4,42944,105,0,2028,3381,10.5,3705.4
4826316519,1,0,0,1,26,21,47,0,0,0,1,38372,11.0,40904,120,0,2928,1968,12.0,3837.2,0,0,0,21,26,55,0,0,0,0,35444,10.6,38936,104,0,-2928,-1968,10.4,3544.4
4826301207,0,12,0,0,5,14,6,0,0,0,0,25860,10.0,32591,77,63,-1910,-2087,14.0,2586.0,14,0,1,14,5,16,0,0,0,0,27770,10.4,34678,70,51,1910,2087,12.1,2777.0
4821000735,1,26,0,0,4,12,6,0,0,0,0,28256,10.2,33726,72,55,-1063,-3454,12.7,2825.6,17,0,1,12,4,17,0,0,0,0,29319,10.6,37180,76,60,1063,3454,13.6,2931.9
4820967434,0,10,0,0,8,20,16,0,0,0,0,32510,10.2,34792,95,51,-4845,-9160,14.6,3251.0,12,0,1,20,8,37,0,0,0,0,37355,11.4,43952,100,63,4845,9160,16.3,3735.5
4820568181,1,16,1,0,2,2,2,0,0,0,0,15609,6.6,17584,235,65,916,76,30.0,1560.9,12,1,1,2,2,2,0,0,0,0,14693,6.6,17508,187,62,-916,-76,24.9,1469.3
4819604820,1,0,0,0,26,25,83,0,0,0,1,38008,11.0,39484,116,0,1896,667,11.6,3800.8,3,0,1,25,26,63,0,0,0,0,36112,10.8,38817,112,0,-1896,-667,11.2,3611.2
4819588403,1,11,1,0,15,15,28,0,0,0,0,35046,11.2,40032,92,55,1448,2524,14.7,3504.6,16,0,1,15,15,28,0,0,0,0,33598,10.6,37508,75,52,-1448,-2524,12.7,3359.8
4819573106,1,12,0,0,16,9,33,0,0,0,1,34668,11.2,41539,88,64,4070,4289,15.2,3466.8,16,0,1,9,16,21,0,0,0,0,30598,10.6,37250,74,64,-4070,-4289,13.8,3059.8
4819021924,0,26,0,1,11,14,29,0,0,0,1,32944,10.8,37820,98,47,-4373,-5656,14.5,3294.4,10,0,0,14,11,26,0,0,0,0,37317,11.6,43476,124,59,4373,5656,18.3,3731.7
4813064931,0,0,0,0,22,26,59,0,0,0,0,35775,11.0,39250,96,0,-2169,-3648,9.6,3577.5,0,0,1,26,22,49,0,0,0,0,37944,11.6,42898,123,0,2169,3648,12.3,3794.4
4787542309,1,0,2,0,19,25,51,0,0,0,0,35889,11.0,40287,113,0,-1078,-591,11.3,3588.9,23,0,1,25,19,66,0,0,0,0,36967,11.2,40878,111,0,1078,591,11.1,3696.7
4786574494,0,0,0,1,14,21,41,0,0,0,0,34382,10.4,36868,89,0,-1308,-2386,8.9,3438.2,0,0,0,21,14,53,0,0,0,0,35690,11.0,39254,92,0,1308,2386,9.2,3569.0
4775100566,1,0,0,0,19,20,46,0,0,0,0,34099,10.6,37981,97,0,-2372,26,9.7,3409.9,0,0,1,20,19,55,0,0,0,0,36471,10.8,37955,113,0,2372,-26,11.3,3647.1
4775042677,1,0,0,0,17,25,36,0,0,0,0,35124,10.4,37313,103,0,-1957,-5682,10.3,3512.4,0,0,1,25,17,52,0,0,0,0,37081,11.4,42995,101,0,1957,5682,10.1,3708.1
4775022368,1,14,0,0,32,28,65,0,0,0,1,39136,11.8,44213,114,0,475,-1601,11.4,3913.6,0,0,1,28,32,52,0,0,0,0,38661,12.2,45814,99,0,-475,1601,9.9,3866.1
4774932868,1,0,0,1,40,22,104,0,0,0,1,43525,12.0,46402,105,0,6533,6955,10.5,4352.5,0,0,0,22,40,57,0,0,0,0,36992,11.0,39447,61,0,-6533,-6955,6.1,3699.2
4774915917,1,1,2,1,24,28,71,0,0,0,2,38111,11.4,41304,107,0,258,1120,10.7,3811.1,55,0,0,28,24,75,0,0,0,0,37853,11.0,40184,96,0,-258,-1120,9.6,3785.3
4774893577,1,16,0,1,21,18,52,0,0,0,1,36050,11.2,40167,122,0,-107,2502,12.2,3605.0,0,4,0,18,21,41,0,0,0,0,36157,10.6,37665,119,0,107,-2502,11.9,3615.7
4856995735,1,2,1,1,12,22,18,0,0,0,0,47510,10.0,47500,3,0,17960,19000,0.3,4751.0,32,2,0,17,7,13,0,0,0,0,29550,6.0,28500,10,0,-17960,-19000,1.0,2955.0
4855815371,1,6,0,0,13,22,16,0,0,0,0,63870,12.0,55000,2,0,24805,22000,0.2,6387.0,0,0,1,17,8,11,0,0,0,0,39065,7.2,33000,3,0,-24805,-22000,0.3,3906.5
4855805204,1,0,0,1,21,18,21,0,0,0,0,64800,12.6,59500,0,0,26891,22000,0.0,6480.0,36,0,0,12,15,9,0,0,0,0,37909,7.8,37500,0,0,-26891,-22000,0.0,3790.9
4855789610,1,33,0,1,20,16,16,0,0,0,0,63280,12.4,57000,4,0,25730,24000,0.4,6328.0,0,0,0,8,12,11,0,0,0,0,37550,7.2,33000,0,0,-25730,-24000,0.0,3755.0
4855775288,1,0,0,0,18,19,21,0,0,0,0,47700,10.0,47500,0,0,18800,19000,0.0,4770.0,10,0,1,12,11,8,0,0,0,0,28900,6.0,28500,0,0,-18800,-19000,0.0,2890.0
4855761191,1,0,0,1,21,22,21,0,0,0,0,62462,12.4,57000,0,0,25240,24000,0.0,6246.2,0,0,0,13,12,12,0,0,0,0,37222,7.2,33000,0,0,-25240,-24000,0.0,3722.2
4854577764,0,10,0,0,6,8,3,0,0,0,0,18073,7.0,18691,200,55,-321,-1112,25.5,1807.3,12,0,1,8,6,5,0,0,0,0,18394,7.4,19803,217,56,321,1112,27.3,1839.4
4854536578,1,12,1,0,6,4,4,1,1,0,0,16700,7.0,19312,200,67,96,1821,26.7,1670.0,12,1,1,4,6,3,0,0,0,0,16604,6.8,17491,207,48,-96,-1821,25.5,1660.4
4854510699,0,11,0,0,5,7,7,0,0,0,0,16549,6.6,17311,191,52,-41,-215,24.3,1654.9,12,1,1,7,5,6,1,1,0,0,16590,6.8,17526,173,76,41,215,24.9,1659.0
4854486557,1,8,0,0,3,8,1,0,0,0,0,14366,6.8,16869,184,36,-4690,-2347,22.0,1436.6,9,0,1,8,3,9,1,1,0,0,19056,7.0,19216,214,68,4690,2347,28.2,1905.6
4854429271,1,2,0,0,21,21,47,0,0,0,1,36984,11.0,39973,114,0,971,-2,11.4,3698.4,0,0,1,20,20,47,0,0,0,0,36013,11.0,39975,94,0,-971,2,9.4,3601.3
4853372192,1,0,0,0,19,15,18,0,0,0,0,62210,12.0,55000,0,0,25690,22000,0.0,6221.0,0,0,1,8,12,5,0,0,0,0,36520,7.2,33000,0,0,-25690,-22000,0.0,3652.0
4853359561,1,0,0,1,15,16,9,0,0,0,0,44990,10.0,47500,0,0,16772,19000,0.0,4499.0,0,0,0,7,6,11,0,0,0,0,28218,6.0,28500,0,0,-16772,-19000,0.0,2821.8
4853358113,1,0,0,1,24,14,26,0,0,0,0,66550,13.0,62500,0,0,30500,28000,0.0,6655.0,0,0,0,7,17,5,0,0,0,0,36050,7.4,34500,0,0,-30500,-28000,0.0,3605.0
4853352900,1,0,0,1,26,28,20,0,0,0,0,64532,12.8,61000,0,0,25232,25000,0.0,6453.2,3,0,0,13,11,11,0,0,0,0,39300,7.6,36000,0,0,-25232,-25000,0.0,3930.0
4853339488,1,36,1,1,8,19,13,0,0,0,0,60211,12.0,55000,2,0,21581,22000,0.2,6021.1,0,1,0,17,6,13,0,0,0,0,38630,7.2,33000,1,0,-21581,-22000,0.1,3863.0
4853284491,1,0,0,1,13,27,16,0,0,0,0,60250,12.0,55000,0,0,19200,22000,0.0,6025.0,0,0,0,18,4,14,0,0,0,0,41050,7.2,33000,0,0,-19200,-22000,0.0,4105.0
4853281204,1,0,0,1,14,18,17,0,0,0,0,61300,12.2,56000,0,0,24100,23000,0.0,6130.0,0,0,0,11,7,10,0,0,0,0,37200,7.2,33000,0,0,-24100,-23000,0.0,3720.0
4853273402,1,0,0,0,20,16,14,0,0,0,0,47250,10.0,47500,0,0,19400,19000,0.0,4725.0,0,0,1,6,10,12,0,0,0,0,27850,6.0,28500,0,0,-19400,-19000,0.0,2785.0
4852548479,0,0,0,0,22,18,60,0,0,0,0,35855,11.4,40587,110,0,-731,1484,11.0,3585.5,0,0,1,18,22,60,0,0,0,0,36586,11.2,39103,113,0,731,-1484,11.3,3658.6
4822857148,0,10,1,1,3,5,1,0,0,0,0,14329,6.6,17232,194,48,-3257,-2454,24.2,1432.9,12,2,0,5,3,5,0,0,0,0,17586,7.6,19686,211,68,3257,2454,27.9,1758.6
4795373197,0,11,0,0,0,3,0,0,0,0,0,15534,7.2,19128,228,40,215,1165,26.8,1553.4,12,0,1,3,0,2,1,1,0,0,15319,7.0,17963,198,64,-215,-1165,26.2,1531.9
4787708185,0,13,0,0,4,3,3,1,0,1,0,14963,6.6,17269,194,40,-317,55,23.4,1496.3,27,1,1,3,4,4,1,1,0,0,15280,6.6,17214,204,72,317,-55,27.6,1528.0
4787680999,1,33,0,0,3,10,3,0,0,0,0,17774,7.2,18238,199,56,-180,187,25.5,1777.4,8,8,1,10,3,5,0,0,0,0,17954,7.2,18051,193,52,180,-187,24.5,1795.4
4786895734,1,16,3,1,10,6,10,1,1,0,0,17838,6.8,17373,197,56,1086,761,25.3,1783.8,12,2,0,6,10,6,0,0,0,0,16752,6.6,16612,160,52,-1086,-761,21.2,1675.2
4786032284,1,0,0,0,26,22,65,0,0,0,0,38231,11.0,40020,95,0,83,-878,9.5,3823.1,0,0,1,22,26,53,0,0,0,0,38148,11.2,40898,97,0,-83,878,9.7,3814.8
4786011946,1,114,0,1,27,23,72,0,0,0,2,39736,11.4,43422,109,0,3380,2913,10.9,3973.6,0,0,0,23,27,59,0,0,0,0,36356,11.2,40509,79,0,-3380,-2913,7.9,3635.6
4785980074,0,0,0,0,25,32,75,0,0,0,1,38340,11.4,41658,111,0,-2124,-3128,11.1,3834.0,0,0,1,32,25,78,0,0,0,0,40464,11.8,44786,105,0,2124,3128,10.5,4046.4
4785936392,1,10,0,0,9,4,6,0,0,0,0,16628,6.6,16978,147,44,-162,-1498,19.1,1662.8,313,1,1,4,9,3,0,0,0,0,16790,6.8,18476,226,56,162,1498,28.2,1679.0
4785476644,1,0,8,1,21,29,56,0,0,0,2,38786,11.2,39931,97,0,-524,-3808,9.7,3878.6,18,0,0,29,21,84,0,0,0,0,39310,11.6,43739,100,0,524,3808,10.0,3931.0
4785470513,1,0,0,0,24,24,60,0,0,0,1,39685,11.8,45312,106,0,3842,4983,10.6,3968.5,0,0,1,24,24,43,0,0,0,0,35843,11.0,40329,77,0,-3842,-4983,7.7,3584.3
4785459101,0,5,0,0,17,21,47,0,0,0,1,34065,10.4,35968,100,0,-3257,-4119,10.0,3406.5,12,0,1,21,17,50,0,0,0,0,37322,11.2,40087,104,0,3257,4119,10.4,3732.2
4785445964,1,0,0,1,27,22,59,0,0,0,0,36761,11.0,40536,96,0,-2495,-1288,9.6,3676.1,0,0,0,22,27,46,0,0,0,0,39256,11.4,41824,109,0,2495,1288,10.9,3925.6
4785426167,1,12,0,0,18,26,36,0,0,0,1,35484,10.6,37445,106,0,-647,-1927,10.6,3548.4,270,1,1,26,18,60,0,0,0,0,36131,11.0,39372,107,0,647,1927,10.7,3613.1
4785417003,1,0,0,1,33,33,86,0,0,0,1,40153,11.4,42792,102,0,2286,-1190,10.2,4015.3,3,0,0,33,33,75,0,0,0,0,37867,11.6,43982,85,0,-2286,1190,8.5,3786.7
4785398341,1,0,0,1,25,26,54,0,0,0,1,39103,11.6,43452,113,0,2566,4114,11.3,3910.3,0,0,0,26,25,58,0,0,0,0,36537,11.0,39338,114,0,-2566,-4114,11.4,3653.7
4785025155,0,38,1,0,6,10,5,1,1,0,0,17584,6.8,17840,207,36,-810,-1129,24.3,1758.4,19,24,1,10,6,6,0,0,0,0,18394,7.0,18969,181,57,810,1129,23.8,1839.4
4784539655,0,11,1,0,3,9,1,1,1,0,0,13412,6.2,14841,173,40,-4703,-3464,21.3,1341.2,11,0,1,9,3,6,0,0,0,0,18115,6.8,18305,182,52,4703,3464,23.4,1811.5
4781735334,1,8,2,1,10,4,8,0,0,0,0,18817,7.0,19372,223,67,4457,2885,29.0,1881.7,10,1,0,4,10,4,0,0,0,0,14360,6.4,16487,191,28,-4457,-2885,21.9,1436.0
4781665731,0,8,1,0,4,4,2,0,0,0,0,15234,6.8,18134,201,57,-700,-288,25.8,1523.4,13,0,1,3,3,4,1,1,0,0,15934,6.8,18422,221,50,700,288,27.1,1593.4
4843221530,0,6,0,1,27,28,62,0,0,0,1,38617,11.8,44008,109,0,-667,-454,10.9,3861.7,0,0,0,28,27,64,0,0,0,0,39284,11.6,44462,107,0,667,454,10.7,3928.4
4843198374,1,0,0,0,24,25,63,0,0,0,0,38969,11.4,42489,95,0,3279,3679,9.5,3896.9,0,0,1,25,24,50,0,0,0,0,35690,11.0,38810,88,0,-3279,-3679,8.8,3569.0
4842936041,1,2,0,0,30,25,72,0,0,0,1,38734,11.6,43808,95,0,53,474,9.5,3873.4,14,0,1,25,30,68,0,0,0,0,38681,11.4,43334,118,0,-53,-474,11.8,3868.1
4842855487,0,0,0,0,32,29,94,0,0,0,1,42221,11.8,45079,118,0,1795,2830,11.8,4222.1,0,0,1,29,32,69,0,0,0,0,40426,11.6,42249,101,0,-1795,-2830,10.1,4042.6
4841326720,1,0,0,0,13,25,32,0,0,0,0,33871,10.0,34972,91,0,-3877,-6384,9.1,3387.1,0,0,1,25,13,65,0,0,0,0,37748,11.2,41356,92,0,3877,6384,9.2,3774.8
4841303438,1,15,0,1,30,26,79,0,0,0,2,38980,11.2,41555,104,0,569,110,10.4,3898.0,0,0,0,26,30,71,0,0,0,0,38411,11.2,41445,94,0,-569,-110,9.4,3841.1
4841289884,0,0,0,0,22,21,50,0,0,0,1,37744,11.0,39549,125,0,921,-105,12.5,3774.4,0,0,1,21,22,51,0,0,0,0,36823,11.0,39654,108,0,-921,105,10.8,3682.3
4841264316,0,0,0,1,16,31,47,0,0,0,1,35687,11.2,39148,101,0,-4484,-4324,10.1,3568.7,0,0,0,31,16,92,0,0,0,0,40171,11.6,43472,123,0,4484,4324,12.3,4017.1
4840914294,1,0,0,0,29,30,76,0,0,0,1,38973,11.4,42449,108,0,736,371,10.8,3897.3,0,0,1,30,29,77,0,0,0,0,38237,11.2,42078,115,0,-736,-371,11.5,3823.7
4840900379,0,76,0,0,24,36,62,0,0,0,1,36335,10.8,38231,95,0,-5447,-9084,9.5,3633.5,0,0,1,36,24,77,0,0,0,0,41782,12.2,47315,97,0,5447,9084,9.7,4178.2
4840853997,1,0,0,0,26,23,80,0,0,0,0,37629,11.4,41654,111,0,-286,185,11.1,3762.9,2,0,1,23,26,54,0,0,0,0,37915,11.2,41469,110,0,286,-185,11.0,3791.5
4840838235,1,14,0,1,24,22,56,0,0,0,0,37686,11.2,41122,117,0,-338,-939,11.7,3768.6,0,5,0,22,24,60,0,0,0,0,38024,11.4,42061,113,0,338,939,11.3,3802.4
4840634355,0,19,0,0,23,32,61,0,0,0,1,37278,11.0,40785,90,0,-3317,-2651,9.0,3727.8,0,0,1,31,22,82,0,0,0,0,40595,11.4,43436,119,0,3317,2651,11.9,4059.5
4840623526,1,68,0,0,26,25,49,0,0,0,1,37630,11.4,42302,99,0,-132,-1248,9.9,3763.0,0,0,1,25,26,66,0,0,0,0,37762,11.8,43550,112,0,132,1248,11.2,3776.2
4840615693,0,2,0,0,24,33,53,0,0,0,1,38564,11.4,41210,132,0,-1142,-1898,13.2,3856.4,0,0,1,33,24,83,0,0,0,0,39706,11.6,43108,113,0,1142,1898,11.3,3970.6
4840276074,1,24,0,1,26,33,70,0,0,0,1,38502,11.4,41749,105,0,-159,-2775,10.5,3850.2,0,0,0,33,26,77,0,0,0,0,38661,11.6,44524,104,0,159,2775,10.4,3866.1
4840255041,1,14,0,1,22,23,74,0,0,0,1,37895,10.8,39071,98,0,631,-1813,9.8,3789.5,0,0,0,23,22,67,0,0,0,0,37264,11.2,40884,73,0,-631,1813,7.3,3726.4
4840223366,1,0,0,1,38,28,108,0,0,0,0,41731,12.0,47152,91,0,1581,2434,9.1,4173.1,0,0,0,28,38,82,0,0,0,0,40150,11.8,44718,91,0,-1581,-2434,9.1,4015.0
4840198361,0,0,2,0,19,29,54,0,0,0,1,36041,10.8,36765,116,0,-4071,-5449,11.6,3604.1,13,0,1,29,19,71,0,0,0,0,40112,11.4,42214,117,0,4071,5449,11.7,4011.2
4840171257,1,0,0,0,17,24,32,0,0,0,0,35515,10.6,37600,109,0,-1367,-3397,10.9,3551.5,0,0,1,24,17,61,0,0,0,0,36882,11.2,40997,115,0,1367,3397,11.5,3688.2
4856212048,0,75,0,1,3,6,3,0,0,0,0,14808,6.8,17654,202,44,-2809,-1069,24.6,1480.8,13,0,0,6,3,5,1,0,1,0,17617,6.8,18723,221,68,2809,1069,28.9,1761.7
4856175537,0,12,10,0,3,6,5,0,0,0,0,14600,6.8,17230,170,52,-2260,-1719,22.2,1460.0,32,3,1,6,3,3,1,1,0,0,16860,7.0,18949,237,54,2260,1719,29.1,1686.0
4856107545,1,11,1,0,4,6,4,0,0,0,0,15901,6.8,16608,182,68,-988,-1932,25.0,1590.1,16,1,1,6,4,2,1,1,0,0,16889,7.2,18540,196,72,988,1932,26.8,1688.9
4853499017,1,8,1,0,4,4,4,0,0,0,0,16257,7.0,18377,204,56,1577,1681,26.0,1625.7,11,0,1,4,4,1,0,0,0,0,14680,6.4,16696,207,56,-1577,-1681,26.3,1468.0
4853469903,0,9,0,0,4,5,2,1,1,0,0,14324,6.6,16626,184,48,-1277,-227,23.2,1432.4,16,1,1,5,4,8,0,0,0,0,15601,6.6,16853,193,54,1277,227,24.7,1560.1
4853407767,0,14,0,1,7,13,5,0,0,0,0,15626,6.2,15599,151,40,-3733,-2105,19.1,1562.6,10,0,0,13,7,9,0,0,0,0,19359,7.0,17704,182,32,3733,2105,21.4,1935.9
4819370573,1,18,1,0,6,6,8,0,0,0,0,15675,6.4,15902,182,51,1055,1055,23.3,1567.5,19,1,1,6,6,5,1,1,0,0,14620,6.2,14847,146,48,-1055,-1055,19.4,1462.0
4818587620,1,13,0,1,10,3,12,0,0,0,0,18894,7.2,19551,196,64,3389,764,26.0,1889.4,12,3,0,3,10,3,1,1,0,0,15505,7.2,18787,200,64,-3389,-764,26.4,1550.5
4800094665,1,12,1,0,5,7,4,0,0,0,0,16221,6.8,17654,199,48,10,1668,24.7,1622.1,90,1,1,7,5,6,1,1,0,0,16211,6.4,15986,161,52,-10,-1668,21.3,1621.1
4798857567,1,19,0,1,8,5,5,0,0,0,0,17040,7.0,17466,178,51,1192,-492,22.9,1704.0,15,2,0,5,8,2,1,1,0,0,15848,7.0,17958,211,64,-1192,492,27.5,1584.8
4789373010,1,19,2,0,10,5,9,0,0,0,0,17973,6.8,17758,189,44,2595,161,23.3,1797.3,81,1,1,5,10,2,0,0,0,0,15378,7.0,17597,171,56,-2595,-161,22.7,1537.8
4786501237,1,145,0,1,6,2,3,1,1,0,0,15687,6.6,17524,189,40,1163,2042,22.9,1568.7,17,0,0,2,6,1,0,0,0,0,14524,6.4,15482,155,52,-1163,-2042,20.7,1452.4
4783169311,1,15,1,1,9,7,7,0,0,0,0,18319,7.0,18471,233,52,32,-558,28.5,1831.9,11,1,0,7,9,6,0,0,0,0,18287,7.2,19029,232,63,-32,558,29.5,1828.7
4783155269,1,11,19,1,5,1,3,0,0,0,0,16014,7.2,19141,217,67,2372,894,28.4,1601.4,33,1,0,0,4,0,0,0,0,0,13642,7.0,18247,212,48,-2372,-894,26.0,1364.2
4783136089,1,15,1,0,10,8,9,0,0,0,0,17197,6.6,16336,161,43,-79,-389,20.4,1719.7,48,2,1,8,10,10,0,0,0,0,17276,6.6,16725,164,66,79,389,23.0,1727.6
4781270527,1,14,2,0,1,3,1,0,0,0,0,15996,6.8,17545,218,40,674,-941,25.8,1599.6,18,1,1,3,1,0,0,0,0,0,15322,7.2,18486,197,56,-674,941,25.3,1532.2
4781246315,1,42,2,1,5,3,2,0,0,0,0,15754,7.0,17446,177,64,1059,-92,24.1,1575.4,13,0,0,3,5,2,0,0,0,0,14695,7.0,17538,196,48,-1059,92,24.4,1469.5
4781199860,1,11,3,0,6,3,6,1,1,0,0,16314,6.8,17792,168,72,1234,880,24.0,1631.4,19,2,1,3,6,3,0,0,0,0,15080,6.8,16912,208,47,-1234,-880,25.5,1508.0
4781181213,0,9,2,0,5,12,2,0,0,0,0,14333,6.6,16285,175,52,-4644,-1378,22.7,1433.3,25,3,1,11,4,16,1,1,0,0,18977,6.8,17663,217,52,4644,1378,26.9,1897.7
4855396882,1,13,1,1,4,2,2,1,0,1,0,15556,7.0,18504,204,60,300,-86,26.4,1555.6,12,0,0,2,4,2,1,1,0,0,15256,7.0,18590,223,68,-300,86,29.1,1525.6
4854365378,1,19,1,1,2,4,1,0,0,0,0,15141,6.8,17558,222,56,263,-21,27.8,1514.1,13,3,0,4,2,9,1,1,0,0,14878,6.8,17579,157,59,-263,21,21.6,1487.8
4852027225,0,0,0,0,22,18,61,0,0,0,0,34617,10.6,37589,85,0,-747,-68,8.5,3461.7,9,0,1,18,22,36,0,0,0,0,35364,10.8,37657,105,0,747,68,10.5,3536.4
4851988586,0,9,1,0,3,5,3,1,0,1,0,14695,6.8,17549,182,48,-2126,-869,23.0,1469.5,13,1,1,5,3,2,0,0,0,0,16821,7.0,18418,202,43,2126,869,24.5,1682.1
4851955433,0,10,1,0,6,7,5,0,0,0,0,15171,6.4,16181,163,48,-1975,-1552,21.1,1517.1,13,1,1,7,6,10,1,1,0,0,17146,6.8,17733,217,44,1975,1552,26.1,1714.6
4851912605,0,13,1,0,3,5,4,1,1,0,0,14003,6.4,15773,174,42,-2130,-2943,21.6,1400.3,9,1,1,5,3,3,0,0,0,0,16133,7.0,18716,221,49,2130,2943,27.0,1613.3
4851046372,0,0,0,0,9,17,23,0,0,0,0,32263,10.0,33580,91,0,-2373,-2917,9.1,3226.3,28,0,1,17,9,46,0,0,0,0,34636,10.6,36497,98,0,2373,2917,9.8,3463.6
4851023746,0,0,2,1,24,26,48,0,0,0,0,36939,11.2,41639,86,0,-2561,-1125,8.6,3693.9,15,0,0,26,24,64,0,0,0,0,39500,11.6,42764,90,0,2561,1125,9.0,3950.0
4850997171,0,0,0,0,24,38,65,0,0,0,1,37830,11.4,41515,103,0,-5299,-6486,10.3,3783.0,0,0,1,38,24,88,0,0,0,0,43129,12.4,48001,119,0,5299,6486,11.9,4312.9
4850954294,0,0,4,0,21,13,33,0,0,0,0,35126,11.0,39174,91,0,1059,1506,9.1,3512.6,37,0,1,13,21,24,0,0,0,0,34067,10.4,37668,92,0,-1059,-1506,9.2,3406.7
4850930431,0,0,0,0,26,32,61,0,0,0,0,36843,11.0,39624,78,0,-4536,-4660,7.8,3684.3,0,0,1,32,26,84,0,0,0,0,41379,11.6,44284,98,0,4536,4660,9.8,4137.9
4850389540,1,3,0,1,19,11,52,0,0,0,1,34838,10.8,38253,103,0,990,1341,10.3,3483.8,0,0,0,11,19,31,0,0,0,0,33848,10.6,36912,93,0,-990,-1341,9.3,3384.8
4850377633,1,0,0,1,18,15,40,0,0,0,0,34516,10.6,36219,114,0,1324,-102,11.4,3451.6,0,0,0,14,17,33,0,0,0,0,33192,10.6,36321,91,0,-1324,102,9.1,3319.2
4850376877,1,0,0,0,22,25,51,0,0,0,1,36556,10.8,38918,93,0,-583,-3783,9.3,3655.6,0,0,1,25,22,58,0,0,0,0,37139,11.6,42701,110,0,583,3783,11.0,3713.9
4850094303,1,0,0,0,14,12,40,0,0,0,0,34752,10.6,37034,106,0,612,1445,10.6,3475.2,1,0,1,12,14,33,0,0,0,0,34140,10.2,35589,109,0,-612,-1445,10.9,3414.0
4850060531,1,0,0,1,22,13,55,0,0,0,1,36347,10.8,39722,101,0,216,-249,10.1,3634.7,0,0,0,13,22,35,0,0,0,0,36131,11.2,39971,110,0,-216,249,11.0,3613.1
4850036372,1,30,2,1,26,17,88,0,0,0,2,38253,11.0,38787,120,0,1379,2596,12.0,3825.3,18,3,0,17,26,44,0,0,0,0,36874,10.4,36191,112,0,-1379,-2596,11.2,3687.4
4850006461,0,11,0,0,16,23,44,0,0,0,1,34131,10.4,35327,89,0,-1668,-3102,8.9,3413.1,0,2,1,23,16,47,0,0,0,0,35799,10.8,38429,119,0,1668,3102,11.9,3579.9
4849202009,0,0,0,0,16,14,38,0,0,0,0,34999,11.0,38271,120,0,981,1295,12.0,3499.9,0,0,1,14,16,29,0,0,0,0,34018,10.6,36976,106,0,-981,-1295,10.6,3401.8
4849175002,0,33,0,1,26,15,74,0,0,0,0,38521,11.2,41344,101,0,3341,4258,10.1,3852.1,0,3,0,15,26,36,0,0,0,0,35180,10.4,37086,107,0,-3341,-4258,10.7,3518.0
4856331499,1,12,1,0,2,5,2,0,0,0,0,16115,7.0,18809,227,52,655,1280,27.9,1611.5,147,2,1,5,2,3,1,1,0,0,15460,6.8,17529,187,59,-655,-1280,24.6,1546.0
4856304083,0,0,0,0,22,25,47,0,0,0,0,35082,11.0,39427,114,0,-1695,-342,11.4,3508.2,0,0,1,25,22,49,0,0,0,0,36777,11.0,39769,117,0,1695,342,11.7,3677.7
4856263577,1,0,0,0,20,14,54,0,0,0,1,36708,11.0,38540,113,0,1624,4108,11.3,3670.8,0,0,1,14,20,36,0,0,0,0,35084,10.0,34432,97,0,-1624,-4108,9.7,3508.4
4856207575,1,21,0,1,31,27,70,0,0,0,1,40292,11.6,44641,113,0,2360,2939,11.3,4029.2,0,0,0,27,31,77,0,0,0,0,37932,11.2,41702,94,0,-2360,-2939,9.4,3793.2
4855160393,1,13,1,0,7,2,6,0,0,0,0,16731,6.4,16692,224,40,2116,3108,26.4,1673.1,16,0,1,2,7,2,1,0,1,0,14615,5.8,13584,158,68,-2116,-3108,22.6,1461.5
4855116478,1,1,0,0,27,24,66,0,0,0,0,38419,11.4,42296,123,0,2475,1889,12.3,3841.9,28,0,1,24,27,49,0,0,0,0,35944,11.2,40407,86,0,-2475,-1889,8.6,3594.4
4855071568,0,0,0,1,22,15,65,0,0,0,0,37196,11.0,40904,105,0,1758,2548,10.5,3719.6,0,0,0,15,22,45,0,0,0,0,35438,10.6,38356,105,0,-1758,-2548,10.5,3543.8
4855051775,0,0,1,0,22,23,59,0,0,0,1,35529,10.4,36646,85,0,-3751,-4095,8.5,3552.9,2,0,1,23,22,78,0,0,0,0,39280,11.0,40741,113,0,3751,4095,11.3,3928.0
4837945095,1,0,2,1,38,28,83,0,0,0,1,41466,12.2,48181,112,0,2830,5344,11.2,4146.6,8,0,0,28,38,58,0,0,0,0,38636,11.6,42837,98,0,-2830,-5344,9.8,3863.6
4837921177,0,0,0,0,11,23,25,0,0,0,0,32233,10.0,33696,81,0,-5694,-4823,8.1,3223.3,8,0,1,23,11,63,0,0,0,0,37927,10.8,38519,121,0,5694,4823,12.1,3792.7
4837889648,0,0,0,1,16,20,40,0,0,0,0,35586,11.0,38371,108,0,-1534,-216,10.8,3558.6,0,0,0,20,16,55,0,0,0,0,37120,10.8,38587,119,0,1534,216,11.9,3712.0
4820841810,0,10,1,1,4,0,2,0,0,0,0,16927,7.0,18286,226,54,2513,1089,28.0,1692.7,77,0,0,0,4,0,0,0,0,0,14414,6.6,17197,187,54,-2513,-1089,24.1,1441.4
4820779473,1,10,3,1,6,2,3,0,0,0,0,16546,7.4,19702,237,66,2047,2334,30.3,1654.6,11,2,0,2,6,2,0,0,0,0,14499,6.6,17368,211,57,-2047,-2334,26.8,1449.9
4818821683,0,45,0,0,35,21,105,0,0,0,1,40438,11.8,43570,101,0,3698,4728,10.1,4043.8,0,0,1,21,35,57,0,0,0,0,36740,10.8,38842,97,0,-3698,-4728,9.7,3674.0
4818807761,1,17,0,1,24,10,67,0,0,0,0,41687,12.0,43711,83,80,7918,8397,16.3,4168.7,11,0,0,10,24,21,0,0,0,0,33769,10.4,35314,84,50,-7918,-8397,13.4,3376.9
4818780492,0,14,1,0,17,23,30,0,0,0,0,36897,11.4,40183,91,59,2335,1558,15.0,3689.7,18,0,1,23,17,53,0,0,0,0,34562,10.8,38625,44,67,-2335,-1558,11.1,3456.2
4818750818,1,11,0,0,5,9,3,0,0,0,0,16016,6.8,17546,195,56,-1886,857,25.1,1601.6,13,1,1,9,5,8,1,1,0,0,17902,6.4,16689,170,56,1886,-857,22.6,1790.2
4816370622,1,10,0,1,12,12,20,0,0,0,0,39851,12.0,45575,123,69,6100,5362,19.2,3985.1,15,0,0,12,12,24,0,0,0,0,33751,11.2,40213,99,63,-6100,-5362,16.2,3375.1
4811209891,0,13,0,0,6,6,7,0,0,0,0,16538,6.8,17432,168,44,-954,-1546,21.2,1653.8,10,1,1,6,6,5,0,0,0,0,17492,7.2,18978,226,64,954,1546,29.0,1749.2
4811154870,0,11,1,0,4,5,5,0,0,0,0,15717,7.2,18283,191,51,-133,607,24.2,1571.7,126,4,1,5,4,7,0,0,0,0,15850,7.0,17676,176,68,133,-607,24.4,1585.0
4854728705,1,0,0,1,13,20,12,0,0,0,0,60890,12.8,59000,0,0,22190,26000,0.0,6089.0,0,0,0,13,6,13,0,0,0,0,38700,7.2,33000,2,0,-22190,-26000,0.2,3870.0
4854692747,1,14,3,1,7,3,8,0,0,0,0,16681,6.4,15724,143,44,909,-1574,18.7,1668.1,13,1,0,3,7,3,1,1,0,0,15772,6.6,17298,184,52,-909,1574,23.6,1577.2
4853017546,1,31,1,0,7,5,6,1,1,0,0,16596,7.0,18049,192,60,582,-174,25.2,1659.6,13,16,1,5,7,3,0,0,0,0,16014,7.0,18223,215,60,-582,174,27.5,1601.4
4852973841,1,11,6,0,9,10,11,0,0,0,0,18490,7.0,17834,157,52,896,239,20.9,1849.0,30,0,1,10,9,6,0,0,0,0,17594,6.8,17595,206,44,-896,-239,25.0,1759.4
4852941994,1,11,3,0,10,4,9,1,1,0,0,18093,7.0,18103,211,44,4155,1780,25.5,1809.3,15,1,1,4,10,2,0,0,0,0,13938,6.2,16323,167,44,-4155,-1780,21.1,1393.8
4843540891,0,14,1,1,10,9,4,0,0,0,0,17885,6.8,17978,206,34,1423,959,24.0,1788.5,12,0,0,9,10,6,0,0,0,0,16462,6.6,17019,147,60,-1423,-959,20.7,1646.2
4843509507,0,10,0,0,1,9,0,0,0,0,0,13252,6.4,15991,134,52,-4744,-2378,18.6,1325.2,12,0,1,9,1,8,0,0,0,0,17996,6.8,18369,209,48,4744,2378,25.7,1799.6
4843479908,0,20,0,1,12,10,12,0,0,0,0,19723,7.0,17902,202,40,2106,2001,24.2,1972.3,10,0,0,10,12,11,1,1,0,0,17617,6.4,15901,157,48,-2106,-2001,20.5,1761.7
4843415280,1,11,0,0,6,5,9,1,1,0,0,17140,7.0,17593,181,51,-992,-651,23.2,1714.0,10,0,1,5,6,5,0,0,0,0,18132,7.0,18244,210,60,992,651,27.0,1813.2
4843371729,0,31,1,0,2,4,5,0,0,0,0,14391,6.2,16306,168,72,-3626,-3484,24.0,1439.1,12,17,1,4,2,4,1,1,0,0,18017,7.2,19790,241,60,3626,3484,30.1,1801.7
4842455562,1,167,2,1,5,4,2,1,1,0,0,16202,6.4,16811,188,48,1340,798,23.6,1620.2,14,3,0,4,5,3,0,0,0,0,14862,6.6,16013,181,52,-1340,-798,23.3,1486.2
4842399371,1,10,0,1,9,4,10,1,1,0,0,17798,7.0,18034,194,56,978,-204,25.0,1779.8,15,2,0,4,9,4,0,0,0,0,16820,7.0,18238,202,56,-978,204,25.8,1682.0
4842360137,0,52,4,0,4,7,2,0,0,0,0,13908,6.8,17278,164,44,-3729,-2835,20.8,1390.8,10,1,1,7,4,3,2,1,1,0,17637,7.6,20113,236,72,3729,2835,30.8,1763.7
4842307687,0,12,2,0,4,8,2,0,0,0,0,14710,6.4,16361,188,36,-2293,-1119,22.4,1471.0,159,1,1,8,4,11,0,0,0,0,17003,6.6,17480,181,60,2293,1119,24.1,1700.3
4842260510,1,15,3,1,9,10,13,0,0,0,0,17612,6.4,16522,166,36,-271,-1860,20.2,1761.2,11,1,0,10,9,7,0,0,0,0,17883,7.2,18382,188,56,271,1860,24.4,1788.3
4835931884,0,12,11,0,3,3,3,1,1,0,0,14855,6.8,16844,219,44,-1480,-1228,26.3,1485.5,31,1,1,3,3,2,0,0,0,0,16335,6.8,18072,197,56,1480,1228,25.3,1633.5
4835889123,1,13,1,1,10,7,10,2,1,1,0,19723,6.6,16870,207,47,3617,622,25.4,1972.3,9,0,0,7,10,4,0,0,0,0,16106,6.6,16248,213,44,-3617,-622,25.7,1610.6
4834594629,0,11,3,1,14,12,13,1,1,0,0,19727,6.8,17302,200,48,1124,597,24.8,1972.7,22,2,0,11,13,8,0,0,0,0,18603,6.6,16705,167,45,-1124,-597,21.2,1860.3
4834573693,1,9,2,1,6,1,4,0,0,0,0,15368,6.8,18052,202,56,806,65,25.8,1536.8,15,3,0,1,6,0,0,0,0,0,14562,7.0,17987,241,64,-806,-65,30.5,1456.2
4834174137,1,11,1,1,3,8,3,0,0,0,0,15770,7.0,18107,219,64,-961,-665,28.3,1577.0,11,1,0,8,3,6,0,0,0,0,16731,7.2,18772,191,48,961,665,23.9,1673.1
4848753611,1,18,1,0,10,8,9,0,0,0,0,18632,7.2,18993,217,56,2595,3015,27.3,1863.2,12,0,1,8,10,5,1,0,1,0,16037,6.6,15978,159,48,-2595,-3015,20.7,1603.7
4848712212,0,15,0,1,7,2,10,1,1,0,0,16955,7.0,18103,182,68,1819,553,25.0,1695.5,14,1,0,2,7,1,0,0,0,0,15136,6.4,17550,188,52,-1819,-553,24.0,1513.6
4845760386,1,15,1,0,4,3,5,0,0,0,0,15530,6.8,17903,209,52,-530,-759,26.1,1553.0,77,2,1,3,4,4,0,0,0,0,16060,7.4,18662,223,64,530,759,28.7,1606.0
4838837027,0,10,0,0,5,5,3,0,0,0,0,15005,6.8,16524,169,48,-1486,-259,21.7,1500.5,12,1,1,5,5,4,1,1,0,0,16491,6.6,16783,202,64,1486,259,26.6,1649.1
4831863959,1,13,1,1,6,6,1,0,0,0,0,15476,7.0,18256,207,56,-196,1406,26.3,1547.6,19,1,0,6,6,7,0,0,0,0,15672,6.8,16850,187,46,196,-1406,23.3,1567.2
4817833746,1,19,2,0,5,4,6,0,0,0,0,16748,6.8,17456,161,48,1779,474,20.9,1674.8,6,1,1,4,5,4,0,0,0,0,14969,6.6,16982,183,36,-1779,-474,21.9,1496.9
4680850424,1,12,2,1,5,4,2,0,0,0,0,15870,7.2,18307,186,48,642,-144,23.4,1587.0,11,2,0,4,5,1,0,0,0,0,15228,6.8,18451,213,50,-642,144,26.3,1522.8
4680816609,1,19,2,1,7,3,7,1,1,0,0,17508,7.0,19144,202,51,2055,1869,25.3,1750.8,9,2,0,3,7,3,1,0,1,0,15453,6.8,17275,216,58,-2055,-1869,27.4,1545.3
4680758231,1,17,2,1,3,5,5,0,0,0,0,14383,6.6,15864,180,43,-1393,-1477,22.3,1438.3,20,2,0,5,3,7,1,1,0,0,15776,6.8,17341,210,58,1393,1477,26.8,1577.6
4680742799,0,48,1,0,7,13,5,0,0,0,0,15743,7.0,17440,153,47,-3705,-1004,20.0,1574.3,21,1,1,13,7,10,1,1,0,0,19448,7.0,18444,219,60,3705,1004,27.9,1944.8
4669730487,0,76,2,1,3,3,2,0,0,0,0,15277,6.8,17493,204,48,-507,-102,25.2,1527.7,13,2,0,3,3,3,0,0,0,0,15784,6.6,17595,190,60,507,102,25.0,1578.4
4669688496,1,13,1,1,6,5,2,0,0,0,0,16269,7.2,18482,215,60,916,669,27.5,1626.9,7,1,0,5,6,1,0,0,0,0,15353,6.8,17813,212,52,-916,-669,26.4,1535.3
4669590805,0,119,10,0,0,6,0,0,0,0,0,13770,6.8,17774,194,60,-4039,297,25.4,1377.0,34,1,1,6,0,8,0,0,0,0,17809,6.8,17477,226,40,4039,-297,26.6,1780.9
4669553303,0,27,1,0,1,2,3,1,1,0,0,14062,6.8,17208,224,56,-1879,17,28.0,1406.2,12,9,1,2,1,3,0,0,0,0,15941,6.6,17191,230,56,1879,-17,28.6,1594.1
4669539054,0,7,4,1,2,7,3,0,0,0,0,13218,6.4,15644,142,40,-4090,-2935,18.2,1321.8,13,1,0,7,2,5,1,1,0,0,17308,6.8,18579,205,76,4090,2935,28.1,1730.8
4668580600,0,14,3,1,5,9,6,0,0,0,0,15106,6.8,17138,193,44,-1877,-1656,23.7,1510.6,26,3,0,9,5,9,1,1,0,0,16983,7.2,18794,210,59,1877,1656,26.9,1698.3
4668545188,0,10,3,0,5,4,7,1,1,0,0,15875,6.6,17229,202,63,700,164,26.5,1587.5,19,0,1,4,5,3,0,0,0,0,15175,6.6,17065,195,51,-700,-164,24.6,1517.5
4668526051,0,12,2,1,7,8,5,0,0,0,0,16981,6.4,16750,199,46,-5,-316,24.5,1698.1,11,2,0,8,7,7,0,0,0,0,16986,6.8,17066,189,60,5,316,24.9,1698.6
4668490826,0,13,0,1,2,5,1,1,1,0,0,13174,6.6,16263,181,52,-4427,-3114,23.3,1317.4,15,3,0,5,2,6,0,0,0,0,17601,7.2,19377,210,72,4427,3114,28.2,1760.1
4848925984,1,2,0,1,2,1,0,0,0,0,0,11574,5.0,13219,129,0,468,-122,12.9,1157.4,0,0,0,1,2,1,0,0,0,0,11106,5.4,13341,111,0,-468,122,11.1,1110.6
4845505791,0,0,0,1,15,16,36,0,0,0,2,34793,10.0,33918,107,0,-1339,-4377,10.7,3479.3,9,0,0,16,15,46,0,0,0,0,36132,10.8,38295,98,0,1339,4377,9.8,3613.2
4845497271,1,0,0,0,15,17,34,0,0,0,2,34274,10.4,36330,97,0,-3076,-2871,9.7,3427.4,0,0,1,17,15,51,0,0,0,0,37350,10.6,39201,93,0,3076,2871,9.3,3735.0
4845491188,1,0,0,0,20,19,54,0,0,0,1,37622,11.0,40116,124,0,1694,1735,12.4,3762.2,16,0,1,19,20,46,0,0,0,0,35928,10.6,38381,97,0,-1694,-1735,9.7,3592.8
4845488819,1,0,0,0,14,18,39,0,0,0,1,33764,10.0,33874,94,0,-2796,-4786,9.4,3376.4,0,0,1,18,14,58,0,0,0,0,36560,11.0,38660,120,0,2796,4786,12.0,3656.0
4845484779,0,26,0,0,23,30,60,0,0,0,0,37714,11.4,42071,95,0,-2296,-3075,9.5,3771.4,6,22,1,30,23,74,0,0,0,0,40010,12.0,45146,106,0,2296,3075,10.6,4001.0
4845479822,0,3,0,1,21,32,44,0,0,0,1,36972,11.0,39962,112,0,-1877,-4157,11.2,3697.2,12,1,0,32,21,87,0,0,0,0,38849,12.0,44119,98,0,1877,4157,9.8,3884.9
4845441652,1,9,0,1,18,18,43,0,0,0,0,35868,10.8,38473,119,0,276,1161,11.9,3586.8,0,0,0,18,18,40,0,0,0,0,35592,10.6,37312,101,0,-276,-1161,10.1,3559.2
4845431015,1,0,0,1,31,35,94,0,0,0,2,39759,11.6,43812,96,0,-1277,1189,9.6,3975.9,0,0,0,35,31,105,0,0,0,0,41036,11.6,42623,100,0,1277,-1189,10.0,4103.6
4845417209,0,20,0,0,21,18,44,0,0,0,0,36712,11.2,39760,119,0,1001,1319,11.9,3671.2,0,20,1,18,21,59,0,0,0,0,35711,10.8,38441,102,0,-1001,-1319,10.2,3571.1
4845404860,1,0,0,1,27,22,64,0,0,0,1,38999,11.4,42210,110,0,3063,3054,11.0,3899.9,0,0,0,22,27,43,0,0,0,0,35936,11.2,39156,94,0,-3063,-3054,9.4,3593.6
4844535289,1,0,0,0,23,27,40,0,0,0,1,35834,11.0,39847,99,0,-3629,-4087,9.9,3583.4,6,0,1,26,22,58,0,0,0,0,39463,11.8,43934,111,0,3629,4087,11.1,3946.3
4844530857,0,13,0,0,21,31,38,0,0,0,0,36560,11.4,41663,100,0,-3458,-2012,10.0,3656.0,0,0,1,31,21,81,0,0,0,0,40018,11.6,43675,104,0,3458,2012,10.4,4001.8
4844513427,1,14,26,1,30,24,77,0,0,0,1,40404,11.8,44507,109,0,3107,3873,10.9,4040.4,27,3,0,24,30,64,0,0,0,0,37297,11.2,40634,104,0,-3107,-3873,10.4,3729.7
4844500563,1,0,2,1,19,20,53,0,0,0,1,38420,11.2,39888,123,0,3950,2565,12.3,3842.0,16,0,0,20,19,51,0,0,0,0,34470,10.6,37323,73,0,-3950,-2565,7.3,3447.0
4844498057,1,68,0,0,34,20,109,0,0,0,2,41941,12.0,45367,106,0,5616,4846,10.6,4194.1,0,0,1,20,34,57,0,0,0,0,36325,11.0,40521,84,0,-5616,-4846,8.4,3632.5
4842674026,1,18,0,0,16,19,43,0,0,0,1,34261,10.4,35229,91,0,-2525,-4817,9.1,3426.1,0,0,1,19,16,51,0,0,0,0,36786,11.0,40046,111,0,2525,4817,11.1,3678.6
4842598137,0,0,0,1,22,19,59,0,0,0,0,37492,11.0,39594,109,0,1408,1361,10.9,3749.2,0,0,0,19,22,52,0,0,0,0,36084,10.8,38233,106,0,-1408,-1361,10.6,3608.4
4842580146,1,3,0,1,31,17,66,0,0,0,1,38267,11.8,44562,116,0,3957,8025,11.6,3826.7,0,0,0,17,31,34,0,0,0,0,34310,10.6,36537,97,0,-3957,-8025,9.7,3431.0
4851133493,1,14,1,0,2,10,0,0,0,0,0,14435,6.6,16516,200,56,-3598,-3004,25.6,1443.5,25,2,1,10,2,8,1,1,0,0,18033,7.2,19520,217,72,3598,3004,28.9,1803.3
4844488566,0,19,0,1,5,10,1,0,0,0,0,13789,6.0,14469,145,40,-5396,-4525,18.5,1378.9,10,1,0,9,4,8,1,1,0,0,19185,7.2,18994,206,68,5396,4525,27.4,1918.5
4801049965,0,0,0,0,26,17,47,0,0,0,1,35653,11.0,39851,93,0,372,2886,9.3,3565.3,0,0,1,17,26,30,0,0,0,0,35281,10.6,36965,123,0,-372,-2886,12.3,3528.1
4796322577,0,0,0,1,32,28,87,0,0,0,0,40501,11.8,45886,102,0,1847,2763,10.2,4050.1,0,0,0,28,32,58,0,0,0,0,38654,11.4,43123,103,0,-1847,-2763,10.3,3865.4
4796315776,1,0,0,0,18,15,45,0,0,0,0,34641,10.6,36986,116,0,1049,470,11.6,3464.1,12,0,1,15,18,27,0,0,0,0,33592,10.6,36516,106,0,-1049,-470,10.6,3359.2
4795450933,0,46,0,0,4,4,4,0,0,0,0,14809,6.8,16931,169,48,-799,-1185,21.7,1480.9,7,1,1,4,4,3,0,0,0,0,15608,6.8,18116,188,52,799,1185,24.0,1560.8
4793918697,1,14,0,1,8,2,5,0,0,0,0,17715,7.2,18655,229,64,2368,981,29.3,1771.5,14,3,0,2,8,1,0,0,0,0,15347,6.8,17674,180,64,-2368,-981,24.4,1534.7
4792148915,0,11,0,0,2,6,2,0,0,0,0,14412,6.8,17741,199,58,-2876,-1545,25.7,1441.2,14,1,1,6,2,7,0,0,0,0,17288,7.0,19286,248,48,2876,1545,29.6,1728.8
4792087937,0,8,3,1,7,8,6,0,0,0,0,15842,6.6,16608,194,44,-1780,-919,23.8,1584.2,13,1,0,8,7,7,0,0,0,0,17622,6.8,17527,189,48,1780,919,23.7,1762.2
4791096523,1,30,0,0,4,5,2,0,0,0,0,16119,6.8,17733,219,44,291,1026,26.3,1611.9,284,2,1,5,4,4,0,0,0,0,15828,6.8,16707,202,44,-291,-1026,24.6,1582.8
4789994958,1,131,2,0,7,3,6,1,1,0,0,16186,7.0,16834,180,52,2293,79,23.2,1618.6,13,0,1,3,7,2,0,0,0,0,13893,6.8,16755,171,52,-2293,-79,22.3,1389.3
4789886627,1,10,0,1,8,3,8,0,0,0,0,17393,7.0,18772,170,48,2493,2273,21.8,1739.3,8,0,0,3,8,3,0,0,0,0,14900,6.8,16499,179,64,-2493,-2273,24.3,1490.0
4789854880,0,11,0,1,12,7,11,0,0,0,0,18613,6.8,18264,166,48,2986,2117,21.4,1861.3,9,1,0,7,12,5,0,0,0,0,15627,6.4,16147,185,28,-2986,-2117,21.3,1562.7
4789790725,1,11,1,0,5,3,3,0,0,0,0,16880,6.8,17622,197,48,2345,-1016,24.5,1688.0,14,1,1,3,5,5,0,0,0,0,14535,7.2,18638,171,76,-2345,1016,24.7,1453.5
4789512924,0,11,0,0,4,3,4,0,0,0,0,15283,6.6,17068,162,52,-329,201,21.4,1528.3,13,1,1,3,4,0,1,1,0,0,15612,6.8,16867,202,44,329,-201,24.6,1561.2
4789483465,0,15,0,1,6,4,5,0,0,0,0,17328,7.0,17995,184,56,623,150,24.0,1732.8,9,2,0,4,6,4,1,1,0,0,16705,7.0,17845,212,60,-623,-150,27.2,1670.5
4787117765,0,9,1,1,5,6,2,0,0,0,0,15185,6.6,16837,179,52,-1367,-968,23.1,1518.5,72,2,0,6,5,6,0,0,0,0,16552,7.0,17805,210,48,1367,968,25.8,1655.2
4785806665,0,13,1,0,7,10,5,0,0,0,0,16739,6.4,17204,189,48,-2427,-522,23.7,1673.9,11,1,1,10,7,11,0,0,0,0,19166,6.8,17726,178,52,2427,522,23.0,1916.6
4776134588,1,0,0,1,38,27,96,0,0,0,1,41528,12.0,46831,93,0,3838,5314,9.3,4152.8,0,0,0,27,38,51,0,0,0,0,37690,11.2,41517,100,0,-3838,-5314,10.0,3769.0
4740099777,0,7,2,1,8,8,9,0,0,0,0,17289,7.0,16867,186,44,-945,-731,23.0,1728.9,11,1,0,8,8,6,1,1,0,0,18234,6.8,17598,222,52,945,731,27.4,1823.4
4851140043,0,15,0,0,3,10,1,1,1,0,0,14519,6.8,16491,161,60,-4597,-2431,22.1,1451.9,45,4,1,10,3,9,0,0,0,0,19116,7.2,18922,214,44,4597,2431,25.8,1911.6
4851117887,1,11,1,1,8,7,3,0,0,0,0,17464,7.0,17856,202,64,-188,-107,26.6,1746.4,10,0,0,7,8,8,0,0,0,0,17652,7.0,17963,192,40,188,107,23.2,1765.2
4849076690,1,103,2,1,11,5,11,0,0,0,0,18749,7.0,18135,218,40,3275,1121,25.8,1874.9,16,4,0,5,11,7,0,0,0,0,15474,6.6,17014,207,27,-3275,-1121,23.4,1547.4
4848657339,1,13,2,1,9,4,16,1,1,0,0,17855,6.8,18074,225,43,3738,1876,26.8,1785.5,13,2,0,4,9,2,0,0,0,0,14117,6.6,16198,168,44,-3738,-1876,21.2,1411.7
4848430438,1,10,0,0,2,8,4,0,0,0,0,14875,6.6,16747,164,52,-2827,-2904,21.6,1487.5,9,0,1,8,2,4,0,0,0,0,17702,7.2,19651,219,68,2827,2904,28.7,1770.2
4848310818,1,27,2,1,3,0,3,0,0,0,0,15348,6.8,18046,224,48,2319,605,27.2,1534.8,22,2,0,0,3,0,0,0,0,0,13029,6.8,17441,222,44,-2319,-605,26.6,1302.9
4847345412,0,12,2,0,3,5,3,0,0,0,0,15944,6.4,16822,147,57,-20,-237,20.4,1594.4,12,0,1,5,3,5,1,1,0,0,15964,7.0,17059,175,58,20,237,23.3,1596.4
4847330490,1,28,0,1,2,5,2,1,0,1,0,14575,6.6,16688,188,49,-2609,-1504,23.7,1457.5,13,17,0,5,2,6,1,1,0,0,17184,7.2,18192,209,60,2609,1504,26.9,1718.4
4847313081,1,14,2,1,7,5,7,0,0,0,0,17228,6.8,18531,187,46,1129,1849,23.3,1722.8,13,0,0,5,7,2,0,0,0,0,16099,6.6,16682,193,49,-1129,-1849,24.2,1609.9
4830801963,1,12,1,1,13,14,25,0,0,0,0,34121,11.6,41358,80,67,-481,-1951,14.7,3412.1,22,0,0,14,13,18,0,0,0,0,34602,11.4,43309,94,67,481,1951,16.1,3460.2
4830777466,1,23,0,0,12,15,34,0,0,0,1,37154,11.4,41657,111,63,2297,4065,17.4,3715.4,16,0,1,15,12,42,0,0,0,0,34857,10.8,37592,81,67,-2297,-4065,14.8,3485.7
4829925675,1,10,0,0,11,15,26,0,0,0,1,31150,10.6,36838,83,55,-3518,-2677,13.8,3115.0,15,0,1,15,11,38,0,0,0,0,34668,11.0,39515,79,58,3518,2677,13.7,3466.8
4826513885,1,14,1,1,15,8,33,0,0,0,0,35596,10.8,38376,103,56,3259,526,15.9,3559.6,8,0,0,8,15,11,0,0,0,0,32337,10.8,37850,91,60,-3259,-526,15.1,3233.7
4826483387,1,18,0,0,10,12,16,0,0,0,0,30359,10.4,35638,86,51,-2193,-552,13.7,3035.9,36,0,1,12,10,26,0,0,0,0,32552,10.4,36190,73,59,2193,552,13.2,3255.2
4826458468,1,13,0,1,15,10,24,0,0,0,0,32993,10.6,37887,102,55,-1238,-1476,15.7,3299.3,18,0,0,10,15,18,0,0,0,0,34231,11.2,39363,69,71,1238,1476,14.0,3423.1
4826440819,0,7,0,1,22,12,53,0,0,0,1,36139,11.4,41042,81,68,-3458,-2969,14.9,3613.9,10,0,0,12,22,26,0,0,0,0,39597,11.6,44011,103,47,3458,2969,15.0,3959.7
4826410671,0,13,0,0,2,12,4,0,0,0,0,28071,10.8,37795,75,67,-6291,-5396,14.2,2807.1,11,0,1,12,2,34,0,0,0,0,34362,11.6,43191,107,67,6291,5396,17.4,3436.2
4824168095,1,47,2,0,22,21,57,0,0,0,0,31965,10.4,36210,77,45,-1208,-7,12.2,3196.5,43,0,1,20,21,36,0,0,0,0,33173,10.6,36217,80,49,1208,7,12.9,3317.3
4853994647,1,12,1,1,9,5,17,0,0,0,0,17898,6.8,17015,193,52,2145,1022,24.5,1789.8,10,0,0,5,9,8,1,1,0,0,15753,6.4,15993,180,62,-2145,-1022,24.2,1575.3
4853947118,0,64,2,0,5,6,2,0,0,0,0,15486,6.8,18323,201,51,-1950,269,25.2,1548.6,23,0,1,6,5,7,1,1,0,0,17436,6.8,18054,228,64,1950,-269,29.2,1743.6
4853894844,1,11,1,0,5,4,1,0,0,0,0,17669,7.2,19462,220,64,2377,2381,28.4,1766.9,10,1,1,4,5,3,0,0,0,0,15292,6.6,17081,211,56,-2377,-2381,26.7,1529.2
4853792852,1,52,1,0,6,3,6,0,0,0,0,15112,6.6,16447,195,52,-543,-2145,24.7,1511.2,12,1,1,3,6,1,0,0,0,0,15655,7.2,18592,223,68,543,2145,29.1,1565.5
4853762304,1,12,1,1,9,4,2,0,0,0,1,18596,7.2,19328,226,64,3760,1485,29.0,1859.6,20,0,0,4,9,2,0,0,0,0,14836,6.8,17843,180,64,-3760,-1485,24.4,1483.6
4847885153,0,12,0,1,5,7,2,2,1,1,0,16607,7.0,18756,183,60,-577,1530,24.3,1660.7,10,0,0,7,5,11,0,0,0,0,17184,6.8,17226,216,52,577,-1530,26.8,1718.4
4847723687,0,10,2,0,7,7,8,0,0,0,0,15404,6.2,15632,171,40,-1348,-480,21.1,1540.4,14,1,1,7,7,10,1,1,0,0,16752,6.8,16112,168,46,1348,480,21.4,1675.2
4847688680,0,12,2,0,1,1,1,0,0,0,0,13822,6.8,17907,213,60,-1793,-8,27.3,1382.2,9,1,1,1,1,1,0,0,0,0,15615,6.8,17915,211,56,1793,8,26.7,1561.5
4847656687,1,17,1,0,5,3,3,1,1,0,0,15698,7.0,17907,216,52,1346,861,26.8,1569.8,15,2,1,3,5,3,0,0,0,0,14352,6.6,17046,184,63,-1346,-861,24.7,1435.2
4847637156,0,11,4,0,7,8,7,1,1,0,0,17245,7.2,18268,206,68,-288,965,27.4,1724.5,13,3,1,8,7,8,0,0,0,0,17533,6.8,17303,205,48,288,-965,25.3,1753.3
4847599330,1,7,3,0,2,4,4,0,0,0,0,14666,7.0,17418,206,44,-1081,60,25.0,1466.6,12,0,1,4,2,5,0,0,0,0,15747,7.0,17358,195,48,1081,-60,24.3,1574.7
4847565915,0,12,0,0,3,3,2,0,0,0,0,13916,7.0,17354,178,52,-1732,-894,23.0,1391.6,8,1,1,3,3,4,0,0,0,0,15648,6.8,18248,207,76,1732,894,28.3,1564.8
4847524499,1,75,2,0,5,8,4,0,0,0,0,16253,6.6,16272,177,52,244,-144,22.9,1625.3,13,3,1,8,5,6,0,0,0,0,16009,6.6,16416,178,44,-244,144,22.2,1600.9
4847011464,1,12,2,0,6,5,6,1,1,0,0,16587,6.8,17708,190,52,958,650,24.2,1658.7,78,1,1,5,6,5,0,0,0,0,15629,6.8,17058,164,48,-958,-650,21.2,1562.9
4846987921,0,12,3,0,4,5,9,0,0,0,0,15868,6.8,17874,208,60,-699,-426,26.8,1586.8,8,3,1,5,4,8,1,1,0,0,16567,6.8,18300,229,68,699,426,29.7,1656.7
4846948479,0,11,0,0,2,5,3,0,0,0,0,15043,7.0,17735,213,48,-1520,-1204,26.1,1504.3,5,1,1,5,2,5,1,1,0,0,16563,7.2,18939,218,52,1520,1204,27.0,1656.3
4846881595,0,12,0,1,10,5,5,0,0,0,0,17381,7.0,18063,218,60,1096,1324,27.8,1738.1,13,0,0,4,9,5,1,1,0,0,16285,6.8,16739,187,40,-1096,-1324,22.7,1628.5
4846845852,0,82,0,1,6,4,3,1,0,1,0,18943,6.8,18341,211,62,2822,1094,27.3,1894.3,14,0,0,4,6,5,1,1,0,0,16121,6.8,17247,202,50,-2822,-1094,25.2,1612.1
4846813846,0,11,0,0,0,9,0,0,0,0,0,14376,6.8,16823,200,52,-4927,-2858,25.2,1437.6,11,0,1,9,0,10,1,1,0,0,19303,7.2,19681,219,58,4927,2858,27.7,1930.3
4856874253,0,3,0,0,20,27,49,0,0,0,0,36172,11.2,41060,108,0,-1227,-434,10.8,3617.2,0,0,1,27,20,74,0,0,0,0,37399,11.6,41494,84,0,1227,434,8.4,3739.9
4856855208,1,4,0,1,15,24,14,0,0,0,0,59909,12.8,59000,0,0,22009,26000,0.0,5990.9,5,0,0,13,4,17,0,0,0,0,37900,7.2,33000,0,0,-22009,-26000,0.0,3790.0
4856843350,1,1,0,0,19,24,23,0,0,0,0,62700,12.8,61000,0,0,24100,25000,0.0,6270.0,39,0,1,15,10,13,0,0,0,0,38600,7.6,36000,0,0,-24100,-25000,0.0,3860.0
4856798175,0,11,2,1,9,6,11,0,0,0,0,17920,7.0,18026,209,48,1985,1822,25.7,1792.0,12,1,0,6,9,4,1,1,0,0,15935,6.6,16204,158,56,-1985,-1822,21.4,1593.5
4856761828,0,0,0,1,30,23,67,0,0,0,0,38154,11.6,43599,101,0,-237,393,10.1,3815.4,0,0,0,23,30,63,0,0,0,0,38391,11.4,43206,96,0,237,-393,9.6,3839.1
4856744546,0,0,0,0,33,30,89,0,0,0,1,41218,11.6,45598,100,0,3109,3234,10.0,4121.8,0,0,1,30,33,71,0,0,0,0,38109,11.2,42364,76,0,-3109,-3234,7.6,3810.9
4856723692,1,0,0,0,23,20,50,0,0,0,1,37726,11.2,40916,121,0,2007,2910,12.1,3772.6,1,0,1,20,23,48,0,0,0,0,35719,10.6,38006,105,0,-2007,-2910,10.5,3571.9
4855900043,0,12,0,1,13,17,29,0,0,0,0,32389,10.0,34624,83,0,-2945,-4510,8.3,3238.9,6,2,0,17,13,49,0,0,0,0,35334,10.8,39134,116,0,2945,4510,11.6,3533.4
4855860220,1,8,0,0,28,29,79,0,0,0,0,39318,11.6,43795,93,0,-174,-1088,9.3,3931.8,0,3,1,29,28,74,0,0,0,0,39492,12.0,44883,118,0,174,1088,11.8,3949.2
4855641782,1,0,0,1,22,16,21,0,0,0,0,62000,12.0,55000,0,0,25500,22000,0.0,6200.0,0,0,0,6,12,9,0,0,0,0,36500,7.2,33000,0,0,-25500,-22000,0.0,3650.0
4855619112,1,15,0,1,21,16,48,0,0,0,0,35980,11.0,38816,110,0,1379,2048,11.0,3598.0,14,1,0,16,21,25,0,0,0,0,34601,10.6,36768,110,0,-1379,-2048,11.0,3460.1
4855610424,1,68,8,1,20,20,17,0,0,0,0,62865,12.0,55000,5,0,22850,22000,0.5,6286.5,0,3,0,13,13,16,0,0,0,0,40015,7.2,33000,0,0,-22850,-22000,0.0,4001.5
4855605523,1,27,0,1,11,21,15,0,0,0,0,46008,10.0,47500,0,0,16714,19000,0.0,4600.8,4,0,0,16,6,13,0,0,0,0,29294,6.0,28500,0,0,-16714,-19000,0.0,2929.4
4855602195,1,0,0,1,19,13,18,0,0,0,0,63134,12.0,55000,0,0,26930,22000,0.0,6313.4,10,0,0,8,14,6,0,0,0,0,36204,7.2,33000,0,0,-26930,-22000,0.0,3620.4
4855596286,1,53,0,0,18,22,15,0,0,0,0,63400,13.0,62500,0,0,24094,25000,0.0,6340.0,0,0,1,13,9,15,0,0,0,0,39306,7.8,37500,0,0,-24094,-25000,0.0,3930.6
4854769784,0,0,0,1,26,24,56,0,0,0,1,38135,11.6,42742,105,0,232,2135,10.5,3813.5,0,0,0,24,26,53,0,0,0,0,37903,11.0,40607,89,0,-232,-2135,8.9,3790.3
4854711357,0,10,1,1,4,1,2,0,0,0,0,17098,7.2,18453,216,60,3113,1344,27.6,1709.8,17,0,0,1,4,1,1,1,0,0,13985,7.0,17109,187,60,-3113,-1344,24.7,1398.5
4854678803,1,0,20,1,20,7,61,0,0,0,0,35004,10.8,36780,110,0,2034,1408,11.0,3500.4,19,0,0,7,20,18,0,0,0,0,32970,10.0,35372,110,0,-2034,-1408,11.0,3297.0
4854630434,1,22,0,1,13,14,21,0,0,0,0,63198,12.0,55000,2,0,27748,22000,0.2,6319.8,24,0,0,10,9,4,0,0,0,0,35450,7.2,33000,0,0,-27748,-22000,0.0,3545.0
4854608769,1,5,0,1,12,20,12,0,0,0,0,60250,12.0,55000,3,0,22000,22000,0.3,6025.0,0,0,0,15,7,13,0,0,0,0,38250,7.2,33000,8,0,-22000,-22000,0.8,3825.0
4847560753,1,19,2,0,7,4,4,0,0,0,0,16874,6.8,17857,212,44,1232,0,25.6,1687.4,15,0,1,4,7,0,0,0,0,0,15642,7.0,17857,205,40,-1232,0,24.5,1564.2
4847542883,0,12,1,0,3,10,1,0,0,0,0,14731,6.8,17133,210,52,-5172,-2530,26.2,1473.1,16,2,1,10,3,12,1,1,0,0,19903,7.4,19663,240,48,5172,2530,28.8,1990.3
4845145157,0,109,1,1,6,4,2,0,0,0,0,16219,7.2,19260,252,61,-30,1225,31.3,1621.9,9,1,0,4,6,4,0,0,0,0,16249,7.0,18035,240,56,30,-1225,29.6,1624.9
4845082893,0,13,0,0,2,4,1,0,0,0,0,14454,7.0,18615,198,60,-1741,-209,25.8,1445.4,11,1,1,4,2,4,0,0,0,0,16195,7.0,18824,219,60,1741,209,27.9,1619.5
4845009562,0,9,5,0,13,9,11,0,0,0,0,20028,7.0,18925,223,52,1593,2487,27.5,2002.8,16,1,1,9,13,16,0,0,0,0,18435,6.6,16438,203,56,-1593,-2487,25.9,1843.5
4824816234,0,17,0,1,8,6,8,0,0,0,0,16775,6.6,16853,163,48,-919,-1120,21.1,1677.5,137,1,0,6,8,3,1,1,0,0,17694,6.8,17973,223,48,919,1120,27.1,1769.4
4824756473,1,14,2,0,5,5,4,0,0,0,0,16797,7.0,18201,178,62,1066,1912,24.0,1679.7,78,1,1,5,5,6,1,1,0,0,15731,6.4,16289,204,40,-1066,-1912,24.4,1573.1
4824716011,1,9,2,0,9,7,1,0,0,0,0,16704,6.8,18202,187,52,-15,98,23.9,1670.4,11,0,1,7,9,5,0,0,0,0,16719,6.8,18104,181,60,15,-98,24.1,1671.9
4824663549,0,20,15,0,5,9,6,0,0,0,0,15084,6.6,16481,165,44,-3947,-1002,20.9,1508.4,36,0,1,9,5,10,0,0,0,0,19031,6.8,17483,178,56,3947,1002,23.4,1903.1
4823585045,1,13,0,1,6,5,6,0,0,0,0,16146,7.0,17890,196,52,544,-569,24.8,1614.6,12,1,0,5,6,3,0,0,0,0,15602,7.0,18459,194,52,-544,569,24.6,1560.2
4818061918,1,58,3,0,9,4,3,0,0,0,0,16265,7.2,18778,174,44,1416,1614,21.8,1626.5,13,1,1,4,9,2,1,1,0,0,14849,6.8,17164,200,67,-1416,-1614,26.7,1484.9
4813090390,0,11,2,0,8,10,7,0,0,0,0,16862,6.8,17071,184,40,-889,679,22.4,1686.2,14,2,1,10,8,11,0,0,0,0,17751,6.4,16392,201,51,889,-679,25.2,1775.1
4812981553,1,11,0,1,13,9,28,0,0,0,0,32921,10.6,38276,104,51,2107,267,15.5,3292.1,10,0,0,9,13,16,0,0,0,0,30814,10.8,38009,90,66,-2107,-267,15.6,3081.4
4812961025,0,10,0,0,7,13,3,0,0,0,0,15860,6.8,17668,185,40,-3769,-2033,22.5,1586.0,12,1,1,12,6,5,1,1,0,0,19629,7.2,19701,223,72,3769,2033,29.5,1962.9
4812917531,0,14,2,0,3,3,3,0,0,0,0,15290,6.6,16558,177,48,-33,-1393,22.5,1529.0,23,3,1,3,3,2,0,0,0,0,15323,7.0,17951,208,56,33,1393,26.4,1532.3
4812901049,0,14,1,0,2,8,4,0,0,0,0,14388,6.6,17109,203,52,-2728,-1524,25.5,1438.8,23,1,1,8,2,7,1,1,0,0,17116,7.2,18633,238,60,2728,1524,29.8,1711.6
4812859275,1,12,0,0,7,9,8,0,0,0,0,19166,7.2,18738,207,51,123,509,25.8,1916.6,19,1,1,9,7,7,0,0,0,0,19043,6.8,18229,225,47,-123,-509,27.2,1904.3
4811316556,1,8,0,1,28,16,65,0,0,0,1,40148,11.8,45059,98,55,7268,6925,15.3,4014.8,247,0,0,16,28,31,0,0,0,0,32880,10.8,38134,88,63,-7268,-6925,15.1,3288.0
4811283722,0,9,1,0,7,14,9,0,0,0,1,31737,10.6,36826,95,54,-1848,-1197,14.9,3173.7,13,0,1,14,7,18,0,0,0,0,33585,10.6,38023,109,56,1848,1197,16.5,3358.5
4811254957,1,10,0,0,13,17,25,0,0,0,0,35723,10.8,38785,113,64,-2828,-2173,17.7,3572.3,12,1,1,16,12,34,0,0,0,0,38551,11.4,40958,94,72,2828,2173,16.6,3855.1
4854819599,1,11,2,0,5,6,4,0,0,0,0,16677,6.8,17457,199,38,1098,120,23.7,1667.7,12,0,1,6,5,4,0,0,0,0,15579,6.8,17337,170,48,-1098,-120,21.8,1557.9
4854794898,1,39,1,1,6,1,3,0,0,0,0,16004,6.8,18353,199,53,1404,876,25.2,1600.4,9,0,0,1,6,0,2,1,1,0,14600,6.8,17477,194,56,-1404,-876,25.0,1460.0
4854762924,0,19,0,0,3,5,2,0,0,0,0,14315,6.8,16694,204,48,-1232,-1457,25.2,1431.5,30,0,1,5,3,8,1,1,0,0,15547,7.0,18151,180,48,1232,1457,22.8,1554.7
4854731354,0,11,0,0,1,5,0,0,0,0,0,13731,6.6,16477,181,44,-3211,-2493,22.5,1373.1,13,0,1,5,1,2,0,0,0,0,16942,7.2,18970,205,60,3211,2493,26.5,1694.2
4854708226,0,15,1,0,4,5,5,1,0,1,0,14490,6.2,15953,151,44,-2585,-2135,19.5,1449.0,10,3,1,5,4,7,0,0,0,0,17075,7.0,18088,219,44,2585,2135,26.3,1707.5
4854665494,0,13,2,1,6,2,8,1,1,0,0,16989,7.2,18605,202,60,1297,787,26.2,1698.9,25,2,0,2,6,3,1,0,1,0,15692,7.0,17818,217,40,-1297,-787,25.7,1569.2
4854587293,0,36,2,0,7,3,7,0,0,0,0,16535,6.8,17089,160,52,2020,892,21.2,1653.5,39,0,1,2,6,2,0,0,0,0,14515,6.4,16197,149,44,-2020,-892,19.3,1451.5
4851718000,1,152,0,1,10,4,9,0,0,0,0,17213,7.0,18677,190,56,2544,2899,24.6,1721.3,8,0,0,4,10,3,0,0,0,0,14669,6.2,15778,124,52,-2544,-2899,17.6,1466.9
4849225495,1,13,0,0,8,5,4,1,1,0,0,16919,7.2,19263,191,72,176,2517,26.3,1691.9,8,1,1,5,8,5,0,0,0,0,16743,6.8,16746,188,44,-176,-2517,23.2,1674.3
4849194187,0,17,0,0,2,3,2,0,0,0,0,15041,6.6,17525,191,60,-489,-329,25.1,1504.1,10,2,1,3,2,2,0,0,0,0,15530,6.8,17854,206,60,489,329,26.6,1553.0
4849149328,1,44,0,0,4,8,4,0,0,0,0,14761,6.4,16279,180,40,-2006,-2121,22.0,1476.1,16,11,1,8,4,6,0,0,0,0,16767,7.0,18400,199,52,2006,2121,25.1,1676.7
4849110835,0,46,1,1,5,3,2,1,1,0,0,15499,6.6,18017,176,53,-825,271,22.9,1549.9,12,1,0,3,5,6,0,0,0,0,16324,7.0,17746,186,66,825,-271,25.2,1632.4
4848676012,0,14,1,0,1,9,0,1,1,0,0,12497,6.0,14131,132,56,-4695,-2193,18.8,1249.7,24,1,1,9,1,8,0,0,0,0,17192,6.6,16324,174,45,4695,2193,21.9,1719.2
4848635765,1,13,1,0,5,5,2,0,0,0,0,15408,6.8,18001,190,48,594,557,23.8,1540.8,15,0,1,5,5,2,0,0,0,0,14814,6.8,17444,160,56,-594,-557,21.6,1481.4
4847787713,0,17,2,0,3,3,2,0,0,0,0,15072,6.8,17998,192,56,792,1316,24.8,1507.2,15,2,1,3,3,2,0,0,0,0,14280,6.6,16682,176,44,-792,-1316,22.0,1428.0
4847764164,1,16,1,1,6,4,0,0,0,0,0,15644,7.0,18344,193,60,1756,932,25.3,1564.4,11,3,0,3,5,1,0,0,0,0,13888,6.8,17412,197,44,-1756,-932,24.1,1388.8
4847551472,0,10,1,0,5,4,2,0,0,0,0,14686,6.8,16763,164,44,-533,-248,20.8,1468.6,8,1,1,4,5,3,0,0,0,0,15219,6.6,17011,202,52,533,248,25.4,1521.9
4847522442,1,10,0,0,5,8,4,0,0,0,0,14949,6.4,16171,160,48,-1442,-1255,20.8,1494.9,13,0,1,8,5,3,1,1,0,0,16391,6.6,17426,190,56,1442,1255,24.6,1639.1
4847083982,1,26,0,1,10,4,6,0,0,0,0,17349,6.6,17631,167,60,2833,1049,22.7,1734.9,10,10,0,4,10,3,1,1,0,0,14516,6.8,16582,175,44,-2833,-1049,21.9,1451.6
4847027677,1,55,2,1,6,1,2,1,1,0,0,15481,6.8,18538,170,52,2316,1879,22.2,1548.1,15,1,0,1,6,1,0,0,0,0,13165,6.8,16659,172,64,-2316,-1879,23.6,1316.5
4854255184,0,10,1,1,4,5,3,0,0,0,0,15592,7.2,18338,192,64,592,927,25.6,1559.2,12,0,0,5,4,2,1,1,0,0,15000,6.8,17411,186,52,-592,-927,23.8,1500.0
4854207158,0,10,1,0,8,3,6,0,0,0,0,16157,6.8,17490,167,44,1093,-369,21.1,1615.7,13,1,1,3,8,0,0,0,0,0,15064,6.8,17859,209,72,-1093,369,28.1,1506.4
4854158722,0,14,0,1,3,7,3,1,1,0,0,13898,6.4,15627,150,52,-4960,-4232,20.2,1389.8,15,1,0,7,3,7,0,0,0,0,18858,7.2,19859,205,64,4960,4232,26.9,1885.8
4854110405,0,11,1,0,7,5,6,0,0,0,0,15156,6.4,16011,129,52,-1204,-1768,18.1,1515.6,23,1,1,5,7,1,0,0,0,0,16360,7.0,17779,189,48,1204,1768,23.7,1636.0
4852340818,1,31,1,1,8,6,8,1,1,0,0,17612,6.8,18029,214,36,1293,-107,25.0,1761.2,10,16,0,6,8,3,0,0,0,0,16319,6.8,18136,181,44,-1293,107,22.5,1631.9
4852322952,1,205,2,0,8,2,7,0,0,0,0,17961,7.0,18669,203,44,3503,2543,24.7,1796.1,15,2,1,2,8,3,0,0,0,0,14458,6.4,16126,176,36,-3503,-2543,21.2,1445.8
4848088837,1,33,3,1,6,6,5,0,0,0,0,16769,7.0,18245,179,64,1296,1904,24.3,1676.9,119,1,0,6,6,7,1,1,0,0,15473,6.4,16341,153,56,-1296,-1904,20.9,1547.3
4847161015,0,14,1,0,3,5,2,0,0,0,0,14561,7.0,17510,168,64,-2177,-1354,23.2,1456.1,8,1,1,5,3,2,0,0,0,0,16738,7.0,18864,232,60,2177,1354,29.2,1673.8
4847137913,1,11,0,0,7,3,4,0,0,0,0,15485,7.0,18225,198,36,-132,566,23.4,1548.5,10,1,1,3,7,2,1,1,0,0,15617,7.0,17659,205,60,132,-566,26.5,1561.7
4834350832,0,10,2,0,4,10,1,0,0,0,0,16396,7.2,18799,199,52,-1702,1337,25.1,1639.6,14,1,1,10,4,8,1,1,0,0,18098,6.8,17462,152,60,1702,-1337,21.2,1809.8
4832406353,1,8,0,1,9,6,8,1,1,0,0,18619,7.2,19358,198,64,3750,1939,26.2,1861.9,9,0,0,6,9,4,0,0,0,0,14869,7.0,17419,141,63,-3750,-1939,20.4,1486.9
4832375563,0,15,1,1,8,6,8,1,1,0,0,19042,7.2,18534,173,52,3456,1516,22.5,1904.2,8,1,0,6,8,4,0,0,0,0,15586,6.6,17018,207,40,-3456,-1516,24.7,1558.6
4832350162,1,52,1,1,5,3,3,0,0,0,0,16540,7.0,17979,215,40,2390,1447,25.5,1654.0,11,0,0,3,5,2,0,0,0,0,14150,6.6,16532,168,40,-2390,-1447,20.8,1415.0
4826991106,1,15,2,1,6,4,0,0,0,0,0,15646,7.2,18913,226,60,-812,139,28.6,1564.6,73,1,0,4,6,2,0,0,0,0,16458,7.0,18774,211,56,812,-139,26.7,1645.8
4826977195,1,12,0,1,12,6,4,0,0,0,0,17935,7.0,18555,179,60,2953,2014,23.9,1793.5,11,0,0,6,12,3,0,0,0,0,14982,6.6,16541,170,32,-2953,-2014,20.2,1498.2
4826950193,0,13,0,1,4,2,3,1,1,0,0,14441,6.8,17318,173,52,-757,-542,22.5,1444.1,9,3,0,2,4,2,0,0,0,0,15198,6.8,17860,215,60,757,542,27.5,1519.8
4826918622,1,15,0,0,5,7,1,1,1,0,0,15597,7.0,18229,194,47,250,2159,24.1,1559.7,11,1,1,7,5,4,1,0,1,0,15347,6.6,16070,153,46,-250,-2159,19.9,1534.7
4825027753,1,13,2,0,7,3,7,0,0,0,0,18488,6.8,18312,207,48,4119,2007,25.5,1848.8,13,2,1,3,7,2,0,0,0,0,14369,6.6,16305,162,48,-4119,-2007,21.0,1436.9
4855989684,1,33,1,0,8,6,4,0,0,0,0,17428,7.2,19681,214,68,1518,1844,28.2,1742.8,19,13,1,6,8,7,0,0,0,0,15910,6.8,17837,200,48,-1518,-1844,24.8,1591.0
4854283480,0,14,1,1,3,3,2,0,0,0,0,15380,7.0,17708,196,63,151,-1085,25.9,1538.0,17,1,0,3,3,2,0,0,0,0,15229,7.2,18793,216,72,-151,1085,28.8,1522.9
4854254348,0,14,0,0,5,9,4,0,0,0,0,16203,6.6,17203,178,40,-2475,-1121,21.8,1620.3,102,0,1,9,5,7,0,0,0,0,18678,7.2,18324,232,52,2475,1121,28.4,1867.8
4854208387,1,222,1,0,13,6,10,0,0,0,0,18141,7.0,17878,196,35,1222,1831,23.1,1814.1,14,0,1,6,13,6,0,0,0,0,16919,6.6,16047,186,46,-1222,-1831,23.2,1691.9
4854137549,1,7,0,1,4,6,0,0,0,0,0,15218,6.8,17441,190,64,-169,636,25.4,1521.8,15,0,0,6,4,6,0,0,0,0,15387,6.6,16805,174,48,169,-636,22.2,1538.7
4854049312,0,15,0,0,2,3,2,1,0,1,0,14797,7.0,18151,207,52,353,624,25.9,1479.7,9,1,1,3,2,2,0,0,0,0,14444,6.8,17527,202,51,-353,-624,25.3,1444.4
4853953531,1,0,0,1,21,21,42,0,0,0,1,37481,11.2,40236,116,0,1682,861,11.6,3748.1,1,0,0,21,21,41,0,0,0,0,35799,11.0,39375,76,0,-1682,-861,7.6,3579.9
4853937967,1,0,0,0,38,27,90,0,0,0,1,43501,12.0,47413,109,0,5429,7475,10.9,4350.1,6,0,1,27,38,78,0,0,0,0,38072,11.2,39938,73,0,-5429,-7475,7.3,3807.2
4853913886,1,0,0,0,28,25,57,0,0,0,1,38071,11.4,41553,109,0,292,723,10.9,3807.1,0,0,1,25,28,60,0,0,0,0,37779,11.0,40830,101,0,-292,-723,10.1,3777.9
4849269396,0,8,0,1,5,2,3,0,0,0,0,15378,6.8,17754,221,47,469,1044,26.8,1537.8,19,1,0,2,5,2,0,0,0,0,14909,6.4,16710,211,56,-469,-1044,26.7,1490.9
4849254806,1,11,1,1,8,6,6,0,0,0,0,17994,6.8,17301,228,40,1609,512,26.8,1799.4,18,2,0,6,8,5,0,0,0,0,16385,6.6,16789,180,48,-1609,-512,22.8,1638.5
4849225359,1,7,2,1,7,6,6,0,0,0,0,16643,6.6,17967,189,48,619,1571,23.7,1664.3,12,0,0,5,6,3,0,0,0,0,16024,6.6,16396,172,52,-619,-1571,22.4,1602.4
4849184400,0,16,0,0,4,7,4,0,0,0,0,15447,6.8,17736,179,64,-1589,-683,24.3,1544.7,12,0,1,7,4,6,0,0,0,0,17036,6.8,18419,216,59,1589,683,27.5,1703.6
4847467685,0,0,0,0,10,28,23,0,0,0,2,32300,10.0,32847,91,0,-7826,-9186,9.1,3230.0,87,0,1,28,10,68,0,0,0,0,40126,11.2,42033,105,0,7826,9186,10.5,4012.6
4847460781,1,0,0,0,23,16,47,0,0,0,2,37168,11.2,41147,111,0,241,1895,11.1,3716.8,0,0,1,16,23,34,0,0,0,0,36927,10.8,39252,97,0,-241,-1895,9.7,3692.7
4847443978,0,0,0,1,30,21,74,0,0,0,0,39001,11.2,41841,107,0,1583,1495,10.7,3900.1,0,0,0,21,30,46,0,0,0,0,37418,11.0,40346,96,0,-1583,-1495,9.6,3741.8
4846086024,0,13,0,0,0,3,0,0,0,0,0,13863,6.6,16892,200,52,-2493,-1595,25.2,1386.3,5,1,1,3,0,3,0,0,0,0,16356,7.0,18487,188,59,2493,1595,24.7,1635.6
4846059413,1,14,0,1,9,2,7,0,0,0,0,17332,7.0,18812,211,64,2848,1284,27.5,1733.2,15,1,0,2,9,1,0,0,0,0,14484,7.0,17528,187,72,-2848,-1284,25.9,1448.4
4846011256,1,19,0,1,2,3,2,0,0,0,0,14649,6.8,17953,211,57,-147,331,26.8,1464.9,13,0,0,3,2,2,0,0,0,0,14796,6.8,17622,205,55,147,-331,26.0,1479.6
4845959399,0,12,2,0,1,6,1,0,0,0,0,14607,6.6,16265,166,48,-4662,-2352,21.4,1460.7,10,0,1,6,1,11,2,1,1,0,19269,7.2,18617,227,64,4662,2352,29.1,1926.9
4852708859,0,103,3,0,8,6,4,0,0,0,0,16945,7.0,18744,183,71,-899,576,25.4,1694.5,15,1,1,6,8,7,1,1,0,0,17844,6.8,18168,242,56,899,-576,29.8,1784.4
4852288828,0,10,1,0,3,5,3,0,0,0,0,15225,6.8,18692,220,56,-1578,-1078,27.6,1522.5,13,0,1,5,3,1,1,1,0,0,16803,7.4,19770,227,63,1578,1078,29.0,1680.3
4852260025,1,25,2,0,7,9,7,0,0,0,0,17695,6.8,17983,223,48,719,622,27.1,1769.5,11,11,1,9,7,8,0,0,0,0,16976,6.8,17361,181,44,-719,-622,22.5,1697.6
4851781288,0,18,3,1,5,5,8,0,0,0,0,15537,6.2,15992,200,48,-256,-1988,24.8,1553.7,21,3,0,5,5,3,1,1,0,0,15793,6.8,17980,202,56,256,1988,25.8,1579.3
4851452262,0,13,0,1,3,6,8,0,0,0,0,15817,6.8,18409,226,56,22,379,28.2,1581.7,81,0,0,6,3,6,1,1,0,0,15795,6.8,18030,200,52,-22,-379,25.2,1579.5
4851266178,1,15,0,0,1,8,0,0,0,0,0,13845,6.6,17676,187,64,-2963,-132,25.1,1384.5,92,1,1,8,1,6,0,0,0,0,16808,6.8,17808,203,55,2963,132,25.8,1680.8
4849497429,1,13,1,0,4,2,5,1,1,0,0,14869,6.4,15888,194,55,-590,-1889,24.9,1486.9,13,0,1,2,4,1,0,0,0,0,15459,7.0,17777,205,60,590,1889,26.5,1545.9
4849481203,1,12,1,1,5,5,5,0,0,0,0,15694,7.0,18030,227,55,429,153,28.2,1569.4,15,0,0,4,4,5,0,0,0,0,15265,6.8,17877,189,72,-429,-153,26.1,1526.5
4848412131,1,91,0,0,6,5,6,1,0,1,0,16375,7.0,17986,223,44,643,106,26.7,1637.5,14,1,1,5,6,7,0,0,0,0,15732,6.8,17880,182,63,-643,-106,24.5,1573.2
4848371791,0,18,3,0,2,5,3,0,0,0,0,14227,6.6,17128,178,60,-1261,-1467,23.8,1422.7,182,1,1,5,2,3,1,1,0,0,15488,7.2,18595,186,56,1261,1467,24.2,1548.8
4847582101,1,0,0,0,22,24,59,0,0,0,0,36978,11.4,40417,97,0,1244,1654,9.7,3697.8,0,0,1,23,21,60,0,0,0,0,35734,11.0,38763,89,0,-1244,-1654,8.9,3573.4
4847542443,0,14,2,1,3,3,3,0,0,0,0,15600,6.8,17573,221,47,768,-557,26.8,1560.0,122,0,0,3,3,3,0,0,0,0,14832,6.8,18130,198,57,-768,557,25.5,1483.2
4847521325,0,13,0,0,22,27,47,0,0,0,0,36238,11.2,40820,99,0,-1025,-1406,9.9,3623.8,90,5,1,27,22,63,0,0,0,0,37263,11.4,42226,108,0,1025,1406,10.8,3726.3
4847495378,0,0,0,1,19,31,38,0,0,0,1,35603,10.8,38102,76,0,-4995,-6666,7.6,3560.3,0,0,0,31,19,80,0,0,0,0,40598,11.8,44768,99,0,4995,6666,9.9,4059.8
4846524337,1,28,0,1,14,22,34,0,0,0,0,35653,11.0,37388,84,0,-664,-3795,8.4,3565.3,0,0,0,22,14,64,0,0,0,0,36317,11.2,41183,89,0,664,3795,8.9,3631.7
4846509593,0,214,0,0,15,27,32,0,0,0,0,34507,10.8,37561,84,0,-3793,-4156,8.4,3450.7,34,0,1,27,15,76,0,0,0,0,38300,11.2,41717,100,0,3793,4156,10.0,3830.0
4845986177,0,0,0,1,27,27,64,0,0,0,1,37542,11.6,42894,108,0,-1330,-230,10.8,3754.2,0,0,0,27,27,48,0,0,0,0,38872,11.6,43124,115,0,1330,230,11.5,3887.2
4845953928,1,0,5,1,24,14,41,0,0,0,1,36396,10.8,38339,130,0,3175,1879,13.0,3639.6,36,0,0,13,23,25,0,0,0,0,33221,10.4,36460,82,0,-3175,-1879,8.2,3322.1
4845929121,1,0,0,0,37,22,98,0,0,0,0,40227,11.6,44021,103,0,2311,1959,10.3,4022.7,0,0,1,22,37,55,0,0,0,0,37916,11.4,42062,91,0,-2311,-1959,9.1,3791.6
4857284537,0,10,1,0,2,5,2,0,0,0,0,14785,7.0,18004,206,52,-1721,-1084,25.8,1478.5,12,1,1,5,2,1,2,1,1,0,16506,7.4,19088,223,60,1721,1084,28.3,1650.6
4857240089,1,15,0,0,4,2,1,1,1,0,0,15019,7.2,19404,187,60,325,1145,24.7,1501.9,7,2,1,2,4,2,0,0,0,0,14694,7.0,18259,179,52,-325,-1145,23.1,1469.4
4857202376,1,14,1,1,4,1,4,0,0,0,0,16782,7.0,18971,202,52,2393,1915,25.4,1678.2,13,1,0,1,4,1,0,0,0,0,14389,6.6,17056,192,60,-2393,-1915,25.2,1438.9
4857123360,1,13,1,1,1,0,1,0,0,0,0,15965,7.0,18771,209,72,2057,1029,28.1,1596.5,53,0,0,0,1,0,0,0,0,0,13908,7.0,17742,224,47,-2057,-1029,27.1,1390.8
4857045290,1,0,0,1,18,15,22,0,0,0,0,63104,12.8,59000,0,0,26909,26000,0.0,6310.4,0,0,0,11,14,6,0,0,0,0,36195,7.2,33000,0,0,-26909,-26000,0.0,3619.5
4857033998,1,22,5,1,15,15,18,0,0,0,0,47575,10.0,47500,5,0,17900,19000,0.5,4757.5,36,0,0,10,10,9,0,0,0,0,29675,6.0,28500,16,0,-17900,-19000,1.6,2967.5
4856999501,1,13,1,1,6,5,2,1,0,1,0,16231,7.4,19253,154,68,1226,1183,22.2,1623.1,14,3,0,5,6,2,0,0,0,0,15005,7.0,18070,181,52,-1226,-1183,23.3,1500.5
4856943402,1,12,0,0,4,6,2,1,1,0,1,13800,6.6,16263,148,48,-2435,-978,19.6,1380.0,140,1,1,6,4,1,0,0,0,0,16235,6.6,17241,158,40,2435,978,19.8,1623.5
4856040588,1,6,0,1,4,3,4,1,1,0,0,16645,7.4,19275,197,72,1774,1218,26.9,1664.5,5,0,0,3,4,4,0,0,0,0,14871,7.0,18057,187,60,-1774,-1218,24.7,1487.1
4855646738,1,13,1,0,6,6,8,1,1,0,0,15768,6.8,16384,193,43,234,63,23.6,1576.8,14,0,1,6,6,6,0,0,0,0,15534,6.4,16321,198,45,-234,-63,24.3,1553.4
4855624602,0,14,1,0,4,7,6,0,0,0,0,15773,6.8,17705,204,48,-432,-286,25.2,1577.3,10,1,1,7,4,6,0,0,0,0,16205,6.8,17991,219,55,432,286,27.4,1620.5
4853753599,1,13,0,0,12,17,18,0,0,0,0,46300,10.6,50500,0,1,24400,22000,0.1,4630.0,0,0,1,14,9,9,0,0,0,0,21900,6.0,28500,0,0,-24400,-22000,0.0,2190.0
4853736234,1,0,0,1,19,16,24,0,0,0,0,47700,10.0,47500,0,0,22300,19000,0.0,4770.0,0,0,0,7,10,3,0,0,0,0,25400,6.0,28500,0,0,-22300,-19000,0.0,2540.0
4853718382,1,0,0,0,13,19,10,0,0,0,0,45845,10.0,47500,2,0,14385,19000,0.2,4584.5,0,0,1,13,7,12,0,0,0,0,31460,6.0,28500,0,0,-14385,-19000,0.0,3146.0
4853697357,1,0,0,0,17,23,17,0,0,0,0,47735,10.0,47500,0,0,18020,19000,0.0,4773.5,0,0,1,13,7,13,0,0,0,0,29715,6.0,28500,1,0,-18020,-19000,0.1,2971.5
4853688770,1,0,0,0,14,17,16,0,0,0,0,61300,12.0,55000,0,0,23390,22000,0.0,6130.0,27,1,1,12,9,13,0,0,0,0,37910,7.2,33000,1,0,-23390,-22000,0.1,3791.0
4853663421,1,99,0,1,21,13,20,0,0,0,0,61799,12.0,55000,0,0,25594,22000,0.0,6179.9,0,0,0,6,14,9,0,0,0,0,36205,7.2,33000,0,0,-25594,-22000,0.0,3620.5
4852940773,0,16,4,0,0,1,0,1,1,0,0,14804,7.0,18740,231,56,198,32,28.7,1480.4,14,3,1,1,0,1,0,0,0,0,14606,7.0,18708,218,68,-198,-32,28.6,1460.6
4852884840,0,13,0,0,7,7,7,0,0,0,0,16419,6.6,16832,195,56,-493,-836,25.1,1641.9,13,1,1,7,7,5,0,0,0,0,16912,6.8,17668,202,52,493,836,25.4,1691.2
4852337788,1,103,3,1,6,2,4,0,0,0,0,16668,6.8,17637,172,44,3620,1960,21.6,1666.8,15,0,0,2,6,1,0,0,0,0,13048,6.4,15677,168,35,-3620,-1960,20.3,1304.8
4855006545,0,10,4,0,9,11,7,0,0,0,0,17151,6.8,16336,167,42,-1931,-746,20.9,1715.1,18,1,1,11,9,18,1,1,0,0,19082,6.8,17082,163,66,1931,746,22.9,1908.2
4854956071,0,18,2,1,5,3,3,0,0,0,0,15173,6.8,18305,206,54,-490,129,26.0,1517.3,15,4,0,2,4,2,0,0,0,0,15663,7.0,18176,229,58,490,-129,28.7,1566.3
4854154572,1,14,2,1,22,16,18,0,0,0,0,63070,12.0,55000,2,0,26210,22000,0.2,6307.0,23,1,0,8,14,11,0,0,0,0,36860,7.2,33000,1,0,-26210,-22000,0.1,3686.0
4854133327,1,0,1,1,15,18,15,0,0,0,0,60955,12.0,55000,0,0,22756,22000,0.0,6095.5,35,0,0,13,10,12,0,0,0,0,38199,7.2,33000,3,0,-22756,-22000,0.3,3819.9
4853550386,1,40,0,1,14,17,18,0,0,0,0,63050,12.0,55000,0,0,24800,22000,0.0,6305.0,26,0,0,15,12,9,0,0,0,0,38250,7.2,33000,0,0,-24800,-22000,0.0,3825.0
4853537574,1,1,0,1,18,17,21,0,0,0,0,62820,12.0,55000,1,0,26318,22000,0.1,6282.0,364,0,0,11,12,11,0,0,0,0,36502,7.2,33000,0,0,-26318,-22000,0.0,3650.2
4853526655,1,0,0,0,21,19,17,0,0,0,0,61035,12.0,55000,1,0,22680,22000,0.1,6103.5,0,0,1,9,11,15,0,0,0,0,38355,7.2,33000,1,0,-22680,-22000,0.1,3835.5
4853524863,1,0,0,1,12,21,13,0,0,0,0,60720,12.8,61000,2,0,22629,25000,0.2,6072.0,0,0,0,15,6,13,0,0,0,0,38091,7.6,36000,1,0,-22629,-25000,0.1,3809.1
4853335829,1,15,0,1,24,17,24,0,0,0,0,64450,12.4,57000,0,0,26200,23000,0.0,6445.0,5,0,0,10,17,9,0,0,0,0,38250,7.4,34000,0,0,-26200,-23000,0.0,3825.0
4853326964,1,5,0,0,17,20,17,0,0,0,0,63767,12.0,55000,0,0,26217,22000,0.0,6376.7,1,0,1,12,9,10,0,0,0,0,37550,7.2,33000,0,0,-26217,-22000,0.0,3755.0
4853314249,1,17,0,1,16,20,14,0,0,0,0,63050,12.0,55000,0,0,24800,18000,0.0,6305.0,0,0,0,13,9,12,0,0,0,0,38250,8.0,37000,0,0,-24800,-18000,0.0,3825.0
4853307474,1,36,7,1,11,21,13,0,0,0,0,59635,12.0,55000,1,0,21185,22000,0.1,5963.5,34,0,0,14,4,13,0,0,0,0,38450,7.2,33000,6,0,-21185,-22000,0.6,3845.0
4853009592,1,16,0,1,15,12,14,0,0,0,0,46300,10.0,47500,0,1,19500,19000,0.1,4630.0,0,0,0,7,10,5,0,0,0,0,26800,6.0,28500,0,0,-19500,-19000,0.0,2680.0
4852993944,1,0,0,0,13,17,23,0,0,0,0,63700,12.0,55000,0,0,25790,22000,0.0,6370.0,29,0,1,14,10,9,0,0,0,0,37910,7.2,33000,1,0,-25790,-22000,0.1,3791.0
4851976060,0,34,4,0,4,9,6,0,0,0,0,14821,6.6,16054,191,48,-3218,-1922,23.9,1482.1,16,3,1,9,4,6,1,1,0,0,18039,6.8,17976,196,56,3218,1922,25.2,1803.9
4851945040,1,11,3,1,7,2,7,1,1,0,0,16135,6.8,16350,198,40,2217,-656,23.8,1613.5,14,1,0,2,7,0,0,0,0,0,13918,6.4,17006,187,60,-2217,656,24.7,1391.8
4850964290,1,13,1,1,7,5,3,0,0,0,0,16019,7.0,18283,189,52,-236,862,24.1,1601.9,11,1,0,5,7,6,1,1,0,0,16255,6.8,17421,183,60,236,-862,24.3,1625.5
4850903172,0,15,0,0,2,3,1,0,0,0,0,13990,6.8,17334,204,48,-345,-234,25.2,1399.0,13,1,1,3,2,1,0,0,0,0,14335,6.8,17568,181,51,345,234,23.2,1433.5
4850852605,1,14,0,0,9,4,11,1,1,0,0,19163,7.2,18864,191,48,5043,2588,23.9,1916.3,9,0,1,4,9,0,0,0,0,0,14120,6.4,16276,160,60,-5043,-2588,22.0,1412.0
4850828383,0,12,2,0,3,12,4,0,0,0,0,12805,6.6,15711,135,40,-8000,-3373,17.5,1280.5,18,0,1,12,3,11,1,1,0,0,20805,7.2,19084,228,56,8000,3373,28.4,2080.5
4856842576,0,16,2,1,6,6,3,0,0,0,0,15682,6.8,17757,180,64,-443,-28,24.4,1568.2,11,1,0,6,6,4,0,0,0,0,16125,6.8,17785,203,52,443,28,25.5,1612.5
4856826108,1,12,4,1,4,3,7,0,0,0,0,16639,7.0,18621,240,56,1946,967,29.6,1663.9,14,2,0,3,4,4,1,1,0,0,14693,6.8,17654,195,63,-1946,-967,25.8,1469.3
4856095468,0,18,1,1,11,7,12,0,0,0,0,19268,6.8,17546,200,60,3172,1393,26.0,1926.8,14,2,0,7,11,4,0,0,0,0,16096,6.2,16153,195,40,-3172,-1393,23.5,1609.6
4855810376,0,21,12,0,4,8,2,0,0,0,0,14235,6.6,16397,174,41,-4730,-2308,21.5,1423.5,31,0,1,8,4,10,1,1,0,0,18965,7.2,18705,205,63,4730,2308,26.8,1896.5
4853859975,0,14,2,0,3,3,8,0,0,0,0,15151,6.6,16851,207,52,-296,-928,25.9,1515.1,14,2,1,3,3,5,1,1,0,0,15447,6.8,17779,212,64,296,928,27.6,1544.7
4853807936,1,13,1,1,10,5,13,0,0,0,0,18635,7.2,19456,221,72,2318,2213,29.3,1863.5,19,0,0,5,10,7,0,0,0,0,16317,6.6,17243,191,52,-2318,-2213,24.3,1631.7
4853759671,1,16,1,0,3,5,1,1,1,0,0,14384,7.2,18683,168,62,-1735,614,23.0,1438.4,18,2,1,5,3,4,0,0,0,0,16119,7.2,18069,218,57,1735,-614,27.5,1611.9
4853725249,0,11,0,1,5,8,0,0,0,0,0,16172,6.8,18015,212,52,-1359,-1419,26.4,1617.2,12,0,0,8,5,7,1,1,0,0,17531,7.4,19434,230,56,1359,1419,28.6,1753.1
4853696495,1,63,4,1,14,4,19,0,0,0,0,20200,7.0,18282,173,60,5361,2861,23.3,2020.0,13,6,0,4,14,12,0,0,0,0,14839,6.4,15421,165,64,-5361,-2861,22.9,1483.9
4850903807,1,18,3,1,4,1,3,1,1,0,0,16216,7.0,18080,230,68,2475,587,29.8,1621.6,21,3,0,1,4,1,0,0,0,0,13741,6.6,17493,189,52,-2475,-587,24.1,1374.1
4850860325,0,85,1,1,9,2,6,0,0,0,0,17010,6.8,18051,186,52,2327,209,23.8,1701.0,7,0,0,2,9,1,1,0,1,0,14683,6.8,17842,163,60,-2327,-209,22.3,1468.3
4850603339,0,11,3,0,2,6,1,0,0,0,0,15617,7.0,17976,227,60,-274,577,28.7,1561.7,11,1,1,6,2,8,1,1,0,0,15891,7.0,17399,171,56,274,-577,22.7,1589.1
4850569732,1,12,4,0,4,3,5,1,1,0,0,15364,6.8,17904,173,56,337,21,22.9,1536.4,17,3,1,3,4,2,0,0,0,0,15027,6.8,17883,208,48,-337,-21,25.6,1502.7
4850553233,1,128,1,0,6,3,6,2,1,1,0,16333,6.6,16569,189,40,804,-611,22.9,1633.3,10,1,1,3,6,1,0,0,0,0,15529,6.8,17180,155,40,-804,611,19.5,1552.9
4843145120,1,11,0,1,5,4,4,1,1,0,0,16422,7.2,19019,218,52,1340,1080,27.0,1642.2,10,0,0,4,5,3,0,0,0,0,15082,7.0,17939,199,48,-1340,-1080,24.7,1508.2
4842339957,1,16,1,1,13,5,9,0,0,0,0,19260,7.4,20161,236,56,3631,2952,29.2,1926.0,86,2,0,5,13,3,0,0,0,0,15629,6.8,17209,194,60,-3631,-2952,25.4,1562.9
4842276448,0,9,0,0,3,8,4,0,0,0,0,14342,6.6,15755,192,45,-3873,-2182,23.7,1434.2,12,1,1,8,3,7,0,0,0,0,18215,6.8,17937,216,52,3873,2182,26.8,1821.5
4842082854,1,11,1,1,10,2,15,2,1,1,0,19696,7.0,18302,204,56,6379,2703,26.0,1969.6,115,1,0,2,10,2,0,0,0,0,13317,6.4,15599,145,44,-6379,-2703,18.9,1331.7
4842022764,1,14,2,1,11,6,7,1,1,0,0,19208,7.0,18531,219,56,2122,1043,27.5,1920.8,16,0,0,6,11,9,0,0,0,0,17086,6.8,17488,175,60,-2122,-1043,23.5,1708.6
4841927180,0,11,1,1,2,7,5,0,0,0,0,15697,7.0,17653,200,64,-1753,-713,26.4,1569.7,11,0,0,7,2,6,1,1,0,0,17450,6.8,18366,216,64,1753,713,28.0,1745.0
4857098320,1,135,1,0,7,10,10,1,1,0,0,16840,6.4,15844,167,51,-1512,-477,21.8,1684.0,14,5,1,10,7,16,0,0,0,0,18352,6.8,16321,199,44,1512,477,24.3,1835.2
4853334604,1,15,0,1,8,3,4,1,1,0,0,17921,7.0,18688,192,60,2005,1222,25.2,1792.1,8,2,0,3,8,4,0,0,0,0,15916,6.8,17466,160,44,-2005,-1222,20.4,1591.6
4851058443,1,38,0,0,7,2,7,0,0,0,0,15935,6.8,17558,195,39,1297,516,23.4,1593.5,17,0,1,2,7,1,1,1,0,0,14638,6.8,17042,177,68,-1297,-516,24.5,1463.8
4850662245,0,11,0,0,5,9,5,0,0,0,0,14851,6.4,16449,145,36,-3070,-1885,18.1,1485.1,264,0,1,9,5,9,1,1,0,0,17921,7.0,18334,204,52,3070,1885,25.6,1792.1
4849759067,1,1,0,0,29,23,82,0,0,0,1,40904,11.6,43716,109,0,3092,3805,10.9,4090.4,37,0,1,23,29,57,0,0,0,0,37812,10.8,39911,96,0,-3092,-3805,9.6,3781.2
4849076707,1,18,0,0,3,7,2,1,1,0,0,14382,6.2,15242,152,44,-1218,-1525,19.6,1438.2,11,0,1,7,3,6,1,0,1,0,15600,6.4,16767,164,59,1218,1525,22.3,1560.0
4848717258,0,12,0,0,2,7,1,0,0,0,0,15200,6.6,17039,157,56,-500,-1143,21.3,1520.0,11,2,1,7,2,3,0,0,0,0,15700,6.8,18182,177,52,500,1143,22.9,1570.0
4848681486,1,23,2,0,5,5,4,1,1,0,0,16079,7.0,17945,221,52,-33,1431,27.3,1607.9,14,1,1,5,5,3,0,0,0,0,16112,6.6,16514,207,52,33,-1431,25.9,1611.2
4846109441,0,0,0,0,25,26,47,0,0,0,1,38150,11.4,41282,93,0,534,-1787,9.3,3815.0,0,0,1,26,25,63,0,0,0,0,37616,11.6,43069,104,0,-534,1787,10.4,3761.6
4841958447,1,10,2,1,7,3,4,0,0,0,0,15522,6.6,16560,132,56,1068,1060,18.8,1552.2,11,2,0,3,7,4,0,0,0,0,14454,6.4,15500,143,44,-1068,-1060,18.7,1445.4
4841942153,1,12,1,1,8,7,8,0,0,0,0,17099,6.6,16958,186,60,415,28,24.6,1709.9,14,1,0,7,8,3,0,0,0,0,16684,6.8,16930,180,40,-415,-28,22.0,1668.4
4837120333,1,12,1,1,9,4,7,1,1,0,0,17507,6.8,17209,165,54,2307,1192,21.9,1750.7,13,1,0,4,9,5,0,0,0,0,15200,6.6,16017,171,36,-2307,-1192,20.7,1520.0
4836147677,1,12,1,1,5,4,2,0,0,0,0,15298,6.8,18455,157,49,-901,1305,20.6,1529.8,14,1,0,4,5,3,0,0,0,0,16199,6.6,17150,207,54,901,-1305,26.1,1619.9
4836130077,1,8,0,1,5,2,3,0,0,0,0,15842,7.0,18398,204,64,2175,575,26.8,1584.2,6,0,0,2,5,1,1,1,0,0,13667,6.8,17823,195,44,-2175,-575,23.9,1366.7
4835133609,0,13,2,0,2,7,2,0,0,0,0,12700,6.2,15167,145,48,-4305,-3325,19.3,1270.0,15,3,1,7,2,3,0,0,0,0,17005,7.0,18492,219,44,4305,3325,26.3,1700.5
4834737198,0,18,3,0,4,8,2,1,1,0,0,16619,7.0,18197,189,64,-136,601,25.3,1661.9,15,3,1,8,4,2,0,0,0,0,16755,6.6,17596,180,54,136,-601,23.4,1675.5
4834685336,0,132,1,0,2,7,1,0,0,0,0,14217,6.4,15908,188,46,-3069,-1546,23.4,1421.7,11,0,1,7,2,5,0,0,0,0,17286,6.8,17454,218,52,3069,1546,27.0,1728.6
4834298779,1,13,2,1,9,7,5,0,0,0,0,17920,6.8,16437,176,44,1084,575,22.0,1792.0,14,0,0,7,9,4,1,1,0,0,16836,6.2,15862,153,39,-1084,-575,19.2,1683.6
4834245286,1,13,2,0,4,6,5,0,0,0,0,16257,6.6,16583,163,52,-637,-699,21.5,1625.7,17,3,1,6,4,6,1,1,0,0,16894,6.6,17282,187,48,637,699,23.5,1689.4
4834203410,1,72,3,1,10,4,9,0,0,0,0,18528,6.8,18416,179,52,3923,1740,23.1,1852.8,15,1,0,4,10,0,1,0,1,0,14605,6.6,16676,189,52,-3923,-1740,24.1,1460.5
4855702580,1,12,1,0,8,10,7,0,0,0,0,16868,6.6,16926,204,56,-152,-996,26.0,1686.8,207,2,1,10,8,9,0,0,0,0,17020,6.8,17922,183,48,152,996,23.1,1702.0
4855682451,0,15,1,0,7,8,8,0,0,0,0,16218,6.4,16296,166,47,-1978,-1779,21.3,1621.8,13,2,1,8,7,7,0,0,0,0,18196,7.2,18075,203,46,1978,1779,24.9,1819.6
4855674044,1,0,0,1,19,11,17,0,0,0,0,47000,10.2,48680,8,0,20900,20180,0.8,4700.0,0,0,0,4,12,6,0,0,0,0,26100,6.0,28500,2,0,-20900,-20180,0.2,2610.0
4850523828,1,16,1,1,9,6,7,0,0,0,0,17702,7.0,18243,179,52,1976,1283,23.1,1770.2,7,1,0,6,9,4,0,0,0,0,15726,6.8,16960,180,48,-1976,-1283,22.8,1572.6
4850502725,1,14,0,0,6,2,6,0,0,0,0,15169,6.6,16948,168,60,1873,1526,22.8,1516.9,16,0,1,2,6,4,0,0,0,0,13296,6.4,15422,180,32,-1873,-1526,21.2,1329.6
4850490357,0,69,1,1,3,3,4,1,1,0,0,14088,6.4,16320,193,40,-1114,-1839,23.3,1408.8,12,0,0,3,3,0,0,0,0,0,15202,7.0,18159,175,56,1114,1839,23.1,1520.2
4850467677,0,18,3,0,3,6,0,1,1,0,0,14592,6.6,17715,174,48,-3388,-1206,22.2,1459.2,26,2,1,6,3,3,0,0,0,0,17980,7.0,18921,199,48,3388,1206,24.7,1798.0
4847474096,1,8,1,1,11,9,10,0,0,0,0,18007,6.6,16477,162,36,1404,674,19.8,1800.7,11,1,0,9,11,9,1,1,0,0,16603,6.2,15803,154,42,-1404,-674,19.6,1660.3
4847457269,0,14,0,0,3,7,1,1,0,1,0,14448,6.6,16346,131,64,-2285,-1606,19.5,1444.8,9,0,1,7,3,5,1,1,0,0,16733,6.8,17952,183,45,2285,1606,22.8,1673.3
4847444753,0,7,0,0,4,5,4,1,1,0,0,14656,6.8,17513,199,47,-1070,-105,24.6,1465.6,7,0,1,5,4,1,0,0,0,0,15726,7.0,17618,240,40,1070,105,28.0,1572.6
4847415048,0,25,2,1,4,9,5,0,0,0,0,15147,6.6,15797,192,52,-3388,-1242,24.4,1514.7,33,2,0,9,4,14,1,1,0,0,18535,6.4,17039,196,36,3388,1242,23.2,1853.5
4847061499,1,8,0,1,5,2,5,0,0,0,0,15245,6.6,16963,138,60,1591,813,19.8,1524.5,19,0,0,2,5,2,1,1,0,0,13654,6.6,16150,133,52,-1591,-813,18.5,1365.4
4847022719,0,11,1,0,8,9,2,0,0,0,0,16198,6.8,17511,143,40,-2149,-1334,18.3,1619.8,388,1,1,9,8,5,1,1,0,0,18347,7.0,18845,194,55,2149,1334,24.9,1834.7
4846998355,0,7,5,0,6,5,2,0,0,0,0,15201,6.8,17576,145,48,-1539,513,19.3,1520.1,30,0,1,5,6,6,0,0,0,0,16740,6.8,17063,182,36,1539,-513,21.8,1674.0
4838704452,0,145,11,0,6,6,6,0,0,0,0,16688,6.6,16617,198,48,588,360,24.6,1668.8,38,1,1,6,6,6,1,1,0,0,16100,6.6,16257,185,52,-588,-360,23.7,1610.0
4838661979,0,10,3,0,3,5,1,0,0,0,0,13708,6.6,15914,177,44,-1846,-1532,22.1,1370.8,15,0,1,5,3,5,0,0,0,0,15554,6.8,17446,180,56,1846,1532,23.6,1555.4
4838632587,1,6,2,1,4,3,5,1,1,0,0,15115,7.0,17388,167,48,277,-685,21.5,1511.5,13,1,0,3,4,3,0,0,0,0,14838,6.8,18073,161,64,-277,685,22.5,1483.8
4832083922,0,111,1,1,5,3,5,1,1,0,0,14655,6.6,16580,175,48,-172,-283,22.3,1465.5,10,0,0,3,5,1,0,0,0,0,14827,6.6,16863,197,52,172,283,24.9,1482.7
4832058272,1,63,1,1,10,8,8,0,0,0,0,17060,7.2,17960,187,31,1203,947,21.8,1706.0,15,0,0,8,10,3,1,1,0,0,15857,6.8,17013,159,58,-1203,-947,21.7,1585.7
4832027465,1,24,0,1,7,7,5,1,0,1,0,17666,7.0,18363,196,60,1453,2549,25.6,1766.6,14,2,0,7,7,7,1,1,0,0,16213,6.6,15814,171,44,-1453,-2549,21.5,1621.3
4857418767,1,18,1,1,8,2,6,0,0,0,0,17224,7.0,17608,182,48,2658,1712,23.0,1722.4,11,0,0,2,8,2,0,0,0,0,14566,6.4,15896,183,52,-2658,-1712,23.5,1456.6
4857371868,0,169,1,0,4,18,1,0,0,0,0,13704,6.4,15766,171,40,-7096,-3102,21.1,1370.4,20,1,1,18,4,10,0,0,0,0,20800,7.2,18868,171,40,7096,3102,21.1,2080.0
4857302779,0,13,0,0,9,6,10,0,0,0,0,19224,6.8,18011,183,56,2494,1229,23.9,1922.4,9,1,1,6,9,10,0,0,0,0,16730,6.8,16782,192,44,-2494,-1229,23.6,1673.0
4856380591,0,12,1,0,8,9,8,0,0,0,0,16417,7.0,17850,146,60,-1300,-1250,20.6,1641.7,12,0,1,9,8,4,0,0,0,0,17717,7.2,19100,193,64,1300,1250,25.7,1771.7
4856330327,0,9,3,1,6,9,4,0,0,0,0,16456,6.6,16737,201,44,-910,-2592,24.5,1645.6,23,1,0,9,6,3,0,0,0,0,17366,7.2,19329,198,56,910,2592,25.4,1736.6
4856297851,0,82,0,0,11,13,27,0,0,0,0,32899,10.2,34337,106,0,-3177,-2629,10.6,3289.9,0,0,1,13,11,34,0,0,0,0,36076,10.8,36966,99,0,3177,2629,9.9,3607.6
4856251919,1,9,5,1,20,21,59,0,0,0,2,36044,10.8,37239,117,0,-59,-122,11.7,3604.4,23,0,0,21,20,53,0,0,0,0,36103,10.8,37361,119,0,59,122,11.9,3610.3
4854666395,0,18,2,0,6,9,0,0,0,0,0,15018,6.6,16417,162,46,-3809,-2341,20.8,1501.8,20,4,1,9,6,5,0,0,0,0,18827,7.0,18758,194,60,3809,2341,25.4,1882.7
4854634489,1,13,17,1,5,2,0,1,1,0,0,15557,7.0,17473,197,52,1667,1591,24.9,1555.7,43,1,0,2,5,3,0,0,0,0,13890,6.4,15882,175,48,-1667,-1591,22.3,1389.0
4853991764,0,14,1,0,5,8,2,0,0,0,0,15363,6.6,17697,206,56,-1483,101,26.2,1536.3,19,1,1,8,5,5,0,0,0,0,16846,6.6,17596,181,60,1483,-101,24.1,1684.6
4853926198,0,11,0,1,6,5,5,0,0,0,0,17268,7.4,18488,197,56,1497,1287,25.3,1726.8,12,0,0,5,6,3,0,0,0,0,15771,6.8,17201,171,54,-1497,-1287,22.5,1577.1
4853853647,0,15,0,0,2,1,2,0,0,0,0,15048,6.8,18003,218,52,950,419,27.0,1504.8,118,3,1,1,2,2,0,0,0,0,14098,6.8,17584,179,68,-950,-419,24.7,1409.8
4853186766,1,0,0,1,29,21,87,0,0,0,1,37899,11.2,42355,103,0,1342,2642,10.3,3789.9,0,0,0,21,29,55,0,0,0,0,36557,11.2,39713,80,0,-1342,-2642,8.0,3655.7
4853164628,0,0,0,1,10,29,27,0,0,0,1,33432,10.2,34649,87,0,-4570,-7225,8.7,3343.2,324,0,0,29,10,84,0,0,0,0,38002,11.4,41874,98,0,4570,7225,9.8,3800.2
4851033155,0,17,1,1,2,6,0,1,0,1,0,14350,6.8,17778,197,48,-2031,121,24.5,1435.0,11,2,0,6,2,6,1,1,0,0,16381,6.8,17657,219,58,2031,-121,27.7,1638.1
4850990815,1,14,2,0,6,9,6,1,1,0,0,14491,5.8,14005,115,45,-3773,-3719,16.0,1449.1,12,1,1,9,6,3,0,0,0,0,18264,6.8,17724,204,60,3773,3719,26.4,1826.4
4850945518,0,12,0,1,4,7,3,0,0,0,0,15758,6.6,16557,203,56,-1759,-1192,25.9,1575.8,11,3,0,7,4,6,1,1,0,0,17517,6.8,17749,190,52,1759,1192,24.2,1751.7
4850168823,0,0,0,1,28,13,60,0,0,0,1,38051,11.4,42480,102,0,3927,6475,10.2,3805.1,0,0,0,13,28,36,0,0,0,0,34124,10.4,36005,77,0,-3927,-6475,7.7,3412.4
4849933069,0,26,0,1,30,35,88,0,0,0,2,39423,11.2,42499,92,0,-2576,-3392,9.2,3942.3,0,21,0,35,30,101,0,0,0,0,41999,11.8,45891,111,0,2576,3392,11.1,4199.9
4848732699,1,13,1,1,2,5,1,0,0,0,0,15268,6.6,17261,181,52,-337,-819,23.3,1526.8,16,1,0,5,2,0,1,1,0,0,15605,7.0,18080,189,60,337,819,24.9,1560.5
4851088669,0,0,0,0,30,18,80,0,0,0,0,40607,11.6,44013,113,0,4814,5853,11.3,4060.7,0,0,1,18,30,37,0,0,0,0,35793,10.8,38160,94,0,-4814,-5853,9.4,3579.3
4841605696,1,34,0,0,24,28,55,0,0,0,0,37276,11.4,42237,105,0,-134,-1259,10.5,3727.6,34,0,1,28,24,71,0,0,0,0,37410,11.4,43496,121,0,134,1259,12.1,3741.0
4841522817,1,5,0,0,40,37,91,0,0,0,0,41415,12.4,47736,91,0,-424,921,9.1,4141.5,0,0,1,37,40,71,0,0,0,0,41839,12.0,46815,91,0,424,-921,9.1,4183.9
4841161475,1,26,0,1,28,15,83,0,0,0,1,40183,11.8,44167,117,0,6778,7995,11.7,4018.3,0,9,0,15,28,33,0,0,0,0,33405,10.4,36172,98,0,-6778,-7995,9.8,3340.5
4840923815,1,55,0,0,26,22,74,0,0,0,0,37759,11.4,41758,106,0,2402,3234,10.6,3775.9,0,0,1,22,26,58,0,0,0,0,35357,11.0,38524,113,0,-2402,-3234,11.3,3535.7
4840896909,1,9,0,1,22,29,49,0,0,0,2,38167,11.2,40807,114,0,-580,-3070,11.4,3816.7,0,0,0,29,22,76,0,0,0,0,38747,11.8,43877,89,0,580,3070,8.9,3874.7
4840587367,1,0,3,0,23,29,59,0,0,0,1,38255,11.2,41252,123,0,-171,-1083,12.3,3825.5,16,0,1,28,22,57,0,0,0,0,38426,11.2,42335,108,0,171,1083,10.8,3842.6
4840567419,0,0,0,0,27,33,68,0,0,0,2,38155,11.2,40902,109,0,-2936,-2133,10.9,3815.5,0,0,1,33,27,91,0,0,0,0,41091,11.4,43035,120,0,2936,2133,12.0,4109.1
4840540373,1,0,0,1,27,21,63,0,0,0,0,36875,11.4,42206,102,0,-55,323,10.2,3687.5,0,0,0,21,27,57,0,0,0,0,36930,11.4,41883,104,0,55,-323,10.4,3693.0
4838445425,0,53,1,0,3,6,1,0,0,0,0,14233,6.6,16692,150,52,-2923,-1571,20.2,1423.3,10,2,1,6,3,6,1,1,0,0,17156,7.0,18263,205,58,2923,1571,26.3,1715.6
4835578493,1,13,1,0,5,2,6,0,0,0,0,17160,7.2,18805,203,52,3046,2332,25.5,1716.0,12,1,1,2,5,3,0,0,0,0,14114,6.6,16473,176,52,-3046,-2332,22.8,1411.4
4835446139,0,0,0,0,19,31,57,0,0,0,0,36849,11.0,40987,89,0,-2956,-3996,8.9,3684.9,0,0,1,31,19,84,0,0,0,0,39805,11.8,44983,123,0,2956,3996,12.3,3980.5
4835382375,0,11,0,0,4,3,3,0,0,0,0,15385,6.8,17187,191,64,-679,-297,25.5,1538.5,112,1,1,3,4,2,0,0,0,0,16064,6.8,17484,185,52,679,297,23.7,1606.4
4835345272,1,11,1,0,7,6,8,1,1,0,0,16355,7.0,18208,180,59,44,705,23.9,1635.5,13,1,1,6,7,5,0,0,0,0,16311,7.0,17503,214,52,-44,-705,26.6,1631.1
4835328300,1,0,0,1,28,18,74,0,0,0,1,38556,11.4,41318,99,0,2031,1214,9.9,3855.6,0,0,0,18,28,44,0,0,0,0,36525,11.4,40104,94,0,-2031,-1214,9.4,3652.5
4835307699,0,37,0,1,26,34,52,0,0,0,0,37930,11.4,41934,105,0,-2464,-4804,10.5,3793.0,34,2,0,34,26,79,0,0,0,0,40394,12.0,46738,99,0,2464,4804,9.9,4039.4
4834714710,0,5,2,0,2,7,1,0,0,0,0,14046,6.6,17148,184,48,-2636,-1581,23.2,1404.6,17,0,1,7,2,4,1,1,0,0,16682,7.0,18729,220,60,2636,1581,28.0,1668.2
4833304546,0,14,0,0,2,7,2,0,0,0,0,13915,6.8,17237,172,52,-3188,-599,22.4,1391.5,12,0,1,7,2,8,0,0,0,0,17103,7.0,17836,194,40,3188,599,23.4,1710.3
4824128934,0,0,0,0,28,24,70,0,0,0,1,38680,11.0,41120,109,0,2937,2536,10.9,3868.0,0,0,1,24,28,61,0,0,0,0,35743,10.6,38584,98,0,-2937,-2536,9.8,3574.3
4813385908,1,0,0,0,29,29,71,0,0,0,0,38643,11.2,42560,107,0,214,-1453,10.7,3864.3,0,0,1,29,29,56,0,0,0,0,38429,11.6,44013,117,0,-214,1453,11.7,3842.9
4857315991,0,1,0,0,33,28,84,0,0,0,1,39749,12.0,45604,97,0,1119,2839,9.7,3974.9,9,0,1,28,33,60,0,0,0,0,38630,11.4,42765,78,0,-1119,-2839,7.8,3863.0
4857281338,0,0,0,0,22,31,48,0,0,0,1,35926,10.8,39553,93,0,-3780,-4121,9.3,3592.6,0,0,1,31,22,87,0,0,0,0,39706,11.8,43674,93,0,3780,4121,9.3,3970.6
4857257865,0,0,0,1,24,26,57,0,0,0,0,36753,11.2,40595,111,0,-1123,-1973,11.1,3675.3,0,0,0,26,24,71,0,0,0,0,37876,11.4,42568,96,0,1123,1973,9.6,3787.6
4856454542,0,0,0,1,24,31,72,0,0,0,1,37885,11.0,40515,75,0,-4514,-6721,7.5,3788.5,3,0,0,31,24,83,0,0,0,0,42399,12.0,47236,105,0,4514,6721,10.5,4239.9
4856416224,1,7,0,1,23,15,70,0,0,0,0,37085,11.0,38701,106,0,2320,1325,10.6,3708.5,220,0,0,15,23,33,0,0,0,0,34765,10.6,37376,106,0,-2320,-1325,10.6,3476.5
4856388826,1,19,0,0,19,18,32,0,0,0,2,36782,11.4,41908,96,0,287,3085,9.6,3678.2,0,0,1,18,19,34,0,0,0,0,36495,11.0,38823,101,0,-287,-3085,10.1,3649.5
4856353701,0,83,0,1,33,43,63,0,0,0,1,41633,12.0,46815,92,0,-1939,-2570,9.2,4163.3,0,4,0,43,33,121,0,0,0,0,43572,12.6,49385,109,0,1939,2570,10.9,4357.2
4855414155,0,16,0,1,25,20,52,0,0,0,1,39545,11.6,44424,117,0,1662,3217,11.7,3954.5,0,1,0,20,25,43,0,0,0,0,37883,11.2,41207,104,0,-1662,-3217,10.4,3788.3
4855395220,1,0,0,1,17,28,31,0,0,0,1,35309,11.0,39246,102,0,-2008,-1758,10.2,3530.9,219,0,0,28,17,66,0,0,0,0,37317,11.2,41004,91,0,2008,1758,9.1,3731.7
4855360664,1,2,16,0,30,22,88,0,0,0,0,39917,11.6,43160,106,0,2501,1369,10.6,3991.7,11,0,1,22,30,49,0,0,0,0,37416,11.4,41791,102,0,-2501,-1369,10.2,3741.6
4855340391,0,0,0,0,26,33,68,0,0,0,2,38178,11.0,41248,101,0,-2968,-3774,10.1,3817.8,0,0,1,33,26,86,0,0,0,0,41146,11.8,45022,112,0,2968,3774,11.2,4114.6
4855319924,1,1,2,1,16,20,36,0,0,0,0,37913,11.2,40281,116,0,2935,1128,11.6,3791.3,15,0,0,20,16,51,0,0,0,0,34978,11.0,39153,90,0,-2935,-1128,9.0,3497.8
4855271720,0,0,0,0,22,34,66,0,0,0,1,37195,11.0,41075,103,0,-2711,-2235,10.3,3719.5,0,0,1,34,22,76,0,0,0,0,39906,11.6,43310,104,0,2711,2235,10.4,3990.6
4855234321,1,0,0,1,31,27,67,0,0,0,1,39929,11.6,44372,112,0,561,99,11.2,3992.9,0,0,0,27,31,60,0,0,0,0,39368,11.6,44273,119,0,-561,-99,11.9,3936.8
4854236948,1,0,0,1,32,32,52,0,0,0,1,38882,12.2,46564,81,0,-1641,746,8.1,3888.2,15,0,0,32,32,56,0,0,0,0,40523,12.0,45818,112,0,1641,-746,11.2,4052.3
4854204446,1,0,0,0,31,24,80,0,0,0,1,38611,12.0,45242,116,0,3023,6508,11.6,3861.1,2,0,1,24,31,52,0,0,0,0,35588,10.8,38734,95,0,-3023,-6508,9.5,3558.8
4854169453,0,5,0,1,23,23,55,0,0,0,2,38034,11.2,41007,110,0,1662,-570,11.0,3803.4,0,1,0,23,23,48,0,0,0,0,36372,11.2,41577,96,0,-1662,570,9.6,3637.2
4854133177,1,0,4,0,28,29,67,0,0,0,0,40224,11.8,44253,99,0,1432,1349,9.9,4022.4,15,0,1,29,28,74,0,0,0,0,38792,11.4,42904,96,0,-1432,-1349,9.6,3879.2
4854113131,1,1,9,0,34,17,94,0,0,0,2,39739,11.6,43724,98,0,2594,4654,9.8,3973.9,61,0,1,17,34,40,0,0,0,0,37145,10.8,39070,90,0,-2594,-4654,9.0,3714.5
4854074315,0,0,0,0,29,25,66,0,0,0,1,38541,11.6,43756,108,0,-864,1328,10.8,3854.1,0,0,1,25,29,63,0,0,0,0,39405,11.6,42428,98,0,864,-1328,9.8,3940.5
4780195422,0,15,2,0,1,7,1,0,0,0,0,14077,6.8,16974,211,53,-4620,-2182,26.4,1407.7,80,1,1,7,1,8,1,1,0,0,18697,7.2,19156,220,57,4620,2182,27.7,1869.7
4780173580,0,10,1,0,2,5,1,0,0,0,0,14816,6.8,17342,207,68,-2327,-529,27.5,1481.6,8,2,1,5,2,3,0,0,0,0,17143,7.2,17871,225,56,2327,529,28.1,1714.3
4780131409,1,16,0,1,6,2,7,0,0,0,0,18819,7.4,18821,228,59,5082,2678,28.7,1881.9,10,2,0,2,6,3,1,1,0,0,13737,6.4,16143,185,52,-5082,-2678,23.7,1373.7
4780118799,1,0,0,0,20,26,53,0,0,0,0,35427,11.0,39675,95,0,-1006,-327,9.5,3542.7,0,0,1,26,20,72,0,0,0,0,36433,11.0,40002,98,0,1006,327,9.8,3643.3
4779748940,1,12,1,1,10,5,7,0,0,0,0,18140,7.2,18275,216,56,2534,1060,27.2,1814.0,46,0,0,5,10,4,1,1,0,0,15606,6.8,17215,146,56,-2534,-1060,20.2,1560.6
4779709995,0,14,2,0,7,4,5,0,0,0,0,16853,6.8,17046,190,36,-1152,-182,22.6,1685.3,13,2,1,4,7,4,1,1,0,0,18005,6.6,17228,215,52,1152,182,26.7,1800.5
4779541409,0,37,0,0,3,6,0,0,0,0,0,14844,6.6,16965,185,60,-2386,-447,24.5,1484.4,10,12,1,6,3,5,1,1,0,0,17230,7.0,17412,197,38,2386,447,23.5,1723.0
4779512477,1,11,1,1,4,0,4,0,0,0,0,16329,7.0,17904,209,70,2053,874,27.9,1632.9,10,2,0,0,4,0,0,0,0,0,14276,6.6,17030,226,54,-2053,-874,28.0,1427.6
4779446830,0,0,0,0,17,27,29,0,0,0,0,35254,10.8,38844,110,0,-2011,-3125,11.0,3525.4,0,0,1,27,17,64,0,0,0,0,37265,11.4,41969,104,0,2011,3125,10.4,3726.5
4779405431,1,18,2,1,5,6,5,0,0,0,0,16209,6.8,17700,192,60,-826,-963,25.2,1620.9,16,3,0,6,5,7,1,0,1,0,17035,7.4,18663,219,56,826,963,27.5,1703.5
4779385818,0,23,0,0,3,7,3,0,0,0,0,14420,6.6,16448,188,56,-4191,-1981,24.4,1442.0,11,2,1,7,3,6,0,0,0,0,18611,6.8,18429,251,48,4191,1981,29.9,1861.1
4779361800,1,13,2,1,4,4,4,0,0,0,0,15989,6.6,17043,202,44,946,177,24.6,1598.9,13,0,0,4,4,2,0,0,0,0,15043,6.6,16866,169,70,-946,-177,23.9,1504.3
4211248512,0,13,1,1,3,7,2,0,0,0,0,14443,6.8,16785,173,56,-2195,-2441,22.9,1444.3,12,1,0,7,3,4,2,1,1,0,16638,7.0,19226,188,56,2195,2441,24.4,1663.8
4211062879,1,14,3,1,8,3,7,0,0,0,0,16861,7.0,18034,198,48,3258,1315,24.6,1686.1,14,1,0,3,8,1,2,1,1,0,13603,6.4,16719,152,90,-3258,-1315,24.2,1360.3
4211019767,0,9,3,0,6,11,5,0,0,0,0,15914,7.0,17409,173,56,-2909,-1259,22.9,1591.4,13,0,1,11,6,13,0,0,0,0,18823,7.2,18668,191,52,2909,1259,24.3,1882.3
4210540488,0,73,0,0,5,7,5,1,1,0,0,16512,6.8,17418,189,63,-573,-254,25.2,1651.2,7,3,1,7,5,5,0,0,0,0,17085,6.8,17672,205,61,573,254,26.6,1708.5
4210483167,1,8,1,1,6,7,7,1,1,0,0,15297,6.8,16846,177,56,-2213,-2391,23.3,1529.7,11,2,0,7,6,2,0,0,0,0,17510,7.2,19237,198,62,2213,2391,26.0,1751.0
4209614952,0,55,2,1,8,9,6,0,0,0,0,16933,6.6,17352,173,60,-2666,-1722,23.3,1693.3,15,1,0,9,8,6,1,1,0,0,19599,7.2,19074,209,63,2666,1722,27.2,1959.9
4209591176,1,11,2,1,6,2,8,1,1,0,0,17967,7.2,18883,236,66,4623,2210,30.2,1796.7,53,1,0,2,6,2,0,0,0,0,13344,6.6,16673,174,44,-4623,-2210,21.8,1334.4
4854255184,0,10,1,1,4,5,3,0,0,0,0,15592,7.2,18338,192,64,592,927,25.6,1559.2,12,0,0,5,4,2,1,1,0,0,15000,6.8,17411,186,52,-592,-927,23.8,1500.0
4854207158,0,10,1,0,8,3,6,0,0,0,0,16157,6.8,17490,167,44,1093,-369,21.1,1615.7,13,1,1,3,8,0,0,0,0,0,15064,6.8,17859,209,72,-1093,369,28.1,1506.4
4854158722,0,14,0,1,3,7,3,1,1,0,0,13898,6.4,15627,150,52,-4960,-4232,20.2,1389.8,15,1,0,7,3,7,0,0,0,0,18858,7.2,19859,205,64,4960,4232,26.9,1885.8
4854110405,0,11,1,0,7,5,6,0,0,0,0,15156,6.4,16011,129,52,-1204,-1768,18.1,1515.6,23,1,1,5,7,1,0,0,0,0,16360,7.0,17779,189,48,1204,1768,23.7,1636.0
4852340818,1,31,1,1,8,6,8,1,1,0,0,17612,6.8,18029,214,36,1293,-107,25.0,1761.2,10,16,0,6,8,3,0,0,0,0,16319,6.8,18136,181,44,-1293,107,22.5,1631.9
4852322952,1,205,2,0,8,2,7,0,0,0,0,17961,7.0,18669,203,44,3503,2543,24.7,1796.1,15,2,1,2,8,3,0,0,0,0,14458,6.4,16126,176,36,-3503,-2543,21.2,1445.8
4848088837,1,33,3,1,6,6,5,0,0,0,0,16769,7.0,18245,179,64,1296,1904,24.3,1676.9,119,1,0,6,6,7,1,1,0,0,15473,6.4,16341,153,56,-1296,-1904,20.9,1547.3
4847161015,0,14,1,0,3,5,2,0,0,0,0,14561,7.0,17510,168,64,-2177,-1354,23.2,1456.1,8,1,1,5,3,2,0,0,0,0,16738,7.0,18864,232,60,2177,1354,29.2,1673.8
4847137913,1,11,0,0,7,3,4,0,0,0,0,15485,7.0,18225,198,36,-132,566,23.4,1548.5,10,1,1,3,7,2,1,1,0,0,15617,7.0,17659,205,60,132,-566,26.5,1561.7
4834350832,0,10,2,0,4,10,1,0,0,0,0,16396,7.2,18799,199,52,-1702,1337,25.1,1639.6,14,1,1,10,4,8,1,1,0,0,18098,6.8,17462,152,60,1702,-1337,21.2,1809.8
4832406353,1,8,0,1,9,6,8,1,1,0,0,18619,7.2,19358,198,64,3750,1939,26.2,1861.9,9,0,0,6,9,4,0,0,0,0,14869,7.0,17419,141,63,-3750,-1939,20.4,1486.9
4832375563,0,15,1,1,8,6,8,1,1,0,0,19042,7.2,18534,173,52,3456,1516,22.5,1904.2,8,1,0,6,8,4,0,0,0,0,15586,6.6,17018,207,40,-3456,-1516,24.7,1558.6
4832350162,1,52,1,1,5,3,3,0,0,0,0,16540,7.0,17979,215,40,2390,1447,25.5,1654.0,11,0,0,3,5,2,0,0,0,0,14150,6.6,16532,168,40,-2390,-1447,20.8,1415.0
4826991106,1,15,2,1,6,4,0,0,0,0,0,15646,7.2,18913,226,60,-812,139,28.6,1564.6,73,1,0,4,6,2,0,0,0,0,16458,7.0,18774,211,56,812,-139,26.7,1645.8
4826977195,1,12,0,1,12,6,4,0,0,0,0,17935,7.0,18555,179,60,2953,2014,23.9,1793.5,11,0,0,6,12,3,0,0,0,0,14982,6.6,16541,170,32,-2953,-2014,20.2,1498.2
4826950193,0,13,0,1,4,2,3,1,1,0,0,14441,6.8,17318,173,52,-757,-542,22.5,1444.1,9,3,0,2,4,2,0,0,0,0,15198,6.8,17860,215,60,757,542,27.5,1519.8
4826918622,1,15,0,0,5,7,1,1,1,0,0,15597,7.0,18229,194,47,250,2159,24.1,1559.7,11,1,1,7,5,4,1,0,1,0,15347,6.6,16070,153,46,-250,-2159,19.9,1534.7
4825027753,1,13,2,0,7,3,7,0,0,0,0,18488,6.8,18312,207,48,4119,2007,25.5,1848.8,13,2,1,3,7,2,0,0,0,0,14369,6.6,16305,162,48,-4119,-2007,21.0,1436.9
4856212048,0,75,0,1,3,6,3,0,0,0,0,14808,6.8,17654,202,44,-2809,-1069,24.6,1480.8,13,0,0,6,3,5,1,0,1,0,17617,6.8,18723,221,68,2809,1069,28.9,1761.7
4856175537,0,12,10,0,3,6,5,0,0,0,0,14600,6.8,17230,170,52,-2260,-1719,22.2,1460.0,32,3,1,6,3,3,1,1,0,0,16860,7.0,18949,237,54,2260,1719,29.1,1686.0
4856107545,1,11,1,0,4,6,4,0,0,0,0,15901,6.8,16608,182,68,-988,-1932,25.0,1590.1,16,1,1,6,4,2,1,1,0,0,16889,7.2,18540,196,72,988,1932,26.8,1688.9
4853499017,1,8,1,0,4,4,4,0,0,0,0,16257,7.0,18377,204,56,1577,1681,26.0,1625.7,11,0,1,4,4,1,0,0,0,0,14680,6.4,16696,207,56,-1577,-1681,26.3,1468.0
4853469903,0,9,0,0,4,5,2,1,1,0,0,14324,6.6,16626,184,48,-1277,-227,23.2,1432.4,16,1,1,5,4,8,0,0,0,0,15601,6.6,16853,193,54,1277,227,24.7,1560.1
4853407767,0,14,0,1,7,13,5,0,0,0,0,15626,6.2,15599,151,40,-3733,-2105,19.1,1562.6,10,0,0,13,7,9,0,0,0,0,19359,7.0,17704,182,32,3733,2105,21.4,1935.9
4819370573,1,18,1,0,6,6,8,0,0,0,0,15675,6.4,15902,182,51,1055,1055,23.3,1567.5,19,1,1,6,6,5,1,1,0,0,14620,6.2,14847,146,48,-1055,-1055,19.4,1462.0
4818587620,1,13,0,1,10,3,12,0,0,0,0,18894,7.2,19551,196,64,3389,764,26.0,1889.4,12,3,0,3,10,3,1,1,0,0,15505,7.2,18787,200,64,-3389,-764,26.4,1550.5
4800094665,1,12,1,0,5,7,4,0,0,0,0,16221,6.8,17654,199,48,10,1668,24.7,1622.1,90,1,1,7,5,6,1,1,0,0,16211,6.4,15986,161,52,-10,-1668,21.3,1621.1
4798857567,1,19,0,1,8,5,5,0,0,0,0,17040,7.0,17466,178,51,1192,-492,22.9,1704.0,15,2,0,5,8,2,1,1,0,0,15848,7.0,17958,211,64,-1192,492,27.5,1584.8
4789373010,1,19,2,0,10,5,9,0,0,0,0,17973,6.8,17758,189,44,2595,161,23.3,1797.3,81,1,1,5,10,2,0,0,0,0,15378,7.0,17597,171,56,-2595,-161,22.7,1537.8
4786501237,1,145,0,1,6,2,3,1,1,0,0,15687,6.6,17524,189,40,1163,2042,22.9,1568.7,17,0,0,2,6,1,0,0,0,0,14524,6.4,15482,155,52,-1163,-2042,20.7,1452.4
4783169311,1,15,1,1,9,7,7,0,0,0,0,18319,7.0,18471,233,52,32,-558,28.5,1831.9,11,1,0,7,9,6,0,0,0,0,18287,7.2,19029,232,63,-32,558,29.5,1828.7
4783155269,1,11,19,1,5,1,3,0,0,0,0,16014,7.2,19141,217,67,2372,894,28.4,1601.4,33,1,0,0,4,0,0,0,0,0,13642,7.0,18247,212,48,-2372,-894,26.0,1364.2
4783136089,1,15,1,0,10,8,9,0,0,0,0,17197,6.6,16336,161,43,-79,-389,20.4,1719.7,48,2,1,8,10,10,0,0,0,0,17276,6.6,16725,164,66,79,389,23.0,1727.6
4781270527,1,14,2,0,1,3,1,0,0,0,0,15996,6.8,17545,218,40,674,-941,25.8,1599.6,18,1,1,3,1,0,0,0,0,0,15322,7.2,18486,197,56,-674,941,25.3,1532.2
4781246315,1,42,2,1,5,3,2,0,0,0,0,15754,7.0,17446,177,64,1059,-92,24.1,1575.4,13,0,0,3,5,2,0,0,0,0,14695,7.0,17538,196,48,-1059,92,24.4,1469.5
4781199860,1,11,3,0,6,3,6,1,1,0,0,16314,6.8,17792,168,72,1234,880,24.0,1631.4,19,2,1,3,6,3,0,0,0,0,15080,6.8,16912,208,47,-1234,-880,25.5,1508.0
4781181213,0,9,2,0,5,12,2,0,0,0,0,14333,6.6,16285,175,52,-4644,-1378,22.7,1433.3,25,3,1,11,4,16,1,1,0,0,18977,6.8,17663,217,52,4644,1378,26.9,1897.7
4848753611,1,18,1,0,10,8,9,0,0,0,0,18632,7.2,18993,217,56,2595,3015,27.3,1863.2,12,0,1,8,10,5,1,0,1,0,16037,6.6,15978,159,48,-2595,-3015,20.7,1603.7
4848712212,0,15,0,1,7,2,10,1,1,0,0,16955,7.0,18103,182,68,1819,553,25.0,1695.5,14,1,0,2,7,1,0,0,0,0,15136,6.4,17550,188,52,-1819,-553,24.0,1513.6
4845760386,1,15,1,0,4,3,5,0,0,0,0,15530,6.8,17903,209,52,-530,-759,26.1,1553.0,77,2,1,3,4,4,0,0,0,0,16060,7.4,18662,223,64,530,759,28.7,1606.0
4838837027,0,10,0,0,5,5,3,0,0,0,0,15005,6.8,16524,169,48,-1486,-259,21.7,1500.5,12,1,1,5,5,4,1,1,0,0,16491,6.6,16783,202,64,1486,259,26.6,1649.1
4831863959,1,13,1,1,6,6,1,0,0,0,0,15476,7.0,18256,207,56,-196,1406,26.3,1547.6,19,1,0,6,6,7,0,0,0,0,15672,6.8,16850,187,46,196,-1406,23.3,1567.2
4817833746,1,19,2,0,5,4,6,0,0,0,0,16748,6.8,17456,161,48,1779,474,20.9,1674.8,6,1,1,4,5,4,0,0,0,0,14969,6.6,16982,183,36,-1779,-474,21.9,1496.9
4680850424,1,12,2,1,5,4,2,0,0,0,0,15870,7.2,18307,186,48,642,-144,23.4,1587.0,11,2,0,4,5,1,0,0,0,0,15228,6.8,18451,213,50,-642,144,26.3,1522.8
4680816609,1,19,2,1,7,3,7,1,1,0,0,17508,7.0,19144,202,51,2055,1869,25.3,1750.8,9,2,0,3,7,3,1,0,1,0,15453,6.8,17275,216,58,-2055,-1869,27.4,1545.3
4680758231,1,17,2,1,3,5,5,0,0,0,0,14383,6.6,15864,180,43,-1393,-1477,22.3,1438.3,20,2,0,5,3,7,1,1,0,0,15776,6.8,17341,210,58,1393,1477,26.8,1577.6
4680742799,0,48,1,0,7,13,5,0,0,0,0,15743,7.0,17440,153,47,-3705,-1004,20.0,1574.3,21,1,1,13,7,10,1,1,0,0,19448,7.0,18444,219,60,3705,1004,27.9,1944.8
4669730487,0,76,2,1,3,3,2,0,0,0,0,15277,6.8,17493,204,48,-507,-102,25.2,1527.7,13,2,0,3,3,3,0,0,0,0,15784,6.6,17595,190,60,507,102,25.0,1578.4
4669688496,1,13,1,1,6,5,2,0,0,0,0,16269,7.2,18482,215,60,916,669,27.5,1626.9,7,1,0,5,6,1,0,0,0,0,15353,6.8,17813,212,52,-916,-669,26.4,1535.3
4669590805,0,119,10,0,0,6,0,0,0,0,0,13770,6.8,17774,194,60,-4039,297,25.4,1377.0,34,1,1,6,0,8,0,0,0,0,17809,6.8,17477,226,40,4039,-297,26.6,1780.9
4669553303,0,27,1,0,1,2,3,1,1,0,0,14062,6.8,17208,224,56,-1879,17,28.0,1406.2,12,9,1,2,1,3,0,0,0,0,15941,6.6,17191,230,56,1879,-17,28.6,1594.1
4669539054,0,7,4,1,2,7,3,0,0,0,0,13218,6.4,15644,142,40,-4090,-2935,18.2,1321.8,13,1,0,7,2,5,1,1,0,0,17308,6.8,18579,205,76,4090,2935,28.1,1730.8
4668580600,0,14,3,1,5,9,6,0,0,0,0,15106,6.8,17138,193,44,-1877,-1656,23.7,1510.6,26,3,0,9,5,9,1,1,0,0,16983,7.2,18794,210,59,1877,1656,26.9,1698.3
4668545188,0,10,3,0,5,4,7,1,1,0,0,15875,6.6,17229,202,63,700,164,26.5,1587.5,19,0,1,4,5,3,0,0,0,0,15175,6.6,17065,195,51,-700,-164,24.6,1517.5
4668526051,0,12,2,1,7,8,5,0,0,0,0,16981,6.4,16750,199,46,-5,-316,24.5,1698.1,11,2,0,8,7,7,0,0,0,0,16986,6.8,17066,189,60,5,316,24.9,1698.6
4668490826,0,13,0,1,2,5,1,1,1,0,0,13174,6.6,16263,181,52,-4427,-3114,23.3,1317.4,15,3,0,5,2,6,0,0,0,0,17601,7.2,19377,210,72,4427,3114,28.2,1760.1
4854926957,1,15,1,0,4,7,1,1,1,0,0,14536,6.6,17248,209,44,-2315,-52,25.3,1453.6,10,3,1,7,4,5,0,0,0,0,16851,6.8,17300,215,51,2315,52,26.6,1685.1
4854893893,0,8,1,0,12,5,11,0,0,0,0,18656,6.8,17685,194,55,3418,1400,24.9,1865.6,10,0,1,5,12,4,1,1,0,0,15238,6.4,16285,162,61,-3418,-1400,22.3,1523.8
4854850798,0,12,0,0,5,5,4,0,0,0,0,15430,6.6,17301,180,48,-956,-1342,22.8,1543.0,7,0,1,5,5,3,0,0,0,0,16386,6.8,18643,196,60,956,1342,25.6,1638.6
4852840065,1,0,0,0,18,16,17,0,0,0,0,46300,10.0,47500,0,0,18775,19000,0.0,4630.0,0,0,1,11,13,9,0,0,0,0,27525,6.0,28500,1,0,-18775,-19000,0.1,2752.5
4852768612,1,10,0,1,5,3,4,0,0,0,0,15049,6.8,17050,164,63,62,-354,22.7,1504.9,21,0,0,3,5,4,1,1,0,0,14987,6.6,17404,214,68,-62,354,28.2,1498.7
4852388027,0,11,0,1,6,6,8,0,0,0,0,16979,6.8,17515,192,48,-581,-1126,24.0,1697.9,12,2,0,6,6,5,0,0,0,0,17560,7.0,18641,184,64,581,1126,24.8,1756.0
4851974839,1,0,0,0,23,29,65,0,0,0,0,37701,11.2,41598,109,0,41,-215,10.9,3770.1,31,0,1,29,23,79,0,0,0,0,37660,11.4,41813,92,0,-41,215,9.2,3766.0
4851953077,0,0,0,1,22,21,61,0,0,0,2,37613,10.6,37540,126,0,526,-649,12.6,3761.3,0,0,0,21,22,58,0,0,0,0,37087,11.0,38189,103,0,-526,649,10.3,3708.7
4851918581,0,26,0,1,23,23,53,0,0,0,0,37706,11.8,42942,95,0,568,2273,9.5,3770.6,17,0,0,23,23,42,0,0,0,0,37138,11.0,40669,107,0,-568,-2273,10.7,3713.8
4851896707,1,0,0,0,30,21,73,0,0,0,0,40880,12.0,45979,118,0,4155,5054,11.8,4088.0,0,0,1,21,30,53,0,0,0,0,36725,11.0,40925,104,0,-4155,-5054,10.4,3672.5
4851060263,0,10,0,0,4,4,5,0,0,0,0,15934,6.6,17511,201,42,-1216,-1808,24.3,1593.4,194,0,1,4,4,5,1,1,0,0,17150,6.8,19319,250,52,1216,1808,30.2,1715.0
4851018488,1,12,0,1,7,6,4,1,1,0,0,17069,7.2,18665,207,64,243,394,27.1,1706.9,12,0,0,6,7,7,0,0,0,0,16826,7.2,18271,218,54,-243,-394,27.2,1682.6
4850989699,0,21,2,0,3,6,3,0,0,0,0,14920,6.4,15787,190,44,-2546,-3635,23.4,1492.0,10,2,1,6,3,3,0,0,0,0,17466,7.2,19422,241,72,2546,3635,31.3,1746.6
4850951413,0,9,0,0,9,10,4,0,0,0,0,17450,6.8,17160,155,60,-1522,-845,21.5,1745.0,9,1,1,10,9,8,1,1,0,0,18972,6.8,18005,219,55,1522,845,27.4,1897.2
4849147322,1,13,0,1,5,1,5,0,0,0,0,16421,7.0,18024,241,48,2504,905,28.9,1642.1,7,1,0,1,5,1,0,0,0,0,13917,6.6,17119,210,59,-2504,-905,26.9,1391.7
4848815727,1,0,0,0,34,18,78,0,0,0,1,41237,12.0,44894,117,0,4921,5960,11.7,4123.7,0,0,1,18,34,55,0,0,0,0,36316,10.8,38934,106,0,-4921,-5960,10.6,3631.6
4848789766,1,0,0,0,18,22,37,0,0,0,0,36032,11.4,41210,100,0,-330,683,10.0,3603.2,0,0,1,22,18,55,0,0,0,0,36362,11.0,40527,107,0,330,-683,10.7,3636.2
4848047139,0,0,0,1,16,18,46,0,0,0,0,36227,10.8,37921,99,0,1725,154,9.9,3622.7,0,0,0,18,16,40,0,0,0,0,34502,10.8,37767,105,0,-1725,-154,10.5,3450.2
4848011650,1,0,0,0,19,19,39,0,0,0,2,36075,10.8,38988,102,0,-28,887,10.2,3607.5,0,0,1,18,18,52,0,0,0,0,36103,10.8,38101,114,0,28,-887,11.4,3610.3
4753040873,1,15,0,1,11,7,12,0,0,0,0,20709,6.6,17379,202,48,3513,1145,25.0,2070.9,11,0,0,7,11,7,1,0,1,0,17196,6.6,16234,172,60,-3513,-1145,23.2,1719.6
4753004240,0,10,1,0,8,6,11,1,1,0,0,16502,6.6,17011,165,48,496,-696,21.3,1650.2,9,1,1,6,8,4,0,0,0,0,16006,7.0,17707,214,44,-496,696,25.8,1600.6
4752957988,1,106,2,1,7,6,5,0,0,0,0,16742,6.6,16287,194,32,-558,-1473,22.6,1674.2,15,4,0,6,7,3,1,1,0,0,17300,6.6,17760,199,60,558,1473,25.9,1730.0
4752904698,1,99,9,1,8,5,9,0,0,0,0,17973,6.8,18098,170,52,3026,1864,22.2,1797.3,39,2,0,5,8,4,0,0,0,0,14947,6.6,16234,148,52,-3026,-1864,20.0,1494.7
4752298059,1,10,1,1,6,1,5,1,0,1,0,17245,7.0,18877,193,68,3191,1826,26.1,1724.5,11,0,0,1,6,0,0,0,0,0,14054,6.6,17051,182,56,-3191,-1826,23.8,1405.4
4752276187,1,8,2,1,6,8,7,1,1,0,0,15759,6.8,16753,189,56,-2024,-454,24.5,1575.9,17,2,0,8,6,13,0,0,0,0,17783,6.6,17207,225,60,2024,454,28.5,1778.3
4751720150,1,11,2,0,3,6,2,0,0,0,0,15973,6.8,17582,200,57,-1322,-1439,25.7,1597.3,15,1,1,6,3,6,0,0,0,0,17295,7.2,19021,215,51,1322,1439,26.6,1729.5
4751399953,1,269,2,0,8,7,4,1,1,0,0,18533,6.8,18249,169,60,1340,183,22.9,1853.3,15,1,1,7,8,2,0,0,0,0,17193,6.8,18066,150,52,-1340,-183,20.2,1719.3
4751388117,1,14,1,0,2,4,2,0,0,0,0,15577,6.8,17313,226,52,-188,-825,27.8,1557.7,13,2,1,4,2,3,1,1,0,0,15765,7.0,18138,211,56,188,825,26.7,1576.5
4751367713,1,10,1,0,8,4,6,1,1,0,0,16596,6.6,17294,208,48,1507,-48,25.6,1659.6,15,0,1,4,8,4,0,0,0,0,15089,6.8,17342,178,52,-1507,48,23.0,1508.9
4751361333,1,9,0,0,4,2,5,0,0,0,0,15327,7.0,18705,207,52,830,-278,25.9,1532.7,6,0,1,2,4,2,0,0,0,0,14497,7.0,18983,198,68,-830,278,26.6,1449.7
4751348953,0,13,0,1,6,2,3,0,0,0,0,16203,7.0,18648,208,56,2004,2476,26.4,1620.3,6,3,0,2,6,2,0,0,0,0,14199,6.4,16172,195,40,-2004,-2476,23.5,1419.9
4751307220,0,68,6,1,9,12,8,0,0,0,0,18319,6.8,16801,171,56,-716,-1713,22.7,1831.9,35,1,0,12,9,11,0,0,0,0,19035,7.0,18514,187,72,716,1713,25.9,1903.5
4751275582,1,17,0,1,9,6,10,1,0,1,0,17750,6.4,16502,167,48,1558,-464,21.5,1775.0,15,3,0,6,9,5,0,0,0,0,16192,6.6,16966,199,48,-1558,464,24.7,1619.2
4751237311,1,16,2,0,10,4,8,2,1,1,0,17861,7.0,17728,171,68,2104,274,23.9,1786.1,10,3,1,4,10,2,0,0,0,0,15757,6.8,17454,202,56,-2104,-274,25.8,1575.7
4750374893,1,13,0,0,4,7,0,0,0,0,0,14989,7.0,18339,193,56,-1757,1429,24.9,1498.9,14,2,1,7,4,8,1,1,0,0,16746,6.8,16910,189,44,1757,-1429,23.3,1674.6
4750347200,1,12,1,1,5,3,4,0,0,0,0,16644,6.8,18422,202,48,1199,1512,25.0,1664.4,10,1,0,3,5,2,0,0,0,0,15445,6.4,16910,193,60,-1199,-1512,25.3,1544.5
4750313998,0,17,1,1,4,7,4,0,0,0,0,15729,6.8,16985,206,48,-575,-1093,25.4,1572.9,15,2,0,7,4,5,0,0,0,0,16304,7.2,18078,194,52,575,1093,24.6,1630.4
4749787777,1,12,4,1,6,4,7,0,0,0,0,17725,7.0,17219,184,60,1277,-487,24.4,1772.5,14,2,0,4,6,3,0,0,0,0,16448,6.8,17706,236,56,-1277,487,29.2,1644.8
4749760318,0,10,0,0,7,8,5,1,1,0,0,16593,6.8,17828,174,60,-790,-744,23.4,1659.3,9,0,1,8,7,4,0,0,0,0,17383,7.2,18572,177,62,790,744,23.9,1738.3
4857401597,1,21,3,1,3,1,4,1,1,0,0,15368,7.0,17954,194,60,1213,-43,25.4,1536.8,70,2,0,1,3,0,0,0,0,0,14155,7.0,17997,196,60,-1213,43,25.6,1415.5
4857371322,0,14,0,0,2,2,1,0,0,0,0,14391,6.8,17792,202,46,-650,-604,24.8,1439.1,11,2,1,2,2,0,0,0,0,0,15041,7.0,18396,236,70,650,604,30.6,1504.1
4856236147,1,21,2,1,6,1,6,1,1,0,0,17841,7.4,20042,227,68,3747,2675,29.5,1784.1,9,2,0,1,6,1,0,0,0,0,14094,6.8,17367,204,48,-3747,-2675,25.2,1409.4
4856032797,0,11,0,0,5,6,6,0,0,0,0,14733,6.4,15865,136,50,-2546,-1627,18.6,1473.3,10,0,1,6,5,5,0,0,0,0,17279,6.8,17492,237,44,2546,1627,28.1,1727.9
4855665165,1,4,1,1,7,5,3,1,1,0,0,16839,7.4,19806,192,80,1407,3193,27.2,1683.9,14,0,0,5,7,3,0,0,0,0,15432,6.6,16613,174,34,-1407,-3193,20.8,1543.2
4855605135,1,17,0,1,20,23,52,0,0,0,0,34586,10.8,38586,87,0,-2498,-998,8.7,3458.6,0,0,0,23,20,57,0,0,0,0,37084,11.0,39584,107,0,2498,998,10.7,3708.4
4855599924,0,0,0,1,23,18,61,0,0,0,1,36952,11.0,39916,97,0,57,-523,9.7,3695.2,3,0,0,18,23,34,0,0,0,0,36895,11.2,40439,114,0,-57,523,11.4,3689.5
4855593983,1,34,0,1,28,27,81,0,0,0,1,39128,11.2,42088,113,0,1320,454,11.3,3912.8,34,0,0,27,28,58,0,0,0,0,37808,11.2,41634,92,0,-1320,-454,9.2,3780.8
4855062703,0,9,0,1,3,4,0,0,0,0,0,14347,7.0,18000,198,56,-356,125,25.4,1434.7,9,0,0,4,3,4,0,0,0,0,14703,6.8,17875,167,64,356,-125,23.1,1470.3
4854713781,1,11,2,1,8,11,9,1,1,0,0,16910,6.0,14833,157,48,-1132,-2322,20.5,1691.0,21,3,0,11,8,11,0,0,0,0,18042,6.8,17155,179,52,1132,2322,23.1,1804.2
4854605949,0,15,0,0,5,6,7,0,0,0,0,14829,6.8,16996,160,48,-1120,-351,20.8,1482.9,8,0,1,6,5,3,1,1,0,0,15949,7.0,17347,184,56,1120,351,24.0,1594.9
4853571173,1,71,0,0,3,6,3,0,0,0,0,14768,6.6,17484,174,60,-287,-613,23.4,1476.8,10,0,1,6,3,2,0,0,0,0,15055,6.8,18097,177,52,287,613,22.9,1505.5
4850931957,1,53,0,0,3,1,5,0,0,0,0,15226,6.8,18354,224,49,436,-256,27.3,1522.6,9,2,1,1,3,1,0,0,0,0,14790,7.2,18610,233,52,-436,256,28.5,1479.0
4850890390,0,17,0,0,5,11,5,0,0,0,0,14740,6.4,15962,202,28,-2908,-745,23.0,1474.0,14,0,1,11,5,15,1,1,0,0,17648,6.8,16707,185,52,2908,745,23.7,1764.8
4850840146,1,31,2,1,8,7,13,0,0,0,0,16825,6.6,16915,183,48,79,-744,23.1,1682.5,36,0,0,6,7,6,0,0,0,0,16746,6.8,17659,195,56,-79,744,25.1,1674.6
4850350332,1,10,2,1,3,5,4,0,0,0,0,15725,6.8,17160,202,36,-667,-1010,23.8,1572.5,9,1,0,5,3,5,0,0,0,0,16392,7.0,18170,155,56,667,1010,21.1,1639.2
4850333659,1,16,1,0,6,9,4,1,1,0,0,17859,6.8,17919,187,47,1602,604,23.4,1785.9,10,0,1,9,6,8,1,0,1,0,16257,6.6,17315,172,56,-1602,-604,22.8,1625.7
4849971963,0,55,1,0,5,8,2,0,0,0,0,14957,6.8,17649,186,59,-2773,-1375,24.5,1495.7,9,1,1,8,5,6,0,0,0,0,17730,7.4,19024,213,60,2773,1375,27.3,1773.0
4847560475,0,11,0,1,8,11,6,0,0,0,0,16877,6.6,16524,160,60,-2240,-1019,22.0,1687.7,12,1,0,11,8,13,0,0,0,0,19117,7.0,17543,173,36,2240,1019,20.9,1911.7
4842841902,1,19,0,0,23,37,51,0,0,0,2,38030,11.0,40580,103,0,-3731,-3788,10.3,3803.0,0,0,1,37,23,109,0,0,0,0,41761,11.8,44368,116,0,3731,3788,11.6,4176.1
4820592609,0,50,0,0,5,4,0,0,0,0,0,16623,7.0,18734,191,64,-202,-1127,25.5,1662.3,71,0,1,3,4,2,0,0,0,0,16825,7.2,19861,208,66,202,1127,27.4,1682.5
4807519979,0,22,5,1,6,3,6,0,0,0,0,16814,6.8,17667,233,44,917,463,27.7,1681.4,11,1,0,3,6,5,1,1,0,0,15897,6.6,17204,214,56,-917,-463,27.0,1589.7
4807297906,0,11,1,1,4,2,3,1,1,0,0,15768,6.8,17765,212,52,-315,-259,26.4,1576.8,7,0,0,2,4,2,0,0,0,0,16083,6.8,18024,220,60,315,259,28.0,1608.3
4807151422,1,79,2,1,4,1,2,1,1,0,0,16310,7.0,18554,224,64,793,1095,28.8,1631.0,10,1,0,1,4,0,0,0,0,0,15517,6.8,17459,201,51,-793,-1095,25.2,1551.7
4806913430,1,14,0,1,5,2,5,0,0,0,0,18144,7.4,18818,264,50,3542,1161,31.4,1814.4,13,2,0,2,5,2,0,0,0,0,14602,6.8,17657,205,48,-3542,-1161,25.3,1460.2
4806085485,0,11,0,1,7,4,3,0,0,0,0,16569,6.8,18162,203,56,239,56,25.9,1656.9,10,1,0,4,7,1,0,0,0,0,16330,7.0,18106,222,52,-239,-56,27.4,1633.0
4798719663,0,73,0,0,0,3,0,0,0,0,0,13911,6.8,17672,195,56,-1870,-1085,25.1,1391.1,13,1,1,3,0,2,1,1,0,0,15781,6.8,18757,227,60,1870,1085,28.7,1578.1
4798601664,0,14,0,0,4,9,4,1,1,0,0,16616,7.0,18261,212,44,-2318,-885,25.6,1661.6,10,2,1,9,4,8,0,0,0,0,18934,7.2,19146,216,64,2318,885,28.0,1893.4
4798568978,1,13,2,0,3,3,3,0,0,0,0,15506,7.2,18667,204,56,553,1647,26.0,1550.6,18,1,1,3,3,2,0,0,0,0,14953,6.8,17020,216,40,-553,-1647,25.6,1495.3
4794649110,1,14,1,0,6,5,4,0,0,0,0,17094,6.8,17261,203,37,1600,1090,24.0,1709.4,18,2,1,5,6,6,1,1,0,0,15494,6.4,16171,156,58,-1600,-1090,21.4,1549.4
4794607929,1,12,1,1,2,4,1,0,0,0,0,15426,6.8,17172,221,48,-844,-191,26.9,1542.6,11,2,0,4,2,4,1,1,0,0,16270,6.8,17363,205,44,844,191,24.9,1627.0
4794586918,1,11,0,1,6,5,9,0,0,0,0,16296,6.8,17072,195,52,-92,-1898,24.7,1629.6,11,2,0,4,5,3,0,0,0,0,16388,7.0,18970,215,72,92,1898,28.7,1638.8
4794367608,1,9,1,1,4,2,2,1,1,0,0,16640,6.8,18626,228,68,1726,692,29.6,1664.0,13,0,0,2,4,3,0,0,0,0,14914,7.2,17934,199,56,-1726,-692,25.5,1491.4
4794325620,0,13,0,0,4,3,2,0,0,0,0,17491,7.2,19174,233,56,2514,1586,28.9,1749.1,9,1,1,3,4,2,0,0,0,0,14977,7.0,17588,187,64,-2514,-1586,25.1,1497.7
4794299473,0,18,5,0,7,4,6,0,0,0,0,18797,7.0,17054,199,44,2157,524,24.3,1879.7,14,2,1,4,7,5,0,0,0,0,16640,6.4,16530,197,36,-2157,-524,23.3,1664.0
4794104482,1,12,1,1,6,3,6,1,1,0,0,19291,7.0,18254,239,54,4226,2000,29.3,1929.1,11,0,0,3,6,2,0,0,0,0,15065,6.6,16254,158,51,-4226,-2000,20.9,1506.5
4794071264,1,8,2,1,5,5,3,1,1,0,0,16689,6.8,18043,183,60,738,1035,24.3,1668.9,27,2,0,5,5,4,0,0,0,0,15951,6.6,17008,179,52,-738,-1035,23.1,1595.1
4794031439,0,14,0,1,5,5,0,0,0,0,0,15214,6.6,16714,203,44,-1526,-1738,24.7,1521.4,12,0,0,5,5,3,1,1,0,0,16740,7.0,18452,199,71,1526,1738,27.0,1674.0
4793969871,0,11,1,1,4,1,2,0,0,0,0,16291,6.8,18502,247,60,1398,-328,30.7,1629.1,12,1,0,1,4,1,1,1,0,0,14893,7.0,18830,195,80,-1398,328,27.5,1489.3
4793937112,1,16,1,0,9,4,11,1,1,0,0,18083,7.0,17436,202,40,1596,-694,24.2,1808.3,9,1,1,4,9,4,0,0,0,0,16487,7.0,18130,230,64,-1596,694,29.4,1648.7
4857456832,0,0,0,1,21,29,56,0,0,0,2,35925,10.8,38284,71,0,-3795,-3984,7.1,3592.5,16,0,0,29,21,61,0,0,0,0,39720,11.2,42268,117,0,3795,3984,11.7,3972.0
4848925984,1,2,0,1,2,1,0,0,0,0,0,11574,5.0,13219,129,0,468,-122,12.9,1157.4,0,0,0,1,2,1,0,0,0,0,11106,5.4,13341,111,0,-468,122,11.1,1110.6
4845505791,0,0,0,1,15,16,36,0,0,0,2,34793,10.0,33918,107,0,-1339,-4377,10.7,3479.3,9,0,0,16,15,46,0,0,0,0,36132,10.8,38295,98,0,1339,4377,9.8,3613.2
4845497271,1,0,0,0,15,17,34,0,0,0,2,34274,10.4,36330,97,0,-3076,-2871,9.7,3427.4,0,0,1,17,15,51,0,0,0,0,37350,10.6,39201,93,0,3076,2871,9.3,3735.0
4845491188,1,0,0,0,20,19,54,0,0,0,1,37622,11.0,40116,124,0,1694,1735,12.4,3762.2,16,0,1,19,20,46,0,0,0,0,35928,10.6,38381,97,0,-1694,-1735,9.7,3592.8
4845488819,1,0,0,0,14,18,39,0,0,0,1,33764,10.0,33874,94,0,-2796,-4786,9.4,3376.4,0,0,1,18,14,58,0,0,0,0,36560,11.0,38660,120,0,2796,4786,12.0,3656.0
4845484779,0,26,0,0,23,30,60,0,0,0,0,37714,11.4,42071,95,0,-2296,-3075,9.5,3771.4,6,22,1,30,23,74,0,0,0,0,40010,12.0,45146,106,0,2296,3075,10.6,4001.0
4845479822,0,3,0,1,21,32,44,0,0,0,1,36972,11.0,39962,112,0,-1877,-4157,11.2,3697.2,12,1,0,32,21,87,0,0,0,0,38849,12.0,44119,98,0,1877,4157,9.8,3884.9
4845441652,1,9,0,1,18,18,43,0,0,0,0,35868,10.8,38473,119,0,276,1161,11.9,3586.8,0,0,0,18,18,40,0,0,0,0,35592,10.6,37312,101,0,-276,-1161,10.1,3559.2
4845431015,1,0,0,1,31,35,94,0,0,0,2,39759,11.6,43812,96,0,-1277,1189,9.6,3975.9,0,0,0,35,31,105,0,0,0,0,41036,11.6,42623,100,0,1277,-1189,10.0,4103.6
4845417209,0,20,0,0,21,18,44,0,0,0,0,36712,11.2,39760,119,0,1001,1319,11.9,3671.2,0,20,1,18,21,59,0,0,0,0,35711,10.8,38441,102,0,-1001,-1319,10.2,3571.1
4845404860,1,0,0,1,27,22,64,0,0,0,1,38999,11.4,42210,110,0,3063,3054,11.0,3899.9,0,0,0,22,27,43,0,0,0,0,35936,11.2,39156,94,0,-3063,-3054,9.4,3593.6
4844535289,1,0,0,0,23,27,40,0,0,0,1,35834,11.0,39847,99,0,-3629,-4087,9.9,3583.4,6,0,1,26,22,58,0,0,0,0,39463,11.8,43934,111,0,3629,4087,11.1,3946.3
4844530857,0,13,0,0,21,31,38,0,0,0,0,36560,11.4,41663,100,0,-3458,-2012,10.0,3656.0,0,0,1,31,21,81,0,0,0,0,40018,11.6,43675,104,0,3458,2012,10.4,4001.8
4844513427,1,14,26,1,30,24,77,0,0,0,1,40404,11.8,44507,109,0,3107,3873,10.9,4040.4,27,3,0,24,30,64,0,0,0,0,37297,11.2,40634,104,0,-3107,-3873,10.4,3729.7
4844500563,1,0,2,1,19,20,53,0,0,0,1,38420,11.2,39888,123,0,3950,2565,12.3,3842.0,16,0,0,20,19,51,0,0,0,0,34470,10.6,37323,73,0,-3950,-2565,7.3,3447.0
4844498057,1,68,0,0,34,20,109,0,0,0,2,41941,12.0,45367,106,0,5616,4846,10.6,4194.1,0,0,1,20,34,57,0,0,0,0,36325,11.0,40521,84,0,-5616,-4846,8.4,3632.5
4842674026,1,18,0,0,16,19,43,0,0,0,1,34261,10.4,35229,91,0,-2525,-4817,9.1,3426.1,0,0,1,19,16,51,0,0,0,0,36786,11.0,40046,111,0,2525,4817,11.1,3678.6
4842598137,0,0,0,1,22,19,59,0,0,0,0,37492,11.0,39594,109,0,1408,1361,10.9,3749.2,0,0,0,19,22,52,0,0,0,0,36084,10.8,38233,106,0,-1408,-1361,10.6,3608.4
4839193775,1,9,1,0,6,6,3,0,0,0,0,15558,7.2,18685,187,68,-770,1235,25.5,1555.8,14,2,1,6,6,5,1,1,0,0,16328,6.6,17450,202,56,770,-1235,25.8,1632.8
4839150358,1,176,1,0,12,1,10,2,1,1,0,18196,7.0,18200,213,40,4559,2037,25.3,1819.6,15,0,1,1,12,3,0,0,0,0,13637,6.6,16163,201,56,-4559,-2037,25.7,1363.7
4839113765,0,13,1,0,4,11,5,0,0,0,1,14816,6.8,17572,180,48,-6471,-2376,22.8,1481.6,89,3,1,11,4,14,1,1,0,0,21287,7.6,19948,220,56,6471,2376,27.6,2128.7
4839083100,1,11,1,1,7,4,10,0,0,0,0,17588,6.8,17535,207,44,1749,902,25.1,1758.8,8,2,0,4,7,3,1,1,0,0,15839,6.6,16633,212,56,-1749,-902,26.8,1583.9
4835114036,0,10,6,0,7,6,5,1,1,0,0,16953,6.4,16698,193,48,-897,-1588,24.1,1695.3,44,0,1,6,7,8,0,0,0,0,17850,7.0,18286,198,53,897,1588,25.1,1785.0
4835080226,1,18,2,0,4,7,6,0,0,0,0,16469,6.8,17466,184,53,631,1282,23.7,1646.9,17,1,1,7,4,4,1,1,0,0,15838,6.4,16184,196,44,-631,-1282,24.0,1583.8
4833755558,1,12,6,1,6,2,7,0,0,0,0,16389,7.0,17949,221,48,1475,91,26.9,1638.9,89,0,0,2,6,2,1,1,0,0,14914,6.8,17858,201,56,-1475,-91,25.7,1491.4
4824521857,1,23,5,1,14,11,13,0,0,0,0,20101,7.0,17760,217,32,2578,-141,24.9,2010.1,12,0,0,11,14,4,0,0,0,0,17523,7.0,17901,164,52,-2578,141,21.6,1752.3
4824391486,1,11,0,1,6,7,1,0,0,0,0,15137,6.6,16758,216,27,-2138,-637,24.3,1513.7,9,1,0,7,6,8,0,0,0,0,17275,6.8,17395,220,56,2138,637,27.6,1727.5
4824236688,0,9,1,0,5,8,4,0,0,0,0,15824,6.4,16005,191,44,-1986,-1727,23.5,1582.4,15,0,1,8,5,6,0,0,0,0,17810,6.8,17732,225,48,1986,1727,27.3,1781.0
4824229100,1,21,1,0,8,4,4,0,0,0,0,16846,7.0,18340,196,72,1643,2225,26.8,1684.6,12,2,1,4,8,8,0,0,0,0,15203,6.4,16115,187,50,-1643,-2225,23.7,1520.3
4823654914,0,11,0,1,8,4,11,1,1,0,0,16715,6.6,16287,188,52,1700,-23,24.0,1671.5,12,0,0,4,8,2,0,0,0,0,15015,6.4,16310,192,60,-1700,23,25.2,1501.5
4823620906,0,32,0,0,4,5,4,0,0,0,0,15632,6.6,17812,168,58,-214,349,22.6,1563.2,14,0,1,5,4,5,1,1,0,0,15846,6.8,17463,194,50,214,-349,24.4,1584.6
4823597072,1,11,0,1,8,5,3,0,0,0,0,16211,7.0,17713,188,56,506,223,24.4,1621.1,14,1,0,5,8,6,0,0,0,0,15705,6.6,17490,215,52,-506,-223,26.7,1570.5
4823579344,1,15,1,0,16,8,17,0,0,0,0,19321,7.0,18493,184,55,2911,2876,23.9,1932.1,9,4,1,7,15,7,0,0,0,0,16410,6.4,15617,186,52,-2911,-2876,23.8,1641.0
4823533434,1,9,1,1,11,7,9,0,0,0,0,18021,6.8,17188,211,16,2497,348,22.7,1802.1,10,2,0,7,11,8,1,1,0,0,15524,6.6,16840,139,56,-2497,-348,19.5,1552.4
4823516510,1,77,1,1,9,3,8,0,0,0,0,18657,7.0,18217,222,48,4309,1197,27.0,1865.7,14,0,0,3,9,0,1,1,0,0,14348,6.6,17020,203,52,-4309,-1197,25.5,1434.8
4822597991,1,8,4,1,6,3,4,0,0,0,0,17084,6.6,16856,190,47,2025,1463,23.7,1708.4,9,3,0,3,6,5,0,0,0,0,15059,6.4,15393,170,44,-2025,-1463,21.4,1505.9
4822372107,0,11,0,0,1,7,0,0,0,0,0,15062,6.6,15978,152,53,-2643,-2822,20.5,1506.2,21,2,1,7,1,3,0,0,0,0,17705,7.0,18800,237,52,2643,2822,28.9,1770.5
4819060930,0,15,0,1,4,3,4,1,1,0,0,16499,7.0,18082,220,68,597,-871,28.8,1649.9,12,1,0,3,4,2,0,0,0,0,15902,7.0,18953,218,67,-597,871,28.5,1590.2
4847681022,1,14,0,0,6,5,7,0,0,0,0,18098,6.8,18076,187,52,1450,1025,23.9,1809.8,11,2,1,5,6,5,1,1,0,0,16648,6.8,17051,221,48,-1450,-1025,26.9,1664.8
4847656239,0,13,1,0,4,4,4,1,1,0,0,15117,7.0,17889,203,48,-1296,206,25.1,1511.7,10,1,1,4,4,3,1,0,1,0,16413,6.8,17683,216,48,1296,-206,26.4,1641.3
4844089100,0,12,1,1,5,6,5,0,0,0,0,16285,6.8,17912,195,52,550,158,24.7,1628.5,11,1,0,6,5,9,1,1,0,0,15735,7.0,17754,202,64,-550,-158,26.6,1573.5
4844039272,1,16,2,0,5,7,5,1,1,0,0,16918,7.0,17885,222,56,483,1186,27.8,1691.8,104,1,1,7,5,5,0,0,0,0,16435,6.6,16699,202,40,-483,-1186,24.2,1643.5
4840152120,0,14,18,1,7,4,6,0,0,0,0,15935,6.6,16629,179,40,-1040,-1179,21.9,1593.5,42,2,0,4,7,3,0,0,0,0,16975,6.8,17808,240,46,1040,1179,28.6,1697.5
4833951993,0,11,4,1,6,2,5,1,1,0,0,16855,7.2,18892,213,68,1917,608,28.1,1685.5,13,1,0,2,6,3,0,0,0,0,14938,6.8,18284,229,59,-1917,-608,28.8,1493.8
4832996740,0,8,1,1,4,6,6,0,0,0,0,16376,6.6,17627,201,48,-206,84,24.9,1637.6,84,0,0,6,4,5,0,0,0,0,16582,7.0,17543,220,44,206,-84,26.4,1658.2
4821701808,0,13,2,1,4,3,4,1,1,0,0,16267,7.0,18311,222,64,1160,304,28.6,1626.7,18,2,0,3,4,3,0,0,0,0,15107,6.8,18007,224,59,-1160,-304,28.3,1510.7
4820733130,0,9,1,0,11,5,9,0,0,0,0,19791,7.2,18833,248,56,3037,1359,30.4,1979.1,6,0,1,5,11,7,0,0,0,0,16754,6.6,17474,217,52,-3037,-1359,26.9,1675.4
4819930981,1,11,14,1,1,2,2,0,0,0,0,14105,6.8,15996,227,38,-611,-2013,26.5,1410.5,33,1,0,2,1,0,0,0,0,0,14716,7.0,18009,215,56,611,2013,27.1,1471.6
4819870571,1,10,2,1,3,4,3,0,0,0,0,14503,6.8,16560,195,50,-2959,-3083,24.5,1450.3,12,0,0,4,3,1,1,1,0,0,17462,7.4,19643,230,64,2959,3083,29.4,1746.2
4819839059,1,21,1,1,8,1,7,0,0,0,0,18321,7.0,18312,211,56,4633,1976,26.7,1832.1,13,0,0,1,8,1,1,1,0,0,13688,6.6,16336,191,48,-4633,-1976,23.9,1368.8
4819793974,1,15,1,1,2,4,2,1,1,0,0,15123,6.8,17565,226,59,-863,-1145,28.5,1512.3,19,3,0,4,2,3,0,0,0,0,15986,7.0,18710,225,56,863,1145,28.1,1598.6
4774101673,0,19,0,1,5,2,4,0,0,0,0,16103,6.6,16614,206,48,2812,598,25.4,1610.3,9,0,0,2,5,1,0,0,0,0,13291,6.6,16016,180,48,-2812,-598,22.8,1329.1
4774060946,1,11,0,0,6,8,2,0,0,0,0,15611,6.8,17061,160,56,-1772,-65,21.6,1561.1,19,0,1,8,6,5,0,0,0,0,17383,6.6,17126,210,42,1772,65,25.2,1738.3
4774030894,0,11,0,0,8,10,5,0,0,0,0,16626,6.4,16134,172,32,-1622,-2689,20.4,1662.6,79,0,1,10,8,5,0,0,0,0,18248,7.2,18823,176,63,1622,2689,23.9,1824.8
4680048607,1,36,1,1,8,2,8,1,1,0,0,17656,7.2,18905,177,69,3285,2847,24.6,1765.6,15,12,0,2,8,2,0,0,0,0,14371,6.4,16058,155,56,-3285,-2847,21.1,1437.1
4680019179,1,14,4,0,8,7,4,0,0,0,0,18163,7.2,18986,212,60,2330,2388,27.2,1816.3,17,3,1,7,8,7,1,1,0,0,15833,6.6,16598,174,32,-2330,-2388,20.6,1583.3
4856995735,1,2,1,1,12,22,18,0,0,0,0,47510,10.0,47500,3,0,17960,19000,0.3,4751.0,32,2,0,17,7,13,0,0,0,0,29550,6.0,28500,10,0,-17960,-19000,1.0,2955.0
4855815371,1,6,0,0,13,22,16,0,0,0,0,63870,12.0,55000,2,0,24805,22000,0.2,6387.0,0,0,1,17,8,11,0,0,0,0,39065,7.2,33000,3,0,-24805,-22000,0.3,3906.5
4855805204,1,0,0,1,21,18,21,0,0,0,0,64800,12.6,59500,0,0,26891,22000,0.0,6480.0,36,0,0,12,15,9,0,0,0,0,37909,7.8,37500,0,0,-26891,-22000,0.0,3790.9
4855789610,1,33,0,1,20,16,16,0,0,0,0,63280,12.4,57000,4,0,25730,24000,0.4,6328.0,0,0,0,8,12,11,0,0,0,0,37550,7.2,33000,0,0,-25730,-24000,0.0,3755.0
4855775288,1,0,0,0,18,19,21,0,0,0,0,47700,10.0,47500,0,0,18800,19000,0.0,4770.0,10,0,1,12,11,8,0,0,0,0,28900,6.0,28500,0,0,-18800,-19000,0.0,2890.0
4855761191,1,0,0,1,21,22,21,0,0,0,0,62462,12.4,57000,0,0,25240,24000,0.0,6246.2,0,0,0,13,12,12,0,0,0,0,37222,7.2,33000,0,0,-25240,-24000,0.0,3722.2
4854577764,0,10,0,0,6,8,3,0,0,0,0,18073,7.0,18691,200,55,-321,-1112,25.5,1807.3,12,0,1,8,6,5,0,0,0,0,18394,7.4,19803,217,56,321,1112,27.3,1839.4
4854536578,1,12,1,0,6,4,4,1,1,0,0,16700,7.0,19312,200,67,96,1821,26.7,1670.0,12,1,1,4,6,3,0,0,0,0,16604,6.8,17491,207,48,-96,-1821,25.5,1660.4
4854510699,0,11,0,0,5,7,7,0,0,0,0,16549,6.6,17311,191,52,-41,-215,24.3,1654.9,12,1,1,7,5,6,1,1,0,0,16590,6.8,17526,173,76,41,215,24.9,1659.0
4854486557,1,8,0,0,3,8,1,0,0,0,0,14366,6.8,16869,184,36,-4690,-2347,22.0,1436.6,9,0,1,8,3,9,1,1,0,0,19056,7.0,19216,214,68,4690,2347,28.2,1905.6
4854429271,1,2,0,0,21,21,47,0,0,0,1,36984,11.0,39973,114,0,971,-2,11.4,3698.4,0,0,1,20,20,47,0,0,0,0,36013,11.0,39975,94,0,-971,2,9.4,3601.3
4853372192,1,0,0,0,19,15,18,0,0,0,0,62210,12.0,55000,0,0,25690,22000,0.0,6221.0,0,0,1,8,12,5,0,0,0,0,36520,7.2,33000,0,0,-25690,-22000,0.0,3652.0
4853359561,1,0,0,1,15,16,9,0,0,0,0,44990,10.0,47500,0,0,16772,19000,0.0,4499.0,0,0,0,7,6,11,0,0,0,0,28218,6.0,28500,0,0,-16772,-19000,0.0,2821.8
4853358113,1,0,0,1,24,14,26,0,0,0,0,66550,13.0,62500,0,0,30500,28000,0.0,6655.0,0,0,0,7,17,5,0,0,0,0,36050,7.4,34500,0,0,-30500,-28000,0.0,3605.0
4853352900,1,0,0,1,26,28,20,0,0,0,0,64532,12.8,61000,0,0,25232,25000,0.0,6453.2,3,0,0,13,11,11,0,0,0,0,39300,7.6,36000,0,0,-25232,-25000,0.0,3930.0
4853339488,1,36,1,1,8,19,13,0,0,0,0,60211,12.0,55000,2,0,21581,22000,0.2,6021.1,0,1,0,17,6,13,0,0,0,0,38630,7.2,33000,1,0,-21581,-22000,0.1,3863.0
4853284491,1,0,0,1,13,27,16,0,0,0,0,60250,12.0,55000,0,0,19200,22000,0.0,6025.0,0,0,0,18,4,14,0,0,0,0,41050,7.2,33000,0,0,-19200,-22000,0.0,4105.0
4853281204,1,0,0,1,14,18,17,0,0,0,0,61300,12.2,56000,0,0,24100,23000,0.0,6130.0,0,0,0,11,7,10,0,0,0,0,37200,7.2,33000,0,0,-24100,-23000,0.0,3720.0
4853273402,1,0,0,0,20,16,14,0,0,0,0,47250,10.0,47500,0,0,19400,19000,0.0,4725.0,0,0,1,6,10,12,0,0,0,0,27850,6.0,28500,0,0,-19400,-19000,0.0,2785.0
4852548479,0,0,0,0,22,18,60,0,0,0,0,35855,11.4,40587,110,0,-731,1484,11.0,3585.5,0,0,1,18,22,60,0,0,0,0,36586,11.2,39103,113,0,731,-1484,11.3,3658.6
4854939071,1,9,1,0,5,4,4,0,0,0,0,16237,7.2,18040,201,52,563,790,25.3,1623.7,49,2,1,4,5,6,1,1,0,0,15674,7.0,17250,187,52,-563,-790,23.9,1567.4
4854897276,1,12,0,1,7,7,10,1,0,1,0,17574,7.0,17799,222,60,595,-1148,28.2,1757.4,7,0,0,7,7,2,1,1,0,0,16979,7.2,18947,213,56,-595,1148,26.9,1697.9
4848503169,0,12,0,0,4,19,5,0,0,0,0,16586,6.2,14366,139,44,-5117,-3777,18.3,1658.6,11,1,1,19,4,20,1,1,0,0,21703,7.0,18143,197,48,5117,3777,24.5,2170.3
4848489304,0,11,0,1,5,6,5,0,0,0,0,16396,6.4,16476,173,51,200,-546,22.4,1639.6,15,2,0,6,5,5,1,1,0,0,16196,6.6,17022,182,56,-200,546,23.8,1619.6
4848149232,1,10,0,0,3,4,3,0,0,0,0,12922,6.0,15047,150,39,-3350,-2466,18.9,1292.2,12,2,1,4,3,4,0,0,0,0,16272,6.8,17513,194,52,3350,2466,24.6,1627.2
4848112592,1,11,2,0,5,3,4,0,0,0,0,15672,6.6,16855,199,52,1537,471,25.1,1567.2,12,1,1,3,5,1,1,1,0,0,14135,6.6,16384,173,60,-1537,-471,23.3,1413.5
4848079238,1,14,3,1,8,7,5,0,0,0,0,17034,6.8,17135,191,44,-755,-1238,23.5,1703.4,15,0,0,7,8,6,0,0,0,0,17789,6.8,18373,184,56,755,1238,24.0,1778.9
4848037746,0,11,1,1,4,6,5,0,0,0,0,15321,6.6,17302,192,44,-1584,-1081,23.6,1532.1,14,1,0,5,3,6,1,1,0,0,16905,7.0,18383,184,60,1584,1081,24.4,1690.5
4847975181,0,8,1,0,7,8,4,1,1,0,0,16319,6.4,15323,141,48,-341,-629,18.9,1631.9,71,1,1,8,7,8,0,0,0,0,16660,6.4,15952,174,31,341,629,20.5,1666.0
4845820161,0,10,15,0,4,4,2,1,0,1,0,15230,7.0,18107,184,59,-969,-722,24.3,1523.0,26,1,1,4,4,2,1,1,0,0,16199,7.2,18829,223,56,969,722,27.9,1619.9
4845780171,0,72,0,0,3,3,1,1,1,0,0,15803,7.6,20129,203,72,630,2444,27.5,1580.3,10,1,1,3,3,2,0,0,0,0,15173,6.8,17685,198,56,-630,-2444,25.4,1517.3
4845703899,1,18,1,1,3,6,1,0,0,0,0,15329,7.0,18286,214,52,-1895,-496,26.6,1532.9,13,2,0,6,3,5,0,0,0,0,17224,7.0,18782,224,48,1895,496,27.2,1722.4
4845676599,1,14,2,0,6,3,6,1,1,0,0,17413,6.6,16688,202,51,3539,2662,25.3,1741.3,40,2,1,3,6,6,1,0,1,0,13874,6.0,14026,135,36,-3539,-2662,17.1,1387.4
4834321914,0,0,1,1,24,26,54,0,0,0,1,38782,11.2,40917,108,0,-554,-1339,10.8,3878.2,19,0,0,26,24,70,0,0,0,0,39336,11.6,42256,104,0,554,1339,10.4,3933.6
4834299591,0,0,0,0,30,33,86,0,0,0,2,38359,11.6,43201,96,0,-2586,-1303,9.6,3835.9,0,0,1,33,30,73,0,0,0,0,40945,11.8,44504,94,0,2586,1303,9.4,4094.5
4834281260,1,0,0,0,23,30,54,0,0,0,1,36734,11.2,40817,97,0,-2208,-4028,9.7,3673.4,0,0,1,30,23,74,0,0,0,0,38942,11.8,44845,99,0,2208,4028,9.9,3894.2
4832867695,0,34,0,1,27,26,51,0,0,0,0,39277,11.0,40648,101,0,2535,-1472,10.1,3927.7,41,0,0,25,26,61,0,0,0,0,36742,11.2,42120,96,0,-2535,1472,9.6,3674.2
4832853103,0,10,0,1,18,27,50,0,0,0,1,37626,11.2,39373,112,0,54,-2080,11.2,3762.6,0,1,0,27,18,82,0,0,0,0,37572,11.0,41453,109,0,-54,2080,10.9,3757.2
4832835268,0,0,0,1,17,18,38,0,0,0,0,34500,10.6,36507,106,0,290,-1213,10.6,3450.0,0,0,0,18,17,38,0,0,0,0,34210,10.8,37720,108,0,-290,1213,10.8,3421.0
4832823771,0,37,0,0,28,35,70,0,0,0,1,39063,11.2,42274,93,0,-2671,-3352,9.3,3906.3,34,0,1,35,28,108,0,0,0,0,41734,11.8,45626,114,0,2671,3352,11.4,4173.4
4854956705,1,0,0,0,26,17,60,0,0,0,1,36379,11.4,42284,97,0,1385,3427,9.7,3637.9,0,0,1,17,26,43,0,0,0,0,34994,11.0,38857,105,0,-1385,-3427,10.5,3499.4
4854937306,1,37,0,0,17,15,42,0,0,0,1,35026,10.6,37738,117,0,969,-887,11.7,3502.6,34,0,1,15,17,28,0,0,0,0,34057,10.6,38625,102,0,-969,887,10.2,3405.7
4854906620,0,0,0,0,16,19,38,0,0,0,0,33568,10.6,37590,95,0,-808,-115,9.5,3356.8,0,0,1,19,16,54,0,0,0,0,34376,10.6,37705,95,0,808,115,9.5,3437.6
4821698985,0,13,0,1,2,3,1,1,1,0,0,14841,7.0,18082,227,56,-387,135,28.3,1484.1,13,2,0,3,2,2,1,0,1,0,15228,6.8,17947,226,48,387,-135,27.4,1522.8
4821650693,0,11,0,0,8,6,11,1,1,0,0,16415,6.4,16012,199,52,-337,-749,25.1,1641.5,17,2,1,6,8,8,0,0,0,0,16752,6.6,16761,199,60,337,749,25.9,1675.2
4821616601,0,14,0,0,3,3,3,0,0,0,0,15563,6.8,16767,199,48,-412,-1595,24.7,1556.3,12,0,1,3,3,1,1,1,0,0,15975,7.0,18362,240,56,412,1595,29.6,1597.5
4821588520,0,12,1,0,2,8,2,0,0,0,0,15031,6.8,17498,166,48,-2734,-1980,21.4,1503.1,12,1,1,8,2,4,1,1,0,0,17765,7.0,19478,235,64,2734,1980,29.9,1776.5
4821548607,0,13,0,0,6,6,4,0,0,0,0,15966,7.0,17820,192,56,-549,-181,24.8,1596.6,12,2,1,6,6,6,1,1,0,0,16515,6.8,18001,212,52,549,181,26.4,1651.5
4821505366,0,12,1,0,2,2,3,0,0,0,0,14631,7.0,17755,204,56,-745,-1059,26.0,1463.1,16,2,1,2,2,1,0,0,0,0,15376,7.2,18814,215,52,745,1059,26.7,1537.6
4820372565,1,11,0,1,4,5,5,1,0,1,0,15262,6.4,16786,176,60,-678,-774,23.6,1526.2,27,2,0,5,4,7,0,0,0,0,15940,6.8,17560,206,59,678,774,26.5,1594.0
4814867640,1,11,1,1,3,4,2,0,0,0,0,15199,6.8,17105,199,46,-2187,132,24.5,1519.9,11,0,0,4,3,8,0,0,0,0,17386,7.0,16973,191,40,2187,-132,23.1,1738.6
4810878890,1,14,0,1,4,4,2,0,0,0,0,15166,6.8,17698,223,60,386,-437,28.3,1516.6,9,3,0,4,4,6,0,0,0,0,14780,7.0,18135,218,52,-386,437,27.0,1478.0
4810863056,1,48,1,0,6,6,7,0,0,0,0,16177,6.8,16922,197,42,-1116,-1780,23.9,1617.7,20,9,1,6,6,0,0,0,0,0,17293,7.0,18702,212,51,1116,1780,26.3,1729.3
4810203934,0,13,1,1,2,1,2,0,0,0,0,14419,6.8,17680,214,44,159,175,25.8,1441.9,8,0,0,1,2,2,0,0,0,0,14260,6.8,17505,222,44,-159,-175,26.6,1426.0
4803627864,1,17,0,0,5,2,7,0,0,0,0,16727,7.0,18190,203,52,1284,1268,25.5,1672.7,8,1,1,2,5,2,1,1,0,0,15443,6.4,16922,221,56,-1284,-1268,27.7,1544.3
4803597705,1,46,1,1,6,1,4,0,0,0,0,17486,7.2,19090,218,63,4210,2059,28.1,1748.6,10,1,0,1,6,0,0,0,0,0,13276,6.8,17031,206,52,-4210,-2059,25.8,1327.6
4803526801,0,12,0,0,3,5,1,0,0,0,0,14452,6.8,17339,194,54,-1154,-94,24.8,1445.2,11,1,1,5,3,2,0,0,0,0,15606,6.8,17433,216,49,1154,94,26.5,1560.6
4802687556,1,13,1,1,5,4,5,0,0,0,0,16567,6.8,17713,198,56,1859,1763,25.4,1656.7,18,0,0,4,5,3,0,0,0,0,14708,6.6,15950,147,52,-1859,-1763,19.9,1470.8
4802645829,0,173,1,0,0,8,0,0,0,0,0,13684,6.2,15253,195,52,-3195,-1699,24.7,1368.4,8,1,1,8,0,9,0,0,0,0,16879,6.8,16952,204,40,3195,1699,24.4,1687.9
4802601008,0,12,1,0,0,7,0,0,0,0,0,13359,6.6,16428,209,48,-4404,-1525,25.7,1335.9,10,1,1,7,0,6,1,1,0,0,17763,7.0,17953,190,56,4404,1525,24.6,1776.3
4851133493,1,14,1,0,2,10,0,0,0,0,0,14435,6.6,16516,200,56,-3598,-3004,25.6,1443.5,25,2,1,10,2,8,1,1,0,0,18033,7.2,19520,217,72,3598,3004,28.9,1803.3
4844488566,0,19,0,1,5,10,1,0,0,0,0,13789,6.0,14469,145,40,-5396,-4525,18.5,1378.9,10,1,0,9,4,8,1,1,0,0,19185,7.2,18994,206,68,5396,4525,27.4,1918.5
4801049965,0,0,0,0,26,17,47,0,0,0,1,35653,11.0,39851,93,0,372,2886,9.3,3565.3,0,0,1,17,26,30,0,0,0,0,35281,10.6,36965,123,0,-372,-2886,12.3,3528.1
4796322577,0,0,0,1,32,28,87,0,0,0,0,40501,11.8,45886,102,0,1847,2763,10.2,4050.1,0,0,0,28,32,58,0,0,0,0,38654,11.4,43123,103,0,-1847,-2763,10.3,3865.4
4796315776,1,0,0,0,18,15,45,0,0,0,0,34641,10.6,36986,116,0,1049,470,11.6,3464.1,12,0,1,15,18,27,0,0,0,0,33592,10.6,36516,106,0,-1049,-470,10.6,3359.2
4795450933,0,46,0,0,4,4,4,0,0,0,0,14809,6.8,16931,169,48,-799,-1185,21.7,1480.9,7,1,1,4,4,3,0,0,0,0,15608,6.8,18116,188,52,799,1185,24.0,1560.8
4793918697,1,14,0,1,8,2,5,0,0,0,0,17715,7.2,18655,229,64,2368,981,29.3,1771.5,14,3,0,2,8,1,0,0,0,0,15347,6.8,17674,180,64,-2368,-981,24.4,1534.7
4792148915,0,11,0,0,2,6,2,0,0,0,0,14412,6.8,17741,199,58,-2876,-1545,25.7,1441.2,14,1,1,6,2,7,0,0,0,0,17288,7.0,19286,248,48,2876,1545,29.6,1728.8
4792087937,0,8,3,1,7,8,6,0,0,0,0,15842,6.6,16608,194,44,-1780,-919,23.8,1584.2,13,1,0,8,7,7,0,0,0,0,17622,6.8,17527,189,48,1780,919,23.7,1762.2
4791096523,1,30,0,0,4,5,2,0,0,0,0,16119,6.8,17733,219,44,291,1026,26.3,1611.9,284,2,1,5,4,4,0,0,0,0,15828,6.8,16707,202,44,-291,-1026,24.6,1582.8
4789994958,1,131,2,0,7,3,6,1,1,0,0,16186,7.0,16834,180,52,2293,79,23.2,1618.6,13,0,1,3,7,2,0,0,0,0,13893,6.8,16755,171,52,-2293,-79,22.3,1389.3
4789886627,1,10,0,1,8,3,8,0,0,0,0,17393,7.0,18772,170,48,2493,2273,21.8,1739.3,8,0,0,3,8,3,0,0,0,0,14900,6.8,16499,179,64,-2493,-2273,24.3,1490.0
4789854880,0,11,0,1,12,7,11,0,0,0,0,18613,6.8,18264,166,48,2986,2117,21.4,1861.3,9,1,0,7,12,5,0,0,0,0,15627,6.4,16147,185,28,-2986,-2117,21.3,1562.7
4789790725,1,11,1,0,5,3,3,0,0,0,0,16880,6.8,17622,197,48,2345,-1016,24.5,1688.0,14,1,1,3,5,5,0,0,0,0,14535,7.2,18638,171,76,-2345,1016,24.7,1453.5
4789512924,0,11,0,0,4,3,4,0,0,0,0,15283,6.6,17068,162,52,-329,201,21.4,1528.3,13,1,1,3,4,0,1,1,0,0,15612,6.8,16867,202,44,329,-201,24.6,1561.2
4789483465,0,15,0,1,6,4,5,0,0,0,0,17328,7.0,17995,184,56,623,150,24.0,1732.8,9,2,0,4,6,4,1,1,0,0,16705,7.0,17845,212,60,-623,-150,27.2,1670.5
4787117765,0,9,1,1,5,6,2,0,0,0,0,15185,6.6,16837,179,52,-1367,-968,23.1,1518.5,72,2,0,6,5,6,0,0,0,0,16552,7.0,17805,210,48,1367,968,25.8,1655.2
4785806665,0,13,1,0,7,10,5,0,0,0,0,16739,6.4,17204,189,48,-2427,-522,23.7,1673.9,11,1,1,10,7,11,0,0,0,0,19166,6.8,17726,178,52,2427,522,23.0,1916.6
4776134588,1,0,0,1,38,27,96,0,0,0,1,41528,12.0,46831,93,0,3838,5314,9.3,4152.8,0,0,0,27,38,51,0,0,0,0,37690,11.2,41517,100,0,-3838,-5314,10.0,3769.0
4740099777,0,7,2,1,8,8,9,0,0,0,0,17289,7.0,16867,186,44,-945,-731,23.0,1728.9,11,1,0,8,8,6,1,1,0,0,18234,6.8,17598,222,52,945,731,27.4,1823.4
4849735037,1,17,0,1,5,4,3,1,1,0,0,14458,6.4,15511,155,52,-805,-1021,20.7,1445.8,89,1,0,4,5,1,0,0,0,0,15263,6.4,16532,165,56,805,1021,22.1,1526.3
4849489601,1,19,1,0,7,5,8,0,0,0,0,17492,6.6,17012,178,44,1404,-3,22.2,1749.2,13,0,1,5,7,2,0,0,0,0,16088,6.6,17015,168,60,-1404,3,22.8,1608.8
4849473630,1,7,0,0,4,4,3,0,0,0,0,15868,6.8,17981,198,60,188,900,25.8,1586.8,8,1,1,4,4,4,0,0,0,0,15680,6.8,17081,190,51,-188,-900,24.1,1568.0
4849453664,0,13,2,1,5,3,4,0,0,0,0,16078,7.2,18791,203,42,935,831,24.5,1607.8,47,1,0,3,5,3,0,0,0,0,15143,7.0,17960,202,56,-935,-831,25.8,1514.3
4849406393,0,135,1,1,9,3,10,1,1,0,0,16784,6.6,16887,174,56,1438,9,23.0,1678.4,15,2,0,3,9,2,0,0,0,0,15346,6.4,16878,209,36,-1438,-9,24.5,1534.6
4849068118,0,25,0,0,7,5,3,0,0,0,0,14750,6.8,16861,139,49,-995,-633,18.8,1475.0,10,2,1,5,7,0,1,1,0,0,15745,6.6,17494,179,64,995,633,24.3,1574.5
4849035817,1,6,0,1,9,4,7,1,1,0,0,17608,7.4,18586,189,56,2317,1352,24.5,1760.8,12,0,0,4,9,1,0,0,0,0,15291,6.8,17234,203,32,-2317,-1352,23.5,1529.1
4848991834,1,11,0,1,4,3,5,0,0,0,0,15050,6.8,18102,190,52,1304,698,24.2,1505.0,8,0,0,3,4,2,0,0,0,0,13746,7.0,17404,181,52,-1304,-698,23.3,1374.6
4847354661,0,11,1,1,4,5,4,0,0,0,0,14823,6.8,17313,198,44,-1677,-1223,24.2,1482.3,10,1,0,5,4,3,2,1,1,0,16500,6.8,18536,220,70,1677,1223,29.0,1650.0
4847347824,0,12,0,0,10,5,16,0,0,0,0,18684,7.0,17584,216,44,2145,774,26.0,1868.4,18,1,1,5,10,11,0,0,0,0,16539,6.4,16810,162,52,-2145,-774,21.4,1653.9
4847328596,0,12,0,0,0,5,0,0,0,0,0,12405,6.2,15857,173,40,-4171,-3071,21.3,1240.5,18,3,1,5,0,2,1,1,0,0,16576,7.0,18928,223,64,4171,3071,28.7,1657.6
4847323986,0,13,0,0,4,11,1,0,0,0,0,13639,6.2,14869,149,44,-4443,-3075,19.3,1363.9,14,0,1,11,4,10,0,0,0,0,18082,6.8,17944,181,46,4443,3075,22.7,1808.2
4847307449,0,25,1,0,5,3,2,0,0,0,0,16074,7.0,17867,213,44,3159,1834,25.7,1607.4,9,11,1,3,5,0,0,0,0,0,12915,6.6,16033,132,56,-3159,-1834,18.8,1291.5
4846699442,0,10,0,0,7,7,6,0,0,0,0,16912,6.6,16658,176,44,215,-2259,22.0,1691.2,12,1,1,6,6,5,1,1,0,0,16697,7.0,18917,175,64,-215,2259,23.9,1669.7
4844705721,1,9,0,1,7,1,2,0,0,0,0,16915,7.0,18856,236,56,4937,4995,29.2,1691.5,14,3,0,1,7,0,0,0,0,0,11978,6.2,13861,136,39,-4937,-4995,17.5,1197.8
4844698055,0,10,0,1,5,9,2,2,1,1,0,15515,6.8,17364,181,49,-2643,-1378,23.0,1551.5,16,1,0,9,5,9,0,0,0,0,18158,7.2,18742,176,63,2643,1378,23.9,1815.8
4844670961,1,11,2,1,7,3,3,1,1,0,0,16624,7.2,18787,168,66,340,655,23.4,1662.4,19,1,0,3,7,1,0,0,0,0,16284,6.8,18132,223,56,-340,-655,27.9,1628.4
4844086966,1,11,0,1,8,4,7,1,1,0,1,18753,7.2,18507,224,60,4400,2989,28.4,1875.3,8,1,0,4,8,1,0,0,0,0,14353,6.0,15518,165,48,-4400,-2989,21.3,1435.3
4835258717,0,11,2,0,4,6,1,0,0,0,0,15387,6.8,18069,213,48,-2306,-517,26.1,1538.7,12,2,1,6,4,6,0,0,0,0,17693,7.0,18586,220,68,2306,517,28.8,1769.3
4835227427,1,12,3,0,10,6,7,0,0,0,0,18725,7.0,18974,178,52,2497,2426,23.0,1872.5,17,2,1,5,9,3,1,1,0,0,16228,6.6,16548,204,43,-2497,-2426,24.7,1622.8
4834673089,0,14,0,1,2,1,2,0,0,0,0,15969,6.8,18104,236,52,763,-777,28.8,1596.9,158,0,0,1,2,0,0,0,0,0,15206,7.4,18881,214,64,-763,777,27.8,1520.6
4834588776,0,13,1,0,2,6,1,0,0,0,0,14870,6.8,17248,233,40,-2283,-1336,27.3,1487.0,11,1,1,5,1,4,0,0,0,0,17153,7.2,18584,217,68,2283,1336,28.5,1715.3
4834558481,1,39,0,0,4,4,4,0,0,0,0,15271,6.8,17396,198,48,-1471,-348,24.6,1527.1,18,16,1,4,4,6,1,1,0,0,16742,6.8,17744,217,60,1471,348,27.7,1674.2
4834117249,0,17,2,0,4,6,4,0,0,0,0,15813,7.0,17004,196,40,-2768,-1365,23.6,1581.3,12,1,1,6,4,4,0,0,0,0,18581,7.0,18369,216,51,2768,1365,26.7,1858.1
4834074507,1,8,2,1,7,5,5,1,0,1,0,17410,7.0,17979,218,52,2372,1246,27.0,1741.0,17,1,0,5,7,2,0,0,0,0,15038,6.8,16733,192,52,-2372,-1246,24.4,1503.8
4834043766,1,39,0,1,3,4,1,0,0,0,0,14625,7.0,17743,188,52,-1456,-1179,24.0,1462.5,14,6,0,4,3,3,0,0,0,0,16081,7.0,18922,233,52,1456,1179,28.5,1608.1
4834006923,0,12,1,1,3,7,2,0,0,0,0,14423,6.6,16487,187,48,-2177,-2232,23.5,1442.3,118,0,0,7,3,3,0,0,0,0,16600,7.2,18719,218,60,2177,2232,27.8,1660.0
4833959765,0,14,0,1,7,5,4,0,0,0,0,17114,7.2,19538,205,68,687,1325,27.3,1711.4,21,2,0,5,7,4,0,0,0,0,16427,7.2,18213,213,52,-687,-1325,26.5,1642.7
4832696701,0,30,1,0,4,10,3,0,0,0,0,15473,6.8,17228,212,64,-2196,-2239,27.6,1547.3,12,2,1,10,4,4,0,0,0,0,17669,7.4,19467,222,61,2196,2239,28.3,1766.9
4832598228,0,14,2,0,5,4,4,0,0,0,0,16268,6.8,18425,206,50,-41,469,25.6,1626.8,28,1,1,4,5,6,0,0,0,0,16309,6.8,17956,236,64,41,-469,30.0,1630.9
4832381275,0,7,2,1,6,7,7,0,0,0,0,16123,6.8,17371,201,44,-1297,-755,24.5,1612.3,12,1,0,7,6,7,1,1,0,0,17420,7.0,18126,209,72,1297,755,28.1,1742.0
4832067036,0,11,2,0,7,6,11,0,0,0,0,17360,6.6,17777,212,52,-1859,-1480,26.4,1736.0,7,0,1,6,7,5,1,1,0,0,19219,7.2,19257,220,48,1859,1480,26.8,1921.9
4772286313,1,16,3,1,7,4,8,1,1,0,0,16904,7.0,17810,203,57,1128,382,26.0,1690.4,28,2,0,4,7,4,1,0,1,0,15776,6.6,17428,220,55,-1128,-382,27.5,1577.6
4770251103,0,24,1,0,8,9,10,0,0,0,0,17873,6.4,15400,198,28,-224,204,22.6,1787.3,27,2,1,9,8,15,0,0,0,0,18097,6.4,15196,149,40,224,-204,18.9,1809.7
4769419008,0,9,3,0,2,8,2,0,0,0,0,15202,6.8,17302,237,56,-2343,-887,29.3,1520.2,12,0,1,8,2,3,1,0,1,0,17545,7.0,18189,223,43,2343,887,26.6,1754.5
4769394228,0,20,1,1,3,1,3,0,0,0,0,16117,7.0,18643,228,53,859,-147,28.1,1611.7,13,0,0,1,3,1,1,1,0,0,15258,7.0,18790,211,56,-859,147,26.7,1525.8
4769368697,0,36,0,0,1,5,0,1,0,1,0,14945,7.2,18885,238,60,-2439,476,29.8,1494.5,19,20,1,5,1,11,1,1,0,0,17384,6.8,18409,221,56,2439,-476,27.7,1738.4
4769349139,0,13,1,1,8,5,8,1,1,0,0,17543,7.0,18252,184,68,1446,-151,25.2,1754.3,14,1,0,5,8,2,0,0,0,0,16097,7.0,18403,203,56,-1446,151,25.9,1609.7
4835099559,0,10,0,0,0,4,0,0,0,0,0,13959,6.4,17352,206,60,-2456,-1408,26.6,1395.9,3,0,1,4,0,3,1,1,0,0,16415,7.0,18760,229,72,2456,1408,30.1,1641.5
4833194177,1,11,2,0,5,3,5,0,0,0,0,15532,7.0,17341,184,56,1769,557,24.0,1553.2,14,0,1,3,5,2,1,1,0,0,13763,6.4,16784,166,52,-1769,-557,21.8,1376.3
4833154288,1,7,0,0,3,3,4,1,1,0,0,15738,7.0,17898,204,68,1136,-814,27.2,1573.8,13,0,1,3,3,1,0,0,0,0,14602,7.2,18712,188,68,-1136,814,25.6,1460.2
4832912985,0,12,0,0,5,2,4,0,0,0,0,16596,6.8,17693,183,60,783,-83,24.3,1659.6,9,0,1,2,5,3,1,1,0,0,15813,6.8,17776,171,47,-783,83,21.8,1581.3
4830938943,1,58,3,1,5,1,4,0,0,0,0,16587,7.0,18389,187,44,2555,1531,23.1,1658.7,12,0,0,1,5,1,0,0,0,0,14032,6.8,16858,189,64,-2555,-1531,25.3,1403.2
4830598517,1,12,1,1,6,5,6,0,0,0,0,17054,6.8,17703,202,44,-275,-881,24.6,1705.4,220,1,0,5,6,3,1,0,1,0,17329,7.2,18584,188,48,275,881,23.6,1732.9
4830472268,1,17,0,0,4,2,1,0,0,0,0,14672,6.8,17651,192,44,1405,1273,23.6,1467.2,12,1,1,2,4,1,0,0,0,0,13267,6.4,16378,175,48,-1405,-1273,22.3,1326.7
4830409312,1,13,3,1,6,2,7,1,1,0,0,16240,6.8,17335,214,55,2552,1161,26.9,1624.0,14,0,0,2,6,1,0,0,0,0,13688,6.6,16174,188,52,-2552,-1161,24.0,1368.8
4830334054,1,12,1,1,8,5,4,0,0,0,0,18304,7.0,18511,208,60,3470,1480,26.8,1830.4,9,0,0,5,8,4,1,1,0,0,14834,6.8,17031,193,26,-3470,-1480,21.9,1483.4
4830250891,0,12,1,1,4,4,4,0,0,0,0,14735,6.8,17048,187,48,-487,-568,23.5,1473.5,11,0,0,4,4,3,1,0,1,0,15222,6.8,17616,183,68,487,568,25.1,1522.2
4830086469,0,11,1,0,9,2,7,0,0,0,0,17732,7.0,18344,238,48,4333,2711,28.6,1773.2,14,2,1,2,9,0,0,0,0,0,13399,6.4,15633,164,53,-4333,-2711,21.7,1339.9
4830027254,0,8,1,1,4,2,6,0,0,0,0,15198,6.8,17015,191,48,816,-681,23.9,1519.8,14,0,0,2,4,2,0,0,0,0,14382,6.8,17696,188,56,-816,681,24.4,1438.2
4829702950,0,17,0,1,1,2,1,0,0,0,0,14877,6.8,17664,222,49,-97,-514,27.1,1487.7,12,1,0,2,1,0,1,1,0,0,14974,7.0,18178,218,56,97,514,27.4,1497.4
4829654911,1,71,1,1,8,4,6,0,0,0,0,17420,7.0,17802,190,52,2366,1571,24.2,1742.0,11,0,0,4,8,0,0,0,0,0,15054,6.6,16231,155,48,-2366,-1571,20.3,1505.4
4829612311,1,16,0,0,0,5,0,0,0,0,0,13469,6.6,16713,220,48,-2150,-395,26.8,1346.9,11,1,1,5,0,2,1,0,1,0,15619,6.6,17108,191,52,2150,395,24.3,1561.9
4829557110,0,16,0,0,2,10,2,1,1,0,0,14933,6.6,16722,207,48,-2705,-1091,25.5,1493.3,15,1,1,10,2,6,0,0,0,0,17638,6.8,17813,202,52,2705,1091,25.4,1763.8
4829480330,1,11,1,1,3,4,3,1,1,0,0,14691,6.4,15940,183,54,-91,-782,23.7,1469.1,65,0,0,4,3,4,0,0,0,0,14782,6.4,16722,181,44,91,782,22.5,1478.2
4829379838,0,89,2,1,6,11,7,0,0,0,0,17712,6.8,17505,180,55,-1478,406,23.5,1771.2,18,4,0,11,6,12,0,0,0,0,19190,6.6,17099,200,52,1478,-406,25.2,1919.0
4856593704,1,13,1,0,10,5,10,0,0,0,0,17630,6.6,16629,198,36,2401,-43,23.4,1763.0,22,1,1,5,10,1,0,0,0,0,15229,6.8,16672,166,40,-2401,43,20.6,1522.9
4856571028,1,27,1,1,5,8,4,0,0,0,0,16417,7.0,18154,216,56,-213,221,27.2,1641.7,16,5,0,8,5,8,1,1,0,0,16630,7.0,17933,182,44,213,-221,22.6,1663.0
4856548888,0,14,6,1,8,3,7,1,1,0,0,17373,7.0,18062,221,45,1979,143,26.6,1737.3,259,3,0,3,8,2,0,0,0,0,15394,7.0,17919,211,46,-1979,-143,25.7,1539.4
4856513198,0,10,1,0,7,6,6,0,0,0,0,16364,7.0,17267,152,44,-1296,-1110,19.6,1636.4,74,0,1,6,7,5,0,0,0,0,17660,7.0,18377,183,52,1296,1110,23.5,1766.0
4856453686,0,9,0,1,8,3,6,0,0,0,0,17005,7.0,17942,168,60,1335,9,22.8,1700.5,12,0,0,3,8,1,1,1,0,0,15670,7.0,17933,167,72,-1335,-9,23.9,1567.0
4856431096,1,10,3,0,5,1,3,0,0,0,0,16913,7.2,18615,229,52,3716,2562,28.1,1691.3,13,1,1,1,5,2,0,0,0,0,13197,6.4,16053,163,56,-3716,-2562,21.9,1319.7
4855442934,1,50,2,1,8,5,3,1,1,0,0,17199,7.2,18406,172,64,910,2020,23.6,1719.9,14,0,0,5,8,5,0,0,0,0,16289,6.4,16386,204,40,-910,-2020,24.4,1628.9
4855403658,1,22,1,0,7,6,6,0,0,0,0,17948,7.4,18781,237,53,2011,1708,29.0,1794.8,12,0,1,6,7,8,0,0,0,0,15937,6.6,17073,181,50,-2011,-1708,23.1,1593.7
4855372751,1,10,2,1,6,5,4,0,0,0,0,16245,7.0,18175,221,44,-567,-248,26.5,1624.5,12,0,0,5,6,9,1,1,0,0,16812,6.8,18423,202,52,567,248,25.4,1681.2
4855333507,1,13,3,1,10,8,10,0,0,0,0,18891,6.6,17136,158,48,3516,1019,20.6,1889.1,11,4,0,8,10,4,0,0,0,0,15375,6.6,16117,129,55,-3516,-1019,18.4,1537.5
4854335202,1,38,0,1,7,3,6,1,1,0,0,17362,7.0,18545,186,72,2410,915,25.8,1736.2,30,1,0,3,7,5,0,0,0,0,14952,6.8,17630,185,48,-2410,-915,23.3,1495.2
4854324774,1,17,1,1,7,3,5,0,0,0,0,17634,7.0,19038,221,44,3342,2689,26.5,1763.4,10,0,0,3,7,4,1,1,0,0,14292,6.4,16349,174,56,-3342,-2689,23.0,1429.2
4854304419,1,13,0,1,8,3,3,0,0,0,0,17947,7.2,18892,212,78,4192,3081,29.0,1794.7,12,1,0,3,8,3,0,0,0,0,13755,6.4,15811,182,35,-4192,-3081,21.7,1375.5
4854280854,1,9,1,1,6,2,7,1,1,0,0,17549,7.0,18751,218,72,3095,2432,29.0,1754.9,9,0,0,2,6,2,0,0,0,0,14454,6.4,16319,191,48,-3095,-2432,23.9,1445.4
4854259944,0,9,2,0,7,9,4,0,0,0,0,15364,6.6,16016,184,44,-4450,-2646,22.8,1536.4,13,1,1,9,7,13,1,1,0,0,19814,7.2,18662,180,68,4450,2646,24.8,1981.4
4854201582,0,8,2,0,8,6,8,0,0,0,0,16412,6.6,16972,176,56,853,803,23.2,1641.2,153,0,1,6,8,8,1,1,0,0,15559,6.4,16169,182,56,-853,-803,23.8,1555.9
4853198620,1,11,1,0,5,4,5,1,1,0,0,15631,7.0,17288,156,64,1543,679,22.0,1563.1,18,0,1,4,5,1,0,0,0,0,14088,6.6,16609,178,28,-1543,-679,20.6,1408.8
4853178537,0,35,2,0,4,11,4,0,0,0,0,15485,6.6,16348,158,40,-4272,-2939,19.8,1548.5,26,10,1,11,4,10,1,0,1,0,19757,7.2,19287,204,52,4272,2939,25.6,1975.7
4853165477,1,10,2,1,12,3,9,1,1,0,0,20741,7.6,20811,237,59,7027,4690,29.6,2074.1,12,2,0,3,12,2,0,0,0,0,13714,6.4,16121,159,48,-7027,-4690,20.7,1371.4
4853140966,1,13,0,1,11,4,3,1,1,0,0,17965,7.4,19860,212,64,699,1923,27.6,1796.5,10,0,0,4,11,5,0,0,0,0,17266,6.8,17937,217,44,-699,-1923,26.1,1726.6
4856434554,1,12,2,0,2,2,1,1,0,1,0,14752,7.0,18524,226,56,-93,-194,28.2,1475.2,11,1,1,2,2,2,0,0,0,0,14845,7.0,18718,202,68,93,194,27.0,1484.5
4854749313,0,20,0,1,4,5,4,0,0,0,0,15437,6.6,17183,213,48,-23,-599,26.1,1543.7,15,1,0,5,4,3,0,0,0,0,15460,7.0,17782,197,60,23,599,25.7,1546.0
4852448191,1,20,0,0,9,4,8,0,0,0,0,17774,7.2,18293,213,42,3038,2512,25.5,1777.4,10,1,1,4,9,8,0,0,0,0,14736,6.6,15781,163,46,-3038,-2512,20.9,1473.6
4852306400,1,11,1,1,8,9,10,0,0,0,0,18233,6.6,16668,197,44,463,177,24.1,1823.3,11,3,0,9,8,9,0,0,0,0,17770,6.4,16491,197,36,-463,-177,23.3,1777.0
4852293515,0,14,2,0,2,6,0,0,0,0,0,13866,6.2,15787,177,62,-1564,-1785,23.9,1386.6,13,0,1,6,2,3,1,1,0,0,15430,7.0,17572,198,45,1564,1785,24.3,1543.0
4850165416,1,17,2,0,6,4,4,1,1,0,0,17118,7.0,17364,188,51,1710,426,23.9,1711.8,11,1,1,4,6,2,0,0,0,0,15408,6.6,16938,183,44,-1710,-426,22.7,1540.8
4847503570,0,32,2,0,1,6,1,1,0,1,0,14601,6.8,18000,223,52,-1852,-1356,27.5,1460.1,87,19,1,6,1,6,1,1,0,0,16453,7.4,19356,225,68,1852,1356,29.3,1645.3
4827593614,0,14,4,0,12,9,4,0,0,0,0,18427,7.0,18610,215,59,904,1340,27.4,1842.7,15,2,1,8,11,4,0,0,0,0,17523,6.8,17270,185,44,-904,-1340,22.9,1752.3
4823829377,0,12,0,1,8,7,8,0,0,0,0,16671,6.4,16934,155,40,-873,-1446,19.5,1667.1,10,0,0,7,8,5,2,1,1,0,17544,7.2,18380,214,56,873,1446,27.0,1754.4
4822008358,1,16,17,1,15,4,22,1,1,0,0,21598,7.0,18554,206,56,5857,1862,26.2,2159.8,175,1,0,4,15,7,0,0,0,0,15741,6.6,16692,212,40,-5857,-1862,25.2,1574.1
4819223802,0,212,1,1,3,3,3,0,0,0,0,15111,6.8,17629,205,60,219,-435,26.5,1511.1,12,2,0,3,3,3,1,1,0,0,14892,6.8,18064,185,56,-219,435,24.1,1489.2
4814080753,1,14,4,1,7,3,6,0,0,0,0,16984,7.0,18565,219,48,1634,556,26.7,1698.4,15,2,0,3,7,3,0,0,0,0,15350,6.8,18009,194,68,-1634,-556,26.2,1535.0
4813155393,1,14,3,1,3,2,3,0,0,0,0,15175,6.8,17199,200,44,400,-904,24.4,1517.5,21,3,0,2,3,3,1,1,0,0,14775,7.0,18103,210,68,-400,904,27.8,1477.5
4813114286,1,16,1,1,9,4,13,1,1,0,0,17921,6.6,17462,204,56,1718,563,26.0,1792.1,16,1,0,4,9,4,0,0,0,0,16203,6.6,16899,229,54,-1718,-563,28.3,1620.3
4812746662,0,11,0,0,2,5,3,0,0,0,0,15067,6.6,16705,172,43,-1275,-1206,21.5,1506.7,12,0,1,5,2,2,0,0,0,0,16342,7.0,17911,210,52,1275,1206,26.2,1634.2
4801289148,0,14,2,0,1,5,2,1,0,1,0,14845,6.8,17274,203,52,-1904,-570,25.5,1484.5,11,0,1,5,1,5,1,1,0,0,16749,7.0,17844,216,60,1904,570,27.6,1674.9
4801271055,1,30,13,0,7,4,9,0,0,0,0,17100,7.2,19157,196,68,1265,823,26.4,1710.0,65,1,1,4,7,4,0,0,0,0,15835,6.8,18334,194,61,-1265,-823,25.5,1583.5
4798648389,0,32,1,0,5,7,5,1,1,0,0,14820,6.4,16304,203,52,-2079,-1379,25.5,1482.0,146,1,1,7,5,2,0,0,0,0,16899,7.2,17683,177,56,2079,1379,23.3,1689.9
4793769503,0,9,0,0,6,5,6,0,0,0,0,16204,6.8,17543,169,65,48,134,23.4,1620.4,11,0,1,5,6,4,0,0,0,0,16156,6.6,17409,216,56,-48,-134,27.2,1615.6
4838038764,0,10,0,1,1,3,1,1,0,1,0,13934,6.8,17336,199,48,-575,-902,24.7,1393.4,12,0,0,3,1,0,0,0,0,0,14509,7.2,18238,192,48,575,902,24.0,1450.9
4837975882,0,11,1,0,1,3,2,0,0,0,0,13964,7.0,17896,200,60,-2789,-609,26.0,1396.4,14,0,1,3,1,5,1,1,0,0,16753,7.0,18505,240,60,2789,609,30.0,1675.3
4836155991,1,10,1,0,2,7,0,0,0,0,0,13748,6.6,16603,164,59,-3278,-3080,22.3,1374.8,12,1,1,7,2,4,1,1,0,0,17026,7.2,19683,254,69,3278,3080,32.3,1702.6
4836109390,0,12,1,1,6,2,9,1,1,0,0,17452,7.0,18212,227,60,2884,682,28.7,1745.2,9,1,0,2,6,2,0,0,0,0,14568,6.8,17530,196,60,-2884,-682,25.6,1456.8
4835943245,0,12,1,1,6,4,3,0,0,0,0,16401,6.8,18081,210,46,1406,667,25.6,1640.1,11,1,0,4,6,1,0,0,0,0,14995,6.8,17414,210,50,-1406,-667,26.0,1499.5
4835219209,0,0,0,0,17,22,32,0,0,0,0,34853,10.6,36950,88,0,1079,-738,8.8,3485.3,0,0,1,22,17,57,0,0,0,0,33774,10.8,37688,89,0,-1079,738,8.9,3377.4
4834165917,1,13,1,1,7,7,0,0,0,0,0,15395,6.6,16893,178,48,-1498,-1568,22.6,1539.5,10,0,0,7,7,5,0,0,0,0,16893,7.2,18461,196,56,1498,1568,25.2,1689.3
4834119240,0,13,1,1,6,5,2,0,0,0,0,15848,6.6,16485,190,40,1193,70,23.0,1584.8,16,1,0,5,6,4,0,0,0,0,14655,6.6,16415,189,40,-1193,-70,22.9,1465.5
4799899167,0,9,18,1,7,9,5,0,0,0,0,15470,6.6,17512,140,56,-2201,-920,19.6,1547.0,100,2,0,9,7,7,0,0,0,0,17671,7.0,18432,158,56,2201,920,21.4,1767.1
4799854419,1,11,0,1,4,6,6,2,1,1,0,15405,6.4,16039,144,49,204,-967,19.3,1540.5,17,2,0,6,4,1,0,0,0,0,15201,6.6,17006,159,56,-204,967,21.5,1520.1
4799813401,1,14,1,1,2,2,1,0,0,0,0,15578,7.0,18853,173,64,605,905,23.7,1557.8,12,1,0,2,2,1,1,1,0,0,14973,7.0,17948,191,48,-605,-905,23.9,1497.3
4799625579,0,11,1,0,2,3,3,0,0,0,0,14323,7.0,17321,175,60,-1089,-111,23.5,1432.3,14,0,1,3,2,4,0,0,0,0,15412,6.8,17432,213,40,1089,111,25.3,1541.2
4798819608,1,14,1,1,7,5,7,0,0,0,0,16885,7.0,17943,198,60,2250,2415,25.8,1688.5,11,1,0,5,7,6,0,0,0,0,14635,6.4,15528,154,40,-2250,-2415,19.4,1463.5
4798763701,0,10,0,0,7,9,4,0,0,0,0,16266,6.8,17236,163,52,-468,503,21.5,1626.6,9,0,1,9,7,8,0,0,0,0,16734,6.4,16733,122,60,468,-503,18.2,1673.4
4798729855,1,9,1,0,9,8,5,0,0,0,0,16945,6.8,16658,171,36,252,-1355,20.7,1694.5,10,0,1,8,9,6,1,1,0,0,16693,7.0,18013,163,66,-252,1355,22.9,1669.3
4798686331,1,12,13,0,3,5,1,0,0,0,0,13795,7.0,17800,179,64,-1179,-15,24.3,1379.5,28,1,1,5,3,1,0,0,0,0,14974,7.0,17815,200,38,1179,15,23.8,1497.4
4795207832,1,8,0,0,4,5,4,0,0,0,0,14231,6.2,15296,141,36,-859,-2059,17.7,1423.1,12,0,1,5,4,3,0,0,0,0,15090,7.0,17355,166,48,859,2059,21.4,1509.0
4792308670,1,11,0,0,8,5,6,1,1,0,0,15915,6.8,16499,133,60,912,-831,19.3,1591.5,7,0,1,4,7,1,0,0,0,0,15003,6.6,17330,157,52,-912,831,20.9,1500.3
4792267505,0,58,0,0,2,7,2,0,0,0,0,14259,6.4,16551,156,48,-1267,-872,20.4,1425.9,28,1,1,7,2,4,2,1,1,0,15526,6.8,17423,140,64,1267,872,20.4,1552.6
4792188883,1,10,1,1,5,5,2,0,0,0,0,15745,6.8,17484,187,36,1158,614,22.3,1574.5,10,0,0,5,5,4,0,0,0,0,14587,6.6,16870,143,64,-1158,-614,20.7,1458.7
4843221530,0,6,0,1,27,28,62,0,0,0,1,38617,11.8,44008,109,0,-667,-454,10.9,3861.7,0,0,0,28,27,64,0,0,0,0,39284,11.6,44462,107,0,667,454,10.7,3928.4
4843198374,1,0,0,0,24,25,63,0,0,0,0,38969,11.4,42489,95,0,3279,3679,9.5,3896.9,0,0,1,25,24,50,0,0,0,0,35690,11.0,38810,88,0,-3279,-3679,8.8,3569.0
4842936041,1,2,0,0,30,25,72,0,0,0,1,38734,11.6,43808,95,0,53,474,9.5,3873.4,14,0,1,25,30,68,0,0,0,0,38681,11.4,43334,118,0,-53,-474,11.8,3868.1
4842855487,0,0,0,0,32,29,94,0,0,0,1,42221,11.8,45079,118,0,1795,2830,11.8,4222.1,0,0,1,29,32,69,0,0,0,0,40426,11.6,42249,101,0,-1795,-2830,10.1,4042.6
4841326720,1,0,0,0,13,25,32,0,0,0,0,33871,10.0,34972,91,0,-3877,-6384,9.1,3387.1,0,0,1,25,13,65,0,0,0,0,37748,11.2,41356,92,0,3877,6384,9.2,3774.8
4841303438,1,15,0,1,30,26,79,0,0,0,2,38980,11.2,41555,104,0,569,110,10.4,3898.0,0,0,0,26,30,71,0,0,0,0,38411,11.2,41445,94,0,-569,-110,9.4,3841.1
4841289884,0,0,0,0,22,21,50,0,0,0,1,37744,11.0,39549,125,0,921,-105,12.5,3774.4,0,0,1,21,22,51,0,0,0,0,36823,11.0,39654,108,0,-921,105,10.8,3682.3
4841264316,0,0,0,1,16,31,47,0,0,0,1,35687,11.2,39148,101,0,-4484,-4324,10.1,3568.7,0,0,0,31,16,92,0,0,0,0,40171,11.6,43472,123,0,4484,4324,12.3,4017.1
4840914294,1,0,0,0,29,30,76,0,0,0,1,38973,11.4,42449,108,0,736,371,10.8,3897.3,0,0,1,30,29,77,0,0,0,0,38237,11.2,42078,115,0,-736,-371,11.5,3823.7
4840900379,0,76,0,0,24,36,62,0,0,0,1,36335,10.8,38231,95,0,-5447,-9084,9.5,3633.5,0,0,1,36,24,77,0,0,0,0,41782,12.2,47315,97,0,5447,9084,9.7,4178.2
4840853997,1,0,0,0,26,23,80,0,0,0,0,37629,11.4,41654,111,0,-286,185,11.1,3762.9,2,0,1,23,26,54,0,0,0,0,37915,11.2,41469,110,0,286,-185,11.0,3791.5
4840838235,1,14,0,1,24,22,56,0,0,0,0,37686,11.2,41122,117,0,-338,-939,11.7,3768.6,0,5,0,22,24,60,0,0,0,0,38024,11.4,42061,113,0,338,939,11.3,3802.4
4840634355,0,19,0,0,23,32,61,0,0,0,1,37278,11.0,40785,90,0,-3317,-2651,9.0,3727.8,0,0,1,31,22,82,0,0,0,0,40595,11.4,43436,119,0,3317,2651,11.9,4059.5
4840623526,1,68,0,0,26,25,49,0,0,0,1,37630,11.4,42302,99,0,-132,-1248,9.9,3763.0,0,0,1,25,26,66,0,0,0,0,37762,11.8,43550,112,0,132,1248,11.2,3776.2
4840615693,0,2,0,0,24,33,53,0,0,0,1,38564,11.4,41210,132,0,-1142,-1898,13.2,3856.4,0,0,1,33,24,83,0,0,0,0,39706,11.6,43108,113,0,1142,1898,11.3,3970.6
4840276074,1,24,0,1,26,33,70,0,0,0,1,38502,11.4,41749,105,0,-159,-2775,10.5,3850.2,0,0,0,33,26,77,0,0,0,0,38661,11.6,44524,104,0,159,2775,10.4,3866.1
4840255041,1,14,0,1,22,23,74,0,0,0,1,37895,10.8,39071,98,0,631,-1813,9.8,3789.5,0,0,0,23,22,67,0,0,0,0,37264,11.2,40884,73,0,-631,1813,7.3,3726.4
4840223366,1,0,0,1,38,28,108,0,0,0,0,41731,12.0,47152,91,0,1581,2434,9.1,4173.1,0,0,0,28,38,82,0,0,0,0,40150,11.8,44718,91,0,-1581,-2434,9.1,4015.0
4840198361,0,0,2,0,19,29,54,0,0,0,1,36041,10.8,36765,116,0,-4071,-5449,11.6,3604.1,13,0,1,29,19,71,0,0,0,0,40112,11.4,42214,117,0,4071,5449,11.7,4011.2
4840171257,1,0,0,0,17,24,32,0,0,0,0,35515,10.6,37600,109,0,-1367,-3397,10.9,3551.5,0,0,1,24,17,61,0,0,0,0,36882,11.2,40997,115,0,1367,3397,11.5,3688.2
4817390549,1,17,1,0,4,6,4,0,0,0,0,16564,6.8,17275,192,60,-381,-981,25.2,1656.4,8,1,1,6,4,1,0,0,0,0,16945,6.8,18256,219,61,381,981,28.0,1694.5
4758801537,0,176,0,1,5,6,2,0,0,0,0,16104,6.6,16165,182,44,-1325,-1023,22.6,1610.4,17,0,0,6,5,7,1,1,0,0,17429,6.8,17188,187,44,1325,1023,23.1,1742.9
4758763086,1,9,0,0,5,11,5,1,1,0,0,16138,6.4,16365,171,52,-2970,-2341,22.3,1613.8,108,0,1,11,5,6,0,0,0,0,19108,7.0,18706,189,56,2970,2341,24.5,1910.8
4752627956,1,11,1,1,4,4,4,1,1,0,0,14800,6.8,17465,184,60,-572,-314,24.4,1480.0,18,0,0,4,4,2,0,0,0,0,15372,6.8,17779,203,45,572,314,24.8,1537.2
4749347023,0,21,0,0,3,8,1,0,0,0,0,14305,6.6,17117,188,50,-3053,-311,23.8,1430.5,13,2,1,8,3,12,0,0,0,0,17358,6.8,17428,206,58,3053,311,26.4,1735.8
4737374790,1,12,2,0,5,1,7,0,0,0,0,16281,6.8,18303,188,60,3169,1855,24.8,1628.1,15,0,1,1,5,1,0,0,0,0,13112,6.4,16448,186,47,-3169,-1855,23.3,1311.2
4675990587,0,12,2,1,6,5,3,0,0,0,0,17103,6.8,17688,199,56,1156,768,25.5,1710.3,13,2,0,5,6,3,0,0,0,0,15947,6.6,16920,180,48,-1156,-768,22.8,1594.7
4675958536,1,10,0,0,8,5,4,0,0,0,0,16625,6.6,17727,168,64,-760,211,23.2,1662.5,16,2,1,5,8,6,1,1,0,0,17385,6.6,17516,193,52,760,-211,24.5,1738.5
4669541981,1,11,3,1,7,4,9,0,0,0,0,16977,6.8,17986,219,52,-553,-909,27.1,1697.7,41,2,0,4,7,4,1,1,0,0,17530,7.0,18895,245,44,553,909,28.9,1753.0
4669503669,1,13,0,1,7,6,5,1,1,0,0,17546,7.0,17994,194,72,1071,87,26.6,1754.6,13,1,0,6,7,6,0,0,0,0,16475,7.2,17907,188,64,-1071,-87,25.2,1647.5
4669483098,0,7,1,1,6,6,3,1,1,0,0,17398,7.0,18351,167,64,446,263,23.1,1739.8,12,0,0,6,6,5,0,0,0,0,16952,7.0,18088,179,52,-446,-263,23.1,1695.2
4669454088,1,15,2,0,2,2,1,0,0,0,0,14918,7.2,19299,202,56,-360,701,25.8,1491.8,15,4,1,2,2,2,1,1,0,0,15278,7.0,18598,247,68,360,-701,31.5,1527.8
4652532332,1,25,1,1,7,8,7,0,0,0,0,17734,6.8,17330,208,36,1520,800,24.4,1773.4,178,0,0,8,7,4,0,0,0,0,16214,6.4,16530,172,42,-1520,-800,21.4,1621.4
4651976085,0,8,3,1,4,4,6,0,0,0,0,14432,6.2,15002,190,36,-1369,-3346,22.6,1443.2,17,0,0,4,4,1,0,0,0,0,15801,6.8,18348,205,52,1369,3346,25.7,1580.1
4651946197,0,7,2,1,3,5,3,0,0,0,0,14135,6.6,16950,158,52,-2359,-1828,21.0,1413.5,15,0,0,5,3,4,1,1,0,0,16494,7.0,18778,236,63,2359,1828,29.9,1649.4
4649382802,1,14,2,1,7,4,5,0,0,0,0,17295,6.4,16243,190,28,2082,583,21.8,1729.5,8,2,0,4,7,4,0,0,0,0,15213,6.6,15660,169,62,-2082,-583,23.1,1521.3
4639883743,1,250,0,1,6,5,3,1,1,0,0,16280,7.0,18282,184,60,569,2446,24.4,1628.0,11,1,0,5,6,5,0,0,0,0,15711,6.4,15836,195,44,-569,-2446,23.9,1571.1
4639826536,0,13,1,1,7,6,4,0,0,0,0,15900,6.8,17216,205,52,348,523,25.7,1590.0,19,0,0,6,7,4,0,0,0,0,15552,6.8,16693,158,52,-348,-523,21.0,1555.2
4636405024,1,8,0,1,8,4,5,0,0,0,0,17106,6.6,16434,151,60,1867,-366,21.1,1710.6,9,0,0,4,8,4,0,0,0,0,15239,6.6,16800,198,40,-1867,366,23.8,1523.9
4855188889,1,65,5,0,18,16,10,0,0,0,0,47530,10.0,47500,7,0,19620,19000,0.7,4753.0,18,7,1,7,9,10,0,0,0,0,27910,6.0,28500,1,0,-19620,-19000,0.1,2791.0
4855160531,1,0,0,1,24,14,22,0,0,0,0,63240,12.8,59000,4,0,26390,26000,0.4,6324.0,0,0,0,7,17,8,0,0,0,0,36850,7.2,33000,0,0,-26390,-26000,0.0,3685.0
4855133433,1,0,0,1,19,18,14,0,0,0,0,45600,10.0,47500,0,0,16700,19000,0.0,4560.0,0,0,0,9,10,14,0,0,0,0,28900,6.0,28500,0,0,-16700,-19000,0.0,2890.0
4855105449,1,0,0,1,21,21,19,0,0,0,0,48086,10.0,47500,0,0,18824,19000,0.0,4808.6,432,0,0,12,12,14,0,0,0,0,29262,6.0,28500,0,0,-18824,-19000,0.0,2926.2
4855064741,1,24,0,0,17,23,11,0,0,0,0,46630,10.0,47500,0,0,16330,19000,0.0,4663.0,2,0,1,15,9,15,0,0,0,0,30300,6.0,28500,0,0,-16330,-19000,0.0,3030.0
4853788184,1,0,0,0,21,11,19,0,0,0,0,62100,12.0,55000,2,0,24840,22000,0.2,6210.0,0,0,1,5,15,6,0,0,0,0,37260,7.2,33000,2,0,-24840,-22000,0.2,3726.0
4852917257,1,0,0,1,22,20,24,0,0,0,0,63106,12.0,55000,0,0,24836,22000,0.0,6310.6,0,0,0,12,14,10,0,0,0,0,38270,7.2,33000,0,0,-24836,-22000,0.0,3827.0
4852890245,1,0,0,1,15,19,12,0,0,0,0,45600,10.0,47500,0,0,16700,16000,0.0,4560.0,0,0,0,14,10,16,0,0,0,0,28900,6.6,31500,0,0,-16700,-16000,0.0,2890.0
4852861349,1,29,3,0,10,21,9,0,0,0,0,45290,10.0,47500,1,0,14005,16000,0.1,4529.0,23,7,1,15,4,13,0,0,0,0,31285,6.6,31500,0,0,-14005,-16000,0.0,3128.5
4852832327,1,0,0,0,16,18,17,0,0,0,0,46300,10.0,47500,0,0,17400,19000,0.0,4630.0,0,0,1,12,10,13,0,0,0,0,28900,6.0,28500,0,0,-17400,-19000,0.0,2890.0
4852798392,1,0,0,1,16,15,16,0,0,0,0,46680,10.0,47500,0,0,19455,19000,0.0,4668.0,0,0,0,7,8,8,0,0,0,0,27225,6.0,28500,1,0,-19455,-19000,0.1,2722.5
4819723357,1,95,0,0,16,16,16,0,0,0,0,33939,10.8,38355,81,67,2178,1634,14.8,3393.9,14,0,1,16,16,22,0,0,0,0,31761,10.8,36721,78,47,-2178,-1634,12.5,3176.1
4819711139,0,11,0,1,16,4,37,0,0,0,0,35015,10.4,36979,55,64,986,1837,11.9,3501.5,34,1,0,4,16,7,0,0,0,0,34029,10.4,35142,81,71,-986,-1837,15.2,3402.9
4818841379,0,80,1,1,12,22,17,0,0,0,2,36287,10.8,38237,84,55,-3420,-2093,13.9,3628.7,8,5,0,22,12,50,0,0,0,0,39707,11.2,40330,73,75,3420,2093,14.8,3970.7
4818815089,1,8,2,1,9,18,27,0,0,0,0,34383,11.2,39600,107,63,-638,-799,17.0,3438.3,15,1,0,18,9,41,0,0,0,0,35021,11.4,40399,95,63,638,799,15.8,3502.1
4818690166,0,15,0,0,16,12,15,0,0,0,1,31960,10.8,36774,59,51,1164,3981,11.0,3196.0,19,0,1,12,16,17,0,0,0,0,30796,10.2,32793,59,59,-1164,-3981,11.8,3079.6
4818679894,0,6,0,0,9,27,15,0,0,0,0,31548,10.0,31102,62,43,-3428,-5690,10.5,3154.8,10,0,1,27,9,64,0,0,0,0,34976,10.6,36792,77,51,3428,5690,12.8,3497.6
4818659595,0,9,0,1,10,14,17,0,0,0,0,31341,10.4,36233,67,59,-2712,-2725,12.6,3134.1,13,0,0,14,10,21,0,0,0,0,34053,11.0,38958,93,68,2712,2725,16.1,3405.3
4817696786,1,15,0,0,20,19,53,0,0,0,0,37328,11.0,38785,69,47,2966,2533,11.6,3732.8,22,0,1,19,20,45,0,0,0,0,34362,10.4,36252,81,43,-2966,-2533,12.4,3436.2
4857205781,1,0,0,1,19,12,23,0,0,0,0,62700,12.8,61000,0,0,26900,25000,0.0,6270.0,0,0,0,6,13,6,0,0,0,0,35800,7.6,36000,0,0,-26900,-25000,0.0,3580.0
4857169686,1,16,0,1,13,17,16,0,0,0,0,45250,10.0,47500,0,0,15500,19000,0.0,4525.0,18,0,0,12,8,11,0,0,0,0,29750,6.0,28500,0,0,-15500,-19000,0.0,2975.0
4857001902,0,15,1,1,8,5,7,0,0,0,0,17551,6.6,17563,198,40,315,-1783,23.8,1755.1,12,0,0,5,8,4,0,0,0,0,17236,7.2,19346,225,76,-315,1783,30.1,1723.6
4856276492,1,0,0,1,18,21,21,0,0,0,0,46650,10.0,47500,0,0,14800,19000,0.0,4665.0,0,0,0,14,11,14,0,0,0,0,31850,6.0,28500,0,0,-14800,-19000,0.0,3185.0
4856246608,1,38,0,1,22,14,26,0,0,0,0,62700,12.0,55000,0,0,26150,22000,0.0,6270.0,9,0,0,10,18,6,0,0,0,0,36550,7.2,33000,1,0,-26150,-22000,0.1,3655.0
4856219970,1,0,0,1,24,10,22,0,0,0,0,47350,10.2,48680,0,0,21600,20180,0.0,4735.0,0,0,0,2,16,5,0,0,0,0,25750,6.0,28500,0,0,-21600,-20180,0.0,2575.0
4855953148,1,39,0,1,19,22,12,0,0,0,0,61395,12.0,55000,1,0,22690,22000,0.1,6139.5,0,1,0,12,9,18,0,0,0,0,38705,7.2,33000,2,0,-22690,-22000,0.2,3870.5
4855936206,1,0,0,1,15,19,11,0,0,0,0,60600,12.2,56000,0,0,22000,23000,0.0,6060.0,0,0,0,12,8,13,0,0,0,0,38600,7.2,33000,0,0,-22000,-23000,0.0,3860.0
4855913734,1,0,10,1,19,16,22,0,0,0,0,64150,12.0,55000,0,0,27575,22000,0.0,6415.0,35,0,0,7,10,6,0,0,0,0,36575,7.2,33000,3,0,-27575,-22000,0.3,3657.5
4855901907,1,19,0,1,16,17,16,0,0,0,0,63750,12.0,55000,0,0,26187,22000,0.0,6375.0,0,1,0,11,10,10,0,0,0,0,37563,7.2,33000,1,0,-26187,-22000,0.1,3756.3
4854003366,1,0,0,0,12,18,13,0,0,0,0,44936,10.2,48680,0,0,16002,20180,0.0,4493.6,0,0,1,13,7,12,0,0,0,0,28934,6.0,28500,0,0,-16002,-20180,0.0,2893.4
4853974613,1,18,0,1,17,17,17,0,0,0,0,47500,10.0,47500,3,0,19650,19000,0.3,4750.0,0,0,0,10,10,8,0,0,0,0,27850,6.0,28500,0,0,-19650,-19000,0.0,2785.0
4853957040,1,3,0,1,14,18,15,0,0,0,0,47000,10.0,47500,0,0,17400,19000,0.0,4700.0,9,0,0,14,10,8,0,0,0,0,29600,6.0,28500,0,0,-17400,-19000,0.0,2960.0
4853935766,1,16,2,1,20,18,20,0,0,0,0,47045,10.0,47500,3,0,18820,19000,0.3,4704.5,5,0,0,7,9,10,0,0,0,0,28225,6.0,28500,1,0,-18820,-19000,0.1,2822.5
4852473702,1,3,0,0,13,16,14,0,0,0,0,60600,12.0,55000,0,0,22939,22000,0.0,6060.0,0,0,1,10,7,8,0,0,0,0,37661,7.2,33000,0,0,-22939,-22000,0.0,3766.1
4851696234,1,14,0,1,5,5,7,1,1,0,0,17374,6.8,18906,212,68,2401,1225,28.0,1737.4,7,2,0,5,5,4,0,0,0,0,14973,6.8,17681,185,44,-2401,-1225,22.9,1497.3
4851635212,1,9,3,0,6,8,6,0,0,0,0,16645,6.6,16642,184,47,-3375,-3207,23.1,1664.5,74,4,1,8,6,8,2,1,1,0,20020,7.6,19849,234,60,3375,3207,29.4,2002.0
4850804078,0,0,0,1,19,24,40,0,0,0,0,35987,10.8,37973,108,0,-761,-2063,10.8,3598.7,0,0,0,24,19,56,0,0,0,0,36748,11.2,40036,83,0,761,2063,8.3,3674.8
4850744625,0,0,1,0,18,24,46,0,0,0,1,36633,10.6,36850,102,0,-1238,-5489,10.2,3663.3,2,0,1,24,18,70,0,0,0,0,37871,11.2,42339,93,0,1238,5489,9.3,3787.1
4850725437,0,0,0,1,23,24,51,0,0,0,1,37730,11.4,40381,95,0,312,-297,9.5,3773.0,3,0,0,24,23,61,0,0,0,0,37418,11.2,40678,112,0,-312,297,11.2,3741.8
4855121343,0,0,0,1,29,30,58,0,0,0,1,38049,11.6,43205,108,0,-1496,-512,10.8,3804.9,0,0,0,30,29,79,0,0,0,0,39545,11.8,43717,88,0,1496,512,8.8,3954.5
4855089879,0,15,0,0,17,21,49,0,0,0,1,35335,10.6,37264,111,0,-1044,-3035,11.1,3533.5,0,1,1,21,17,50,0,0,0,0,36379,11.0,40299,100,0,1044,3035,10.0,3637.9
4855061735,0,0,0,0,20,18,48,0,0,0,2,35337,11.0,40559,90,0,-1859,159,9.0,3533.7,0,0,1,18,20,28,0,0,0,0,37196,11.0,40400,120,0,1859,-159,12.0,3719.6
4855009282,0,16,3,0,2,4,2,1,0,1,0,15089,7.0,17947,180,56,-906,309,23.6,1508.9,13,3,1,4,2,6,1,1,0,0,15995,6.6,17638,185,56,906,-309,24.1,1599.5
4854949411,1,27,3,1,5,1,5,0,0,0,0,15901,6.8,17850,202,52,2103,674,25.4,1590.1,17,2,0,1,5,0,0,0,0,0,13798,6.8,17176,209,56,-2103,-674,26.5,1379.8
4854922602,1,9,0,0,20,29,70,0,0,0,1,36709,10.8,38891,87,0,-2852,-4222,8.7,3670.9,0,0,1,29,20,82,0,0,0,0,39561,11.4,43113,113,0,2852,4222,11.3,3956.1
4854890701,1,68,0,1,24,22,68,0,0,0,0,37392,11.2,41068,100,0,1291,1186,10.0,3739.2,0,0,0,22,24,61,0,0,0,0,36101,11.0,39882,107,0,-1291,-1186,10.7,3610.1
4854868565,0,0,0,0,18,17,50,0,0,0,0,35884,11.2,39887,90,0,499,2991,9.0,3588.4,0,0,1,16,17,40,0,0,0,0,35385,10.6,36896,81,0,-499,-2991,8.1,3538.5
4854806599,1,16,1,0,4,5,3,0,0,0,0,15339,7.2,18213,185,60,-1550,-1300,24.5,1533.9,12,0,1,5,4,5,1,1,0,0,16889,7.2,19513,205,80,1550,1300,28.5,1688.9
4854763960,0,17,1,0,5,3,3,0,0,0,0,16240,7.0,18047,201,60,505,1111,26.1,1624.0,168,1,1,3,5,3,1,1,0,0,15735,6.8,16936,222,48,-505,-1111,27.0,1573.5
4854744967,0,0,3,0,19,28,48,0,0,0,0,37314,10.8,38790,93,0,-1144,-3220,9.3,3731.4,15,0,1,28,19,75,0,0,0,0,38458,11.4,42010,94,0,1144,3220,9.4,3845.8
4854721461,0,0,0,1,20,24,37,0,0,0,1,35259,10.6,38270,99,0,-2458,-3262,9.9,3525.9,89,0,0,24,20,66,0,0,0,0,37717,11.2,41532,100,0,2458,3262,10.0,3771.7
4854221704,0,10,0,0,20,33,45,0,0,0,3,36483,10.8,37874,101,0,-4285,-4526,10.1,3648.3,25,0,1,33,20,85,0,0,0,0,40768,11.4,42400,122,0,4285,4526,12.2,4076.8
4854193698,1,15,0,1,26,28,58,0,0,0,1,38664,11.0,40549,118,0,427,-1055,11.8,3866.4,19,6,0,28,26,83,0,0,0,0,38237,11.2,41604,110,0,-427,1055,11.0,3823.7
4854170645,1,0,0,1,20,20,42,0,0,0,1,37092,10.8,39013,118,0,2023,1419,11.8,3709.2,0,0,0,20,20,40,0,0,0,0,35069,10.6,37594,80,0,-2023,-1419,8.0,3506.9
4853828427,0,15,1,1,3,0,4,0,0,0,0,14434,6.6,17058,196,48,443,-698,24.4,1443.4,11,2,0,0,3,0,1,1,0,0,13991,6.8,17756,224,56,-443,698,28.0,1399.1
4853782164,1,0,0,0,20,25,43,0,0,0,0,34413,10.6,37545,107,0,-2100,-1885,10.7,3441.3,0,0,1,25,20,69,0,0,0,0,36513,11.2,39430,115,0,2100,1885,11.5,3651.3
4852806586,1,9,0,0,23,19,73,0,0,0,0,37106,11.0,40705,104,0,654,873,10.4,3710.6,19,0,1,19,23,38,0,0,0,0,36452,11.0,39832,108,0,-654,-873,10.8,3645.2
4852788069,1,0,0,0,23,17,62,0,0,0,2,37535,11.0,37970,120,0,1454,2918,12.0,3753.5,0,0,1,17,23,36,0,0,0,0,36081,10.2,35052,98,0,-1454,-2918,9.8,3608.1
4849642605,0,34,0,0,26,19,80,0,0,0,0,37192,11.4,41936,99,0,10,2033,9.9,3719.2,34,0,1,19,26,46,0,0,0,0,37182,11.0,39903,91,0,-10,-2033,9.1,3718.2
4849626267,0,13,0,0,16,27,40,0,0,0,0,34458,10.4,36250,94,0,-5986,-6294,9.4,3445.8,0,5,1,27,16,65,0,0,0,0,40444,11.6,42544,124,0,5986,6294,12.4,4044.4
4849607274,0,23,2,0,22,32,63,0,0,0,0,36335,11.2,41615,91,0,-1247,-169,9.1,3633.5,21,15,1,32,22,74,0,0,0,0,37582,11.2,41784,81,0,1247,169,8.1,3758.2
4849585649,0,0,2,0,14,21,30,0,0,0,0,35123,10.6,36539,94,0,-537,-1894,9.4,3512.3,352,0,1,21,14,50,0,0,0,0,35660,10.6,38433,95,0,537,1894,9.5,3566.0
4843972848,0,7,0,0,14,30,41,0,0,0,2,35448,10.4,37828,88,0,-3941,-5036,8.8,3544.8,0,0,1,30,14,78,0,0,0,0,39389,11.4,42864,112,0,3941,5036,11.2,3938.9
4843950380,1,16,0,0,17,16,51,0,0,0,0,36229,11.0,39469,106,0,1454,2574,10.6,3622.9,0,2,1,16,17,43,0,0,0,0,34775,10.4,36895,104,0,-1454,-2574,10.4,3477.5
4843937831,0,252,0,1,22,28,52,0,0,0,0,37934,11.4,41703,111,0,1207,754,11.1,3793.4,11,0,0,28,22,61,0,0,0,0,36727,11.2,40949,92,0,-1207,-754,9.2,3672.7
4843922233,1,356,0,0,26,30,61,0,0,0,0,38995,11.8,45147,105,0,1961,4407,10.5,3899.5,0,0,1,30,26,75,0,0,0,0,37034,11.2,40740,99,0,-1961,-4407,9.9,3703.4
4839452885,1,14,0,1,17,20,43,0,0,0,1,36603,11.2,40244,124,0,912,1343,12.4,3660.3,0,4,0,20,17,55,0,0,0,0,35691,10.8,38901,86,0,-912,-1343,8.6,3569.1
4839435353,1,1,0,0,33,29,86,0,0,0,1,40941,11.8,44297,102,0,13,225,10.2,4094.1,22,0,1,29,33,87,0,0,0,0,40928,11.6,44072,73,0,-13,-225,7.3,4092.8
4839417637,1,12,1,0,22,31,49,0,0,0,0,38492,11.4,42387,111,0,-184,835,11.1,3849.2,3,1,1,31,22,76,0,0,0,0,38676,11.0,41552,102,0,184,-835,10.2,3867.6
4837157953,0,0,0,0,15,25,38,0,0,0,0,35025,10.8,38515,90,0,-2525,-3198,9.0,3502.5,77,0,1,25,15,66,0,0,0,0,37550,11.6,41713,106,0,2525,3198,10.6,3755.0
4837136838,1,11,0,0,26,27,51,0,0,0,1,39435,11.8,44235,98,0,1913,2609,9.8,3943.5,0,4,1,27,26,69,0,0,0,0,37522,11.4,41626,108,0,-1913,-2609,10.8,3752.2
4837101749,1,14,0,0,17,22,45,0,0,0,0,35078,10.8,37972,88,0,-1527,-2641,8.8,3507.8,0,4,1,22,17,59,0,0,0,0,36605,11.2,40613,102,0,1527,2641,10.2,3660.5
4833208658,1,3,0,1,31,29,72,0,0,0,0,38665,11.6,43400,94,0,-430,963,9.4,3866.5,7,0,0,29,31,66,0,0,0,0,39095,11.4,42437,100,0,430,-963,10.0,3909.5
4833186172,1,0,0,1,25,22,67,0,0,0,2,38850,11.4,43030,109,0,1498,2521,10.9,3885.0,0,0,0,22,25,55,0,0,0,0,37352,11.2,40509,75,0,-1498,-2521,7.5,3735.2
4833156326,0,92,0,1,18,16,34,0,0,0,0,35057,10.8,37795,92,0,357,1011,9.2,3505.7,0,0,0,16,18,43,0,0,0,0,34700,10.6,36784,76,0,-357,-1011,7.6,3470.0
4833124984,0,0,0,1,36,27,85,0,0,0,0,40438,12.0,46795,86,0,2475,4630,8.6,4043.8,9,0,0,27,36,40,0,0,0,0,37963,11.4,42165,92,0,-2475,-4630,9.2,3796.3
4829828812,0,0,0,0,25,24,50,0,0,0,0,36818,11.4,41520,107,0,-803,-1086,10.7,3681.8,4,0,1,24,25,55,0,0,0,0,37621,11.2,42606,111,0,803,1086,11.1,3762.1
4829804235,1,0,0,1,41,20,114,0,0,0,1,40999,12.0,46213,97,0,3789,5795,9.7,4099.9,171,0,0,20,41,42,0,0,0,0,37210,11.2,40418,100,0,-3789,-5795,10.0,3721.0
4852000197,0,7,0,1,2,7,2,1,1,0,0,12435,6.0,13150,158,24,-7331,-6182,18.2,1243.5,19,0,0,7,2,10,0,0,0,0,19766,7.2,19332,240,73,7331,6182,31.3,1976.6
4851960856,1,63,1,0,4,4,5,0,0,0,0,15716,6.6,16512,204,46,201,-1430,25.0,1571.6,14,1,1,4,4,2,1,1,0,0,15515,6.8,17942,204,52,-201,1430,25.6,1551.5
4851039396,0,12,0,0,10,8,7,1,1,0,0,17799,6.8,17956,183,43,851,1068,22.6,1779.9,10,0,1,8,10,7,0,0,0,0,16948,6.6,16888,188,52,-851,-1068,24.0,1694.8
4845980676,1,20,1,0,4,8,5,1,1,0,0,15418,6.8,17586,204,48,-2467,-896,25.2,1541.8,12,1,1,8,4,5,0,0,0,0,17885,7.0,18482,204,56,2467,896,26.0,1788.5
4845388672,0,13,0,0,3,3,2,0,0,0,0,13860,6.6,17347,167,44,-1305,-1664,21.1,1386.0,9,0,1,3,3,0,0,0,0,0,15165,7.0,19011,239,56,1305,1664,29.5,1516.5
4845374937,1,11,1,1,5,4,6,1,1,0,0,16074,7.2,18595,206,56,750,635,26.2,1607.4,10,2,0,4,5,4,0,0,0,0,15324,6.8,17960,220,51,-750,-635,27.1,1532.4
4845331210,0,15,0,1,7,6,3,0,0,0,0,16427,6.6,15992,188,36,-8,-1222,22.4,1642.7,10,1,0,6,7,4,0,0,0,0,16435,7.0,17214,189,52,8,1222,24.1,1643.5
4845294686,0,11,1,0,6,11,6,1,1,0,0,18058,7.0,19460,225,56,157,-91,28.1,1805.8,18,0,1,11,6,5,0,0,0,0,17901,7.0,19551,186,68,-157,91,25.4,1790.1
4845269972,1,13,1,1,4,4,5,0,0,0,0,18032,7.2,19163,222,60,3382,2654,28.2,1803.2,9,3,0,4,4,4,0,0,0,0,14650,6.6,16509,180,52,-3382,-2654,23.2,1465.0
4839960763,1,11,0,1,8,1,10,0,0,0,0,16908,6.8,16844,197,54,2341,-130,25.1,1690.8,13,0,0,1,8,1,0,0,0,0,14567,6.8,16974,181,43,-2341,130,22.4,1456.7
4833853427,0,178,0,1,4,4,1,1,1,0,0,16286,7.0,18004,202,64,-1399,-639,26.6,1628.6,9,0,0,4,4,1,0,0,0,0,17685,7.4,18643,208,41,1399,639,24.9,1768.5
4833824374,0,114,1,1,8,4,4,0,0,0,0,16516,7.0,18371,204,52,268,-271,25.6,1651.6,15,2,0,4,8,4,1,1,0,0,16248,7.0,18642,228,64,-268,271,29.2,1624.8
4833795912,0,19,2,0,7,10,4,0,0,0,0,15982,6.8,17324,183,56,-1355,7,23.9,1598.2,17,2,1,10,7,9,1,1,0,0,17337,6.8,17317,187,68,1355,-7,25.5,1733.7
4833342803,0,8,2,0,3,2,3,0,0,0,0,13553,6.6,16479,142,51,-1254,21,19.3,1355.3,12,0,1,2,3,2,1,1,0,0,14807,6.6,16458,223,45,1254,-21,26.8,1480.7
4833313758,0,7,1,0,6,7,4,1,0,1,0,16178,6.8,16618,195,48,-1020,-130,24.3,1617.8,13,0,1,7,6,5,0,0,0,0,17198,6.4,16748,195,48,1020,130,24.3,1719.8
4833266028,1,35,1,0,5,2,4,1,1,0,0,16412,7.0,18753,204,56,2557,1827,26.0,1641.2,89,14,1,2,5,2,0,0,0,0,13855,6.6,16926,166,43,-2557,-1827,20.9,1385.5
4833228036,1,16,2,1,7,3,4,1,0,1,0,16906,7.0,18964,212,64,1086,1070,27.6,1690.6,7,2,0,3,7,3,1,1,0,0,15820,6.8,17894,221,54,-1086,-1070,27.5,1582.0
4833145296,0,19,0,0,6,1,6,0,0,0,0,16059,7.2,18720,200,60,799,1344,26.0,1605.9,17,1,1,1,6,0,0,0,0,0,15260,6.6,17376,209,52,-799,-1344,26.1,1526.0
4833108216,1,12,1,1,8,1,9,1,1,0,0,18823,7.2,19107,244,60,4472,1130,30.4,1882.3,12,0,0,1,8,1,0,0,0,0,14351,7.0,17977,194,60,-4472,-1130,25.4,1435.1
4855963486,0,5,0,1,31,20,85,0,0,0,1,40571,11.8,44907,102,0,3633,4864,10.2,4057.1,0,0,0,20,31,36,0,0,0,0,36938,11.0,40043,92,0,-3633,-4864,9.2,3693.8
4855950766,1,0,0,1,33,23,82,0,0,0,0,38112,11.8,44049,113,0,914,2940,11.3,3811.2,0,0,0,23,33,49,0,0,0,0,37198,11.4,41109,84,0,-914,-2940,8.4,3719.8
4854395453,1,15,2,0,5,4,5,0,0,0,0,16216,7.0,18115,167,51,1088,1838,21.8,1621.6,12,1,1,4,5,5,1,1,0,0,15128,6.4,16277,168,48,-1088,-1838,21.6,1512.8
4854259283,1,17,2,1,6,2,2,0,0,0,0,16822,7.0,18028,201,54,3723,1911,25.5,1682.2,13,1,0,2,6,1,0,0,0,0,13099,6.6,16117,162,50,-3723,-1911,21.2,1309.9
4853300892,0,16,4,1,5,6,6,1,1,0,0,15702,6.8,17191,179,36,-1119,-851,21.5,1570.2,10,0,0,6,5,4,1,0,1,0,16821,6.8,18042,191,60,1119,851,25.1,1682.1
4853266604,1,14,1,1,5,3,4,0,0,0,0,16109,7.0,17654,177,45,1245,756,22.2,1610.9,26,0,0,3,5,3,0,0,0,0,14864,6.8,16898,182,48,-1245,-756,23.0,1486.4
4853257602,1,11,0,0,4,4,2,0,0,0,0,15342,6.8,17673,178,56,-429,-124,23.4,1534.2,11,1,1,4,4,1,0,0,0,0,15771,7.0,17797,213,44,429,124,25.7,1577.1
4853225698,1,0,0,1,23,17,65,0,0,0,0,35725,11.0,39239,116,0,1431,-308,11.6,3572.5,0,0,0,17,23,51,0,0,0,0,34294,10.8,39547,66,0,-1431,308,6.6,3429.4
4853220155,0,29,0,1,26,23,80,0,0,0,1,37123,11.0,39637,80,0,-714,-1933,8.0,3712.3,18,0,0,23,26,50,0,0,0,0,37837,11.4,41570,108,0,714,1933,10.8,3783.7
4853208444,1,0,0,1,22,19,72,0,0,0,1,36880,11.0,39768,105,0,1686,1093,10.5,3688.0,0,0,0,19,22,45,0,0,0,0,35194,10.8,38675,67,0,-1686,-1093,6.7,3519.4
4852961577,1,13,1,0,5,3,9,1,1,0,0,14942,6.8,16587,173,44,565,837,21.7,1494.2,20,1,1,3,5,5,0,0,0,0,14377,6.2,15750,190,52,-565,-837,24.2,1437.7
4852912473,1,11,3,0,8,7,6,1,1,0,0,16615,7.2,17981,192,64,-67,-1249,25.6,1661.5,16,1,1,7,8,3,0,0,0,0,16682,7.2,19230,190,56,67,1249,24.6,1668.2
4852855217,1,12,1,1,3,2,4,1,1,0,0,15655,7.0,17916,232,55,516,-870,28.7,1565.5,10,0,0,2,3,1,0,0,0,0,15139,7.2,18786,214,67,-516,870,28.1,1513.9
4852644901,0,11,2,1,2,6,1,0,0,0,0,14894,7.0,18061,228,66,-749,865,29.4,1489.4,14,4,0,6,2,6,0,0,0,0,15643,6.8,17196,188,36,749,-865,22.4,1564.3
4852225992,1,34,2,1,3,6,1,1,0,1,0,15930,6.8,18054,201,56,-667,603,25.7,1593.0,7,14,0,6,3,8,1,1,0,0,16597,7.0,17451,199,52,667,-603,25.1,1659.7
4852213259,0,14,9,1,6,1,5,0,0,0,0,16123,7.0,17681,206,40,857,-565,24.6,1612.3,33,2,0,1,6,0,1,1,0,0,15266,7.4,18246,222,64,-857,565,28.6,1526.6
4852198510,0,10,0,1,6,4,4,0,0,0,0,16139,6.6,17036,195,41,143,-208,23.6,1613.9,15,0,0,4,6,6,0,0,0,0,15996,7.0,17244,166,58,-143,208,22.4,1599.6
4852192858,1,15,1,0,2,6,1,1,1,0,0,14690,7.0,18467,191,72,-2137,-307,26.3,1469.0,16,2,1,6,2,6,0,0,0,0,16827,7.2,18774,179,44,2137,307,22.3,1682.7
4852175594,0,0,0,0,29,46,78,0,0,0,1,39869,11.6,43271,81,0,-5224,-5395,8.1,3986.9,0,0,1,46,29,133,0,0,0,0,45093,12.2,48666,115,0,5224,5395,11.5,4509.3
4852164713,0,10,0,1,24,22,51,0,0,0,0,38139,11.0,41547,104,0,2039,1466,10.4,3813.9,0,2,0,22,24,66,0,0,0,0,36100,11.0,40081,106,0,-2039,-1466,10.6,3610.0
4852015902,1,11,0,0,7,4,6,1,1,0,0,15967,7.2,19414,199,44,626,2012,24.3,1596.7,11,1,1,4,7,0,1,0,1,0,15341,7.0,17402,171,60,-626,-2012,23.1,1534.1
4850028337,0,81,1,1,5,5,0,0,0,0,0,14915,6.4,16462,182,48,-1068,-1868,23.0,1491.5,20,1,0,5,5,4,0,0,0,0,15983,7.0,18330,180,40,1068,1868,22.0,1598.3
4849989582,0,36,0,0,3,6,1,0,0,0,0,15112,7.0,17827,187,56,-1496,-826,24.3,1511.2,19,14,1,6,3,6,1,1,0,0,16608,7.4,18653,207,64,1496,826,27.1,1660.8
4849965177,1,67,0,1,12,2,7,0,0,0,0,18342,7.0,18190,147,44,6128,3878,19.1,1834.2,0,0,0,2,12,1,0,0,0,0,12214,6.2,14312,136,0,-6128,-3878,13.6,1221.4
4848998744,1,18,0,1,10,0,12,1,1,0,0,18298,6.2,15528,117,56,7270,389,17.3,1829.8,5,0,0,0,10,0,0,0,0,0,11028,6.4,15139,120,0,-7270,-389,12.0,1102.8
4848974753,1,9,0,0,9,1,10,0,0,0,0,16748,6.8,16691,117,48,5061,1870,16.5,1674.8,58,1,1,1,9,1,0,0,0,0,11687,6.2,14821,151,0,-5061,-1870,15.1,1168.7
4839175312,0,68,0,1,20,14,49,0,0,0,1,35678,11.2,41573,89,0,1395,5176,8.9,3567.8,8,0,0,14,20,34,0,0,0,0,34283,10.6,36397,107,0,-1395,-5176,10.7,3428.3
4837654539,1,162,2,1,28,18,74,0,0,0,1,38903,11.8,43411,86,0,3569,6289,8.6,3890.3,13,0,0,18,28,42,0,0,0,0,35334,10.6,37122,84,0,-3569,-6289,8.4,3533.4
4837645453,1,12,1,0,12,13,22,0,0,0,1,35502,11.2,39842,94,61,5856,7362,15.5,3550.2,8,1,1,13,12,25,0,0,0,0,29646,10.2,32480,71,44,-5856,-7362,11.5,2964.6
4837124284,1,24,0,1,14,11,19,0,0,0,1,30496,10.2,35050,72,43,-1693,1000,11.5,3049.6,135,3,0,10,13,15,0,0,0,0,32189,10.2,34050,95,51,1693,-1000,14.6,3218.9
4837105911,1,33,2,1,13,1,21,0,0,0,2,35758,11.2,40034,111,55,7161,6165,16.6,3575.8,19,0,0,1,13,2,0,0,0,0,28597,10.2,33869,105,55,-7161,-6165,16.0,2859.7
4833560055,0,12,1,1,12,11,18,0,0,0,0,36987,11.2,40854,100,71,6215,3759,17.1,3698.7,27,0,0,11,12,20,0,0,0,0,30772,10.8,37095,91,57,-6215,-3759,14.8,3077.2
4833548023,1,13,0,0,18,25,36,0,0,0,0,36141,10.4,36481,87,61,-1420,-2118,14.8,3614.1,19,0,1,25,18,63,0,0,0,0,37561,11.0,38599,95,51,1420,2118,14.6,3756.1
4833538911,1,15,0,0,21,14,29,0,0,0,1,36349,11.2,41028,79,71,4211,4509,15.0,3634.9,12,0,1,14,21,23,0,0,0,0,32138,10.4,36519,67,55,-4211,-4509,12.2,3213.8
4833048651,1,65,1,1,13,12,36,0,0,0,0,34376,10.4,37461,109,51,4748,2754,16.0,3437.6,76,0,0,12,13,25,0,0,0,0,29628,10.4,34707,73,51,-4748,-2754,12.4,2962.8
4831302513,0,26,0,1,28,23,60,0,0,0,1,39466,11.6,42977,64,67,832,-989,13.1,3946.6,9,1,0,22,27,54,0,0,0,0,38634,11.8,43966,71,59,-832,989,13.0,3863.4
4831067938,0,10,0,0,5,22,5,0,0,0,1,29522,10.4,36551,71,43,-9652,-7099,11.4,2952.2,9,2,1,22,5,37,0,0,0,0,39174,11.6,43650,85,77,9652,7099,16.2,3917.4
4830413402,1,104,0,1,28,15,62,0,0,0,1,36333,11.0,39603,59,67,604,4335,12.6,3633.3,105,0,0,15,28,33,0,0,0,0,35729,10.4,35268,55,59,-604,-4335,11.4,3572.9
4845866131,1,15,2,0,9,6,6,0,0,0,0,17749,6.6,17392,201,52,1118,-657,25.3,1774.9,10,1,1,6,9,3,0,0,0,0,16631,6.8,18049,176,54,-1118,657,23.0,1663.1
4845804941,0,7,0,1,5,6,4,0,0,0,0,14549,7.0,17755,173,52,-1867,112,22.5,1454.9,17,0,0,6,5,3,0,0,0,0,16416,6.8,17643,190,63,1867,-112,25.3,1641.6
4828531853,1,11,1,1,4,2,3,0,0,0,0,17058,7.6,20248,182,71,3465,4527,25.3,1705.8,11,0,0,2,4,2,0,0,0,0,13593,6.4,15721,180,44,-3465,-4527,22.4,1359.3
4827640244,0,55,0,0,3,6,1,0,0,0,0,14474,6.6,16766,169,52,-1534,-1282,22.1,1447.4,12,0,1,6,3,2,1,1,0,0,16008,6.8,18048,170,56,1534,1282,22.6,1600.8
4821872527,0,29,1,0,2,5,3,2,1,1,0,14153,6.6,16558,141,44,-2229,-1451,18.5,1415.3,18,2,1,5,2,4,0,0,0,0,16382,6.8,18009,182,56,2229,1451,23.8,1638.2
4821838516,1,15,0,0,8,6,7,1,1,0,0,17124,7.0,19245,209,59,1484,2089,26.8,1712.4,26,0,1,6,8,5,0,0,0,0,15640,6.6,17156,144,40,-1484,-2089,18.4,1564.0
4821801775,1,175,2,1,11,5,10,0,0,0,0,17907,7.0,18398,193,56,2712,2293,24.9,1790.7,12,1,0,4,10,3,0,0,0,0,15195,6.6,16105,144,48,-2712,-2293,19.2,1519.5
4821501539,1,12,0,1,9,5,3,0,0,0,0,17343,6.6,16802,175,56,1424,524,23.1,1734.3,12,0,0,5,9,7,0,0,0,0,15919,6.6,16278,173,52,-1424,-524,22.5,1591.9
4820833550,0,12,2,0,4,3,2,1,1,0,0,15738,6.8,18214,214,56,1686,1959,27.0,1573.8,25,0,1,3,4,3,0,0,0,0,14052,6.6,16255,168,51,-1686,-1959,21.9,1405.2
4818973458,0,14,1,0,6,11,10,0,0,0,0,16492,6.4,16542,158,52,-3470,-2481,21.0,1649.2,13,4,1,11,6,13,0,0,0,0,19962,7.0,19023,216,48,3470,2481,26.4,1996.2
4818928047,1,19,2,1,6,1,4,0,0,0,0,15919,6.6,16613,177,40,289,-1641,21.7,1591.9,14,2,0,1,6,0,0,0,0,0,15630,7.2,18254,200,52,-289,1641,25.2,1563.0
4818867486,1,71,0,0,5,7,4,1,1,0,0,16138,6.4,15815,183,48,-965,-446,23.1,1613.8,14,1,1,7,5,7,0,0,0,0,17103,6.6,16261,166,38,965,446,20.4,1710.3
4818070319,0,15,2,1,3,2,3,0,0,0,0,14126,6.4,15925,175,48,-1366,-1026,22.3,1412.6,18,1,0,2,3,2,1,1,0,0,15492,6.6,16951,219,52,1366,1026,27.1,1549.2
4817978251,1,0,0,0,31,30,66,0,0,0,1,39247,11.8,44563,90,0,-893,-52,9.0,3924.7,2,0,1,30,31,79,0,0,0,0,40140,11.6,44615,110,0,893,52,11.0,4014.0
4815315874,1,13,2,0,6,4,8,1,1,0,0,15507,6.4,15666,164,40,147,-1807,20.4,1550.7,49,0,1,4,6,1,0,0,0,0,15360,6.8,17473,154,61,-147,1807,21.5,1536.0
4803648690,1,71,0,0,2,5,1,0,0,0,0,14856,7.0,18422,214,64,32,678,27.8,1485.6,11,0,1,5,2,7,0,0,0,0,14824,6.6,17744,165,52,-32,-678,21.7,1482.4
4803615753,0,7,1,1,4,4,4,0,0,0,0,16064,7.2,19502,218,60,413,1093,27.8,1606.4,12,0,0,4,4,4,0,0,0,0,15651,7.0,18409,232,48,-413,-1093,28.0,1565.1
4801288634,1,14,2,0,3,3,2,1,0,1,0,15494,7.6,19771,203,64,1098,1644,26.7,1549.4,13,1,1,3,3,4,0,0,0,0,14396,7.0,18127,192,62,-1098,-1644,25.4,1439.6
4801274063,0,35,1,0,3,8,3,1,1,0,0,13964,6.6,16745,185,47,-3012,-1621,23.2,1396.4,12,8,1,8,3,3,1,0,1,0,16976,7.0,18366,214,52,3012,1621,26.6,1697.6
4857696390,0,164,0,0,14,19,31,0,0,0,0,33566,10.4,35600,100,0,-1926,-3823,10.0,3356.6,0,3,1,19,14,49,0,0,0,0,35492,11.0,39423,101,0,1926,3823,10.1,3549.2
4857694814,0,34,0,1,25,22,73,0,0,0,1,36940,11.2,41593,95,0,295,2347,9.5,3694.0,119,2,0,22,25,59,0,0,0,0,36645,11.0,39246,116,0,-295,-2347,11.6,3664.5
4857680371,1,0,0,1,16,17,39,0,0,0,0,34701,10.8,37803,101,0,1045,1040,10.1,3470.1,86,0,0,17,16,45,0,0,0,0,33656,10.6,36763,108,0,-1045,-1040,10.8,3365.6
4857675439,1,0,0,0,30,26,69,0,0,0,1,40013,11.2,42528,108,0,2655,1734,10.8,4001.3,0,0,1,25,29,73,0,0,0,0,37358,11.2,40794,83,0,-2655,-1734,8.3,3735.8
4857657521,1,11,2,1,2,3,3,0,0,0,0,14765,6.8,17473,231,48,-156,-122,27.9,1476.5,24,1,0,3,2,4,0,0,0,0,14921,6.8,17595,225,46,156,122,27.1,1492.1
4857636829,0,8,0,1,1,0,0,0,0,0,0,14123,6.6,17351,197,52,-924,-153,24.9,1412.3,15,0,0,0,1,0,0,0,0,0,15047,6.8,17504,213,52,924,153,26.5,1504.7
4857612716,1,12,0,1,4,2,6,1,0,1,0,15676,7.0,17414,210,44,909,834,25.4,1567.6,11,0,0,2,4,3,0,0,0,0,14767,6.6,16580,189,55,-909,-834,24.4,1476.7
4856659686,0,0,0,1,29,28,70,0,0,0,1,37869,11.8,44340,90,0,-917,69,9.0,3786.9,0,0,0,28,29,64,0,0,0,0,38786,11.8,44271,106,0,917,-69,10.6,3878.6
4856656172,0,48,1,1,5,0,4,0,0,0,0,15985,7.0,18659,201,62,2507,1263,26.3,1598.5,71,0,0,0,5,0,1,1,0,0,13478,6.8,17396,201,51,-2507,-1263,25.2,1347.8
4856634617,1,9,0,1,4,3,4,1,0,1,0,16288,7.0,18415,201,67,1812,1272,26.8,1628.8,12,2,0,3,4,0,0,0,0,0,14476,6.8,17143,195,40,-1812,-1272,23.5,1447.6
4856614702,0,15,1,1,6,5,5,0,0,0,0,15977,6.8,17471,172,51,-1078,-1036,22.3,1597.7,8,1,0,5,6,3,1,0,1,0,17055,7.2,18507,238,52,1078,1036,29.0,1705.5
4856604441,0,10,0,1,6,5,7,0,0,0,0,15487,6.6,16945,175,61,-2439,-506,23.6,1548.7,12,1,0,5,6,7,0,0,0,0,17926,6.8,17451,217,36,2439,506,25.3,1792.6
4856310382,0,0,0,1,11,13,35,0,0,0,1,35834,10.6,36928,117,0,1106,348,11.7,3583.4,0,0,0,13,11,43,0,0,0,0,34728,10.6,36580,81,0,-1106,-348,8.1,3472.8
4856265386,1,0,0,0,13,12,35,0,0,0,1,33166,10.0,33694,113,0,-1112,-1660,11.3,3316.6,0,0,1,12,13,26,0,0,0,0,34278,10.0,35354,109,0,1112,1660,10.9,3427.8
4856213814,0,2,0,0,11,23,23,0,0,0,1,33312,10.0,35398,89,0,-4852,-5809,8.9,3331.2,0,0,1,23,11,68,0,0,0,0,38164,11.0,41207,112,0,4852,5809,11.2,3816.4
4855571787,1,0,0,1,20,18,44,0,0,0,0,37440,10.8,39943,93,0,1163,-214,9.3,3744.0,0,0,0,18,20,48,0,0,0,0,36277,11.4,40157,107,0,-1163,214,10.7,3627.7
4855562183,0,0,0,0,19,24,41,0,0,0,0,35305,11.0,39062,95,0,-1741,490,9.5,3530.5,0,0,1,24,19,56,0,0,0,0,37046,11.0,38572,103,0,1741,-490,10.3,3704.6
4855556277,1,0,0,0,33,37,70,0,0,0,1,40758,12.2,45603,117,0,547,528,11.7,4075.8,3,0,1,37,33,82,0,0,0,0,40211,12.0,45075,98,0,-547,-528,9.8,4021.1
4855548389,1,0,2,0,16,21,29,0,0,0,0,35294,10.8,38184,126,0,22,-2224,12.6,3529.4,17,0,1,21,16,53,0,0,0,0,35272,10.8,40408,101,0,-22,2224,10.1,3527.2
4855542320,1,0,0,1,36,22,94,0,0,0,1,41358,12.0,45479,116,0,2743,5161,11.6,4135.8,0,0,0,22,36,45,0,0,0,0,38615,11.0,40318,99,0,-2743,-5161,9.9,3861.5
4858047089,1,6,2,0,9,4,6,0,0,0,0,19879,7.4,18833,219,50,5224,3015,26.9,1987.9,11,1,1,4,9,4,1,1,0,0,14655,6.4,15818,155,48,-5224,-3015,20.3,1465.5
4857997642,1,12,0,1,7,8,6,0,0,0,0,16882,7.0,18253,176,64,-598,342,24.0,1688.2,9,0,0,8,7,11,0,0,0,0,17480,7.0,17911,194,66,598,-342,26.0,1748.0
4857463819,0,23,0,1,6,5,8,0,0,0,0,15970,6.8,17720,193,52,841,548,24.5,1597.0,15,0,0,5,6,4,0,0,0,0,15129,6.6,17172,196,48,-841,-548,24.4,1512.9
4856928241,0,8,1,1,5,7,7,0,0,0,0,15305,6.6,17604,179,48,-834,1163,22.7,1530.5,15,1,0,7,5,10,0,0,0,0,16139,6.8,16441,166,51,834,-1163,21.7,1613.9
4856903217,1,9,2,0,2,3,2,0,0,0,0,14013,6.8,17011,178,56,-1808,-1823,23.4,1401.3,13,0,1,3,2,1,0,0,0,0,15821,7.0,18834,263,56,1808,1823,31.9,1582.1
4855922116,1,14,0,0,11,21,13,0,0,0,0,61020,12.4,57000,0,0,22031,24000,0.0,6102.0,0,0,1,16,6,14,0,0,0,0,38989,7.2,33000,1,0,-22031,-24000,0.1,3898.9
4851909013,1,14,16,1,8,4,3,0,0,0,0,16888,7.4,19457,191,71,296,1188,26.2,1688.8,47,0,0,4,8,2,0,0,0,0,16592,7.0,18269,192,64,-296,-1188,25.6,1659.2
4843470293,0,0,0,0,27,29,52,0,0,0,0,38829,11.4,43264,100,0,199,-827,10.0,3882.9,0,0,1,29,27,75,0,0,0,0,38630,11.6,44091,103,0,-199,827,10.3,3863.0
4840230315,1,19,0,1,7,1,5,0,0,0,0,17550,7.0,18297,204,56,3833,1946,26.0,1755.0,10,2,0,1,7,2,0,0,0,0,13717,6.4,16351,173,48,-3833,-1946,22.1,1371.7
4838334767,1,94,1,0,5,12,2,0,0,0,0,16665,6.8,17790,168,54,-1428,-1019,22.2,1666.5,20,10,1,12,5,6,0,0,0,0,18093,7.2,18809,172,58,1428,1019,23.0,1809.3
4838263104,1,17,1,1,10,7,10,0,0,0,0,19510,6.8,17510,180,48,2208,-141,22.8,1951.0,13,0,0,7,10,8,0,0,0,0,17302,7.0,17651,190,48,-2208,141,23.8,1730.2
4837275759,0,9,0,0,3,7,5,0,0,0,0,14472,6.6,17125,154,44,-2081,254,19.8,1447.2,12,0,1,7,3,6,0,0,0,0,16553,6.4,16871,154,52,2081,-254,20.6,1655.3
4836130720,0,0,0,1,16,22,20,0,0,0,0,33962,10.8,37693,89,0,-3084,-4472,8.9,3396.2,0,0,0,22,16,43,0,0,0,0,37046,11.4,42165,94,0,3084,4472,9.4,3704.6
4836121874,1,0,3,0,29,23,86,0,0,0,0,38915,11.6,43274,109,0,1050,1998,10.9,3891.5,27,0,1,23,29,53,0,0,0,0,37865,11.4,41276,91,0,-1050,-1998,9.1,3786.5
4835619273,1,16,0,1,6,6,7,0,0,0,0,17599,7.0,18220,205,42,1219,-282,24.7,1759.9,10,1,0,6,6,2,0,0,0,0,16380,7.2,18502,198,55,-1219,282,25.3,1638.0
4835605235,1,16,1,1,5,5,5,0,0,0,0,16929,7.0,17952,197,56,1752,594,25.3,1692.9,12,1,0,5,5,4,0,0,0,0,15177,6.8,17358,194,48,-1752,-594,24.2,1517.7
4821137447,0,12,0,1,10,9,9,0,0,0,0,18401,6.6,16764,158,56,-8,-540,21.4,1840.1,8,0,0,9,10,7,0,0,0,0,18409,6.6,17304,176,64,8,540,24.0,1840.9
4821095048,0,19,2,1,9,8,8,0,0,0,0,17442,6.4,16547,197,48,1051,-332,24.5,1744.2,14,1,0,8,9,5,0,0,0,0,16391,6.8,16879,172,55,-1051,332,22.7,1639.1
4858078767,1,16,0,1,5,0,4,0,0,0,0,16486,6.8,18229,196,68,3708,1810,26.4,1648.6,11,0,0,0,5,0,1,1,0,0,12778,6.6,16419,187,48,-3708,-1810,23.5,1277.8
4852928500,0,7,0,0,6,6,7,0,0,0,0,15850,7.0,17773,188,48,59,-1079,23.6,1585.0,11,0,1,6,6,4,0,0,0,0,15791,7.2,18852,185,52,-59,1079,23.7,1579.1
4852034887,0,35,1,0,2,3,1,1,1,0,0,14000,6.8,17379,190,44,-1525,-1111,23.4,1400.0,19,9,1,3,2,0,0,0,0,0,15525,7.0,18490,210,56,1525,1111,26.6,1552.5
4852003113,1,4,0,1,29,18,66,0,0,0,1,39475,11.4,43328,104,0,2691,3497,10.4,3947.5,0,0,0,18,29,31,0,0,0,0,36784,11.0,39831,84,0,-2691,-3497,8.4,3678.4
4851985927,1,0,4,1,20,15,54,0,0,0,1,37807,11.0,40118,111,0,3943,5124,11.1,3780.7,35,0,0,15,20,42,0,0,0,0,33864,10.2,34994,87,0,-3943,-5124,8.7,3386.4
4851955960,1,0,0,1,28,28,83,0,0,0,1,39863,11.4,43206,94,0,2899,2352,9.4,3986.3,0,0,0,28,28,58,0,0,0,0,36964,11.2,40854,104,0,-2899,-2352,10.4,3696.4
4851919264,0,0,0,0,16,17,50,0,0,0,1,33134,10.6,35960,78,0,-3008,-3390,7.8,3313.4,0,0,1,17,16,38,0,0,0,0,36142,11.0,39350,103,0,3008,3390,10.3,3614.2
4851897925,1,0,3,1,27,15,66,0,0,0,0,38648,11.2,41933,93,0,4395,5275,9.3,3864.8,13,0,0,15,27,34,0,0,0,0,34253,10.4,36658,78,0,-4395,-5275,7.8,3425.3
4847099483,0,11,4,0,5,3,6,0,0,0,0,15754,6.8,18173,207,56,495,731,26.3,1575.4,9,2,1,3,5,4,0,0,0,0,15259,6.8,17442,212,47,-495,-731,25.9,1525.9
4847050334,0,7,0,1,6,5,6,0,0,0,0,15587,7.0,17681,205,56,27,63,26.1,1558.7,8,1,0,5,6,2,0,0,0,0,15560,7.0,17618,188,48,-27,-63,23.6,1556.0
4847016438,0,10,1,0,5,6,5,0,0,0,0,15615,6.8,18541,205,56,598,406,26.1,1561.5,9,2,1,6,5,2,1,1,0,0,15017,6.8,18135,178,56,-598,-406,23.4,1501.7
4846980433,1,180,0,0,17,17,40,0,0,0,0,34265,10.4,36075,115,0,-718,-2095,11.5,3426.5,0,0,1,17,17,36,0,0,0,0,34983,10.8,38170,105,0,718,2095,10.5,3498.3
4846946291,0,0,0,0,22,19,54,0,0,0,0,36551,11.0,40316,117,0,-56,838,11.7,3655.1,0,0,1,19,22,54,0,0,0,0,36607,10.8,39478,113,0,56,-838,11.3,3660.7
4846931838,0,1,0,0,7,15,19,0,0,0,1,31405,9.8,32517,62,0,-5731,-5797,6.2,3140.5,0,0,1,15,7,42,0,0,0,0,37136,11.0,38314,133,0,5731,5797,13.3,3713.6
4843611385,1,8,0,1,15,13,31,0,0,0,1,35099,10.4,35831,108,0,2753,849,10.8,3509.9,12,2,0,13,15,27,0,0,0,0,32346,10.4,34982,85,0,-2753,-849,8.5,3234.6
4843598388,1,16,0,0,25,26,63,0,0,0,1,37501,11.4,42210,100,0,-2541,-607,10.0,3750.1,0,0,1,26,25,49,0,0,0,0,40042,11.4,42817,105,0,2541,607,10.5,4004.2
4841152296,1,29,0,1,6,6,4,1,1,0,0,17266,7.0,17737,216,52,1422,1059,26.8,1726.6,11,9,0,6,6,9,0,0,0,0,15844,6.6,16678,173,36,-1422,-1059,20.9,1584.4
4841132182,1,14,0,0,7,3,7,1,1,0,0,16427,7.0,18256,217,48,1827,437,26.5,1642.7,25,1,1,3,7,2,0,0,0,0,14600,7.0,17819,198,64,-1827,-437,26.2,1460.0
4840381360,0,11,1,0,4,6,2,0,0,0,0,14578,6.8,17306,173,64,-2183,-1537,23.7,1457.8,70,1,1,6,4,2,0,0,0,0,16761,7.0,18843,203,56,2183,1537,25.9,1676.1
4840351135,1,22,0,1,8,3,8,0,0,0,0,17598,7.0,18291,185,68,2223,1035,25.3,1759.8,12,0,0,3,8,3,1,1,0,0,15375,6.6,17256,175,48,-2223,-1035,22.3,1537.5
4858103620,0,12,1,0,10,7,10,1,1,0,0,17592,6.4,16432,150,52,1712,-368,20.2,1759.2,11,0,1,7,10,2,0,0,0,0,15880,6.6,16800,159,52,-1712,368,21.1,1588.0
4858062733,1,16,4,1,8,8,5,1,1,0,0,16937,6.8,17080,162,39,595,-380,20.1,1693.7,15,4,0,8,8,6,0,0,0,0,16342,6.6,17460,180,56,-595,380,23.6,1634.2
4857934826,1,34,4,1,17,18,21,0,0,0,0,61870,12.4,57000,5,0,24305,24000,0.5,6187.0,0,2,0,11,10,10,0,0,0,0,37565,7.2,33000,0,0,-24305,-24000,0.0,3756.5
4857921760,1,2,2,1,21,16,18,0,0,0,0,66640,12.0,55000,3,0,30298,22000,0.3,6664.0,42,1,0,7,12,6,0,0,0,0,36342,7.2,33000,7,0,-30298,-22000,0.7,3634.2
4857901708,1,0,0,1,19,17,20,0,0,0,0,63210,12.8,61000,3,0,24930,25000,0.3,6321.0,34,1,0,10,12,11,0,0,0,0,38280,7.6,36000,1,0,-24930,-25000,0.1,3828.0
4855383609,0,13,2,0,4,4,4,0,0,0,0,14670,6.4,15546,173,34,121,-509,20.7,1467.0,21,1,1,4,4,2,0,0,0,0,14549,6.4,16055,176,44,-121,509,22.0,1454.9
4855356093,0,13,0,0,1,2,1,1,1,0,0,13551,7.0,17641,174,52,-4048,-2171,22.6,1355.1,16,0,1,2,1,2,0,0,0,0,17599,7.4,19812,231,56,4048,2171,28.7,1759.9
4854407575,0,14,3,1,4,8,1,0,0,0,0,14784,6.8,17483,188,48,-1322,-822,23.6,1478.4,13,3,0,8,4,5,1,1,0,0,16106,7.0,18305,190,67,1322,822,25.7,1610.6
4854401471,1,12,1,1,6,1,2,1,1,0,0,16047,7.0,17955,199,52,2961,1033,25.1,1604.7,10,1,0,1,6,0,0,0,0,0,13086,6.4,16922,167,60,-2961,-1033,22.7,1308.6
4854388363,1,12,1,1,3,5,1,1,1,0,0,14873,6.8,17208,175,64,-919,-544,23.9,1487.3,15,0,0,5,3,0,0,0,0,0,15792,6.8,17752,188,46,919,544,23.4,1579.2
4854378873,1,10,0,0,2,4,3,0,0,0,0,14303,6.6,16718,170,48,-808,-694,21.8,1430.3,8,0,1,4,2,1,0,0,0,0,15111,6.8,17412,209,40,808,694,24.9,1511.1
4854356834,1,10,1,1,4,5,0,1,1,0,0,14419,6.6,16388,136,52,-1361,-88,18.8,1441.9,14,1,0,5,4,2,0,0,0,0,15780,6.6,16476,157,48,1361,88,20.5,1578.0
4854344245,0,15,2,0,4,7,3,0,0,0,0,16426,7.0,17531,201,64,-1264,244,26.5,1642.6,16,3,1,7,4,4,0,0,0,0,17690,6.8,17287,201,40,1264,-244,24.1,1769.0
4854326223,1,24,0,0,24,12,16,0,0,0,0,64175,12.0,55000,0,0,26569,22000,0.0,6417.5,0,0,1,1,13,9,0,0,0,0,37606,7.2,33000,0,0,-26569,-22000,0.0,3760.6
4854316118,1,0,0,1,16,21,19,0,0,0,0,61330,12.0,55000,0,0,23400,22000,0.0,6133.0,0,0,0,15,10,14,0,0,0,0,37930,7.2,33000,0,0,-23400,-22000,0.0,3793.0
4852946244,1,0,0,0,7,17,8,0,0,0,0,43578,10.0,47500,0,0,14645,19000,0.0,4357.8,0,0,1,14,4,12,0,0,0,0,28933,6.0,28500,0,0,-14645,-19000,0.0,2893.3
4852913395,1,0,0,1,24,12,23,0,0,0,0,49175,10.0,47500,2,0,21675,19000,0.2,4917.5,0,0,0,5,17,4,0,0,0,0,27500,6.0,28500,0,0,-21675,-19000,0.0,2750.0
4852887881,1,0,0,1,19,18,22,0,0,0,0,61300,12.0,55000,0,0,22700,22000,0.0,6130.0,0,0,0,12,13,10,0,0,0,0,38600,7.2,33000,0,0,-22700,-22000,0.0,3860.0
4852865973,1,34,3,1,17,19,16,0,0,0,0,61365,12.6,59500,2,0,21759,21000,0.2,6136.5,70,2,0,10,8,14,0,0,0,0,39606,8.0,38500,1,0,-21759,-21000,0.1,3960.6
4852829541,1,15,6,1,16,21,10,0,0,0,0,45980,12.0,55000,0,0,16580,22000,0.0,4598.0,41,0,0,10,5,15,0,0,0,0,29400,7.2,33000,6,0,-16580,-22000,0.6,2940.0
4780195422,0,15,2,0,1,7,1,0,0,0,0,14077,6.8,16974,211,53,-4620,-2182,26.4,1407.7,80,1,1,7,1,8,1,1,0,0,18697,7.2,19156,220,57,4620,2182,27.7,1869.7
4780173580,0,10,1,0,2,5,1,0,0,0,0,14816,6.8,17342,207,68,-2327,-529,27.5,1481.6,8,2,1,5,2,3,0,0,0,0,17143,7.2,17871,225,56,2327,529,28.1,1714.3
4780131409,1,16,0,1,6,2,7,0,0,0,0,18819,7.4,18821,228,59,5082,2678,28.7,1881.9,10,2,0,2,6,3,1,1,0,0,13737,6.4,16143,185,52,-5082,-2678,23.7,1373.7
4780118799,1,0,0,0,20,26,53,0,0,0,0,35427,11.0,39675,95,0,-1006,-327,9.5,3542.7,0,0,1,26,20,72,0,0,0,0,36433,11.0,40002,98,0,1006,327,9.8,3643.3
4779748940,1,12,1,1,10,5,7,0,0,0,0,18140,7.2,18275,216,56,2534,1060,27.2,1814.0,46,0,0,5,10,4,1,1,0,0,15606,6.8,17215,146,56,-2534,-1060,20.2,1560.6
4779709995,0,14,2,0,7,4,5,0,0,0,0,16853,6.8,17046,190,36,-1152,-182,22.6,1685.3,13,2,1,4,7,4,1,1,0,0,18005,6.6,17228,215,52,1152,182,26.7,1800.5
4779541409,0,37,0,0,3,6,0,0,0,0,0,14844,6.6,16965,185,60,-2386,-447,24.5,1484.4,10,12,1,6,3,5,1,1,0,0,17230,7.0,17412,197,38,2386,447,23.5,1723.0
4779512477,1,11,1,1,4,0,4,0,0,0,0,16329,7.0,17904,209,70,2053,874,27.9,1632.9,10,2,0,0,4,0,0,0,0,0,14276,6.6,17030,226,54,-2053,-874,28.0,1427.6
4779446830,0,0,0,0,17,27,29,0,0,0,0,35254,10.8,38844,110,0,-2011,-3125,11.0,3525.4,0,0,1,27,17,64,0,0,0,0,37265,11.4,41969,104,0,2011,3125,10.4,3726.5
4779405431,1,18,2,1,5,6,5,0,0,0,0,16209,6.8,17700,192,60,-826,-963,25.2,1620.9,16,3,0,6,5,7,1,0,1,0,17035,7.4,18663,219,56,826,963,27.5,1703.5
4779385818,0,23,0,0,3,7,3,0,0,0,0,14420,6.6,16448,188,56,-4191,-1981,24.4,1442.0,11,2,1,7,3,6,0,0,0,0,18611,6.8,18429,251,48,4191,1981,29.9,1861.1
4779361800,1,13,2,1,4,4,4,0,0,0,0,15989,6.6,17043,202,44,946,177,24.6,1598.9,13,0,0,4,4,2,0,0,0,0,15043,6.6,16866,169,70,-946,-177,23.9,1504.3
4211248512,0,13,1,1,3,7,2,0,0,0,0,14443,6.8,16785,173,56,-2195,-2441,22.9,1444.3,12,1,0,7,3,4,2,1,1,0,16638,7.0,19226,188,56,2195,2441,24.4,1663.8
4211062879,1,14,3,1,8,3,7,0,0,0,0,16861,7.0,18034,198,48,3258,1315,24.6,1686.1,14,1,0,3,8,1,2,1,1,0,13603,6.4,16719,152,90,-3258,-1315,24.2,1360.3
4211019767,0,9,3,0,6,11,5,0,0,0,0,15914,7.0,17409,173,56,-2909,-1259,22.9,1591.4,13,0,1,11,6,13,0,0,0,0,18823,7.2,18668,191,52,2909,1259,24.3,1882.3
4210540488,0,73,0,0,5,7,5,1,1,0,0,16512,6.8,17418,189,63,-573,-254,25.2,1651.2,7,3,1,7,5,5,0,0,0,0,17085,6.8,17672,205,61,573,254,26.6,1708.5
4210483167,1,8,1,1,6,7,7,1,1,0,0,15297,6.8,16846,177,56,-2213,-2391,23.3,1529.7,11,2,0,7,6,2,0,0,0,0,17510,7.2,19237,198,62,2213,2391,26.0,1751.0
4209614952,0,55,2,1,8,9,6,0,0,0,0,16933,6.6,17352,173,60,-2666,-1722,23.3,1693.3,15,1,0,9,8,6,1,1,0,0,19599,7.2,19074,209,63,2666,1722,27.2,1959.9
4209591176,1,11,2,1,6,2,8,1,1,0,0,17967,7.2,18883,236,66,4623,2210,30.2,1796.7,53,1,0,2,6,2,0,0,0,0,13344,6.6,16673,174,44,-4623,-2210,21.8,1334.4
4858176371,1,14,2,1,6,5,5,0,0,0,0,15671,6.6,16778,147,52,237,-595,19.9,1567.1,12,1,0,5,6,3,0,0,0,0,15434,6.8,17373,207,50,-237,595,25.7,1543.4
4858060312,0,12,0,1,11,5,9,0,0,0,0,18505,6.8,18255,196,40,1595,244,23.6,1850.5,7,2,0,5,11,4,0,0,0,0,16910,6.8,18011,202,66,-1595,-244,26.8,1691.0
4857918016,0,44,0,0,4,5,5,0,0,0,0,15816,7.0,17344,211,48,58,-315,25.9,1581.6,11,0,1,5,4,3,0,0,0,0,15758,7.0,17659,204,40,-58,315,24.4,1575.8
4857898136,1,11,1,0,9,4,8,0,0,0,0,16509,6.8,17252,175,44,2009,671,21.9,1650.9,13,2,1,4,9,2,1,1,0,0,14500,6.4,16581,140,54,-2009,-671,19.4,1450.0
4857878150,0,0,0,1,39,20,117,0,0,0,0,40686,12.0,46707,102,0,4045,6610,10.2,4068.6,0,0,0,20,39,44,0,0,0,0,36641,11.0,40097,106,0,-4045,-6610,10.6,3664.1
4857401597,1,21,3,1,3,1,4,1,1,0,0,15368,7.0,17954,194,60,1213,-43,25.4,1536.8,70,2,0,1,3,0,0,0,0,0,14155,7.0,17997,196,60,-1213,43,25.6,1415.5
4857371322,0,14,0,0,2,2,1,0,0,0,0,14391,6.8,17792,202,46,-650,-604,24.8,1439.1,11,2,1,2,2,0,0,0,0,0,15041,7.0,18396,236,70,650,604,30.6,1504.1
4856236147,1,21,2,1,6,1,6,1,1,0,0,17841,7.4,20042,227,68,3747,2675,29.5,1784.1,9,2,0,1,6,1,0,0,0,0,14094,6.8,17367,204,48,-3747,-2675,25.2,1409.4
4856032797,0,11,0,0,5,6,6,0,0,0,0,14733,6.4,15865,136,50,-2546,-1627,18.6,1473.3,10,0,1,6,5,5,0,0,0,0,17279,6.8,17492,237,44,2546,1627,28.1,1727.9
4855665165,1,4,1,1,7,5,3,1,1,0,0,16839,7.4,19806,192,80,1407,3193,27.2,1683.9,14,0,0,5,7,3,0,0,0,0,15432,6.6,16613,174,34,-1407,-3193,20.8,1543.2
4855605135,1,17,0,1,20,23,52,0,0,0,0,34586,10.8,38586,87,0,-2498,-998,8.7,3458.6,0,0,0,23,20,57,0,0,0,0,37084,11.0,39584,107,0,2498,998,10.7,3708.4
4855599924,0,0,0,1,23,18,61,0,0,0,1,36952,11.0,39916,97,0,57,-523,9.7,3695.2,3,0,0,18,23,34,0,0,0,0,36895,11.2,40439,114,0,-57,523,11.4,3689.5
4855593983,1,34,0,1,28,27,81,0,0,0,1,39128,11.2,42088,113,0,1320,454,11.3,3912.8,34,0,0,27,28,58,0,0,0,0,37808,11.2,41634,92,0,-1320,-454,9.2,3780.8
4855062703,0,9,0,1,3,4,0,0,0,0,0,14347,7.0,18000,198,56,-356,125,25.4,1434.7,9,0,0,4,3,4,0,0,0,0,14703,6.8,17875,167,64,356,-125,23.1,1470.3
4854713781,1,11,2,1,8,11,9,1,1,0,0,16910,6.0,14833,157,48,-1132,-2322,20.5,1691.0,21,3,0,11,8,11,0,0,0,0,18042,6.8,17155,179,52,1132,2322,23.1,1804.2
4854605949,0,15,0,0,5,6,7,0,0,0,0,14829,6.8,16996,160,48,-1120,-351,20.8,1482.9,8,0,1,6,5,3,1,1,0,0,15949,7.0,17347,184,56,1120,351,24.0,1594.9
4853571173,1,71,0,0,3,6,3,0,0,0,0,14768,6.6,17484,174,60,-287,-613,23.4,1476.8,10,0,1,6,3,2,0,0,0,0,15055,6.8,18097,177,52,287,613,22.9,1505.5
4850931957,1,53,0,0,3,1,5,0,0,0,0,15226,6.8,18354,224,49,436,-256,27.3,1522.6,9,2,1,1,3,1,0,0,0,0,14790,7.2,18610,233,52,-436,256,28.5,1479.0
4850890390,0,17,0,0,5,11,5,0,0,0,0,14740,6.4,15962,202,28,-2908,-745,23.0,1474.0,14,0,1,11,5,15,1,1,0,0,17648,6.8,16707,185,52,2908,745,23.7,1764.8
4850840146,1,31,2,1,8,7,13,0,0,0,0,16825,6.6,16915,183,48,79,-744,23.1,1682.5,36,0,0,6,7,6,0,0,0,0,16746,6.8,17659,195,56,-79,744,25.1,1674.6
4839316787,0,10,2,1,4,4,5,1,1,0,0,15333,6.4,15554,180,41,299,-1358,22.1,1533.3,10,1,0,4,4,5,0,0,0,0,15034,6.6,16912,225,52,-299,1358,27.7,1503.4
4838840417,0,10,0,0,7,4,4,1,0,1,0,15989,6.8,17323,203,48,70,81,25.1,1598.9,78,2,1,4,7,5,1,1,0,0,15919,7.0,17242,165,56,-70,-81,22.1,1591.9
4838807385,0,78,2,0,13,6,10,0,0,0,0,19020,7.2,19305,193,52,1982,2180,24.5,1902.0,14,2,1,6,13,2,0,0,0,0,17038,6.8,17125,180,48,-1982,-2180,22.8,1703.8
4832728625,0,16,1,0,5,9,2,0,0,0,0,15825,6.4,15773,172,48,-1853,-794,22.0,1582.5,12,2,1,9,5,5,0,0,0,0,17678,6.6,16567,185,36,1853,794,22.1,1767.8
4832024379,1,12,1,1,13,3,5,1,1,0,0,18061,7.2,19421,182,72,3941,2688,25.4,1806.1,10,3,0,2,12,2,0,0,0,0,14120,6.6,16733,188,38,-3941,-2688,22.6,1412.0
4830918445,1,13,1,1,7,6,2,0,0,0,0,15668,6.6,17047,180,55,418,409,23.5,1566.8,19,1,0,6,7,4,1,1,0,0,15250,6.8,16638,174,32,-418,-409,20.6,1525.0
4830255747,0,22,2,0,5,3,4,0,0,0,0,15340,6.8,17386,186,42,706,430,22.8,1534.0,12,2,1,3,5,3,0,0,0,0,14634,6.6,16956,209,52,-706,-430,26.1,1463.4
4830126336,1,9,0,0,8,6,3,0,0,0,0,16584,6.8,17908,190,51,-417,12,24.1,1658.4,13,1,1,6,8,4,1,1,0,0,17001,6.8,17896,187,64,417,-12,25.1,1700.1
4829410671,0,15,3,0,3,4,2,0,0,0,0,15407,7.2,19002,213,68,-135,2047,28.1,1540.7,15,4,1,4,3,4,0,0,0,0,15542,6.6,16955,185,48,135,-2047,23.3,1554.2
4829291583,1,13,5,1,5,3,5,0,0,0,0,17953,7.0,18487,218,60,2912,2040,27.8,1795.3,11,1,0,3,5,2,0,0,0,0,15041,6.6,16447,174,60,-2912,-2040,23.4,1504.1
4829265466,0,13,0,1,5,2,4,0,0,0,0,16160,7.2,18471,194,72,1763,509,26.6,1616.0,8,1,0,2,5,1,0,0,0,0,14397,7.0,17962,242,44,-1763,-509,28.6,1439.7
4829245276,0,8,1,1,6,5,4,0,0,0,0,15788,6.6,16463,181,48,472,-1590,22.9,1578.8,14,0,0,5,6,6,1,1,0,0,15316,7.0,18053,186,76,-472,1590,26.2,1531.6
4826874509,1,14,0,1,6,7,2,0,0,0,0,16560,7.0,18094,196,48,620,984,24.4,1656.0,21,1,0,7,6,8,1,1,0,0,15940,6.8,17110,172,60,-620,-984,23.2,1594.0
4826838686,0,12,0,1,6,2,4,0,0,0,0,16021,6.6,16566,205,52,-389,-2063,25.7,1602.1,15,0,0,2,6,2,2,1,1,0,16410,7.0,18629,208,56,389,2063,26.4,1641.0
4826778635,1,14,2,1,6,0,7,0,0,0,0,17237,6.8,18146,191,51,3525,639,24.2,1723.7,11,2,0,0,6,0,0,0,0,0,13712,6.8,17507,218,52,-3525,-639,27.0,1371.2
4825496429,1,9,1,1,2,0,0,0,0,0,0,14370,7.0,18035,192,52,1513,1750,24.4,1437.0,102,0,0,0,2,0,0,0,0,0,12857,6.6,16285,188,44,-1513,-1750,23.2,1285.7
4825476128,0,12,0,0,3,8,2,0,0,0,0,15099,6.8,17408,208,51,-3552,-2179,25.9,1509.9,21,1,1,8,3,3,0,0,0,0,18651,7.0,19587,212,52,3552,2179,26.4,1865.1
4825449421,1,8,1,1,12,5,9,1,0,1,0,18106,6.8,17706,160,44,3127,879,20.4,1810.6,10,0,0,5,12,1,0,0,0,0,14979,6.6,16827,167,52,-3127,-879,21.9,1497.9
4825309578,1,8,1,1,11,4,4,0,0,0,0,16895,6.6,17324,178,48,2186,246,22.6,1689.5,11,2,0,4,11,3,1,0,1,0,14709,6.8,17078,154,52,-2186,-246,20.6,1470.9
4824413649,1,11,0,1,9,2,6,0,0,0,0,19174,7.0,18809,207,59,4795,2472,26.6,1917.4,155,0,0,2,9,2,0,0,0,0,14379,6.6,16337,161,44,-4795,-2472,20.5,1437.9
4852822967,1,35,0,1,12,11,32,0,0,0,0,34979,10.4,36004,121,0,1792,-810,12.1,3497.9,34,0,0,11,12,27,0,0,0,0,33187,10.4,36814,100,0,-1792,810,10.0,3318.7
4852798766,0,47,0,0,17,14,34,0,0,0,0,33803,10.4,35590,86,0,-1388,-2051,8.6,3380.3,0,16,1,14,17,46,0,0,0,0,35191,10.8,37641,127,0,1388,2051,12.7,3519.1
4852762457,0,0,0,1,22,18,70,0,0,0,0,36843,11.2,39379,85,0,200,191,8.5,3684.3,0,0,0,18,22,47,0,0,0,0,36643,11.0,39188,110,0,-200,-191,11.0,3664.3
4852734823,1,0,0,0,21,22,50,0,0,0,0,37158,11.0,40741,93,0,404,751,9.3,3715.8,0,0,1,22,21,48,0,0,0,0,36754,11.0,39990,107,0,-404,-751,10.7,3675.4
4852695679,0,16,0,1,35,37,85,0,0,0,0,39233,12.4,46763,103,0,-2436,-1312,10.3,3923.3,0,1,0,37,35,90,0,0,0,0,41669,12.2,48075,117,0,2436,1312,11.7,4166.9
4852675302,1,0,0,0,16,11,44,0,0,0,2,35692,10.8,37749,123,0,1028,2820,12.3,3569.2,10,0,1,11,16,23,0,0,0,0,34664,10.2,34929,107,0,-1028,-2820,10.7,3466.4
4852642703,0,0,0,0,24,26,67,0,0,0,0,35891,11.0,39717,105,0,-1857,-1746,10.5,3589.1,0,0,1,26,24,68,0,0,0,0,37748,11.4,41463,108,0,1857,1746,10.8,3774.8
4852627605,1,15,0,0,23,18,54,0,0,0,0,35878,11.0,39891,105,0,311,2668,10.5,3587.8,12,1,1,18,23,50,0,0,0,0,35567,10.8,37223,101,0,-311,-2668,10.1,3556.7
4851966938,1,2,9,0,9,13,22,0,0,0,0,33767,10.4,35729,118,0,-1674,-45,11.8,3376.7,28,0,1,13,9,35,0,0,0,0,35441,10.2,35774,110,0,1674,45,11.0,3544.1
4851939789,1,0,0,0,14,12,33,0,0,0,0,33928,10.6,36124,119,0,1049,510,11.9,3392.8,0,0,1,12,14,34,0,0,0,0,32879,10.0,35614,111,0,-1049,-510,11.1,3287.9
4851049470,1,30,0,0,16,15,36,0,0,0,0,36454,10.8,38745,121,0,2313,2660,12.1,3645.4,0,0,1,15,16,39,0,0,0,0,34141,10.6,36085,107,0,-2313,-2660,10.7,3414.1
4851034966,0,0,0,1,23,27,54,0,0,0,1,35905,11.0,40006,99,0,-3254,-1884,9.9,3590.5,0,0,0,25,21,68,0,0,0,0,39159,11.4,41890,119,0,3254,1884,11.9,3915.9
4851007164,0,0,0,0,19,27,57,0,0,0,0,36774,11.0,38871,126,0,-3049,-2727,12.6,3677.4,0,0,1,27,19,72,0,0,0,0,39823,11.0,41598,110,0,3049,2727,11.0,3982.3
4850984872,0,0,0,0,20,31,44,0,0,0,1,36008,10.8,38638,95,0,-3668,-5955,9.5,3600.8,0,0,1,31,20,88,0,0,0,0,39676,11.8,44593,111,0,3668,5955,11.1,3967.6
4850957242,0,0,0,1,23,17,63,0,0,0,2,37067,10.8,38566,102,0,852,-633,10.2,3706.7,0,0,0,17,23,46,0,0,0,0,36215,11.0,39199,103,0,-852,633,10.3,3621.5
4850932388,0,16,0,0,17,20,43,0,0,0,1,36236,10.8,38644,99,0,-138,947,9.9,3623.6,0,0,1,20,17,65,0,0,0,0,36374,10.6,37697,92,0,138,-947,9.2,3637.4
4850908605,1,17,0,0,27,25,76,0,0,0,1,37762,11.4,41915,107,0,-1832,168,10.7,3776.2,3,0,1,25,27,52,0,0,0,0,39594,11.4,41747,117,0,1832,-168,11.7,3959.4
4850886761,1,18,0,1,11,10,36,0,0,0,1,34044,10.0,34190,123,0,1393,812,12.3,3404.4,0,2,0,10,11,31,0,0,0,0,32651,10.0,33378,105,0,-1393,-812,10.5,3265.1
4850087057,1,1,4,1,19,16,43,0,0,0,1,35597,10.6,37823,106,0,2243,636,10.6,3559.7,105,0,0,16,19,37,0,0,0,0,33354,10.8,37187,100,0,-2243,-636,10.0,3335.4
4850057685,1,0,0,0,24,23,70,0,0,0,1,39088,11.4,42200,119,0,1046,1536,11.9,3908.8,0,0,1,23,24,49,0,0,0,0,38042,11.2,40664,95,0,-1046,-1536,9.5,3804.2
4850070341,1,17,0,1,4,4,5,1,1,0,0,15162,6.4,16364,184,52,544,-191,23.6,1516.2,7,1,0,4,4,1,0,0,0,0,14618,6.4,16555,199,40,-544,191,23.9,1461.8
4850018897,0,176,0,1,9,5,7,0,0,0,0,16650,6.8,18700,188,52,691,830,24.0,1665.0,13,0,0,5,9,2,2,1,1,0,15959,6.8,17870,209,68,-691,-830,27.7,1595.9
4833229090,0,68,1,1,2,4,1,0,0,0,0,14393,7.0,17430,197,44,-1801,-1887,24.1,1439.3,12,0,0,4,2,2,0,0,0,0,16194,7.4,19317,185,64,1801,1887,24.9,1619.4
4833173326,1,13,1,0,2,7,2,1,1,0,0,14858,6.6,16893,181,52,-2092,-864,23.3,1485.8,10,1,1,7,2,6,0,0,0,0,16950,6.6,17757,206,55,2092,864,26.1,1695.0
4763003982,0,12,4,1,7,10,5,1,1,0,0,18275,6.8,17195,193,60,-465,-580,25.3,1827.5,22,1,0,10,7,9,0,0,0,0,18740,6.8,17775,187,52,465,580,23.9,1874.0
4629283815,0,11,0,1,8,11,6,0,0,0,0,16323,6.6,16021,160,68,-686,-1213,22.8,1632.3,13,1,0,11,8,9,1,1,0,0,17009,6.8,17234,147,56,686,1213,20.3,1700.9
4546023758,1,11,1,0,5,8,5,0,0,0,0,15558,6.6,16803,159,44,-1231,-961,20.3,1555.8,11,0,1,8,5,6,1,1,0,0,16789,6.8,17764,174,48,1231,961,22.2,1678.9
4545958691,1,33,0,0,7,6,7,0,0,0,0,18793,7.0,18712,214,56,2964,1867,27.0,1879.3,12,13,1,6,7,6,1,1,0,0,15829,6.6,16845,180,56,-2964,-1867,23.6,1582.9
4545910580,0,16,0,0,3,4,1,0,0,0,0,15166,7.0,18489,224,45,-1774,-373,26.9,1516.6,17,0,1,4,3,3,1,1,0,0,16940,7.2,18862,226,72,1774,373,29.8,1694.0
4538515649,0,348,0,0,3,4,5,0,0,0,0,14707,6.6,17322,183,47,169,-1371,23.0,1470.7,10,1,1,4,3,2,1,1,0,0,14538,7.2,18693,185,72,-169,1371,25.7,1453.8
4412259184,0,14,0,0,1,4,2,0,0,0,0,14667,6.6,17056,211,48,-1772,-1616,25.9,1466.7,34,0,1,4,1,5,0,0,0,0,16439,7.2,18672,223,48,1772,1616,27.1,1643.9
4406299575,1,18,3,1,9,2,9,1,0,1,0,19510,7.0,19014,207,53,5586,2411,26.0,1951.0,12,2,0,2,9,2,0,0,0,0,13924,6.4,16603,194,56,-5586,-2411,25.0,1392.4
4390450439,0,11,0,0,4,8,4,0,0,0,0,14277,6.6,15495,127,60,-5664,-3975,18.7,1427.7,14,3,1,8,4,10,0,0,0,0,19941,7.2,19470,211,64,5664,3975,27.5,1994.1
4365338840,1,15,3,0,6,9,5,1,0,1,0,17113,6.6,17369,155,54,911,685,20.9,1711.3,16,1,1,9,6,9,1,1,0,0,16202,6.8,16684,174,49,-911,-685,22.3,1620.2
4337941743,0,29,15,0,4,2,5,0,0,0,0,14901,6.6,17346,187,44,1086,-37,23.1,1490.1,28,1,1,2,4,2,0,0,0,0,13815,6.8,17383,175,48,-1086,37,22.3,1381.5
4337855800,0,16,0,0,2,8,1,0,0,0,0,14570,6.6,15820,179,53,-1605,-1300,23.2,1457.0,80,1,1,8,2,5,0,0,0,0,16175,6.6,17120,162,40,1605,1300,20.2,1617.5
4337870760,0,65,1,0,0,4,0,1,0,1,0,14915,7.0,17534,199,52,-1053,-1371,25.1,1491.5,16,2,1,4,0,4,1,1,0,0,15968,7.2,18905,200,64,1053,1371,26.4,1596.8
4331856659,0,14,0,1,4,4,3,1,1,0,0,14711,6.2,15322,161,52,-1513,-2342,21.3,1471.1,17,1,0,4,4,5,0,0,0,0,16224,6.8,17664,171,60,1513,2342,23.1,1622.4
4331797022,1,14,1,1,2,7,1,0,0,0,0,14905,6.4,16214,172,52,-2555,-1389,22.4,1490.5,15,0,0,7,2,7,0,0,0,0,17460,6.6,17603,155,48,2555,1389,20.3,1746.0
4330825570,1,13,19,0,2,4,2,0,0,0,0,16225,7.0,18469,191,72,1100,722,26.3,1622.5,35,0,1,4,2,2,0,0,0,0,15125,6.6,17747,209,48,-1100,-722,25.7,1512.5
4855180049,1,15,1,0,6,2,5,1,1,0,0,16052,7.0,18437,194,56,1408,360,25.0,1605.2,12,1,1,2,6,0,0,0,0,0,14644,6.8,18077,186,64,-1408,-360,25.0,1464.4
4855129315,0,19,1,1,5,8,2,0,0,0,0,14399,6.6,16086,148,40,-2872,-2509,18.8,1439.9,12,1,0,8,5,5,1,1,0,0,17271,7.2,18595,191,67,2872,2509,25.8,1727.1
4854798173,1,12,1,1,6,4,9,1,1,0,0,15859,6.8,17147,184,56,938,-915,24.0,1585.9,11,1,0,4,6,0,0,0,0,0,14921,7.0,18062,187,56,-938,915,24.3,1492.1
4854329957,1,18,2,1,7,3,3,1,1,0,0,16865,7.0,18262,206,64,2081,2234,27.0,1686.5,15,2,0,3,7,2,0,0,0,0,14784,6.6,16028,186,56,-2081,-2234,24.2,1478.4
4853133249,0,9,1,0,0,7,0,0,0,0,0,13061,6.8,16726,195,52,-4930,-3089,24.7,1306.1,11,0,1,7,0,6,0,0,0,0,17991,7.2,19815,220,67,4930,3089,28.7,1799.1
4853092535,0,12,0,1,6,3,8,0,0,0,0,15506,7.0,17550,164,52,874,1618,21.6,1550.6,22,1,0,3,6,2,0,0,0,0,14632,6.4,15932,207,8,-874,-1618,21.5,1463.2
4852062179,1,9,1,1,4,5,3,0,0,0,0,14752,7.0,18417,182,51,-1057,328,23.3,1475.2,12,2,0,5,4,5,0,0,0,0,15809,7.0,18089,203,52,1057,-328,25.5,1580.9
4851124609,0,7,1,1,3,3,2,0,0,0,0,14574,6.8,17460,180,52,-1806,-1007,23.2,1457.4,11,1,0,3,3,3,0,0,0,0,16380,7.0,18467,212,48,1806,1007,26.0,1638.0
4851108255,1,14,2,0,4,3,5,0,0,0,0,16559,7.0,18789,183,64,1887,2160,24.7,1655.9,13,1,1,3,4,2,1,1,0,0,14672,6.6,16629,190,44,-1887,-2160,23.4,1467.2
4850180570,0,12,1,1,4,4,4,0,0,0,0,16190,6.8,17212,202,41,1034,-44,24.3,1619.0,10,2,0,4,4,10,1,1,0,0,15156,6.6,17256,161,54,-1034,44,21.5,1515.6
4849270092,0,47,0,0,11,6,11,0,0,0,0,18789,7.0,18629,182,52,1932,460,23.4,1878.9,10,0,1,6,11,2,0,0,0,0,16857,7.2,18169,181,64,-1932,-460,24.5,1685.7
4848105886,1,34,0,1,2,1,0,0,0,0,0,15251,7.0,19154,225,72,1477,828,29.7,1525.1,10,15,0,1,2,0,1,1,0,0,13774,6.8,18326,208,56,-1477,-828,26.4,1377.4
4848033723,0,134,0,1,6,4,3,0,0,0,0,15862,6.8,17079,198,48,-362,-686,24.6,1586.2,16,0,0,4,6,5,1,1,0,0,16224,6.8,17765,196,44,362,686,24.0,1622.4
4847249312,1,9,0,0,1,6,1,0,0,0,0,14386,6.8,16778,204,52,-2369,-491,25.6,1438.6,89,0,1,6,1,5,0,0,0,0,16755,6.6,17269,173,52,2369,491,22.5,1675.5
4847232172,1,21,1,1,9,8,6,1,1,0,0,16536,6.8,16795,185,44,-104,766,22.9,1653.6,17,1,0,8,9,9,0,0,0,0,16640,6.6,16029,171,44,104,-766,21.5,1664.0
4847219024,0,48,1,0,4,6,4,1,1,0,0,15113,6.6,16963,179,52,-1631,-1308,23.1,1511.3,8,10,1,6,4,2,0,0,0,0,16744,6.8,18271,205,64,1631,1308,26.9,1674.4
4846136208,1,49,2,0,6,3,7,0,0,0,0,16674,6.8,17353,196,44,8,33,24.0,1667.4,264,2,1,3,6,3,0,0,0,0,16666,6.8,17320,196,56,-8,-33,25.2,1666.6
4846097890,1,14,1,0,3,3,2,0,0,0,0,15243,6.8,17948,203,56,-938,286,25.9,1524.3,71,1,1,3,3,3,0,0,0,0,16181,6.8,17662,219,44,938,-286,26.3,1618.1
4846059248,0,11,3,0,2,9,0,0,0,0,0,14586,7.2,18216,209,60,-3343,1250,26.9,1458.6,12,0,1,9,2,11,0,0,0,0,17929,6.8,16966,198,48,3343,-1250,24.6,1792.9
4844460979,0,11,2,1,2,2,2,0,0,0,0,15212,7.0,18193,175,64,-184,694,23.9,1521.2,15,1,0,2,2,2,1,1,0,0,15396,7.0,17499,211,56,184,-694,26.7,1539.6
4817390549,1,17,1,0,4,6,4,0,0,0,0,16564,6.8,17275,192,60,-381,-981,25.2,1656.4,8,1,1,6,4,1,0,0,0,0,16945,6.8,18256,219,61,381,981,28.0,1694.5
4758801537,0,176,0,1,5,6,2,0,0,0,0,16104,6.6,16165,182,44,-1325,-1023,22.6,1610.4,17,0,0,6,5,7,1,1,0,0,17429,6.8,17188,187,44,1325,1023,23.1,1742.9
4758763086,1,9,0,0,5,11,5,1,1,0,0,16138,6.4,16365,171,52,-2970,-2341,22.3,1613.8,108,0,1,11,5,6,0,0,0,0,19108,7.0,18706,189,56,2970,2341,24.5,1910.8
4752627956,1,11,1,1,4,4,4,1,1,0,0,14800,6.8,17465,184,60,-572,-314,24.4,1480.0,18,0,0,4,4,2,0,0,0,0,15372,6.8,17779,203,45,572,314,24.8,1537.2
4749347023,0,21,0,0,3,8,1,0,0,0,0,14305,6.6,17117,188,50,-3053,-311,23.8,1430.5,13,2,1,8,3,12,0,0,0,0,17358,6.8,17428,206,58,3053,311,26.4,1735.8
4737374790,1,12,2,0,5,1,7,0,0,0,0,16281,6.8,18303,188,60,3169,1855,24.8,1628.1,15,0,1,1,5,1,0,0,0,0,13112,6.4,16448,186,47,-3169,-1855,23.3,1311.2
4675990587,0,12,2,1,6,5,3,0,0,0,0,17103,6.8,17688,199,56,1156,768,25.5,1710.3,13,2,0,5,6,3,0,0,0,0,15947,6.6,16920,180,48,-1156,-768,22.8,1594.7
4675958536,1,10,0,0,8,5,4,0,0,0,0,16625,6.6,17727,168,64,-760,211,23.2,1662.5,16,2,1,5,8,6,1,1,0,0,17385,6.6,17516,193,52,760,-211,24.5,1738.5
4669541981,1,11,3,1,7,4,9,0,0,0,0,16977,6.8,17986,219,52,-553,-909,27.1,1697.7,41,2,0,4,7,4,1,1,0,0,17530,7.0,18895,245,44,553,909,28.9,1753.0
4669503669,1,13,0,1,7,6,5,1,1,0,0,17546,7.0,17994,194,72,1071,87,26.6,1754.6,13,1,0,6,7,6,0,0,0,0,16475,7.2,17907,188,64,-1071,-87,25.2,1647.5
4669483098,0,7,1,1,6,6,3,1,1,0,0,17398,7.0,18351,167,64,446,263,23.1,1739.8,12,0,0,6,6,5,0,0,0,0,16952,7.0,18088,179,52,-446,-263,23.1,1695.2
4669454088,1,15,2,0,2,2,1,0,0,0,0,14918,7.2,19299,202,56,-360,701,25.8,1491.8,15,4,1,2,2,2,1,1,0,0,15278,7.0,18598,247,68,360,-701,31.5,1527.8
4652532332,1,25,1,1,7,8,7,0,0,0,0,17734,6.8,17330,208,36,1520,800,24.4,1773.4,178,0,0,8,7,4,0,0,0,0,16214,6.4,16530,172,42,-1520,-800,21.4,1621.4
4651976085,0,8,3,1,4,4,6,0,0,0,0,14432,6.2,15002,190,36,-1369,-3346,22.6,1443.2,17,0,0,4,4,1,0,0,0,0,15801,6.8,18348,205,52,1369,3346,25.7,1580.1
4651946197,0,7,2,1,3,5,3,0,0,0,0,14135,6.6,16950,158,52,-2359,-1828,21.0,1413.5,15,0,0,5,3,4,1,1,0,0,16494,7.0,18778,236,63,2359,1828,29.9,1649.4
4649382802,1,14,2,1,7,4,5,0,0,0,0,17295,6.4,16243,190,28,2082,583,21.8,1729.5,8,2,0,4,7,4,0,0,0,0,15213,6.6,15660,169,62,-2082,-583,23.1,1521.3
4639883743,1,250,0,1,6,5,3,1,1,0,0,16280,7.0,18282,184,60,569,2446,24.4,1628.0,11,1,0,5,6,5,0,0,0,0,15711,6.4,15836,195,44,-569,-2446,23.9,1571.1
4639826536,0,13,1,1,7,6,4,0,0,0,0,15900,6.8,17216,205,52,348,523,25.7,1590.0,19,0,0,6,7,4,0,0,0,0,15552,6.8,16693,158,52,-348,-523,21.0,1555.2
4636405024,1,8,0,1,8,4,5,0,0,0,0,17106,6.6,16434,151,60,1867,-366,21.1,1710.6,9,0,0,4,8,4,0,0,0,0,15239,6.6,16800,198,40,-1867,366,23.8,1523.9
4858177468,0,12,2,1,4,1,3,0,0,0,0,15928,7.0,19139,228,68,1050,2001,29.6,1592.8,13,3,0,1,4,1,1,1,0,0,14878,6.8,17138,204,60,-1050,-2001,26.4,1487.8
4858126455,1,14,0,1,7,11,8,0,0,0,0,18193,6.8,17251,192,60,-1191,-582,25.2,1819.3,17,0,0,11,7,14,1,1,0,0,19384,7.0,17833,178,42,1191,582,22.0,1938.4
4858089637,1,10,0,1,7,3,6,0,0,0,0,15746,6.4,16020,190,58,1170,-1201,24.8,1574.6,11,0,0,2,6,3,0,0,0,0,14576,6.8,17221,228,39,-1170,1201,26.7,1457.6
4858053568,1,11,3,1,6,4,6,0,0,0,0,17694,6.8,17997,213,56,1391,1062,26.9,1769.4,14,0,0,4,6,3,1,1,0,0,16303,6.8,16935,206,54,-1391,-1062,26.0,1630.3
4857377327,0,24,1,1,8,8,11,0,0,0,0,19380,6.8,17432,192,44,3055,670,23.6,1938.0,12,2,0,8,8,7,0,0,0,0,16325,6.6,16762,181,52,-3055,-670,23.3,1632.5
4857260385,1,11,2,0,3,3,0,1,1,0,0,14407,6.8,17178,219,44,-144,-1276,26.3,1440.7,10,1,1,3,3,3,0,0,0,0,14551,7.0,18454,143,64,144,1276,20.7,1455.1
4857212283,1,10,1,1,4,3,3,0,0,0,0,15460,6.8,17789,203,44,412,-677,24.7,1546.0,27,1,0,3,4,3,0,0,0,0,15048,7.0,18466,215,48,-412,677,26.3,1504.8
4857166669,0,14,2,0,5,6,4,0,0,0,0,15533,6.6,17523,211,52,-1014,-149,26.3,1553.3,24,2,1,6,5,6,1,1,0,0,16547,7.0,17672,202,61,1014,149,26.3,1654.7
4857079962,1,105,2,0,6,6,8,1,1,0,0,16547,7.0,18180,185,40,532,1455,22.5,1654.7,13,2,1,6,6,5,0,0,0,0,16015,6.8,16725,195,47,-532,-1455,24.2,1601.5
4856006406,1,11,0,0,6,5,4,0,0,0,0,16170,6.8,16914,163,44,-281,-1290,20.7,1617.0,15,1,1,5,6,6,0,0,0,0,16451,7.0,18204,192,56,281,1290,24.8,1645.1
4855963758,0,18,1,1,5,8,4,0,0,0,0,15263,6.6,17231,178,56,-3365,-2875,23.4,1526.3,13,0,0,8,5,8,2,1,1,0,18628,7.4,20106,228,64,3365,2875,29.2,1862.8
4855910455,0,13,1,1,2,7,4,0,0,0,0,13629,6.8,16317,179,44,-3564,-2033,22.3,1362.9,12,3,0,7,2,8,1,1,0,0,17193,6.8,18350,239,58,3564,2033,29.7,1719.3
4855852488,1,13,2,0,4,5,4,0,0,0,0,16774,6.4,16352,197,40,1188,612,23.7,1677.4,12,0,1,5,4,5,0,0,0,0,15586,6.2,15740,152,40,-1188,-612,19.2,1558.6
4855812068,1,11,0,0,5,6,4,0,0,0,0,15010,7.0,17330,212,52,-249,557,26.4,1501.0,10,0,1,5,4,4,1,1,0,0,15259,7.0,16773,165,48,249,-557,21.3,1525.9
4855348361,1,12,0,0,4,3,5,0,0,0,0,16459,7.0,18541,216,60,1448,950,27.6,1645.9,9,2,1,3,4,2,0,0,0,0,15011,6.8,17591,187,55,-1448,-950,24.2,1501.1
4855307139,1,15,1,1,6,3,5,1,1,0,0,15127,7.0,18023,168,64,396,43,23.2,1512.7,5,1,0,3,6,1,0,0,0,0,14731,6.8,17980,214,48,-396,-43,26.2,1473.1
4855198479,0,15,3,1,4,6,3,0,0,0,0,15789,6.6,16808,185,52,-1133,-1390,23.7,1578.9,12,1,0,6,4,6,1,1,0,0,16922,6.8,18198,186,76,1133,1390,26.2,1692.2
4855150756,1,10,3,0,8,8,10,0,0,0,0,15994,6.6,15966,165,44,-457,-612,20.9,1599.4,14,1,1,8,8,10,0,0,0,0,16451,6.6,16578,178,48,457,612,22.6,1645.1
4855095877,0,10,0,1,6,5,5,0,0,0,0,16603,7.2,18549,219,52,1041,566,27.1,1660.3,11,1,0,5,6,6,0,0,0,0,15562,6.8,17983,197,48,-1041,-566,24.5,1556.2
4854931268,1,7,1,1,9,11,5,1,1,0,0,17245,7.0,17887,205,56,-1585,-240,26.1,1724.5,13,0,0,11,9,12,1,0,1,0,18830,6.8,18127,195,59,1585,240,25.4,1883.0
4857336487,0,28,0,1,8,3,5,0,0,0,0,16557,7.0,17652,166,64,1464,206,23.0,1655.7,38,0,0,3,8,5,0,0,0,0,15093,6.8,17446,197,36,-1464,-206,23.3,1509.3
4857309153,1,0,0,0,16,20,13,0,0,0,0,62700,12.0,55000,0,0,25150,22000,0.0,6270.0,0,0,1,11,7,9,0,0,0,0,37550,7.2,33000,0,0,-25150,-22000,0.0,3755.0
4856608298,1,0,0,1,23,16,18,0,0,0,0,48641,10.0,47500,0,0,20351,19000,0.0,4864.1,17,0,0,6,13,10,0,0,0,0,28290,6.0,28500,0,0,-20351,-19000,0.0,2829.0
4856597172,1,0,0,0,13,15,16,0,0,0,0,46411,10.0,47500,0,0,18191,19000,0.0,4641.1,0,0,1,11,9,7,0,0,0,0,28220,6.0,28500,0,0,-18191,-19000,0.0,2822.0
4856585909,1,288,0,1,17,11,16,0,0,0,0,46370,10.4,49860,1,0,18802,21360,0.1,4637.0,0,0,0,7,13,6,0,0,0,0,27568,6.0,28500,1,0,-18802,-21360,0.1,2756.8
4856569365,1,34,5,1,20,17,21,0,0,0,0,62475,12.0,55000,4,0,24920,22000,0.4,6247.5,0,1,0,9,12,10,0,0,0,0,37555,7.2,33000,0,0,-24920,-22000,0.0,3755.5
4856516192,1,0,0,0,15,15,12,0,0,0,0,46300,10.0,47500,0,0,18100,19000,0.0,4630.0,0,0,1,8,8,10,0,0,0,0,28200,6.0,28500,0,0,-18100,-19000,0.0,2820.0
4856496072,1,0,0,1,19,15,24,0,0,0,0,62350,12.0,55000,0,0,24800,22000,0.0,6235.0,0,0,0,11,15,8,0,0,0,0,37550,7.2,33000,0,0,-24800,-22000,0.0,3755.0
4856476386,1,25,4,0,24,17,21,0,0,0,0,47485,10.0,47500,1,0,17970,19000,0.1,4748.5,29,0,1,9,16,13,0,0,0,0,29515,6.0,28500,8,0,-17970,-19000,0.8,2951.5
4856082149,1,5,0,0,12,18,14,0,0,0,0,60250,12.0,55000,0,0,22700,20000,0.0,6025.0,0,0,1,13,7,11,0,0,0,0,37550,7.6,35000,0,0,-22700,-20000,0.0,3755.0
4856066077,1,0,0,0,13,17,13,0,0,0,0,62350,12.0,55000,0,0,24100,22000,0.0,6235.0,0,0,1,13,9,10,0,0,0,0,38250,7.2,33000,0,0,-24100,-22000,0.0,3825.0
4856037455,1,0,0,0,12,16,16,0,0,0,0,48110,10.0,47500,0,0,20200,19000,0.0,4811.0,0,0,1,11,7,7,0,0,0,0,27910,6.0,28500,0,0,-20200,-19000,0.0,2791.0
4856012385,1,0,0,1,21,12,18,0,0,0,0,47045,10.0,47500,0,0,19515,19000,0.0,4704.5,0,0,0,6,15,6,0,0,0,0,27530,6.0,28500,0,0,-19515,-19000,0.0,2753.0
4854140004,0,16,1,0,3,5,5,1,0,1,0,15599,6.8,17451,205,56,-1869,-1632,26.1,1559.9,9,1,1,5,3,6,0,0,0,0,17468,7.0,19083,211,54,1869,1632,26.5,1746.8
4854109874,0,11,1,1,4,8,6,1,1,0,0,14782,6.2,14813,159,56,-3456,-3879,21.5,1478.2,14,1,0,8,4,1,0,0,0,0,18238,7.2,18692,197,52,3456,3879,24.9,1823.8
4854064097,1,102,1,1,6,5,4,0,0,0,0,16264,6.6,17025,188,44,336,-681,23.2,1626.4,10,0,0,5,6,3,0,0,0,0,15928,7.0,17706,231,52,-336,681,28.3,1592.8
4854025741,0,5,1,0,18,13,45,0,0,0,0,34809,10.6,36924,98,0,293,546,9.8,3480.9,5,0,1,13,18,31,0,0,0,0,34516,10.2,36378,102,0,-293,-546,10.2,3451.6
4852002319,0,30,0,0,17,37,41,0,0,0,1,34563,10.4,37082,97,0,-6394,-8769,9.7,3456.3,0,0,1,37,17,110,0,0,0,0,40957,12.0,45851,103,0,6394,8769,10.3,4095.7
4851968022,0,15,0,1,1,5,0,0,0,0,0,14838,6.8,17631,190,52,-1170,-920,24.2,1483.8,14,1,0,5,1,3,0,0,0,0,16008,7.0,18551,193,56,1170,920,24.9,1600.8
4851939265,0,11,1,0,0,5,0,0,0,0,0,14181,6.8,17496,207,58,-2893,-1986,26.5,1418.1,14,0,1,5,0,4,1,1,0,0,17074,7.4,19482,231,61,2893,1986,29.2,1707.4
4832810935,0,10,1,0,2,3,1,0,0,0,0,13996,6.4,17162,210,28,-673,-2104,23.8,1399.6,13,1,1,3,2,1,1,1,0,0,14669,7.2,19266,221,68,673,2104,28.9,1466.9
4831908755,1,12,1,1,6,4,7,0,0,0,0,16264,6.8,17414,212,56,66,-480,26.8,1626.4,12,1,0,4,6,7,0,0,0,0,16198,6.8,17894,212,48,-66,480,26.0,1619.8
4831880446,1,13,0,1,1,9,1,1,1,0,0,13754,6.4,15921,199,60,-5227,-2025,25.9,1375.4,14,1,0,9,1,13,0,0,0,0,18981,7.2,17946,197,56,5227,2025,25.3,1898.1
4831858487,1,10,0,1,6,5,5,0,0,0,0,17095,7.0,18517,220,44,1675,506,26.4,1709.5,11,0,0,5,6,3,1,1,0,0,15420,6.8,18011,204,64,-1675,-506,26.8,1542.0
4831361135,0,18,3,1,6,4,8,1,1,0,0,16657,6.6,16984,200,36,660,-56,23.6,1665.7,15,2,0,4,6,4,0,0,0,0,15997,6.8,17040,189,59,-660,56,24.8,1599.7
4831328888,0,11,1,0,4,5,6,0,0,0,0,14713,6.8,17149,179,52,-3654,-2828,23.1,1471.3,9,0,1,5,4,5,0,0,0,0,18367,7.4,19977,234,64,3654,2828,29.8,1836.7
4822635110,1,19,2,0,6,5,8,0,0,0,0,16388,6.8,16393,174,40,829,506,21.4,1638.8,18,1,1,5,6,11,0,0,0,0,15559,6.4,15887,164,48,-829,-506,21.2,1555.9
4822613903,1,16,0,1,3,3,3,1,1,0,0,15676,6.8,17507,246,64,1458,32,31.0,1567.6,14,0,0,3,3,0,0,0,0,0,14218,6.8,17475,208,50,-1458,-32,25.8,1421.8
4821897716,0,12,1,1,3,7,4,0,0,0,0,16326,6.6,16776,171,48,-968,-2752,21.9,1632.6,13,3,0,7,3,3,1,1,0,0,17294,7.2,19528,211,52,968,2752,26.3,1729.4
4821839538,0,8,0,1,2,1,1,0,0,0,0,15098,7.0,18060,246,59,-675,1329,30.5,1509.8,9,0,0,1,2,2,0,0,0,0,15773,6.6,16731,194,36,675,-1329,23.0,1577.3
4821782501,0,18,1,0,6,6,4,0,0,0,0,16325,6.6,16827,180,46,-873,352,22.6,1632.5,8,0,1,6,6,6,0,0,0,0,17198,6.6,16475,168,40,873,-352,20.8,1719.8
4821726288,1,37,1,1,10,2,8,1,1,0,0,19346,7.6,20323,225,72,5946,3832,29.7,1934.6,8,8,0,2,10,1,0,0,0,0,13400,6.6,16491,151,44,-5946,-3832,19.5,1340.0
4821708220,1,13,2,1,10,2,12,1,1,0,0,18953,6.8,18394,199,52,3849,1229,25.1,1895.3,12,2,0,2,10,4,0,0,0,0,15104,6.6,17165,202,56,-3849,-1229,25.8,1510.4
4819555768,1,12,1,1,4,1,3,1,1,0,0,15164,6.8,18347,194,55,1415,333,24.9,1516.4,13,1,0,1,4,0,0,0,0,0,13749,6.8,18014,191,68,-1415,-333,25.9,1374.9
4819497985,0,12,2,0,7,6,5,1,1,0,0,16698,7.0,18505,190,64,166,-15,25.4,1669.8,11,0,1,6,7,5,0,0,0,0,16532,7.2,18520,203,56,-166,15,25.9,1653.2
4819463246,1,15,1,0,5,4,2,0,0,0,0,17880,6.8,17530,197,44,1770,1103,24.1,1788.0,10,1,1,4,5,5,0,0,0,0,16110,6.8,16427,187,52,-1770,-1103,23.9,1611.0
4819446838,1,11,1,1,3,4,2,0,0,0,0,16418,7.2,18403,212,59,1128,410,27.1,1641.8,16,2,0,4,3,3,0,0,0,0,15290,6.8,17993,205,56,-1128,-410,26.1,1529.0
4813711356,0,12,0,0,4,6,6,0,0,0,0,16058,6.8,17059,195,48,-2276,-583,24.3,1605.8,26,0,1,6,4,7,0,0,0,0,18334,7.0,17642,224,35,2276,583,25.9,1833.4
4813700960,0,14,2,0,10,7,10,1,1,0,0,18372,7.2,19000,241,52,1222,1325,29.3,1837.2,12,1,1,7,10,9,0,0,0,0,17150,6.8,17675,188,63,-1222,-1325,25.1,1715.0
4812698801,0,14,2,0,1,7,2,1,1,0,0,14598,7.0,17710,213,56,-1514,-521,26.9,1459.8,15,0,1,7,1,3,0,0,0,0,16112,7.0,18231,198,48,1514,521,24.6,1611.2
4812677693,1,12,0,0,6,4,7,0,0,0,0,16463,6.8,17837,225,52,637,328,27.7,1646.3,10,0,1,4,6,5,1,1,0,0,15826,6.8,17509,218,52,-637,-328,27.0,1582.6
4812669447,1,11,0,0,5,8,4,0,0,0,0,15524,6.8,17134,190,44,-644,155,23.4,1552.4,11,0,1,8,5,7,0,0,0,0,16168,6.8,16979,170,52,644,-155,22.2,1616.8
4544409053,0,76,0,1,7,13,8,0,0,0,0,16229,6.4,16638,176,44,-4961,-3426,22.0,1622.9,10,1,0,13,7,11,0,0,0,0,21190,7.4,20064,238,48,4961,3426,28.6,2119.0
4544374305,1,11,0,1,7,2,4,0,0,0,0,17009,7.0,18314,166,60,1246,787,22.6,1700.9,11,1,0,2,7,0,0,0,0,0,15763,7.0,17527,195,40,-1246,-787,23.5,1576.3
4544338638,1,10,11,1,7,6,2,0,0,0,0,18392,7.4,19812,210,52,2871,1768,26.2,1839.2,34,0,0,6,7,5,1,1,0,0,15521,7.2,18044,184,48,-2871,-1768,23.2,1552.1
4544190946,0,10,1,0,1,7,1,0,0,0,0,13822,6.6,16307,181,44,-4384,-1644,22.5,1382.2,10,2,1,7,1,8,0,0,0,0,18206,6.8,17951,229,48,4384,1644,27.7,1820.6
4544150441,0,10,3,0,6,8,3,0,0,0,0,16470,7.2,18792,219,52,-482,603,27.1,1647.0,12,1,1,8,6,7,0,0,0,0,16952,7.0,18189,214,32,482,-603,24.6,1695.2
4544118259,0,50,1,0,1,7,2,0,0,0,0,13349,6.6,16836,167,52,-3914,-1009,21.9,1334.9,20,2,1,7,1,9,0,0,0,0,17263,7.0,17845,200,56,3914,1009,25.6,1726.3
4544070703,0,11,2,0,3,6,1,0,0,0,0,14420,6.6,17311,210,44,-1948,-1453,25.4,1442.0,14,1,1,6,3,5,1,1,0,0,16368,7.0,18764,197,52,1948,1453,24.9,1636.8
4544053901,1,40,1,1,4,6,10,1,1,0,0,16750,6.8,18007,171,65,41,-1464,23.6,1675.0,8,0,0,6,4,3,0,0,0,0,16709,7.2,19471,238,60,-41,1464,29.8,1670.9
4544024023,1,11,1,1,7,5,5,0,0,0,0,16519,7.0,17795,162,44,1450,798,20.6,1651.9,13,0,0,5,7,4,0,0,0,0,15069,6.8,16997,185,44,-1450,-798,22.9,1506.9
4543991189,0,12,0,0,0,5,0,0,0,0,0,13531,6.8,16992,207,48,-3038,-2468,25.5,1353.1,10,3,1,5,0,3,1,1,0,0,16569,7.4,19460,233,72,3038,2468,30.5,1656.9
4543973167,0,10,1,0,1,5,0,0,0,0,0,14105,7.0,18366,251,52,-1766,223,30.3,1410.5,12,2,1,5,1,10,0,0,0,0,15871,6.8,18143,189,60,1766,-223,24.9,1587.1
4543600483,1,11,0,1,8,6,6,0,0,0,0,19076,7.4,19616,194,56,3377,2424,25.0,1907.6,11,0,0,6,8,4,0,0,0,0,15699,6.8,17192,177,52,-3377,-2424,22.9,1569.9
4826355343,1,1,0,0,31,30,64,0,0,0,1,39335,11.8,44884,91,0,260,3342,9.1,3933.5,0,0,1,30,31,83,0,0,0,0,39075,11.2,41542,100,0,-260,-3342,10.0,3907.5
4826334331,1,0,0,0,20,25,53,0,0,0,0,35026,11.2,39563,91,0,-2028,-3381,9.1,3502.6,0,0,1,25,20,72,0,0,0,0,37054,11.4,42944,105,0,2028,3381,10.5,3705.4
4826316519,1,0,0,1,26,21,47,0,0,0,1,38372,11.0,40904,120,0,2928,1968,12.0,3837.2,0,0,0,21,26,55,0,0,0,0,35444,10.6,38936,104,0,-2928,-1968,10.4,3544.4
4826301207,0,12,0,0,5,14,6,0,0,0,0,25860,10.0,32591,77,63,-1910,-2087,14.0,2586.0,14,0,1,14,5,16,0,0,0,0,27770,10.4,34678,70,51,1910,2087,12.1,2777.0
4821000735,1,26,0,0,4,12,6,0,0,0,0,28256,10.2,33726,72,55,-1063,-3454,12.7,2825.6,17,0,1,12,4,17,0,0,0,0,29319,10.6,37180,76,60,1063,3454,13.6,2931.9
4820967434,0,10,0,0,8,20,16,0,0,0,0,32510,10.2,34792,95,51,-4845,-9160,14.6,3251.0,12,0,1,20,8,37,0,0,0,0,37355,11.4,43952,100,63,4845,9160,16.3,3735.5
4820568181,1,16,1,0,2,2,2,0,0,0,0,15609,6.6,17584,235,65,916,76,30.0,1560.9,12,1,1,2,2,2,0,0,0,0,14693,6.6,17508,187,62,-916,-76,24.9,1469.3
4819604820,1,0,0,0,26,25,83,0,0,0,1,38008,11.0,39484,116,0,1896,667,11.6,3800.8,3,0,1,25,26,63,0,0,0,0,36112,10.8,38817,112,0,-1896,-667,11.2,3611.2
4819588403,1,11,1,0,15,15,28,0,0,0,0,35046,11.2,40032,92,55,1448,2524,14.7,3504.6,16,0,1,15,15,28,0,0,0,0,33598,10.6,37508,75,52,-1448,-2524,12.7,3359.8
4819573106,1,12,0,0,16,9,33,0,0,0,1,34668,11.2,41539,88,64,4070,4289,15.2,3466.8,16,0,1,9,16,21,0,0,0,0,30598,10.6,37250,74,64,-4070,-4289,13.8,3059.8
4819021924,0,26,0,1,11,14,29,0,0,0,1,32944,10.8,37820,98,47,-4373,-5656,14.5,3294.4,10,0,0,14,11,26,0,0,0,0,37317,11.6,43476,124,59,4373,5656,18.3,3731.7
4813064931,0,0,0,0,22,26,59,0,0,0,0,35775,11.0,39250,96,0,-2169,-3648,9.6,3577.5,0,0,1,26,22,49,0,0,0,0,37944,11.6,42898,123,0,2169,3648,12.3,3794.4
4787542309,1,0,2,0,19,25,51,0,0,0,0,35889,11.0,40287,113,0,-1078,-591,11.3,3588.9,23,0,1,25,19,66,0,0,0,0,36967,11.2,40878,111,0,1078,591,11.1,3696.7
4786574494,0,0,0,1,14,21,41,0,0,0,0,34382,10.4,36868,89,0,-1308,-2386,8.9,3438.2,0,0,0,21,14,53,0,0,0,0,35690,11.0,39254,92,0,1308,2386,9.2,3569.0
4775100566,1,0,0,0,19,20,46,0,0,0,0,34099,10.6,37981,97,0,-2372,26,9.7,3409.9,0,0,1,20,19,55,0,0,0,0,36471,10.8,37955,113,0,2372,-26,11.3,3647.1
4775042677,1,0,0,0,17,25,36,0,0,0,0,35124,10.4,37313,103,0,-1957,-5682,10.3,3512.4,0,0,1,25,17,52,0,0,0,0,37081,11.4,42995,101,0,1957,5682,10.1,3708.1
4775022368,1,14,0,0,32,28,65,0,0,0,1,39136,11.8,44213,114,0,475,-1601,11.4,3913.6,0,0,1,28,32,52,0,0,0,0,38661,12.2,45814,99,0,-475,1601,9.9,3866.1
4774932868,1,0,0,1,40,22,104,0,0,0,1,43525,12.0,46402,105,0,6533,6955,10.5,4352.5,0,0,0,22,40,57,0,0,0,0,36992,11.0,39447,61,0,-6533,-6955,6.1,3699.2
4774915917,1,1,2,1,24,28,71,0,0,0,2,38111,11.4,41304,107,0,258,1120,10.7,3811.1,55,0,0,28,24,75,0,0,0,0,37853,11.0,40184,96,0,-258,-1120,9.6,3785.3
4774893577,1,16,0,1,21,18,52,0,0,0,1,36050,11.2,40167,122,0,-107,2502,12.2,3605.0,0,4,0,18,21,41,0,0,0,0,36157,10.6,37665,119,0,107,-2502,11.9,3615.7
4855454207,0,22,0,1,12,2,17,1,1,0,0,17700,7.0,17557,164,45,2937,-583,20.9,1770.0,12,0,0,2,12,1,1,0,1,0,14763,7.2,18140,183,56,-2937,583,23.9,1476.3
4855421054,0,12,5,0,6,10,6,0,0,0,0,17227,6.6,16253,158,53,-766,-1220,21.1,1722.7,13,2,1,10,6,12,1,1,0,0,17993,6.6,17473,228,38,766,1220,26.6,1799.3
4855382212,1,11,1,0,1,7,0,0,0,0,0,13452,6.8,17256,208,48,-3794,641,25.6,1345.2,14,2,1,7,1,10,0,0,0,0,17246,6.6,16615,214,49,3794,-641,26.3,1724.6
4855316545,1,13,3,1,1,2,1,1,1,0,0,13343,6.4,15517,169,52,-2063,-2470,22.1,1334.3,22,2,0,2,1,1,0,0,0,0,15406,7.0,17987,215,40,2063,2470,25.5,1540.6
4855252205,1,29,1,1,6,0,7,1,1,0,0,15436,7.0,17995,169,52,805,908,22.1,1543.6,12,1,0,0,6,0,0,0,0,0,14631,6.8,17087,193,52,-805,-908,24.5,1463.1
4855208492,0,8,0,0,8,9,4,0,0,0,0,16337,6.8,17869,165,72,-1866,100,23.7,1633.7,10,1,1,9,8,4,1,1,0,0,18203,6.8,17769,189,56,1866,-100,24.5,1820.3
4853050951,1,40,2,0,14,4,18,1,1,0,0,18415,6.6,16703,170,56,2612,93,22.6,1841.5,10,3,1,4,14,8,0,0,0,0,15803,6.6,16610,169,48,-2612,-93,21.7,1580.3
4852995731,0,11,1,0,6,10,5,0,0,0,0,15342,6.6,16551,193,50,-3174,-1296,24.3,1534.2,19,2,1,10,6,11,1,1,0,0,18516,6.8,17847,185,56,3174,1296,24.1,1851.6
4852951005,0,18,3,0,2,8,3,0,0,0,0,14923,6.2,15263,147,56,-2360,-1620,20.3,1492.3,15,1,1,8,2,7,1,1,0,0,17283,6.4,16883,191,40,2360,1620,23.1,1728.3
4852887453,1,14,1,0,7,5,5,1,1,0,0,15810,6.6,16284,163,52,906,518,21.5,1581.0,19,2,1,5,7,4,0,0,0,0,14904,6.4,15766,159,44,-906,-518,20.3,1490.4
4849197881,0,12,2,0,8,7,4,0,0,0,0,17341,7.0,18129,200,52,235,305,25.2,1734.1,13,1,1,7,8,7,2,1,1,0,17106,7.0,17824,192,64,-235,-305,25.6,1710.6
4849161090,1,13,2,1,10,5,10,0,0,0,0,17133,6.4,16657,164,41,689,-835,20.5,1713.3,13,0,0,5,10,1,1,1,0,0,16444,6.8,17492,201,56,-689,835,25.7,1644.4
4846227018,0,14,2,0,8,10,8,1,1,0,0,16640,6.4,16510,155,56,-2381,-2186,21.1,1664.0,81,1,1,10,8,9,0,0,0,0,19021,7.0,18696,194,46,2381,2186,24.0,1902.1
4846191480,0,53,0,1,4,7,3,1,0,1,0,14763,6.8,17001,163,44,-2766,-1376,20.7,1476.3,12,2,0,7,4,10,1,1,0,0,17529,6.8,18377,183,56,2766,1376,23.9,1752.9
4846153674,0,12,3,0,10,6,9,1,1,0,0,16259,6.8,17059,173,40,6,-251,21.3,1625.9,11,0,1,6,10,6,1,0,1,0,16253,7.0,17310,200,52,-6,251,25.2,1625.3
4846118434,1,12,2,0,6,8,8,0,0,0,0,15917,6.2,15598,177,48,-1753,-1514,22.5,1591.7,17,1,1,8,6,4,1,0,1,0,17670,6.8,17112,203,52,1753,1514,25.5,1767.0
4842579469,1,142,2,1,6,3,7,0,0,0,0,17399,7.0,18660,219,54,1757,1211,27.3,1739.9,16,3,0,3,6,3,0,0,0,0,15642,6.6,17449,206,52,-1757,-1211,25.8,1564.2
4842521434,0,19,0,0,3,2,3,0,0,0,0,15451,6.8,18007,212,60,1114,644,27.2,1545.1,13,1,1,2,3,1,0,0,0,0,14337,6.8,17363,207,60,-1114,-644,26.7,1433.7
4837142006,0,61,2,0,6,9,4,0,0,0,0,16928,6.0,15847,179,40,-1509,-689,21.9,1692.8,13,1,1,9,6,14,1,1,0,0,18437,6.8,16536,143,52,1509,689,19.5,1843.7
4858209043,1,12,0,0,4,5,2,2,1,1,0,15362,6.8,17283,176,56,-334,-791,23.2,1536.2,6,0,1,5,4,2,0,0,0,0,15696,6.8,18074,191,50,334,791,24.1,1569.6
4857452261,1,0,0,1,20,28,49,0,0,0,1,36616,11.0,39377,96,0,-1649,-3351,9.6,3661.6,0,0,0,28,20,81,0,0,0,0,38265,11.6,42728,111,0,1649,3351,11.1,3826.5
4857425024,0,34,0,1,22,22,56,0,0,0,0,36397,11.0,38997,89,0,55,-1928,8.9,3639.7,38,0,0,22,22,49,0,0,0,0,36342,11.2,40925,88,0,-55,1928,8.8,3634.2
4857397236,0,5,1,0,32,24,87,0,0,0,1,39565,11.2,41000,103,0,3011,1458,10.3,3956.5,177,0,1,24,32,68,0,0,0,0,36554,11.0,39542,103,0,-3011,-1458,10.3,3655.4
4857371888,1,12,0,1,17,6,41,0,0,0,0,34537,10.8,37591,91,0,467,2688,9.1,3453.7,0,1,0,6,17,9,0,0,0,0,34070,10.2,34903,105,0,-467,-2688,10.5,3407.0
4857327733,0,20,2,0,26,27,52,0,0,0,1,38370,11.6,42059,106,0,2404,584,10.6,3837.0,7,1,1,27,26,72,0,0,0,0,35966,11.2,41475,93,0,-2404,-584,9.3,3596.6
4857299644,1,3,0,0,27,28,69,0,0,0,0,41226,11.8,44979,115,0,1886,869,11.5,4122.6,86,0,1,28,27,66,0,0,0,0,39340,11.6,44110,103,0,-1886,-869,10.3,3934.0
4857221416,1,7,0,0,3,5,2,0,0,0,0,16685,7.2,19451,226,52,1634,2156,27.8,1668.5,11,0,1,5,3,5,1,1,0,0,15051,6.6,17295,172,44,-1634,-2156,21.6,1505.1
4857149299,1,11,0,0,2,2,0,0,0,0,0,14600,6.8,17136,187,60,78,-234,24.7,1460.0,8,0,1,2,2,3,0,0,0,0,14522,6.6,17370,212,60,-78,234,27.2,1452.2
4856958614,1,14,2,0,9,9,6,0,0,0,0,18309,7.2,18830,175,60,1520,1334,23.5,1830.9,69,1,1,9,9,3,1,1,0,0,16789,6.8,17496,187,52,-1520,-1334,23.9,1678.9
4856939986,0,65,1,0,7,14,9,0,0,0,0,17903,6.8,18299,172,59,-2482,-721,23.1,1790.3,12,2,1,14,7,19,0,0,0,0,20385,7.4,19020,203,48,2482,721,25.1,2038.5
4856907539,1,19,2,0,8,4,10,1,1,0,0,17069,7.2,18761,182,68,2316,2378,25.0,1706.9,12,0,1,4,8,3,0,0,0,0,14753,6.4,16383,166,56,-2316,-2378,22.2,1475.3
4856882811,1,9,1,1,5,6,3,0,0,0,0,17099,7.0,18283,215,62,667,483,27.7,1709.9,7,0,0,6,5,6,0,0,0,0,16432,6.8,17800,168,56,-667,-483,22.4,1643.2
4856849579,0,82,0,1,9,11,10,0,0,0,0,18017,6.6,16484,193,43,-1350,-1315,23.6,1801.7,16,2,0,11,9,13,0,0,0,0,19367,7.0,17799,177,56,1350,1315,23.3,1936.7
4856830896,1,13,1,0,7,5,7,1,1,0,0,16512,6.8,17602,194,56,771,1228,25.0,1651.2,13,3,1,5,7,6,0,0,0,0,15741,6.6,16374,156,52,-771,-1228,20.8,1574.1
4856254846,1,81,0,1,4,5,5,0,0,0,0,15854,6.6,16539,181,36,-24,86,21.7,1585.4,15,1,0,5,4,6,0,0,0,0,15878,6.6,16453,215,44,24,-86,25.9,1587.8
4856198419,0,52,15,1,7,2,5,0,0,0,0,15234,6.6,16235,155,48,293,-1447,20.3,1523.4,29,1,0,2,7,2,1,1,0,0,14941,6.8,17682,200,56,-293,1447,25.6,1494.1
4855774269,1,12,1,0,3,3,5,0,0,0,0,16254,7.0,17885,223,62,2268,549,28.5,1625.4,48,0,1,3,3,2,0,0,0,0,13986,7.0,17336,171,52,-2268,-549,22.3,1398.6
4855349865,1,0,0,1,30,23,80,0,0,0,0,38833,11.2,42226,97,0,1040,2146,9.7,3883.3,0,0,0,23,30,41,0,0,0,0,37793,11.0,40080,104,0,-1040,-2146,10.4,3779.3
4855332756,0,0,0,0,18,21,58,0,0,0,0,36176,11.0,38539,107,0,-1167,-1079,10.7,3617.6,0,0,1,21,18,66,0,0,0,0,37343,10.8,39618,122,0,1167,1079,12.2,3734.3
4857342632,1,12,2,1,8,4,5,0,0,0,0,17502,6.8,18017,198,47,3485,1879,24.5,1750.2,13,1,0,4,8,2,0,0,0,0,14017,6.4,16138,181,34,-3485,-1879,21.5,1401.7
4857316508,0,8,2,0,2,9,2,0,0,0,0,13310,6.4,15531,171,49,-5464,-3568,22.0,1331.0,11,1,1,9,2,3,2,1,1,0,18774,7.2,19099,223,46,5464,3568,26.9,1877.4
4857276544,1,14,1,1,6,5,6,0,0,0,0,15703,6.8,17442,181,40,-612,-146,22.1,1570.3,12,1,0,5,6,3,0,0,0,0,16315,6.6,17588,193,52,612,146,24.5,1631.5
4854846511,1,11,1,0,9,3,8,0,0,0,0,17291,6.8,17791,187,48,2535,874,23.5,1729.1,71,0,1,3,9,5,0,0,0,0,14756,6.6,16917,169,56,-2535,-874,22.5,1475.6
4851869636,0,11,0,1,6,4,4,0,0,0,0,15706,6.6,17003,195,48,1115,-231,24.3,1570.6,13,0,0,4,6,2,0,0,0,0,14591,6.8,17234,177,52,-1115,231,22.9,1459.1
4850738178,1,15,1,0,4,4,5,0,0,0,0,15782,7.2,18370,197,71,161,378,26.8,1578.2,128,3,1,4,4,4,0,0,0,0,15621,7.0,17992,200,48,-161,-378,24.8,1562.1
4850651037,0,10,0,1,7,7,5,1,1,0,0,16223,6.6,16464,193,40,-918,258,23.3,1622.3,11,1,0,7,7,11,0,0,0,0,17141,6.6,16206,217,31,918,-258,24.8,1714.1
4849859184,1,13,1,1,8,4,10,1,1,0,0,20298,7.6,19861,219,68,5902,3173,28.7,2029.8,11,0,0,4,8,0,0,0,0,0,14396,6.4,16688,171,40,-5902,-3173,21.1,1439.6
4849815025,1,11,4,1,5,2,3,0,0,0,0,16181,7.0,18398,217,52,2674,1618,26.9,1618.1,23,1,0,2,5,1,0,0,0,0,13507,6.6,16780,166,56,-2674,-1618,22.2,1350.7
4849281913,1,31,0,1,14,4,6,1,1,0,0,20345,7.2,19112,220,60,6180,4349,28.0,2034.5,29,0,0,4,14,7,0,0,0,0,14165,6.4,14763,144,39,-6180,-4349,18.3,1416.5
4849256746,1,11,0,1,6,5,7,0,0,0,0,16717,6.6,17412,183,63,680,167,24.6,1671.7,12,1,0,5,6,2,0,0,0,0,16037,6.6,17245,182,50,-680,-167,23.2,1603.7
4849028585,0,12,3,1,7,3,4,0,0,0,0,17647,6.8,18572,240,52,1174,296,29.2,1764.7,76,1,0,3,7,3,1,1,0,0,16473,7.2,18276,198,59,-1174,-296,25.7,1647.3
4848984250,0,34,0,1,12,5,16,1,0,1,0,20241,7.0,18528,180,60,3953,2425,24.0,2024.1,7,10,0,5,12,4,0,0,0,0,16288,6.4,16103,153,52,-3953,-2425,20.5,1628.8
4848919679,1,65,3,1,7,7,4,1,0,1,0,18053,7.0,18050,211,48,1312,1009,25.9,1805.3,21,1,0,7,7,5,1,1,0,0,16741,6.6,17041,155,60,-1312,-1009,21.5,1674.1
4848860990,1,49,0,1,7,5,7,1,1,0,0,16972,6.8,17706,215,60,1134,344,27.5,1697.2,15,2,0,5,7,5,0,0,0,0,15838,6.6,17362,179,52,-1134,-344,23.1,1583.8
4848111090,1,13,0,1,4,5,4,1,1,0,0,16074,6.8,16426,174,52,-1108,-1134,22.6,1607.4,7,0,0,5,4,10,0,0,0,0,17182,6.6,17560,209,56,1108,1134,26.5,1718.2
4848021096,1,12,0,0,9,7,9,2,1,1,0,17856,7.0,18288,216,64,1461,2857,28.0,1785.6,11,2,1,7,9,9,0,0,0,0,16395,6.2,15431,190,48,-1461,-2857,23.8,1639.5
4847998914,0,14,0,0,0,5,0,0,0,0,0,12798,6.6,16778,198,38,-3876,-1951,23.6,1279.8,15,2,1,5,0,8,1,1,0,0,16674,7.0,18729,235,54,3876,1951,28.9,1667.4
4847942267,0,8,2,1,6,8,4,0,0,0,0,17221,7.0,18438,205,42,-189,1712,24.7,1722.1,14,0,0,8,6,8,1,1,0,0,17410,6.8,16726,176,46,189,-1712,22.2,1741.0
4753040873,1,15,0,1,11,7,12,0,0,0,0,20709,6.6,17379,202,48,3513,1145,25.0,2070.9,11,0,0,7,11,7,1,0,1,0,17196,6.6,16234,172,60,-3513,-1145,23.2,1719.6
4753004240,0,10,1,0,8,6,11,1,1,0,0,16502,6.6,17011,165,48,496,-696,21.3,1650.2,9,1,1,6,8,4,0,0,0,0,16006,7.0,17707,214,44,-496,696,25.8,1600.6
4752957988,1,106,2,1,7,6,5,0,0,0,0,16742,6.6,16287,194,32,-558,-1473,22.6,1674.2,15,4,0,6,7,3,1,1,0,0,17300,6.6,17760,199,60,558,1473,25.9,1730.0
4752904698,1,99,9,1,8,5,9,0,0,0,0,17973,6.8,18098,170,52,3026,1864,22.2,1797.3,39,2,0,5,8,4,0,0,0,0,14947,6.6,16234,148,52,-3026,-1864,20.0,1494.7
4752298059,1,10,1,1,6,1,5,1,0,1,0,17245,7.0,18877,193,68,3191,1826,26.1,1724.5,11,0,0,1,6,0,0,0,0,0,14054,6.6,17051,182,56,-3191,-1826,23.8,1405.4
4752276187,1,8,2,1,6,8,7,1,1,0,0,15759,6.8,16753,189,56,-2024,-454,24.5,1575.9,17,2,0,8,6,13,0,0,0,0,17783,6.6,17207,225,60,2024,454,28.5,1778.3
4751720150,1,11,2,0,3,6,2,0,0,0,0,15973,6.8,17582,200,57,-1322,-1439,25.7,1597.3,15,1,1,6,3,6,0,0,0,0,17295,7.2,19021,215,51,1322,1439,26.6,1729.5
4751399953,1,269,2,0,8,7,4,1,1,0,0,18533,6.8,18249,169,60,1340,183,22.9,1853.3,15,1,1,7,8,2,0,0,0,0,17193,6.8,18066,150,52,-1340,-183,20.2,1719.3
4751388117,1,14,1,0,2,4,2,0,0,0,0,15577,6.8,17313,226,52,-188,-825,27.8,1557.7,13,2,1,4,2,3,1,1,0,0,15765,7.0,18138,211,56,188,825,26.7,1576.5
4751367713,1,10,1,0,8,4,6,1,1,0,0,16596,6.6,17294,208,48,1507,-48,25.6,1659.6,15,0,1,4,8,4,0,0,0,0,15089,6.8,17342,178,52,-1507,48,23.0,1508.9
4751361333,1,9,0,0,4,2,5,0,0,0,0,15327,7.0,18705,207,52,830,-278,25.9,1532.7,6,0,1,2,4,2,0,0,0,0,14497,7.0,18983,198,68,-830,278,26.6,1449.7
4751348953,0,13,0,1,6,2,3,0,0,0,0,16203,7.0,18648,208,56,2004,2476,26.4,1620.3,6,3,0,2,6,2,0,0,0,0,14199,6.4,16172,195,40,-2004,-2476,23.5,1419.9
4751307220,0,68,6,1,9,12,8,0,0,0,0,18319,6.8,16801,171,56,-716,-1713,22.7,1831.9,35,1,0,12,9,11,0,0,0,0,19035,7.0,18514,187,72,716,1713,25.9,1903.5
4751275582,1,17,0,1,9,6,10,1,0,1,0,17750,6.4,16502,167,48,1558,-464,21.5,1775.0,15,3,0,6,9,5,0,0,0,0,16192,6.6,16966,199,48,-1558,464,24.7,1619.2
4751237311,1,16,2,0,10,4,8,2,1,1,0,17861,7.0,17728,171,68,2104,274,23.9,1786.1,10,3,1,4,10,2,0,0,0,0,15757,6.8,17454,202,56,-2104,-274,25.8,1575.7
4750374893,1,13,0,0,4,7,0,0,0,0,0,14989,7.0,18339,193,56,-1757,1429,24.9,1498.9,14,2,1,7,4,8,1,1,0,0,16746,6.8,16910,189,44,1757,-1429,23.3,1674.6
4750347200,1,12,1,1,5,3,4,0,0,0,0,16644,6.8,18422,202,48,1199,1512,25.0,1664.4,10,1,0,3,5,2,0,0,0,0,15445,6.4,16910,193,60,-1199,-1512,25.3,1544.5
4750313998,0,17,1,1,4,7,4,0,0,0,0,15729,6.8,16985,206,48,-575,-1093,25.4,1572.9,15,2,0,7,4,5,0,0,0,0,16304,7.2,18078,194,52,575,1093,24.6,1630.4
4749787777,1,12,4,1,6,4,7,0,0,0,0,17725,7.0,17219,184,60,1277,-487,24.4,1772.5,14,2,0,4,6,3,0,0,0,0,16448,6.8,17706,236,56,-1277,487,29.2,1644.8
4749760318,0,10,0,0,7,8,5,1,1,0,0,16593,6.8,17828,174,60,-790,-744,23.4,1659.3,9,0,1,8,7,4,0,0,0,0,17383,7.2,18572,177,62,790,744,23.9,1738.3
4858204520,0,8,2,0,7,5,3,1,1,0,0,15932,6.6,17851,188,44,-1028,-1183,23.2,1593.2,14,2,1,5,7,6,0,0,0,0,16960,7.4,19034,205,59,1028,1183,26.4,1696.0
4851725099,1,31,3,0,3,6,0,0,0,0,0,15168,6.8,17249,203,48,-1445,-499,25.1,1516.8,36,4,1,6,3,3,1,1,0,0,16613,7.0,17748,195,60,1445,499,25.5,1661.3
4851662828,0,9,0,0,7,8,7,0,0,0,0,16766,6.8,17684,186,40,-1401,-335,22.6,1676.6,17,0,1,8,7,6,0,0,0,0,18167,6.8,18019,182,56,1401,335,23.8,1816.7
4851450414,1,11,0,1,4,5,2,0,0,0,0,15362,6.6,16831,193,60,-342,-774,25.3,1536.2,7,0,0,5,4,6,0,0,0,0,15704,6.6,17605,190,56,342,774,24.6,1570.4
4851443792,1,15,0,0,4,4,3,1,1,0,0,15819,6.8,18149,202,64,516,1820,26.6,1581.9,13,0,1,4,4,4,0,0,0,0,15303,6.6,16329,183,44,-516,-1820,22.7,1530.3
4851410507,0,26,0,0,2,2,3,0,0,0,0,15062,6.8,18226,213,48,82,-50,26.1,1506.2,12,7,1,2,2,2,0,0,0,0,14980,7.0,18276,204,60,-82,50,26.4,1498.0
4851130782,0,8,0,0,3,6,2,1,1,0,0,14166,6.4,15986,165,47,-3046,-3329,21.2,1416.6,11,0,1,6,3,1,0,0,0,0,17212,7.2,19315,216,64,3046,3329,28.0,1721.2
4850526449,0,13,2,0,7,8,7,0,0,0,0,18319,7.4,18496,205,60,1293,1475,26.5,1831.9,13,2,1,8,7,9,1,1,0,0,17026,6.6,17021,186,48,-1293,-1475,23.4,1702.6
4849631767,0,14,2,1,6,3,1,0,0,0,0,14679,7.0,18052,167,64,-266,-826,23.1,1467.9,16,0,0,2,5,1,0,0,0,0,14945,7.2,18878,208,64,266,826,27.2,1494.5
4847796187,1,39,0,0,19,15,55,0,0,0,1,36301,10.8,37910,109,0,1709,800,10.9,3630.1,0,23,1,15,19,35,0,0,0,0,34592,10.6,37110,90,0,-1709,-800,9.0,3459.2
4847771533,1,0,0,1,37,33,95,0,0,0,0,40535,12.2,47626,108,0,1078,3476,10.8,4053.5,4,0,0,33,37,76,0,0,0,0,39457,11.6,44150,89,0,-1078,-3476,8.9,3945.7
4846668395,0,13,1,1,4,3,5,0,0,0,0,15317,7.0,17575,202,64,549,-356,26.6,1531.7,12,2,0,3,4,3,1,1,0,0,14768,7.0,17931,204,40,-549,356,24.4,1476.8
4846634237,1,17,2,1,3,3,6,0,0,0,0,15448,6.6,17177,185,48,885,-194,23.3,1544.8,20,1,0,3,3,3,0,0,0,0,14563,6.8,17371,191,51,-885,194,24.2,1456.3
4845369349,1,15,0,1,6,3,5,1,1,0,0,16133,6.8,17846,199,56,2397,1704,25.5,1613.3,9,0,0,3,6,2,0,0,0,0,13736,6.6,16142,145,48,-2397,-1704,19.3,1373.6
4844960095,1,9,0,0,11,7,6,1,1,0,0,17364,7.0,18214,178,64,816,1653,24.2,1736.4,10,0,1,7,11,4,0,0,0,0,16548,6.6,16561,192,31,-816,-1653,22.3,1654.8
4844928120,1,12,1,0,9,9,6,0,0,0,0,16938,6.8,17352,166,48,429,291,21.4,1693.8,15,0,1,9,9,9,0,0,0,0,16509,6.6,17061,152,46,-429,-291,19.8,1650.9
4844497107,0,11,1,1,8,6,8,0,0,0,0,15858,7.0,16996,163,56,-1022,-686,21.9,1585.8,15,1,0,6,8,4,1,1,0,0,16880,6.8,17682,173,56,1022,686,22.9,1688.0
4844470606,1,10,0,1,7,5,7,0,0,0,0,17883,6.8,17626,165,58,727,842,22.3,1788.3,13,0,0,5,7,5,0,0,0,0,17156,6.8,16784,204,51,-727,-842,25.5,1715.6
4844456073,0,12,1,0,4,5,5,0,0,0,0,14695,6.6,16249,186,24,-1610,-1122,21.0,1469.5,116,0,1,5,4,6,0,0,0,0,16305,6.8,17371,196,60,1610,1122,25.6,1630.5
4856310378,1,0,0,0,28,26,65,0,0,0,0,36954,11.2,41855,115,0,-381,-108,11.5,3695.4,0,0,1,26,28,76,0,0,0,0,37335,11.2,41963,94,0,381,108,9.4,3733.5
4856277654,1,0,0,0,20,20,42,0,0,0,0,33943,10.8,37304,93,0,-1882,-855,9.3,3394.3,0,0,1,20,20,59,0,0,0,0,35825,10.6,38159,109,0,1882,855,10.9,3582.5
4855808936,1,18,2,1,6,6,3,0,0,0,0,16354,6.8,16607,188,45,1124,-241,23.3,1635.4,10,2,0,6,6,4,0,0,0,0,15230,6.8,16848,159,36,-1124,241,19.5,1523.0
4855781590,1,6,0,0,18,19,18,0,0,0,0,47054,10.4,49000,0,0,18786,20500,0.0,4705.4,0,0,1,10,9,11,0,0,0,0,28268,6.0,28500,0,0,-18786,-20500,0.0,2826.8
4855699899,1,5,0,0,16,24,19,0,0,0,0,63475,12.8,61000,0,0,24851,25000,0.0,6347.5,7,0,1,15,7,12,0,0,0,0,38624,7.6,36000,0,0,-24851,-25000,0.0,3862.4
4855682241,1,28,3,1,19,21,20,0,0,0,0,62765,13.8,66500,2,0,25555,29000,0.2,6276.5,0,2,0,11,9,10,0,0,0,0,37210,7.8,37500,0,0,-25555,-29000,0.0,3721.0
4854993984,1,13,1,0,5,3,4,0,0,0,0,15535,6.8,17886,216,36,93,-22,25.2,1553.5,17,1,1,3,5,4,0,0,0,0,15442,7.0,17908,243,64,-93,22,30.7,1544.2
4854950085,1,34,0,0,21,18,62,0,0,0,0,38717,11.4,41704,107,0,3650,4294,10.7,3871.7,34,0,1,18,21,51,0,0,0,0,35067,10.6,37410,94,0,-3650,-4294,9.4,3506.7
4854926131,1,0,0,1,29,26,76,0,0,0,1,39882,11.8,44324,113,0,3183,3718,11.3,3988.2,13,0,0,26,29,53,0,0,0,0,36699,11.2,40606,89,0,-3183,-3718,8.9,3669.9
4854719857,1,0,0,0,18,15,20,0,0,0,0,64169,12.0,55000,0,0,26960,22000,0.0,6416.9,0,0,1,9,12,6,0,0,0,0,37209,7.2,33000,0,0,-26960,-22000,0.0,3720.9
4854705873,1,49,0,1,14,11,13,0,0,0,0,45675,10.0,47500,2,0,19180,19000,0.2,4567.5,0,0,0,6,9,6,0,0,0,0,26495,6.0,28500,1,0,-19180,-19000,0.1,2649.5
4853975884,1,5,2,1,19,12,17,0,0,0,0,62035,12.0,55000,1,0,24967,20000,0.1,6203.5,30,3,0,7,14,10,0,0,0,0,37068,7.6,35000,1,0,-24967,-20000,0.1,3706.8
4853855039,1,8,0,0,22,21,17,0,0,0,0,63400,12.6,59500,0,0,26200,19500,0.0,6340.0,0,0,1,10,11,10,0,0,0,0,37200,8.4,40000,0,0,-26200,-19500,0.0,3720.0
4847385504,1,14,1,1,5,3,3,1,0,1,0,16170,6.6,17150,191,48,1605,42,23.9,1617.0,17,0,0,3,5,2,0,0,0,0,14565,6.8,17108,198,44,-1605,-42,24.2,1456.5
4847184755,0,1,10,0,27,37,78,0,0,0,2,39214,11.6,42350,90,0,-3390,-5331,9.0,3921.4,24,0,1,37,27,113,0,0,0,0,42604,12.2,47681,121,0,3390,5331,12.1,4260.4
4842040969,0,11,0,0,15,14,32,0,0,0,0,35696,11.2,39873,99,55,5056,3043,15.4,3569.6,27,1,1,13,14,31,0,0,0,0,30640,10.6,36830,81,59,-5056,-3043,14.0,3064.0
4842020777,0,18,0,0,9,7,26,0,0,0,1,31694,11.0,38899,95,56,-248,-90,15.1,3169.4,14,2,1,7,9,12,0,0,0,0,31942,11.2,38989,113,67,248,90,18.0,3194.2
4841995348,1,13,0,1,13,14,16,0,0,0,1,31227,10.6,36099,100,47,-4490,-3070,14.7,3122.7,10,0,0,14,13,30,0,0,0,0,35717,11.0,39169,75,59,4490,3070,13.4,3571.7
4857619381,1,10,0,1,7,6,7,1,1,0,0,17754,6.8,16857,179,52,1282,1698,23.1,1775.4,11,0,0,6,7,5,0,0,0,0,16472,6.2,15159,154,51,-1282,-1698,20.5,1647.2
4857597586,1,15,4,1,8,7,5,2,1,1,0,17242,7.2,18837,156,68,484,739,22.4,1724.2,14,1,0,7,8,5,0,0,0,0,16758,6.8,18098,204,56,-484,-739,26.0,1675.8
4857578782,0,12,0,0,1,5,0,0,0,0,0,13073,6.4,16694,179,56,-4122,-2579,23.5,1307.3,7,2,1,5,1,1,1,1,0,0,17195,7.0,19273,243,44,4122,2579,28.7,1719.5
4857550899,1,9,0,1,7,3,4,0,0,0,0,16801,7.0,18493,236,48,3365,1637,28.4,1680.1,8,0,0,3,7,2,0,0,0,0,13436,6.6,16856,144,52,-3365,-1637,19.6,1343.6
4857393587,1,11,0,1,12,8,10,0,0,0,0,20267,7.0,18583,223,60,3303,676,28.3,2026.7,5,0,0,8,12,8,0,0,0,0,16964,6.6,17907,188,51,-3303,-676,23.9,1696.4
4856981638,0,11,2,1,4,9,5,0,0,0,0,15816,7.0,17435,229,48,-1074,3,27.7,1581.6,11,1,0,9,4,12,1,1,0,0,16890,6.8,17432,194,48,1074,-3,24.2,1689.0
4856906494,0,36,1,0,4,7,3,0,0,0,0,16266,6.8,17803,203,72,-744,730,27.5,1626.6,13,0,1,7,4,5,0,0,0,0,17010,6.6,17073,220,24,744,-730,24.4,1701.0
4856893042,0,12,0,0,4,5,2,0,0,0,0,15647,6.6,17461,201,56,-244,-976,25.7,1564.7,12,0,1,5,4,2,0,0,0,0,15891,6.8,18437,210,51,244,976,26.1,1589.1
4856649236,1,16,0,1,3,2,2,0,0,0,0,16951,7.0,18000,186,52,3971,1884,23.8,1695.1,9,0,0,2,3,0,0,0,0,0,12980,6.6,16116,151,63,-3971,-1884,21.4,1298.0
4856632334,0,11,0,1,9,6,3,0,0,0,0,16997,6.8,17484,187,60,1151,1797,24.7,1699.7,9,0,0,6,9,9,0,0,0,0,15846,6.2,15687,147,50,-1151,-1797,19.7,1584.6
4856614481,0,53,2,0,1,4,0,0,0,0,0,13476,6.8,16794,159,40,-3064,-1248,19.9,1347.6,14,1,1,4,1,3,1,1,0,0,16540,7.0,18042,234,56,3064,1248,29.0,1654.0
4856584904,1,232,2,0,7,6,3,1,1,0,0,15386,6.8,17400,166,56,-1765,-988,22.2,1538.6,12,2,1,6,7,5,0,0,0,0,17151,7.0,18388,232,56,1765,988,28.8,1715.1
4856561523,1,20,0,1,9,3,4,1,1,0,0,17247,7.2,19198,243,56,2289,1454,29.9,1724.7,162,1,0,3,9,1,0,0,0,0,14958,6.8,17744,187,52,-2289,-1454,23.9,1495.8
4856356961,0,11,1,0,7,8,5,0,0,0,0,16471,6.6,17172,197,48,-1353,-1260,24.5,1647.1,71,0,1,8,7,6,1,1,0,0,17824,7.0,18432,192,50,1353,1260,24.2,1782.4
4856016317,1,45,1,1,9,7,10,0,0,0,0,18260,7.0,17930,185,52,461,-234,23.7,1826.0,8,1,0,7,9,2,0,0,0,0,17799,7.0,18164,233,56,-461,234,28.9,1779.9
4855988893,0,29,2,1,4,5,3,0,0,0,0,14694,6.6,16660,168,48,-1119,-1892,21.6,1469.4,31,1,0,5,4,2,0,0,0,0,15813,7.0,18552,224,60,1119,1892,28.4,1581.3
4855948711,0,8,1,1,6,7,5,1,1,0,0,16590,7.0,17749,195,69,-1259,-1044,26.4,1659.0,13,1,0,7,6,6,1,0,1,0,17849,7.0,18793,184,44,1259,1044,22.8,1784.9
4855459011,1,10,0,0,3,4,2,0,0,0,0,15342,7.2,18221,198,52,-1087,30,25.0,1534.2,6,0,1,4,3,4,0,0,0,0,16429,6.8,18191,218,56,1087,-30,27.4,1642.9
4855426755,1,10,0,1,7,6,1,1,1,0,0,16418,6.8,17209,178,56,264,696,23.4,1641.8,161,0,0,6,7,6,0,0,0,0,16154,6.6,16513,190,40,-264,-696,23.0,1615.4
4855702580,1,12,1,0,8,10,7,0,0,0,0,16868,6.6,16926,204,56,-152,-996,26.0,1686.8,207,2,1,10,8,9,0,0,0,0,17020,6.8,17922,183,48,152,996,23.1,1702.0
4855682451,0,15,1,0,7,8,8,0,0,0,0,16218,6.4,16296,166,47,-1978,-1779,21.3,1621.8,13,2,1,8,7,7,0,0,0,0,18196,7.2,18075,203,46,1978,1779,24.9,1819.6
4855674044,1,0,0,1,19,11,17,0,0,0,0,47000,10.2,48680,8,0,20900,20180,0.8,4700.0,0,0,0,4,12,6,0,0,0,0,26100,6.0,28500,2,0,-20900,-20180,0.2,2610.0
4850523828,1,16,1,1,9,6,7,0,0,0,0,17702,7.0,18243,179,52,1976,1283,23.1,1770.2,7,1,0,6,9,4,0,0,0,0,15726,6.8,16960,180,48,-1976,-1283,22.8,1572.6
4850502725,1,14,0,0,6,2,6,0,0,0,0,15169,6.6,16948,168,60,1873,1526,22.8,1516.9,16,0,1,2,6,4,0,0,0,0,13296,6.4,15422,180,32,-1873,-1526,21.2,1329.6
4850490357,0,69,1,1,3,3,4,1,1,0,0,14088,6.4,16320,193,40,-1114,-1839,23.3,1408.8,12,0,0,3,3,0,0,0,0,0,15202,7.0,18159,175,56,1114,1839,23.1,1520.2
4850467677,0,18,3,0,3,6,0,1,1,0,0,14592,6.6,17715,174,48,-3388,-1206,22.2,1459.2,26,2,1,6,3,3,0,0,0,0,17980,7.0,18921,199,48,3388,1206,24.7,1798.0
4847474096,1,8,1,1,11,9,10,0,0,0,0,18007,6.6,16477,162,36,1404,674,19.8,1800.7,11,1,0,9,11,9,1,1,0,0,16603,6.2,15803,154,42,-1404,-674,19.6,1660.3
4847457269,0,14,0,0,3,7,1,1,0,1,0,14448,6.6,16346,131,64,-2285,-1606,19.5,1444.8,9,0,1,7,3,5,1,1,0,0,16733,6.8,17952,183,45,2285,1606,22.8,1673.3
4847444753,0,7,0,0,4,5,4,1,1,0,0,14656,6.8,17513,199,47,-1070,-105,24.6,1465.6,7,0,1,5,4,1,0,0,0,0,15726,7.0,17618,240,40,1070,105,28.0,1572.6
4847415048,0,25,2,1,4,9,5,0,0,0,0,15147,6.6,15797,192,52,-3388,-1242,24.4,1514.7,33,2,0,9,4,14,1,1,0,0,18535,6.4,17039,196,36,3388,1242,23.2,1853.5
4847061499,1,8,0,1,5,2,5,0,0,0,0,15245,6.6,16963,138,60,1591,813,19.8,1524.5,19,0,0,2,5,2,1,1,0,0,13654,6.6,16150,133,52,-1591,-813,18.5,1365.4
4847022719,0,11,1,0,8,9,2,0,0,0,0,16198,6.8,17511,143,40,-2149,-1334,18.3,1619.8,388,1,1,9,8,5,1,1,0,0,18347,7.0,18845,194,55,2149,1334,24.9,1834.7
4846998355,0,7,5,0,6,5,2,0,0,0,0,15201,6.8,17576,145,48,-1539,513,19.3,1520.1,30,0,1,5,6,6,0,0,0,0,16740,6.8,17063,182,36,1539,-513,21.8,1674.0
4838704452,0,145,11,0,6,6,6,0,0,0,0,16688,6.6,16617,198,48,588,360,24.6,1668.8,38,1,1,6,6,6,1,1,0,0,16100,6.6,16257,185,52,-588,-360,23.7,1610.0
4838661979,0,10,3,0,3,5,1,0,0,0,0,13708,6.6,15914,177,44,-1846,-1532,22.1,1370.8,15,0,1,5,3,5,0,0,0,0,15554,6.8,17446,180,56,1846,1532,23.6,1555.4
4838632587,1,6,2,1,4,3,5,1,1,0,0,15115,7.0,17388,167,48,277,-685,21.5,1511.5,13,1,0,3,4,3,0,0,0,0,14838,6.8,18073,161,64,-277,685,22.5,1483.8
4832083922,0,111,1,1,5,3,5,1,1,0,0,14655,6.6,16580,175,48,-172,-283,22.3,1465.5,10,0,0,3,5,1,0,0,0,0,14827,6.6,16863,197,52,172,283,24.9,1482.7
4832058272,1,63,1,1,10,8,8,0,0,0,0,17060,7.2,17960,187,31,1203,947,21.8,1706.0,15,0,0,8,10,3,1,1,0,0,15857,6.8,17013,159,58,-1203,-947,21.7,1585.7
4832027465,1,24,0,1,7,7,5,1,0,1,0,17666,7.0,18363,196,60,1453,2549,25.6,1766.6,14,2,0,7,7,7,1,1,0,0,16213,6.6,15814,171,44,-1453,-2549,21.5,1621.3
4857284537,0,10,1,0,2,5,2,0,0,0,0,14785,7.0,18004,206,52,-1721,-1084,25.8,1478.5,12,1,1,5,2,1,2,1,1,0,16506,7.4,19088,223,60,1721,1084,28.3,1650.6
4857240089,1,15,0,0,4,2,1,1,1,0,0,15019,7.2,19404,187,60,325,1145,24.7,1501.9,7,2,1,2,4,2,0,0,0,0,14694,7.0,18259,179,52,-325,-1145,23.1,1469.4
4857202376,1,14,1,1,4,1,4,0,0,0,0,16782,7.0,18971,202,52,2393,1915,25.4,1678.2,13,1,0,1,4,1,0,0,0,0,14389,6.6,17056,192,60,-2393,-1915,25.2,1438.9
4857123360,1,13,1,1,1,0,1,0,0,0,0,15965,7.0,18771,209,72,2057,1029,28.1,1596.5,53,0,0,0,1,0,0,0,0,0,13908,7.0,17742,224,47,-2057,-1029,27.1,1390.8
4857045290,1,0,0,1,18,15,22,0,0,0,0,63104,12.8,59000,0,0,26909,26000,0.0,6310.4,0,0,0,11,14,6,0,0,0,0,36195,7.2,33000,0,0,-26909,-26000,0.0,3619.5
4857033998,1,22,5,1,15,15,18,0,0,0,0,47575,10.0,47500,5,0,17900,19000,0.5,4757.5,36,0,0,10,10,9,0,0,0,0,29675,6.0,28500,16,0,-17900,-19000,1.6,2967.5
4856999501,1,13,1,1,6,5,2,1,0,1,0,16231,7.4,19253,154,68,1226,1183,22.2,1623.1,14,3,0,5,6,2,0,0,0,0,15005,7.0,18070,181,52,-1226,-1183,23.3,1500.5
4856943402,1,12,0,0,4,6,2,1,1,0,1,13800,6.6,16263,148,48,-2435,-978,19.6,1380.0,140,1,1,6,4,1,0,0,0,0,16235,6.6,17241,158,40,2435,978,19.8,1623.5
4856040588,1,6,0,1,4,3,4,1,1,0,0,16645,7.4,19275,197,72,1774,1218,26.9,1664.5,5,0,0,3,4,4,0,0,0,0,14871,7.0,18057,187,60,-1774,-1218,24.7,1487.1
4855646738,1,13,1,0,6,6,8,1,1,0,0,15768,6.8,16384,193,43,234,63,23.6,1576.8,14,0,1,6,6,6,0,0,0,0,15534,6.4,16321,198,45,-234,-63,24.3,1553.4
4855624602,0,14,1,0,4,7,6,0,0,0,0,15773,6.8,17705,204,48,-432,-286,25.2,1577.3,10,1,1,7,4,6,0,0,0,0,16205,6.8,17991,219,55,432,286,27.4,1620.5
4853753599,1,13,0,0,12,17,18,0,0,0,0,46300,10.6,50500,0,1,24400,22000,0.1,4630.0,0,0,1,14,9,9,0,0,0,0,21900,6.0,28500,0,0,-24400,-22000,0.0,2190.0
4853736234,1,0,0,1,19,16,24,0,0,0,0,47700,10.0,47500,0,0,22300,19000,0.0,4770.0,0,0,0,7,10,3,0,0,0,0,25400,6.0,28500,0,0,-22300,-19000,0.0,2540.0
4853718382,1,0,0,0,13,19,10,0,0,0,0,45845,10.0,47500,2,0,14385,19000,0.2,4584.5,0,0,1,13,7,12,0,0,0,0,31460,6.0,28500,0,0,-14385,-19000,0.0,3146.0
4853697357,1,0,0,0,17,23,17,0,0,0,0,47735,10.0,47500,0,0,18020,19000,0.0,4773.5,0,0,1,13,7,13,0,0,0,0,29715,6.0,28500,1,0,-18020,-19000,0.1,2971.5
4853688770,1,0,0,0,14,17,16,0,0,0,0,61300,12.0,55000,0,0,23390,22000,0.0,6130.0,27,1,1,12,9,13,0,0,0,0,37910,7.2,33000,1,0,-23390,-22000,0.1,3791.0
4853663421,1,99,0,1,21,13,20,0,0,0,0,61799,12.0,55000,0,0,25594,22000,0.0,6179.9,0,0,0,6,14,9,0,0,0,0,36205,7.2,33000,0,0,-25594,-22000,0.0,3620.5
4852940773,0,16,4,0,0,1,0,1,1,0,0,14804,7.0,18740,231,56,198,32,28.7,1480.4,14,3,1,1,0,1,0,0,0,0,14606,7.0,18708,218,68,-198,-32,28.6,1460.6
4852884840,0,13,0,0,7,7,7,0,0,0,0,16419,6.6,16832,195,56,-493,-836,25.1,1641.9,13,1,1,7,7,5,0,0,0,0,16912,6.8,17668,202,52,493,836,25.4,1691.2
4852337788,1,103,3,1,6,2,4,0,0,0,0,16668,6.8,17637,172,44,3620,1960,21.6,1666.8,15,0,0,2,6,1,0,0,0,0,13048,6.4,15677,168,35,-3620,-1960,20.3,1304.8
4855963486,0,5,0,1,31,20,85,0,0,0,1,40571,11.8,44907,102,0,3633,4864,10.2,4057.1,0,0,0,20,31,36,0,0,0,0,36938,11.0,40043,92,0,-3633,-4864,9.2,3693.8
4855950766,1,0,0,1,33,23,82,0,0,0,0,38112,11.8,44049,113,0,914,2940,11.3,3811.2,0,0,0,23,33,49,0,0,0,0,37198,11.4,41109,84,0,-914,-2940,8.4,3719.8
4854395453,1,15,2,0,5,4,5,0,0,0,0,16216,7.0,18115,167,51,1088,1838,21.8,1621.6,12,1,1,4,5,5,1,1,0,0,15128,6.4,16277,168,48,-1088,-1838,21.6,1512.8
4854259283,1,17,2,1,6,2,2,0,0,0,0,16822,7.0,18028,201,54,3723,1911,25.5,1682.2,13,1,0,2,6,1,0,0,0,0,13099,6.6,16117,162,50,-3723,-1911,21.2,1309.9
4853300892,0,16,4,1,5,6,6,1,1,0,0,15702,6.8,17191,179,36,-1119,-851,21.5,1570.2,10,0,0,6,5,4,1,0,1,0,16821,6.8,18042,191,60,1119,851,25.1,1682.1
4853266604,1,14,1,1,5,3,4,0,0,0,0,16109,7.0,17654,177,45,1245,756,22.2,1610.9,26,0,0,3,5,3,0,0,0,0,14864,6.8,16898,182,48,-1245,-756,23.0,1486.4
4853257602,1,11,0,0,4,4,2,0,0,0,0,15342,6.8,17673,178,56,-429,-124,23.4,1534.2,11,1,1,4,4,1,0,0,0,0,15771,7.0,17797,213,44,429,124,25.7,1577.1
4853225698,1,0,0,1,23,17,65,0,0,0,0,35725,11.0,39239,116,0,1431,-308,11.6,3572.5,0,0,0,17,23,51,0,0,0,0,34294,10.8,39547,66,0,-1431,308,6.6,3429.4
4853220155,0,29,0,1,26,23,80,0,0,0,1,37123,11.0,39637,80,0,-714,-1933,8.0,3712.3,18,0,0,23,26,50,0,0,0,0,37837,11.4,41570,108,0,714,1933,10.8,3783.7
4853208444,1,0,0,1,22,19,72,0,0,0,1,36880,11.0,39768,105,0,1686,1093,10.5,3688.0,0,0,0,19,22,45,0,0,0,0,35194,10.8,38675,67,0,-1686,-1093,6.7,3519.4
4852961577,1,13,1,0,5,3,9,1,1,0,0,14942,6.8,16587,173,44,565,837,21.7,1494.2,20,1,1,3,5,5,0,0,0,0,14377,6.2,15750,190,52,-565,-837,24.2,1437.7
4852912473,1,11,3,0,8,7,6,1,1,0,0,16615,7.2,17981,192,64,-67,-1249,25.6,1661.5,16,1,1,7,8,3,0,0,0,0,16682,7.2,19230,190,56,67,1249,24.6,1668.2
4852855217,1,12,1,1,3,2,4,1,1,0,0,15655,7.0,17916,232,55,516,-870,28.7,1565.5,10,0,0,2,3,1,0,0,0,0,15139,7.2,18786,214,67,-516,870,28.1,1513.9
4852644901,0,11,2,1,2,6,1,0,0,0,0,14894,7.0,18061,228,66,-749,865,29.4,1489.4,14,4,0,6,2,6,0,0,0,0,15643,6.8,17196,188,36,749,-865,22.4,1564.3
4852225992,1,34,2,1,3,6,1,1,0,1,0,15930,6.8,18054,201,56,-667,603,25.7,1593.0,7,14,0,6,3,8,1,1,0,0,16597,7.0,17451,199,52,667,-603,25.1,1659.7
4852213259,0,14,9,1,6,1,5,0,0,0,0,16123,7.0,17681,206,40,857,-565,24.6,1612.3,33,2,0,1,6,0,1,1,0,0,15266,7.4,18246,222,64,-857,565,28.6,1526.6
4852198510,0,10,0,1,6,4,4,0,0,0,0,16139,6.6,17036,195,41,143,-208,23.6,1613.9,15,0,0,4,6,6,0,0,0,0,15996,7.0,17244,166,58,-143,208,22.4,1599.6
4852192858,1,15,1,0,2,6,1,1,1,0,0,14690,7.0,18467,191,72,-2137,-307,26.3,1469.0,16,2,1,6,2,6,0,0,0,0,16827,7.2,18774,179,44,2137,307,22.3,1682.7
4852175594,0,0,0,0,29,46,78,0,0,0,1,39869,11.6,43271,81,0,-5224,-5395,8.1,3986.9,0,0,1,46,29,133,0,0,0,0,45093,12.2,48666,115,0,5224,5395,11.5,4509.3
4852164713,0,10,0,1,24,22,51,0,0,0,0,38139,11.0,41547,104,0,2039,1466,10.4,3813.9,0,2,0,22,24,66,0,0,0,0,36100,11.0,40081,106,0,-2039,-1466,10.6,3610.0
4858195309,1,12,5,1,6,5,4,0,0,0,0,17340,7.0,17993,203,55,1677,850,25.8,1734.0,13,0,0,5,6,6,0,0,0,0,15663,6.8,17143,188,55,-1677,-850,24.3,1566.3
4857155029,1,29,0,1,14,18,14,0,0,0,0,61650,12.0,55000,0,0,24780,22000,0.0,6165.0,0,2,0,11,7,8,0,0,0,0,36870,7.2,33000,2,0,-24780,-22000,0.2,3687.0
4857130919,1,0,0,0,20,14,16,0,0,0,0,46650,10.0,47500,0,0,18800,19000,0.0,4665.0,0,0,1,7,13,10,0,0,0,0,27850,6.0,28500,0,0,-18800,-19000,0.0,2785.0
4857110868,1,0,0,0,20,10,17,0,0,0,0,49900,12.0,55000,0,0,22200,22000,0.0,4990.0,5,0,1,6,16,3,0,0,0,0,27700,7.2,33000,0,0,-22200,-22000,0.0,2770.0
4857097004,1,0,0,0,15,20,13,0,0,0,0,59550,12.0,55000,0,0,21920,22000,0.0,5955.0,0,0,1,11,6,14,0,0,0,0,37630,7.2,33000,0,0,-21920,-22000,0.0,3763.0
4855145899,1,14,1,1,8,5,5,0,0,0,0,16866,6.6,17174,166,52,1222,73,21.8,1686.6,11,2,0,5,8,4,0,0,0,0,15644,7.0,17101,159,44,-1222,-73,20.3,1564.4
4855102947,1,6,0,0,4,4,1,0,0,0,0,15141,7.0,18516,194,65,287,1288,25.9,1514.1,12,0,1,4,4,3,0,0,0,0,14854,6.6,17228,167,54,-287,-1288,22.1,1485.4
4855072806,0,9,1,0,0,2,0,0,0,0,0,13155,6.2,15549,223,16,-838,-2382,23.9,1315.5,19,1,1,2,0,0,0,0,0,0,13993,7.0,17931,180,56,838,2382,23.6,1399.3
4854958366,1,0,0,1,17,17,19,0,0,0,0,48050,10.2,48680,0,0,19500,20180,0.0,4805.0,0,0,0,11,11,6,0,0,0,0,28550,6.0,28500,0,0,-19500,-20180,0.0,2855.0
4854755879,1,66,0,0,6,6,4,0,0,0,0,15786,6.6,16812,171,48,-308,-337,21.9,1578.6,9,0,1,6,6,5,0,0,0,0,16094,6.8,17149,177,44,308,337,22.1,1609.4
4854709730,0,51,1,1,3,7,4,0,0,0,0,15410,7.0,17928,220,47,-2125,-828,26.7,1541.0,14,0,0,7,3,12,0,0,0,0,17535,6.8,18756,247,60,2125,828,30.7,1753.5
4854667505,1,11,0,0,6,4,6,0,0,0,0,16168,6.8,17422,178,48,229,-42,22.6,1616.8,11,0,1,4,6,0,0,0,0,0,15939,6.6,17464,172,56,-229,42,22.8,1593.9
4854281776,0,51,1,0,1,2,1,0,0,0,0,14378,7.2,18466,196,60,-1216,-507,25.6,1437.8,10,0,1,2,1,1,2,1,1,0,15594,7.2,18973,203,64,1216,507,26.7,1559.4
4854247301,0,13,0,0,4,10,3,0,0,0,0,15556,6.6,17050,178,52,-3035,-1663,23.0,1555.6,15,0,1,10,4,7,1,0,1,0,18591,7.0,18713,212,40,3035,1663,25.2,1859.1
4854194253,1,8,0,1,5,6,3,0,0,0,0,17128,7.2,18432,189,52,941,415,24.1,1712.8,11,0,0,6,5,3,1,1,0,0,16187,7.0,18017,226,44,-941,-415,27.0,1618.7
4853504359,0,18,0,1,4,5,8,0,0,0,0,15233,6.6,16514,153,60,-2149,-2532,21.3,1523.3,13,4,0,5,4,5,0,0,0,0,17382,7.0,19046,210,48,2149,2532,25.8,1738.2
4853471210,1,14,1,0,6,3,5,0,0,0,0,15972,7.0,16858,192,40,1256,-346,23.2,1597.2,9,0,1,3,6,2,0,0,0,0,14716,6.8,17204,187,48,-1256,346,23.5,1471.6
4853442673,1,86,1,0,5,5,5,1,1,0,0,15847,6.8,17449,186,52,423,231,23.8,1584.7,12,1,1,5,5,4,0,0,0,0,15424,6.6,17218,202,52,-423,-231,25.4,1542.4
4853079395,1,0,0,1,25,12,24,0,0,0,0,49714,10.0,47500,0,0,21164,19000,0.0,4971.4,39,0,0,6,19,10,0,0,0,0,28550,6.0,28500,0,0,-21164,-19000,0.0,2855.0
4853058550,1,0,0,1,16,16,16,0,0,0,0,31717,9.0,40000,0,0,13217,16000,0.0,3171.7,0,0,0,9,9,9,0,0,0,0,18500,5.4,24000,0,0,-13217,-16000,0.0,1850.0
4854728705,1,0,0,1,13,20,12,0,0,0,0,60890,12.8,59000,0,0,22190,26000,0.0,6089.0,0,0,0,13,6,13,0,0,0,0,38700,7.2,33000,2,0,-22190,-26000,0.2,3870.0
4854692747,1,14,3,1,7,3,8,0,0,0,0,16681,6.4,15724,143,44,909,-1574,18.7,1668.1,13,1,0,3,7,3,1,1,0,0,15772,6.6,17298,184,52,-909,1574,23.6,1577.2
4853017546,1,31,1,0,7,5,6,1,1,0,0,16596,7.0,18049,192,60,582,-174,25.2,1659.6,13,16,1,5,7,3,0,0,0,0,16014,7.0,18223,215,60,-582,174,27.5,1601.4
4852973841,1,11,6,0,9,10,11,0,0,0,0,18490,7.0,17834,157,52,896,239,20.9,1849.0,30,0,1,10,9,6,0,0,0,0,17594,6.8,17595,206,44,-896,-239,25.0,1759.4
4852941994,1,11,3,0,10,4,9,1,1,0,0,18093,7.0,18103,211,44,4155,1780,25.5,1809.3,15,1,1,4,10,2,0,0,0,0,13938,6.2,16323,167,44,-4155,-1780,21.1,1393.8
4843540891,0,14,1,1,10,9,4,0,0,0,0,17885,6.8,17978,206,34,1423,959,24.0,1788.5,12,0,0,9,10,6,0,0,0,0,16462,6.6,17019,147,60,-1423,-959,20.7,1646.2
4843509507,0,10,0,0,1,9,0,0,0,0,0,13252,6.4,15991,134,52,-4744,-2378,18.6,1325.2,12,0,1,9,1,8,0,0,0,0,17996,6.8,18369,209,48,4744,2378,25.7,1799.6
4843479908,0,20,0,1,12,10,12,0,0,0,0,19723,7.0,17902,202,40,2106,2001,24.2,1972.3,10,0,0,10,12,11,1,1,0,0,17617,6.4,15901,157,48,-2106,-2001,20.5,1761.7
4843415280,1,11,0,0,6,5,9,1,1,0,0,17140,7.0,17593,181,51,-992,-651,23.2,1714.0,10,0,1,5,6,5,0,0,0,0,18132,7.0,18244,210,60,992,651,27.0,1813.2
4843371729,0,31,1,0,2,4,5,0,0,0,0,14391,6.2,16306,168,72,-3626,-3484,24.0,1439.1,12,17,1,4,2,4,1,1,0,0,18017,7.2,19790,241,60,3626,3484,30.1,1801.7
4842455562,1,167,2,1,5,4,2,1,1,0,0,16202,6.4,16811,188,48,1340,798,23.6,1620.2,14,3,0,4,5,3,0,0,0,0,14862,6.6,16013,181,52,-1340,-798,23.3,1486.2
4842399371,1,10,0,1,9,4,10,1,1,0,0,17798,7.0,18034,194,56,978,-204,25.0,1779.8,15,2,0,4,9,4,0,0,0,0,16820,7.0,18238,202,56,-978,204,25.8,1682.0
4842360137,0,52,4,0,4,7,2,0,0,0,0,13908,6.8,17278,164,44,-3729,-2835,20.8,1390.8,10,1,1,7,4,3,2,1,1,0,17637,7.6,20113,236,72,3729,2835,30.8,1763.7
4842307687,0,12,2,0,4,8,2,0,0,0,0,14710,6.4,16361,188,36,-2293,-1119,22.4,1471.0,159,1,1,8,4,11,0,0,0,0,17003,6.6,17480,181,60,2293,1119,24.1,1700.3
4842260510,1,15,3,1,9,10,13,0,0,0,0,17612,6.4,16522,166,36,-271,-1860,20.2,1761.2,11,1,0,10,9,7,0,0,0,0,17883,7.2,18382,188,56,271,1860,24.4,1788.3
4835931884,0,12,11,0,3,3,3,1,1,0,0,14855,6.8,16844,219,44,-1480,-1228,26.3,1485.5,31,1,1,3,3,2,0,0,0,0,16335,6.8,18072,197,56,1480,1228,25.3,1633.5
4835889123,1,13,1,1,10,7,10,2,1,1,0,19723,6.6,16870,207,47,3617,622,25.4,1972.3,9,0,0,7,10,4,0,0,0,0,16106,6.6,16248,213,44,-3617,-622,25.7,1610.6
4834594629,0,11,3,1,14,12,13,1,1,0,0,19727,6.8,17302,200,48,1124,597,24.8,1972.7,22,2,0,11,13,8,0,0,0,0,18603,6.6,16705,167,45,-1124,-597,21.2,1860.3
4834573693,1,9,2,1,6,1,4,0,0,0,0,15368,6.8,18052,202,56,806,65,25.8,1536.8,15,3,0,1,6,0,0,0,0,0,14562,7.0,17987,241,64,-806,-65,30.5,1456.2
4834174137,1,11,1,1,3,8,3,0,0,0,0,15770,7.0,18107,219,64,-961,-665,28.3,1577.0,11,1,0,8,3,6,0,0,0,0,16731,7.2,18772,191,48,961,665,23.9,1673.1
4855233917,1,0,0,1,13,16,18,0,0,0,0,46348,10.0,47500,0,0,18833,19000,0.0,4634.8,91,0,0,13,10,8,0,0,0,0,27515,6.0,28500,0,0,-18833,-19000,0.0,2751.5
4855195373,1,0,0,0,12,17,17,0,0,0,0,45950,10.0,47500,0,0,18100,19000,0.0,4595.0,56,0,1,13,8,10,0,0,0,0,27850,6.0,28500,0,0,-18100,-19000,0.0,2785.0
4855171137,1,0,0,1,18,12,24,0,0,0,0,47819,10.0,47500,0,0,21119,19000,0.0,4781.9,0,0,0,6,12,4,0,0,0,0,26700,6.0,28500,0,0,-21119,-19000,0.0,2670.0
4855131635,1,5,0,0,19,16,20,0,0,0,0,47700,10.0,47500,0,0,18800,19000,0.0,4770.0,0,0,1,9,12,12,0,0,0,0,28900,6.0,28500,0,0,-18800,-19000,0.0,2890.0
4855112821,1,45,3,0,16,14,17,0,0,0,0,63780,12.0,55000,3,0,26930,22000,0.3,6378.0,0,0,1,8,10,6,0,0,0,0,36850,7.2,33000,0,0,-26930,-22000,0.0,3685.0
4855071847,0,21,0,1,22,32,40,0,0,0,2,37465,11.4,42220,92,0,-4511,-2510,9.2,3746.5,0,0,0,32,22,98,0,0,0,0,41976,11.6,44730,115,0,4511,2510,11.5,4197.6
4855044097,0,4,0,1,13,16,41,0,0,0,1,34814,11.0,39777,101,0,-1862,723,10.1,3481.4,0,0,0,16,13,44,0,0,0,0,36676,11.0,39054,116,0,1862,-723,11.6,3667.6
4855015793,1,0,0,1,26,22,74,0,0,0,3,38743,11.2,40273,109,0,106,1383,10.9,3874.3,27,0,0,22,26,60,0,0,0,0,38637,10.8,38890,107,0,-106,-1383,10.7,3863.7
4854954779,1,17,2,1,28,28,82,0,0,0,0,38810,10.8,40132,107,0,-1040,-1920,10.7,3881.0,16,4,0,28,28,70,0,0,0,0,39850,11.2,42052,118,0,1040,1920,11.8,3985.0
4854932873,1,0,6,1,18,26,39,0,0,0,1,37713,11.0,39756,108,0,-206,-727,10.8,3771.3,18,0,0,26,18,69,0,0,0,0,37919,11.0,40483,125,0,206,727,12.5,3791.9
4854911145,1,0,0,0,33,24,88,0,0,0,1,41109,12.0,45891,121,0,5397,6596,12.1,4110.9,1,0,1,24,33,49,0,0,0,0,35712,10.8,39295,72,0,-5397,-6596,7.2,3571.2
4841094268,0,20,1,0,4,8,3,0,0,0,0,16184,7.0,18434,239,60,-183,735,29.9,1618.4,16,0,1,8,4,10,1,1,0,0,16367,7.0,17699,169,60,183,-735,22.9,1636.7
4828698783,1,13,1,1,3,1,2,1,1,0,0,14838,6.6,16781,216,48,1951,851,26.4,1483.8,17,0,0,1,3,1,0,0,0,0,12887,6.4,15930,156,44,-1951,-851,20.0,1288.7
4827712051,1,9,7,1,7,5,5,0,0,0,0,20146,7.4,19734,248,72,4658,3042,32.0,2014.6,33,1,0,5,7,4,1,1,0,0,15488,6.8,16692,217,50,-4658,-3042,26.7,1548.8
4827530988,1,68,5,1,8,6,10,1,1,0,0,17793,7.0,18408,211,68,1830,307,27.9,1779.3,28,2,0,6,8,6,0,0,0,0,15963,7.0,18101,207,60,-1830,-307,26.7,1596.3
4827487425,0,100,0,0,4,8,1,0,0,0,0,14687,6.6,16710,208,48,-1439,-459,25.6,1468.7,13,0,1,8,4,9,1,1,0,0,16126,6.8,17169,170,52,1439,459,22.2,1612.6
4827351542,0,15,2,0,10,7,9,0,0,0,0,19514,6.8,17541,227,40,2465,2622,26.7,1951.4,20,0,1,7,10,9,0,0,0,0,17049,6.2,14919,152,48,-2465,-2622,20.0,1704.9
4821790170,1,14,2,0,4,8,3,0,0,0,0,16573,6.8,17609,190,52,916,93,24.2,1657.3,13,2,1,8,4,2,0,0,0,0,15657,7.0,17516,163,48,-916,-93,21.1,1565.7
4820356092,1,15,1,0,3,6,1,0,0,0,0,14781,6.6,17335,203,56,-1024,1592,25.9,1478.1,14,2,1,6,3,12,0,0,0,0,15805,6.6,15743,172,48,1024,-1592,22.0,1580.5
4820038023,1,12,1,0,13,30,27,0,0,0,0,38240,11.2,40368,95,72,-458,-3024,16.7,3824.0,6,0,1,30,13,71,0,0,0,0,38698,11.8,43392,81,43,458,3024,12.4,3869.8
4847735143,0,15,0,1,6,6,5,1,1,0,0,15738,6.6,16398,195,48,-989,-1520,24.3,1573.8,15,1,0,6,6,6,0,0,0,0,16727,6.8,17918,228,52,989,1520,28.0,1672.7
4846822190,1,24,0,1,39,29,82,0,0,0,1,43592,12.4,49090,114,0,4451,5728,11.4,4359.2,2,16,0,29,39,85,0,0,0,0,39141,11.6,43362,89,0,-4451,-5728,8.9,3914.1
4846796858,0,10,0,1,12,5,13,1,1,0,0,17452,6.6,17314,148,48,2437,1028,19.6,1745.2,13,1,0,5,12,4,0,0,0,0,15015,6.6,16286,165,43,-2437,-1028,20.8,1501.5
4846764637,0,16,3,1,1,5,0,0,0,0,0,13744,7.0,17250,199,64,-1796,-2361,26.3,1374.4,11,4,0,5,1,2,1,1,0,0,15540,7.2,19611,189,49,1796,2361,23.8,1554.0
4837268907,0,8,0,0,7,6,6,0,0,0,0,14815,6.2,15744,140,20,-1585,-1315,16.0,1481.5,7,0,1,6,7,5,1,1,0,0,16400,6.6,17059,160,64,1585,1315,22.4,1640.0
4836996690,1,11,2,0,12,6,24,0,0,0,1,30624,10.4,36684,68,55,-461,1154,12.3,3062.4,17,0,1,6,12,11,0,0,0,0,31085,10.6,35530,66,55,461,-1154,12.1,3108.5
4832883733,1,36,1,0,10,6,6,0,0,0,0,17182,6.6,17534,170,48,2812,2080,21.8,1718.2,14,8,1,6,10,2,0,0,0,0,14370,6.4,15454,147,48,-2812,-2080,19.5,1437.0
4828537382,1,86,2,1,4,2,4,1,0,1,0,15742,6.8,17988,209,47,1064,-151,25.6,1574.2,10,1,0,2,4,1,1,1,0,0,14678,6.8,18139,227,52,-1064,151,27.9,1467.8
4820676836,1,14,0,1,26,14,53,0,0,0,0,38339,12.0,46516,86,66,6708,4549,15.2,3833.9,6,0,0,14,26,25,0,0,0,0,31631,11.4,41967,77,60,-6708,-4549,13.7,3163.1
4801534351,1,86,0,1,3,6,2,0,0,0,0,15008,6.6,16531,176,56,-1161,-2546,23.2,1500.8,11,0,0,6,3,3,0,0,0,0,16169,7.2,19077,190,44,1161,2546,23.4,1616.9
4801519072,0,11,0,1,6,7,5,0,0,0,0,15862,6.2,16066,182,55,-431,-896,23.7,1586.2,13,1,0,7,6,3,0,0,0,0,16293,6.8,16962,167,48,431,896,21.5,1629.3
4796824061,0,12,0,0,8,10,4,0,0,0,0,16845,6.6,17681,216,56,-480,164,27.2,1684.5,12,1,1,10,8,9,0,0,0,0,17325,6.8,17517,157,58,480,-164,21.5,1732.5
4796025618,0,1,0,1,9,14,19,0,0,0,0,31166,9.6,32665,87,0,-3384,-3693,8.7,3116.6,0,0,0,14,9,27,0,0,0,0,34550,10.2,36358,115,0,3384,3693,11.5,3455.0
4795987571,1,66,0,0,7,5,9,0,0,0,0,16719,6.2,16101,162,45,-1135,-672,20.7,1671.9,18,0,1,5,7,6,0,0,0,0,17854,6.8,16773,198,40,1135,672,23.8,1785.4
4795951290,1,12,0,0,7,3,3,0,0,0,0,15156,6.4,15678,179,52,700,-808,23.1,1515.6,14,0,1,3,7,1,0,0,0,0,14456,6.6,16486,176,48,-700,808,22.4,1445.6
4792905848,0,11,1,1,3,3,3,0,0,0,0,15050,6.8,17131,226,48,554,-76,27.4,1505.0,7,1,0,3,3,4,1,1,0,0,14496,7.0,17207,215,40,-554,76,25.5,1449.6
4792875674,0,14,1,0,3,4,3,0,0,0,0,14902,6.8,17273,179,52,305,-790,23.1,1490.2,13,1,1,4,3,3,0,0,0,0,14597,6.8,18063,174,48,-305,790,22.2,1459.7
4792749959,1,0,0,0,21,13,64,0,0,0,0,34282,10.8,37234,89,0,1182,2966,8.9,3428.2,219,0,1,13,21,27,0,0,0,0,33100,10.2,34268,93,0,-1182,-2966,9.3,3310.0
4792736098,1,14,0,1,6,4,5,0,0,0,0,16276,6.8,17957,224,56,2473,1383,28.0,1627.6,7,0,0,4,6,4,0,0,0,0,13803,6.8,16574,160,52,-2473,-1383,21.2,1380.3
4814736756,1,18,2,0,7,3,8,0,0,0,0,16620,6.8,17248,183,44,1353,-888,22.7,1662.0,10,0,1,3,7,0,1,1,0,0,15267,6.8,18136,222,60,-1353,888,28.2,1526.7
4753690520,1,13,1,1,7,2,7,1,1,0,0,18466,7.0,17808,187,76,3212,663,26.3,1846.6,14,1,0,2,7,2,0,0,0,0,15254,6.6,17145,170,59,-3212,-663,22.9,1525.4
4736839428,0,33,1,0,0,5,0,2,1,1,0,14670,6.6,17436,234,56,-2460,-602,29.0,1467.0,14,0,1,5,0,7,0,0,0,0,17130,7.2,18038,208,59,2460,602,26.7,1713.0
4733059680,1,13,1,0,7,5,7,0,0,0,0,18423,6.8,18489,212,56,2612,2636,26.8,1842.3,11,1,1,5,7,4,0,0,0,0,15811,6.2,15853,170,52,-2612,-2636,22.2,1581.1
4726862512,0,12,3,0,4,4,3,0,0,0,0,15383,6.6,17290,186,47,-2006,-795,23.3,1538.3,14,1,1,4,4,4,1,1,0,0,17389,6.8,18085,241,61,2006,795,30.2,1738.9
4724620264,0,8,2,0,3,12,2,0,0,0,0,14943,6.8,17600,190,52,-5835,-1391,24.2,1494.3,11,1,1,12,3,10,1,1,0,0,20778,7.2,18991,203,56,5835,1391,25.9,2077.8
4722572810,0,14,1,1,5,8,3,0,0,0,0,16241,6.6,17600,191,56,-1942,-1589,24.7,1624.1,16,2,0,8,5,8,1,1,0,0,18183,7.2,19189,226,59,1942,1589,28.5,1818.3
4722539525,1,13,2,1,7,6,7,1,1,0,0,17479,6.6,16346,215,48,-680,-1567,26.3,1747.9,12,3,0,6,7,7,0,0,0,0,18159,7.0,17913,234,64,680,1567,29.8,1815.9
4697749614,1,30,2,1,8,6,12,1,1,0,0,19852,7.0,18400,240,49,1801,-1470,28.9,1985.2,136,1,0,6,8,5,0,0,0,0,18051,7.6,19870,214,60,-1801,1470,27.4,1805.1
4697711269,1,17,3,1,7,2,5,0,0,0,0,16536,7.0,18747,197,59,2853,2685,25.6,1653.6,13,0,0,1,6,1,0,0,0,0,13683,6.4,16062,196,44,-2853,-2685,24.0,1368.3
4697527151,1,10,0,1,8,2,3,0,0,0,0,16857,7.0,17810,185,48,2757,203,23.3,1685.7,12,0,0,2,8,1,0,0,0,0,14100,7.0,17607,146,68,-2757,-203,21.4,1410.0
4695723931,1,11,1,1,6,3,5,0,0,0,0,16830,7.0,18323,233,56,2706,2471,28.9,1683.0,62,1,0,3,6,3,0,0,0,0,14124,6.4,15852,182,41,-2706,-2471,22.3,1412.4
4694915380,1,13,2,1,9,4,5,1,1,0,0,18406,7.0,18796,221,56,3210,2595,27.7,1840.6,9,0,0,4,9,4,0,0,0,0,15196,6.4,16201,189,44,-3210,-2595,23.3,1519.6
4694708528,1,31,2,0,9,10,6,0,0,0,0,18857,6.8,18170,182,44,368,348,22.6,1885.7,22,3,1,10,9,9,0,0,0,0,18489,6.8,17822,189,52,-368,-348,24.1,1848.9
4693863473,1,24,1,1,14,8,10,1,1,0,0,20402,7.0,18662,219,52,2634,1825,27.1,2040.2,17,0,0,8,14,5,0,0,0,0,17768,6.8,16837,182,60,-2634,-1825,24.2,1776.8
4693831190,0,10,19,1,5,7,6,1,0,1,0,17205,7.0,17419,163,60,566,-340,22.3,1720.5,31,1,0,7,5,8,0,0,0,0,16639,6.8,17759,223,44,-566,340,26.7,1663.9
4690522157,0,13,7,0,4,6,2,1,1,0,0,14399,6.8,16989,167,42,-2389,-1077,20.9,1439.9,33,1,1,6,4,3,0,0,0,0,16788,6.8,18066,218,63,2389,1077,28.1,1678.8
4689507449,0,16,1,1,5,9,5,0,0,0,0,15871,7.0,17555,186,48,-2757,-1172,23.4,1587.1,12,2,0,9,5,7,0,0,0,0,18628,7.0,18727,224,56,2757,1172,28.0,1862.8
4688830596,0,12,2,0,7,7,8,0,0,0,0,16165,6.2,15670,142,56,-885,-1337,19.8,1616.5,10,4,1,7,7,4,0,0,0,0,17050,6.4,17007,189,56,885,1337,24.5,1705.0
4688797316,0,14,2,1,5,4,3,0,0,0,0,16533,7.0,18418,205,67,348,-754,27.2,1653.3,15,1,0,4,5,1,1,1,0,0,16185,7.2,19172,171,72,-348,754,24.3,1618.5
4858064581,0,14,0,0,6,5,6,0,0,0,0,17377,7.2,19792,212,64,1146,2022,27.6,1737.7,5,0,1,5,6,7,2,1,1,0,16231,7.0,17770,215,48,-1146,-2022,26.3,1623.1
4858044747,1,10,0,1,7,3,4,0,0,0,0,16581,7.2,19136,205,56,698,1056,26.1,1658.1,40,0,0,3,7,4,0,0,0,0,15883,7.0,18080,212,68,-698,-1056,28.0,1588.3
4856429813,0,20,1,0,5,5,5,1,0,1,0,15931,7.0,17981,181,52,-61,717,23.3,1593.1,15,2,1,5,5,6,0,0,0,0,15992,6.8,17264,157,64,61,-717,22.1,1599.2
4856385894,0,13,0,0,10,9,4,0,0,0,0,18255,6.8,17800,186,39,1526,1804,22.5,1825.5,13,2,1,9,10,7,0,0,0,0,16729,6.4,15996,173,40,-1526,-1804,21.3,1672.9
4856350474,1,14,2,1,8,1,4,1,1,0,0,16795,7.0,18528,194,60,3217,1424,25.4,1679.5,14,1,0,1,8,1,0,0,0,0,13578,6.8,17104,199,52,-3217,-1424,25.1,1357.8
4855524343,0,29,0,0,28,29,60,0,0,0,1,37287,11.2,41000,114,0,-1679,-899,11.4,3728.7,0,0,1,29,28,69,0,0,0,0,38966,11.2,41899,114,0,1679,899,11.4,3896.6
4855516054,0,35,0,0,34,28,78,0,0,0,2,42347,12.0,46042,128,0,3494,2135,12.8,4234.7,72,0,1,28,34,73,0,0,0,0,38853,11.6,43907,92,0,-3494,-2135,9.2,3885.3
4855499590,0,1,2,0,19,34,52,0,0,0,1,36430,11.2,41255,113,0,-4248,-3080,11.3,3643.0,52,0,1,34,19,90,0,0,0,0,40678,11.4,44335,111,0,4248,3080,11.1,4067.8
4855469578,1,13,2,1,4,5,5,0,0,0,0,17249,7.2,18343,242,52,1137,299,29.4,1724.9,17,2,0,5,4,5,0,0,0,0,16112,7.0,18044,194,68,-1137,-299,26.2,1611.2
4855457101,0,18,2,0,3,6,2,1,0,1,0,14718,6.6,16179,177,50,-2735,-1486,22.7,1471.8,13,0,1,6,3,5,1,1,0,0,17453,6.8,17665,184,42,2735,1486,22.6,1745.3
4855434906,1,16,0,1,4,4,4,1,1,0,0,17624,7.2,18658,235,59,2716,2055,29.4,1762.4,11,0,0,4,4,4,0,0,0,0,14908,6.8,16603,172,44,-2716,-2055,21.6,1490.8
4855405805,1,9,1,0,4,9,3,0,0,0,0,16168,6.6,16860,190,52,-1732,-1530,24.2,1616.8,14,1,1,9,4,3,1,1,0,0,17900,7.0,18390,198,60,1732,1530,25.8,1790.0
4855381260,0,0,0,1,25,29,66,0,0,0,2,37010,11.4,41020,88,0,-2844,-2829,8.8,3701.0,0,0,0,29,25,83,0,0,0,0,39854,11.6,43849,113,0,2844,2829,11.3,3985.4
4855363945,0,0,3,0,15,35,29,0,0,0,1,36540,10.6,38306,113,0,-3048,-5261,11.3,3654.0,22,0,1,35,15,106,0,0,0,0,39588,11.8,43567,106,0,3048,5261,10.6,3958.8
4855333160,0,14,0,1,21,32,49,0,0,0,1,37526,11.2,41758,85,0,-1775,-2773,8.5,3752.6,9,2,0,32,21,84,0,0,0,0,39301,11.6,44531,116,0,1775,2773,11.6,3930.1
4855122159,0,13,0,0,27,32,68,0,0,0,1,40100,11.4,43469,103,0,204,742,10.3,4010.0,0,0,1,32,27,73,0,0,0,0,39896,11.4,42727,101,0,-204,-742,10.1,3989.6
4855093621,0,29,0,0,25,30,54,0,0,0,2,37185,11.2,40478,81,0,-4511,-3360,8.1,3718.5,0,5,1,30,25,79,0,0,0,0,41696,11.6,43838,122,0,4511,3360,12.2,4169.6
4855065186,0,19,4,0,4,10,7,0,0,0,0,15287,6.8,17326,164,52,-3020,-1289,21.6,1528.7,13,4,1,10,4,8,1,1,0,0,18307,7.0,18615,204,40,3020,1289,24.4,1830.7
4855026786,0,11,2,0,6,9,5,0,0,0,0,16286,7.0,17018,147,48,-2867,-728,19.5,1628.6,13,1,1,9,6,6,1,1,0,0,19153,6.8,17746,197,59,2867,728,25.6,1915.3
4854997816,1,11,1,1,9,1,4,0,0,0,0,19274,7.4,19872,209,60,5196,3255,26.9,1927.4,41,2,0,1,9,0,0,0,0,0,14078,6.8,16617,188,60,-5196,-3255,24.8,1407.8
4729726039,1,13,0,0,21,21,49,0,0,0,1,35185,11.0,38663,86,0,-690,-264,8.6,3518.5,0,0,1,21,21,60,0,0,0,0,35875,10.8,38927,98,0,690,264,9.8,3587.5
4729698709,0,11,0,1,16,19,38,0,0,0,0,34778,10.6,38414,111,0,-785,159,11.1,3477.8,166,1,0,19,16,41,0,0,0,0,35563,10.8,38255,108,0,785,-159,10.8,3556.3
4729691351,0,2,0,1,26,27,69,0,0,0,1,36409,11.2,39804,96,0,-2185,-3331,9.6,3640.9,1,0,0,27,26,64,0,0,0,0,38594,11.6,43135,107,0,2185,3331,10.7,3859.4
4728620343,1,16,1,1,4,3,4,0,0,0,0,16344,7.2,18980,207,75,2090,426,28.2,1634.4,12,1,0,3,4,1,1,1,0,0,14254,7.2,18554,154,60,-2090,-426,21.4,1425.4
4728603124,0,19,1,1,7,4,10,1,1,0,0,17231,7.0,18592,203,67,2688,1830,27.0,1723.1,16,1,0,4,7,4,0,0,0,0,14543,6.6,16762,188,56,-2688,-1830,24.4,1454.3
4728570697,1,17,13,1,14,6,7,0,0,0,0,19772,7.4,19868,200,51,3681,1469,25.1,1977.2,90,0,0,5,13,4,0,0,0,0,16091,7.0,18399,169,48,-3681,-1469,21.7,1609.1
4728553387,1,15,2,0,3,5,0,1,1,0,0,15024,7.0,18823,191,60,-1115,1562,25.1,1502.4,18,2,1,5,3,5,1,0,1,0,16139,6.8,17261,208,51,1115,-1562,25.9,1613.9
4728544210,1,17,1,1,7,6,7,0,0,0,0,17746,7.2,19089,184,64,3320,2898,24.8,1774.6,11,2,0,6,7,2,0,0,0,0,14426,6.2,16191,155,44,-3320,-2898,19.9,1442.6
4727367147,1,11,0,0,9,10,12,0,0,0,0,16441,7.0,17256,180,56,-1721,-2040,23.6,1644.1,13,0,1,10,9,12,0,0,0,0,18162,7.2,19296,212,38,1721,2040,25.0,1816.2
4726784122,0,10,0,0,4,7,3,0,0,0,0,14426,6.6,16302,190,46,-1397,-551,23.6,1442.6,11,1,1,7,4,9,1,1,0,0,15823,6.8,16853,156,59,1397,551,21.5,1582.3
4726731606,0,8,2,1,5,4,2,0,0,0,0,15082,7.0,18697,176,68,-1350,843,24.4,1508.2,13,1,0,4,5,4,0,0,0,0,16432,7.0,17854,220,52,1350,-843,27.2,1643.2
4726676831,0,12,0,1,2,7,3,0,0,0,0,13679,6.6,16432,171,47,-4746,-2256,21.8,1367.9,14,1,0,7,2,8,1,1,0,0,18425,7.0,18688,236,49,4746,2256,28.5,1842.5
4726631492,1,148,0,1,3,6,5,1,1,0,0,15351,6.8,16444,190,53,-731,-1689,24.3,1535.1,13,0,0,6,3,4,0,0,0,0,16082,6.8,18133,202,68,731,1689,27.0,1608.2
4726611050,1,13,3,1,6,5,5,1,1,0,0,17636,7.2,18675,221,60,2098,1665,28.1,1763.6,13,1,0,5,6,2,0,0,0,0,15538,6.6,17010,210,48,-2098,-1665,25.8,1553.8
4726437841,1,17,12,1,6,3,6,1,1,0,0,16873,7.0,18545,214,68,928,-330,28.2,1687.3,37,6,0,3,6,2,0,0,0,0,15945,7.4,18875,231,58,-928,330,28.9,1594.5
4726409883,0,11,0,1,4,6,5,0,0,0,0,14745,6.6,15682,167,60,-2682,-3201,22.7,1474.5,13,1,0,6,4,4,0,0,0,0,17427,7.0,18883,203,60,2682,3201,26.3,1742.7
4726375509,0,16,3,0,3,4,5,1,1,0,0,14566,7.0,17865,142,72,95,-569,21.4,1456.6,12,1,1,4,3,2,0,0,0,0,14471,6.8,18434,177,56,-95,569,23.3,1447.1
4726357566,1,44,2,1,6,2,10,0,0,0,0,17550,7.0,18813,231,68,3764,2511,29.9,1755.0,14,1,0,2,6,2,0,0,0,0,13786,6.6,16302,151,51,-3764,-2511,20.2,1378.6
4726348402,1,218,1,1,9,2,8,0,0,0,0,18067,6.8,17634,187,52,4794,2253,23.9,1806.7,14,1,0,2,9,2,0,0,0,0,13273,6.4,15381,183,44,-4794,-2253,22.7,1327.3
4725531824,1,6,1,0,3,7,1,0,0,0,0,15125,6.4,16478,172,48,-1260,-701,22.0,1512.5,19,1,1,7,3,3,0,0,0,0,16385,6.6,17179,192,52,1260,701,24.4,1638.5
4857786859,1,3,0,1,28,17,82,0,0,0,1,39132,11.4,41360,111,0,3788,2909,11.1,3913.2,23,0,0,17,28,46,0,0,0,0,35344,10.8,38451,93,0,-3788,-2909,9.3,3534.4
4857764394,1,3,0,1,26,19,57,0,0,0,2,37926,11.0,40357,115,0,430,-846,11.5,3792.6,0,0,0,19,26,50,0,0,0,0,37496,11.4,41203,108,0,-430,846,10.8,3749.6
4857748651,0,0,0,0,19,25,37,0,0,0,1,35760,11.0,39074,113,0,-2252,-921,11.3,3576.0,0,0,1,25,19,72,0,0,0,0,38012,11.0,39995,107,0,2252,921,10.7,3801.2
4856874253,0,3,0,0,20,27,49,0,0,0,0,36172,11.2,41060,108,0,-1227,-434,10.8,3617.2,0,0,1,27,20,74,0,0,0,0,37399,11.6,41494,84,0,1227,434,8.4,3739.9
4856855208,1,4,0,1,15,24,14,0,0,0,0,59909,12.8,59000,0,0,22009,26000,0.0,5990.9,5,0,0,13,4,17,0,0,0,0,37900,7.2,33000,0,0,-22009,-26000,0.0,3790.0
4856843350,1,1,0,0,19,24,23,0,0,0,0,62700,12.8,61000,0,0,24100,25000,0.0,6270.0,39,0,1,15,10,13,0,0,0,0,38600,7.6,36000,0,0,-24100,-25000,0.0,3860.0
4856798175,0,11,2,1,9,6,11,0,0,0,0,17920,7.0,18026,209,48,1985,1822,25.7,1792.0,12,1,0,6,9,4,1,1,0,0,15935,6.6,16204,158,56,-1985,-1822,21.4,1593.5
4856761828,0,0,0,1,30,23,67,0,0,0,0,38154,11.6,43599,101,0,-237,393,10.1,3815.4,0,0,0,23,30,63,0,0,0,0,38391,11.4,43206,96,0,237,-393,9.6,3839.1
4856744546,0,0,0,0,33,30,89,0,0,0,1,41218,11.6,45598,100,0,3109,3234,10.0,4121.8,0,0,1,30,33,71,0,0,0,0,38109,11.2,42364,76,0,-3109,-3234,7.6,3810.9
4856723692,1,0,0,0,23,20,50,0,0,0,1,37726,11.2,40916,121,0,2007,2910,12.1,3772.6,1,0,1,20,23,48,0,0,0,0,35719,10.6,38006,105,0,-2007,-2910,10.5,3571.9
4855900043,0,12,0,1,13,17,29,0,0,0,0,32389,10.0,34624,83,0,-2945,-4510,8.3,3238.9,6,2,0,17,13,49,0,0,0,0,35334,10.8,39134,116,0,2945,4510,11.6,3533.4
4855860220,1,8,0,0,28,29,79,0,0,0,0,39318,11.6,43795,93,0,-174,-1088,9.3,3931.8,0,3,1,29,28,74,0,0,0,0,39492,12.0,44883,118,0,174,1088,11.8,3949.2
4855641782,1,0,0,1,22,16,21,0,0,0,0,62000,12.0,55000,0,0,25500,22000,0.0,6200.0,0,0,0,6,12,9,0,0,0,0,36500,7.2,33000,0,0,-25500,-22000,0.0,3650.0
4855619112,1,15,0,1,21,16,48,0,0,0,0,35980,11.0,38816,110,0,1379,2048,11.0,3598.0,14,1,0,16,21,25,0,0,0,0,34601,10.6,36768,110,0,-1379,-2048,11.0,3460.1
4855610424,1,68,8,1,20,20,17,0,0,0,0,62865,12.0,55000,5,0,22850,22000,0.5,6286.5,0,3,0,13,13,16,0,0,0,0,40015,7.2,33000,0,0,-22850,-22000,0.0,4001.5
4855605523,1,27,0,1,11,21,15,0,0,0,0,46008,10.0,47500,0,0,16714,19000,0.0,4600.8,4,0,0,16,6,13,0,0,0,0,29294,6.0,28500,0,0,-16714,-19000,0.0,2929.4
4855602195,1,0,0,1,19,13,18,0,0,0,0,63134,12.0,55000,0,0,26930,22000,0.0,6313.4,10,0,0,8,14,6,0,0,0,0,36204,7.2,33000,0,0,-26930,-22000,0.0,3620.4
4855596286,1,53,0,0,18,22,15,0,0,0,0,63400,13.0,62500,0,0,24094,25000,0.0,6340.0,0,0,1,13,9,15,0,0,0,0,39306,7.8,37500,0,0,-24094,-25000,0.0,3930.6
4854769784,0,0,0,1,26,24,56,0,0,0,1,38135,11.6,42742,105,0,232,2135,10.5,3813.5,0,0,0,24,26,53,0,0,0,0,37903,11.0,40607,89,0,-232,-2135,8.9,3790.3
4854711357,0,10,1,1,4,1,2,0,0,0,0,17098,7.2,18453,216,60,3113,1344,27.6,1709.8,17,0,0,1,4,1,1,1,0,0,13985,7.0,17109,187,60,-3113,-1344,24.7,1398.5
4857567839,0,13,1,1,6,7,8,1,1,0,0,16563,6.8,17777,210,48,271,-1078,25.8,1656.3,11,1,0,7,6,2,0,0,0,0,16292,7.0,18855,179,68,-271,1078,24.7,1629.2
4857531993,1,16,1,0,6,7,6,1,1,0,0,16126,7.0,16860,179,56,-1465,-745,23.5,1612.6,13,1,1,7,6,5,0,0,0,0,17591,6.8,17605,202,63,1465,745,26.5,1759.1
4857364506,1,8,0,1,8,7,1,0,0,0,0,15226,6.4,16164,170,43,-1232,-111,21.3,1522.6,82,1,0,7,8,3,1,1,0,0,16458,6.6,16275,160,48,1232,111,20.8,1645.8
4857319595,0,19,3,1,5,1,3,0,0,0,0,16270,7.0,18749,201,44,1566,896,24.5,1627.0,15,1,0,1,5,1,0,0,0,0,14704,6.8,17853,224,48,-1566,-896,27.2,1470.4
4857267227,1,17,2,0,3,2,1,1,1,0,0,14222,6.8,17889,198,48,-680,487,24.6,1422.2,11,0,1,2,3,1,0,0,0,0,14902,6.6,17402,210,56,680,-487,26.6,1490.2
4857207715,0,11,1,0,3,5,5,1,1,0,0,14107,6.6,16170,169,52,-2407,-1481,22.1,1410.7,11,0,1,5,3,4,0,0,0,0,16514,7.0,17651,214,40,2407,1481,25.4,1651.4
4857163533,1,9,1,0,7,9,7,1,1,0,0,16962,7.0,17866,209,61,-498,826,27.0,1696.2,18,0,1,9,7,10,1,0,1,0,17460,6.6,17040,170,48,498,-826,21.8,1746.0
4853711732,0,98,1,0,6,4,6,0,0,0,0,15720,6.8,16690,167,52,-1697,-1223,21.9,1572.0,18,0,1,4,6,2,1,1,0,0,17417,6.8,17913,184,48,1697,1223,23.2,1741.7
4853655247,1,11,0,1,11,2,13,0,0,0,0,18535,6.8,18371,204,40,3657,1446,24.4,1853.5,12,1,0,2,11,1,1,1,0,0,14878,6.8,16925,182,56,-3657,-1446,23.8,1487.8
4853159204,0,16,1,0,9,7,13,0,0,0,0,17391,6.4,16569,193,42,95,-1828,23.5,1739.1,170,1,1,7,9,3,2,1,1,0,17296,6.8,18397,188,58,-95,1828,24.6,1729.6
4853126582,0,119,2,1,13,5,8,0,0,0,0,19365,7.0,17604,188,42,4328,1585,23.0,1936.5,12,1,0,5,13,7,1,1,0,0,15037,6.2,16019,163,38,-4328,-1585,20.1,1503.7
4853090552,0,31,0,1,3,4,2,0,0,0,0,15237,6.6,16883,159,50,37,-597,20.9,1523.7,11,2,0,4,3,3,0,0,0,0,15200,6.8,17480,183,52,-37,597,23.5,1520.0
4852989194,0,22,1,0,6,8,5,1,1,0,0,16769,6.4,16622,186,36,-100,-45,22.2,1676.9,10,0,1,8,6,10,0,0,0,0,16869,6.8,16667,172,64,100,45,23.6,1686.9
4852104626,1,19,2,1,8,11,8,1,1,0,0,16129,6.8,16713,174,60,-632,-503,23.4,1612.9,15,1,0,11,8,4,0,0,0,0,16761,7.0,17216,152,40,632,503,19.2,1676.1
4851928254,1,15,3,1,7,7,7,0,0,0,0,16410,7.0,17706,151,55,859,980,20.6,1641.0,14,0,0,7,7,4,0,0,0,0,15551,6.6,16726,168,44,-859,-980,21.2,1555.1
4851867299,0,128,0,0,8,7,6,0,0,0,0,17726,6.8,17441,183,48,1273,223,23.1,1772.6,26,2,1,7,8,5,1,1,0,0,16453,6.8,17218,177,60,-1273,-223,23.7,1645.3
4851810174,1,30,0,1,7,5,5,1,1,0,0,15986,7.0,18139,187,44,525,1222,23.1,1598.6,12,9,0,5,7,4,0,0,0,0,15461,6.8,16917,177,52,-525,-1222,22.9,1546.1
4851779553,1,17,0,1,7,3,2,0,0,0,0,16341,7.0,18068,207,56,1669,2193,26.3,1634.1,10,0,0,3,7,4,1,0,1,0,14672,6.4,15875,171,49,-1669,-2193,22.0,1467.2
4851162026,1,12,0,0,9,4,4,0,0,0,0,17585,7.4,19431,212,56,238,1211,26.8,1758.5,11,1,1,4,9,6,0,0,0,0,17347,6.8,18220,218,67,-238,-1211,28.5,1734.7
4856212048,0,75,0,1,3,6,3,0,0,0,0,14808,6.8,17654,202,44,-2809,-1069,24.6,1480.8,13,0,0,6,3,5,1,0,1,0,17617,6.8,18723,221,68,2809,1069,28.9,1761.7
4856175537,0,12,10,0,3,6,5,0,0,0,0,14600,6.8,17230,170,52,-2260,-1719,22.2,1460.0,32,3,1,6,3,3,1,1,0,0,16860,7.0,18949,237,54,2260,1719,29.1,1686.0
4856107545,1,11,1,0,4,6,4,0,0,0,0,15901,6.8,16608,182,68,-988,-1932,25.0,1590.1,16,1,1,6,4,2,1,1,0,0,16889,7.2,18540,196,72,988,1932,26.8,1688.9
4853499017,1,8,1,0,4,4,4,0,0,0,0,16257,7.0,18377,204,56,1577,1681,26.0,1625.7,11,0,1,4,4,1,0,0,0,0,14680,6.4,16696,207,56,-1577,-1681,26.3,1468.0
4853469903,0,9,0,0,4,5,2,1,1,0,0,14324,6.6,16626,184,48,-1277,-227,23.2,1432.4,16,1,1,5,4,8,0,0,0,0,15601,6.6,16853,193,54,1277,227,24.7,1560.1
4853407767,0,14,0,1,7,13,5,0,0,0,0,15626,6.2,15599,151,40,-3733,-2105,19.1,1562.6,10,0,0,13,7,9,0,0,0,0,19359,7.0,17704,182,32,3733,2105,21.4,1935.9
4819370573,1,18,1,0,6,6,8,0,0,0,0,15675,6.4,15902,182,51,1055,1055,23.3,1567.5,19,1,1,6,6,5,1,1,0,0,14620,6.2,14847,146,48,-1055,-1055,19.4,1462.0
4818587620,1,13,0,1,10,3,12,0,0,0,0,18894,7.2,19551,196,64,3389,764,26.0,1889.4,12,3,0,3,10,3,1,1,0,0,15505,7.2,18787,200,64,-3389,-764,26.4,1550.5
4800094665,1,12,1,0,5,7,4,0,0,0,0,16221,6.8,17654,199,48,10,1668,24.7,1622.1,90,1,1,7,5,6,1,1,0,0,16211,6.4,15986,161,52,-10,-1668,21.3,1621.1
4798857567,1,19,0,1,8,5,5,0,0,0,0,17040,7.0,17466,178,51,1192,-492,22.9,1704.0,15,2,0,5,8,2,1,1,0,0,15848,7.0,17958,211,64,-1192,492,27.5,1584.8
4789373010,1,19,2,0,10,5,9,0,0,0,0,17973,6.8,17758,189,44,2595,161,23.3,1797.3,81,1,1,5,10,2,0,0,0,0,15378,7.0,17597,171,56,-2595,-161,22.7,1537.8
4786501237,1,145,0,1,6,2,3,1,1,0,0,15687,6.6,17524,189,40,1163,2042,22.9,1568.7,17,0,0,2,6,1,0,0,0,0,14524,6.4,15482,155,52,-1163,-2042,20.7,1452.4
4783169311,1,15,1,1,9,7,7,0,0,0,0,18319,7.0,18471,233,52,32,-558,28.5,1831.9,11,1,0,7,9,6,0,0,0,0,18287,7.2,19029,232,63,-32,558,29.5,1828.7
4783155269,1,11,19,1,5,1,3,0,0,0,0,16014,7.2,19141,217,67,2372,894,28.4,1601.4,33,1,0,0,4,0,0,0,0,0,13642,7.0,18247,212,48,-2372,-894,26.0,1364.2
4783136089,1,15,1,0,10,8,9,0,0,0,0,17197,6.6,16336,161,43,-79,-389,20.4,1719.7,48,2,1,8,10,10,0,0,0,0,17276,6.6,16725,164,66,79,389,23.0,1727.6
4781270527,1,14,2,0,1,3,1,0,0,0,0,15996,6.8,17545,218,40,674,-941,25.8,1599.6,18,1,1,3,1,0,0,0,0,0,15322,7.2,18486,197,56,-674,941,25.3,1532.2
4781246315,1,42,2,1,5,3,2,0,0,0,0,15754,7.0,17446,177,64,1059,-92,24.1,1575.4,13,0,0,3,5,2,0,0,0,0,14695,7.0,17538,196,48,-1059,92,24.4,1469.5
4781199860,1,11,3,0,6,3,6,1,1,0,0,16314,6.8,17792,168,72,1234,880,24.0,1631.4,19,2,1,3,6,3,0,0,0,0,15080,6.8,16912,208,47,-1234,-880,25.5,1508.0
4781181213,0,9,2,0,5,12,2,0,0,0,0,14333,6.6,16285,175,52,-4644,-1378,22.7,1433.3,25,3,1,11,4,16,1,1,0,0,18977,6.8,17663,217,52,4644,1378,26.9,1897.7
4857423650,1,190,2,1,4,3,2,1,1,0,0,16294,7.2,18439,222,48,1490,492,27.0,1629.4,23,2,0,3,4,2,0,0,0,0,14804,7.0,17947,191,51,-1490,-492,24.2,1480.4
4857381567,1,16,2,1,6,6,6,0,0,0,0,16835,7.0,18563,192,68,1107,130,26.0,1683.5,13,5,0,6,6,6,1,1,0,0,15728,7.0,18433,191,52,-1107,-130,24.3,1572.8
4857355745,1,0,0,0,27,28,67,0,0,0,0,37704,11.4,43252,105,0,-809,396,10.5,3770.4,16,0,1,28,27,74,0,0,0,0,38513,11.4,42856,103,0,809,-396,10.3,3851.3
4857318491,0,10,0,1,22,22,48,0,0,0,0,35595,11.0,38452,100,0,237,-271,10.0,3559.5,96,3,0,22,22,62,0,0,0,0,35358,10.8,38723,113,0,-237,271,11.3,3535.8
4857299001,1,0,0,0,28,18,59,0,0,0,1,39363,11.2,42137,128,0,4392,5544,12.8,3936.3,0,0,1,17,27,50,0,0,0,0,34971,10.4,36593,93,0,-4392,-5544,9.3,3497.1
4857267506,0,0,0,0,27,33,66,0,0,0,0,37389,11.2,41115,93,0,-4245,-6878,9.3,3738.9,0,0,1,33,27,63,0,0,0,0,41634,12.0,47993,106,0,4245,6878,10.6,4163.4
4857204930,0,13,0,1,3,6,2,0,0,0,0,15944,6.6,16818,173,60,609,-841,23.3,1594.4,18,0,0,6,3,3,1,1,0,0,15335,6.6,17659,183,56,-609,841,23.9,1533.5
4857146642,0,61,2,1,7,8,5,0,0,0,0,17653,6.8,18288,201,61,868,467,26.2,1765.3,11,4,0,8,7,10,0,0,0,0,16785,7.0,17821,208,46,-868,-467,25.4,1678.5
4855989684,1,33,1,0,8,6,4,0,0,0,0,17428,7.2,19681,214,68,1518,1844,28.2,1742.8,19,13,1,6,8,7,0,0,0,0,15910,6.8,17837,200,48,-1518,-1844,24.8,1591.0
4854283480,0,14,1,1,3,3,2,0,0,0,0,15380,7.0,17708,196,63,151,-1085,25.9,1538.0,17,1,0,3,3,2,0,0,0,0,15229,7.2,18793,216,72,-151,1085,28.8,1522.9
4854254348,0,14,0,0,5,9,4,0,0,0,0,16203,6.6,17203,178,40,-2475,-1121,21.8,1620.3,102,0,1,9,5,7,0,0,0,0,18678,7.2,18324,232,52,2475,1121,28.4,1867.8
4854208387,1,222,1,0,13,6,10,0,0,0,0,18141,7.0,17878,196,35,1222,1831,23.1,1814.1,14,0,1,6,13,6,0,0,0,0,16919,6.6,16047,186,46,-1222,-1831,23.2,1691.9
4854137549,1,7,0,1,4,6,0,0,0,0,0,15218,6.8,17441,190,64,-169,636,25.4,1521.8,15,0,0,6,4,6,0,0,0,0,15387,6.6,16805,174,48,169,-636,22.2,1538.7
4854049312,0,15,0,0,2,3,2,1,0,1,0,14797,7.0,18151,207,52,353,624,25.9,1479.7,9,1,1,3,2,2,0,0,0,0,14444,6.8,17527,202,51,-353,-624,25.3,1444.4
4853953531,1,0,0,1,21,21,42,0,0,0,1,37481,11.2,40236,116,0,1682,861,11.6,3748.1,1,0,0,21,21,41,0,0,0,0,35799,11.0,39375,76,0,-1682,-861,7.6,3579.9
4853937967,1,0,0,0,38,27,90,0,0,0,1,43501,12.0,47413,109,0,5429,7475,10.9,4350.1,6,0,1,27,38,78,0,0,0,0,38072,11.2,39938,73,0,-5429,-7475,7.3,3807.2
4853913886,1,0,0,0,28,25,57,0,0,0,1,38071,11.4,41553,109,0,292,723,10.9,3807.1,0,0,1,25,28,60,0,0,0,0,37779,11.0,40830,101,0,-292,-723,10.1,3777.9
4849269396,0,8,0,1,5,2,3,0,0,0,0,15378,6.8,17754,221,47,469,1044,26.8,1537.8,19,1,0,2,5,2,0,0,0,0,14909,6.4,16710,211,56,-469,-1044,26.7,1490.9
4849254806,1,11,1,1,8,6,6,0,0,0,0,17994,6.8,17301,228,40,1609,512,26.8,1799.4,18,2,0,6,8,5,0,0,0,0,16385,6.6,16789,180,48,-1609,-512,22.8,1638.5
4849225359,1,7,2,1,7,6,6,0,0,0,0,16643,6.6,17967,189,48,619,1571,23.7,1664.3,12,0,0,5,6,3,0,0,0,0,16024,6.6,16396,172,52,-619,-1571,22.4,1602.4
4835258717,0,11,2,0,4,6,1,0,0,0,0,15387,6.8,18069,213,48,-2306,-517,26.1,1538.7,12,2,1,6,4,6,0,0,0,0,17693,7.0,18586,220,68,2306,517,28.8,1769.3
4835227427,1,12,3,0,10,6,7,0,0,0,0,18725,7.0,18974,178,52,2497,2426,23.0,1872.5,17,2,1,5,9,3,1,1,0,0,16228,6.6,16548,204,43,-2497,-2426,24.7,1622.8
4834673089,0,14,0,1,2,1,2,0,0,0,0,15969,6.8,18104,236,52,763,-777,28.8,1596.9,158,0,0,1,2,0,0,0,0,0,15206,7.4,18881,214,64,-763,777,27.8,1520.6
4834588776,0,13,1,0,2,6,1,0,0,0,0,14870,6.8,17248,233,40,-2283,-1336,27.3,1487.0,11,1,1,5,1,4,0,0,0,0,17153,7.2,18584,217,68,2283,1336,28.5,1715.3
4834558481,1,39,0,0,4,4,4,0,0,0,0,15271,6.8,17396,198,48,-1471,-348,24.6,1527.1,18,16,1,4,4,6,1,1,0,0,16742,6.8,17744,217,60,1471,348,27.7,1674.2
4834117249,0,17,2,0,4,6,4,0,0,0,0,15813,7.0,17004,196,40,-2768,-1365,23.6,1581.3,12,1,1,6,4,4,0,0,0,0,18581,7.0,18369,216,51,2768,1365,26.7,1858.1
4834074507,1,8,2,1,7,5,5,1,0,1,0,17410,7.0,17979,218,52,2372,1246,27.0,1741.0,17,1,0,5,7,2,0,0,0,0,15038,6.8,16733,192,52,-2372,-1246,24.4,1503.8
4834043766,1,39,0,1,3,4,1,0,0,0,0,14625,7.0,17743,188,52,-1456,-1179,24.0,1462.5,14,6,0,4,3,3,0,0,0,0,16081,7.0,18922,233,52,1456,1179,28.5,1608.1
4834006923,0,12,1,1,3,7,2,0,0,0,0,14423,6.6,16487,187,48,-2177,-2232,23.5,1442.3,118,0,0,7,3,3,0,0,0,0,16600,7.2,18719,218,60,2177,2232,27.8,1660.0
4833959765,0,14,0,1,7,5,4,0,0,0,0,17114,7.2,19538,205,68,687,1325,27.3,1711.4,21,2,0,5,7,4,0,0,0,0,16427,7.2,18213,213,52,-687,-1325,26.5,1642.7
4832696701,0,30,1,0,4,10,3,0,0,0,0,15473,6.8,17228,212,64,-2196,-2239,27.6,1547.3,12,2,1,10,4,4,0,0,0,0,17669,7.4,19467,222,61,2196,2239,28.3,1766.9
4832598228,0,14,2,0,5,4,4,0,0,0,0,16268,6.8,18425,206,50,-41,469,25.6,1626.8,28,1,1,4,5,6,0,0,0,0,16309,6.8,17956,236,64,41,-469,30.0,1630.9
4832381275,0,7,2,1,6,7,7,0,0,0,0,16123,6.8,17371,201,44,-1297,-755,24.5,1612.3,12,1,0,7,6,7,1,1,0,0,17420,7.0,18126,209,72,1297,755,28.1,1742.0
4832067036,0,11,2,0,7,6,11,0,0,0,0,17360,6.6,17777,212,52,-1859,-1480,26.4,1736.0,7,0,1,6,7,5,1,1,0,0,19219,7.2,19257,220,48,1859,1480,26.8,1921.9
4772286313,1,16,3,1,7,4,8,1,1,0,0,16904,7.0,17810,203,57,1128,382,26.0,1690.4,28,2,0,4,7,4,1,0,1,0,15776,6.6,17428,220,55,-1128,-382,27.5,1577.6
4770251103,0,24,1,0,8,9,10,0,0,0,0,17873,6.4,15400,198,28,-224,204,22.6,1787.3,27,2,1,9,8,15,0,0,0,0,18097,6.4,15196,149,40,224,-204,18.9,1809.7
4769419008,0,9,3,0,2,8,2,0,0,0,0,15202,6.8,17302,237,56,-2343,-887,29.3,1520.2,12,0,1,8,2,3,1,0,1,0,17545,7.0,18189,223,43,2343,887,26.6,1754.5
4769394228,0,20,1,1,3,1,3,0,0,0,0,16117,7.0,18643,228,53,859,-147,28.1,1611.7,13,0,0,1,3,1,1,1,0,0,15258,7.0,18790,211,56,-859,147,26.7,1525.8
4769368697,0,36,0,0,1,5,0,1,0,1,0,14945,7.2,18885,238,60,-2439,476,29.8,1494.5,19,20,1,5,1,11,1,1,0,0,17384,6.8,18409,221,56,2439,-476,27.7,1738.4
4769349139,0,13,1,1,8,5,8,1,1,0,0,17543,7.0,18252,184,68,1446,-151,25.2,1754.3,14,1,0,5,8,2,0,0,0,0,16097,7.0,18403,203,56,-1446,151,25.9,1609.7
4843822234,1,15,3,1,10,5,9,0,0,0,0,19497,6.8,18010,202,36,3996,1602,23.8,1949.7,12,0,0,5,10,6,1,1,0,0,15501,6.4,16408,156,60,-3996,-1602,21.6,1550.1
4842266724,1,12,1,0,5,2,3,1,0,1,0,16477,6.8,18434,173,62,2567,1619,23.5,1647.7,8,0,1,2,5,0,0,0,0,0,13910,6.6,16815,193,52,-2567,-1619,24.5,1391.0
4841891305,1,8,1,0,4,7,4,0,0,0,0,14855,6.8,17767,170,58,-2274,922,22.8,1485.5,19,1,1,7,4,7,0,0,0,0,17129,6.6,16845,207,52,2274,-922,25.9,1712.9
4841282521,0,12,6,0,3,8,0,0,0,0,0,14346,6.4,16515,193,28,-3016,-1581,22.1,1434.6,40,0,1,8,3,6,1,1,0,0,17362,6.8,18096,200,64,3016,1581,26.4,1736.2
4841223678,0,13,1,0,11,10,7,0,0,0,0,17443,6.6,17011,160,44,-1491,-295,20.4,1744.3,13,0,1,10,11,10,0,0,0,0,18934,6.6,17306,170,48,1491,295,21.8,1893.4
4840276552,1,12,0,0,3,5,4,0,0,0,0,15476,7.0,18223,218,62,-116,666,28.0,1547.6,11,1,1,5,3,3,0,0,0,0,15592,6.8,17557,188,50,116,-666,23.8,1559.2
4838830513,1,20,2,1,7,6,5,0,0,0,0,16999,6.8,17715,200,67,1395,1750,26.7,1699.9,11,2,0,6,7,8,0,0,0,0,15604,6.4,15965,197,44,-1395,-1750,24.1,1560.4
4838807739,0,30,18,1,5,7,4,0,0,0,0,16752,6.6,17028,191,52,-539,10,24.3,1675.2,31,0,0,7,5,5,1,1,0,0,17291,6.6,17018,201,44,539,-10,24.5,1729.1
4838771480,1,13,2,0,8,10,7,0,0,0,0,17209,6.4,16392,196,36,-389,-1684,23.2,1720.9,13,1,1,10,8,7,0,0,0,0,17598,7.2,18076,190,48,389,1684,23.8,1759.8
4838760332,1,109,2,1,11,1,6,0,0,0,0,16462,6.8,17556,165,56,3042,2050,22.1,1646.2,50,0,0,1,11,1,0,0,0,0,13420,6.2,15506,165,52,-3042,-2050,21.7,1342.0
4837933551,1,12,1,1,7,6,3,0,0,0,0,17922,7.0,18423,209,52,1741,573,26.1,1792.2,11,1,0,6,7,5,0,0,0,0,16181,6.8,17850,206,48,-1741,-573,25.4,1618.1
4837896641,0,9,1,0,5,5,3,0,0,0,0,15530,7.0,17793,172,52,-570,-189,22.4,1553.0,16,0,1,5,5,4,0,0,0,0,16100,7.0,17982,179,56,570,189,23.5,1610.0
4837867604,1,15,1,1,5,4,5,1,1,0,0,16839,7.2,18874,218,60,1234,1273,27.8,1683.9,15,0,0,4,5,3,0,0,0,0,15605,6.6,17601,223,56,-1234,-1273,27.9,1560.5
4836599690,0,15,1,1,5,13,3,0,0,0,0,16166,6.6,17681,192,51,-3409,-1899,24.3,1616.6,19,4,0,13,5,7,1,1,0,0,19575,7.0,19580,217,52,3409,1899,26.9,1957.5
4836577451,1,139,1,1,10,2,7,1,1,0,0,17742,6.8,19025,186,59,4099,3711,24.5,1774.2,11,0,0,2,10,1,0,0,0,0,13643,6.4,15314,177,40,-4099,-3711,21.7,1364.3
4833011444,0,75,1,1,4,2,4,0,0,0,0,16122,7.2,18511,202,64,1381,199,26.6,1612.2,12,3,0,2,4,2,0,0,0,0,14741,7.0,18312,197,60,-1381,-199,25.7,1474.1
4832983487,1,12,1,1,15,4,16,0,0,0,0,20586,6.8,18138,210,56,5274,1111,26.6,2058.6,15,0,0,4,15,6,0,0,0,0,15312,6.8,17027,194,40,-5274,-1111,23.4,1531.2
4832946604,0,11,0,1,2,9,2,1,0,1,0,14763,6.2,16509,154,47,-3240,-1525,20.1,1476.3,11,1,0,9,2,7,0,0,0,0,18003,7.0,18034,207,48,3240,1525,25.5,1800.3
4831505591,0,123,12,1,4,9,4,0,0,0,0,15676,6.8,16639,181,53,-2353,-2962,23.4,1567.6,37,0,0,9,4,7,1,1,0,0,18029,7.4,19601,206,62,2353,2962,26.8,1802.9
4821185759,1,71,2,1,9,6,5,0,0,0,0,17279,6.6,17005,192,52,472,229,24.4,1727.9,15,4,0,6,9,6,0,0,0,0,16807,6.8,16776,207,43,-472,-229,25.0,1680.7
4821138599,0,11,1,0,6,4,8,0,0,0,0,16365,6.8,17942,201,56,-60,-150,25.7,1636.5,12,2,1,4,6,3,0,0,0,0,16425,7.0,18092,208,56,60,150,26.4,1642.5
4821079212,0,113,14,0,5,10,7,0,0,0,0,15018,6.4,16203,174,40,-3752,-2600,21.4,1501.8,32,3,1,10,5,12,1,1,0,0,18770,7.0,18803,204,68,3752,2600,27.2,1877.0
4814525692,1,8,0,1,4,10,2,1,0,1,0,15256,7.0,18218,175,44,-1650,1322,21.9,1525.6,9,1,0,10,4,10,0,0,0,0,16906,6.6,16896,190,46,1650,-1322,23.6,1690.6
4814446832,0,20,2,1,8,4,10,1,1,0,0,17290,6.6,17056,191,49,1868,18,24.0,1729.0,12,2,0,4,8,3,0,0,0,0,15422,6.8,17038,207,46,-1868,-18,25.3,1542.2
4814410074,1,12,17,1,3,6,2,0,0,0,0,18111,7.0,18349,219,56,1021,211,27.5,1811.1,42,2,0,6,3,7,0,0,0,0,17090,6.8,18138,204,64,-1021,-211,26.8,1709.0
4814331901,1,38,0,1,4,4,5,1,0,1,0,15711,6.8,18335,177,52,-100,-95,22.9,1571.1,10,1,0,4,4,5,1,1,0,0,15811,7.0,18430,203,68,100,95,27.1,1581.1
4426321558,0,12,1,1,5,5,7,0,0,0,0,15153,6.8,18069,186,56,-1935,657,24.2,1515.3,12,0,0,5,5,9,0,0,0,0,17088,6.8,17412,215,64,1935,-657,27.9,1708.8
4426276654,0,13,0,0,12,15,30,0,0,0,0,33006,10.0,34681,100,0,-2482,-2599,10.0,3300.6,0,3,1,15,12,36,0,0,0,0,35488,10.6,37280,93,0,2482,2599,9.3,3548.8
4216132245,1,8,1,0,6,3,7,1,1,0,0,15997,7.2,18630,192,64,1098,1215,25.6,1599.7,15,0,1,3,6,4,0,0,0,0,14899,6.8,17415,210,48,-1098,-1215,25.8,1489.9
4213906988,0,52,2,0,3,7,2,1,1,0,0,15092,7.2,18165,186,56,-2049,70,24.2,1509.2,26,2,1,7,3,3,0,0,0,0,17141,6.8,18095,187,59,2049,-70,24.6,1714.1
4162000525,1,3,0,1,13,3,5,0,0,0,0,16710,6.8,17731,154,0,4354,3226,15.4,1671.0,253,0,0,3,13,3,0,0,0,0,12356,6.0,14505,120,0,-4354,-3226,12.0,1235.6
4161908629,1,4,0,1,10,2,5,1,1,0,0,17214,7.2,18636,117,81,4510,3673,19.8,1721.4,0,0,0,2,10,1,0,0,0,0,12704,6.2,14963,121,0,-4510,-3673,12.1,1270.4
4161940941,1,13,0,1,12,2,8,0,0,0,0,15481,6.4,15465,124,8,3663,1233,13.2,1548.1,67,1,0,2,12,1,0,0,0,0,11818,6.0,14232,124,0,-3663,-1233,12.4,1181.8
4161848965,1,9,0,1,20,1,13,0,0,0,0,21348,7.2,18655,131,0,12974,8346,13.1,2134.8,0,0,0,0,19,0,0,0,0,0,8374,5.0,10309,39,0,-12974,-8346,3.9,837.4
4858226616,1,0,0,1,17,17,15,0,0,0,0,61440,12.0,55000,1,0,23480,22000,0.1,6144.0,0,0,0,8,8,14,0,0,0,0,37960,7.2,33000,1,0,-23480,-22000,0.1,3796.0
4858207936,1,0,0,1,21,17,13,0,0,0,0,33445,9.0,40000,2,0,14215,16000,0.2,3344.5,0,0,0,9,13,14,0,0,0,0,19230,5.4,24000,2,0,-14215,-16000,0.2,1923.0
4858179612,1,38,0,1,21,18,17,0,0,0,0,63750,12.0,55000,0,0,26852,22000,0.0,6375.0,0,0,0,8,11,10,0,0,0,0,36898,7.2,33000,0,0,-26852,-22000,0.0,3689.8
4858165107,1,0,0,1,12,23,13,0,0,0,0,61004,13.0,62500,0,0,22051,25000,0.0,6100.4,94,0,0,16,5,13,0,0,0,0,38953,7.8,37500,0,0,-22051,-25000,0.0,3895.3
4858138630,1,5,0,1,15,10,16,0,0,0,0,47409,10.0,47500,0,0,20609,19000,0.0,4740.9,0,0,0,7,12,6,0,0,0,0,26800,6.0,28500,0,0,-20609,-19000,0.0,2680.0
4858127368,1,46,0,0,18,15,17,0,0,0,0,47015,10.0,47500,0,0,18815,19000,0.0,4701.5,0,0,1,11,14,12,0,0,0,0,28200,6.0,28500,0,0,-18815,-19000,0.0,2820.0
4856130509,1,0,0,0,15,22,11,0,0,0,0,44900,10.0,47500,1,0,16000,19000,0.1,4490.0,0,0,1,14,7,14,0,0,0,0,28900,6.0,28500,0,0,-16000,-19000,0.0,2890.0
4856108971,1,0,0,1,16,23,15,0,0,0,0,61025,12.0,55000,3,0,22650,22000,0.3,6102.5,17,0,0,14,7,13,0,0,0,0,38375,7.2,33000,3,0,-22650,-22000,0.3,3837.5
4856078072,1,34,0,1,25,18,19,0,0,0,0,47000,10.0,47500,0,0,20876,19000,0.0,4700.0,0,0,0,5,12,9,0,0,0,0,26124,6.0,28500,0,0,-20876,-19000,0.0,2612.4
4856049549,1,51,0,0,11,22,17,0,0,0,0,45950,10.0,47500,0,0,17370,19000,0.0,4595.0,50,0,1,18,7,10,0,0,0,0,28580,6.0,28500,0,0,-17370,-19000,0.0,2858.0
4855976428,1,1,0,0,17,22,14,0,0,0,0,46995,10.0,47500,3,0,23650,16000,0.3,4699.5,51,0,1,14,9,17,0,0,0,0,23345,6.6,31500,1,0,-23650,-16000,0.1,2334.5
4855963180,1,0,0,0,19,12,23,0,0,0,0,47350,10.8,51980,0,0,19833,22300,0.0,4735.0,16,0,1,7,14,4,0,0,0,0,27517,6.2,29680,0,0,-19833,-22300,0.0,2751.7
4855943729,1,13,0,1,22,11,18,0,0,0,0,47365,10.0,47500,0,0,21565,19000,0.0,4736.5,0,0,0,2,13,9,0,0,0,0,25800,6.0,28500,0,0,-21565,-19000,0.0,2580.0
4855928259,1,6,0,1,22,20,15,0,0,0,0,63050,12.2,56000,0,0,25500,23000,0.0,6305.0,0,0,0,8,10,13,0,0,0,0,37550,7.2,33000,0,0,-25500,-23000,0.0,3755.0
4854424237,1,8,0,1,21,17,20,0,0,0,0,63400,12.0,55000,0,0,25500,22000,0.0,6340.0,0,0,0,9,13,9,0,0,0,0,37900,7.2,33000,0,0,-25500,-22000,0.0,3790.0
4854417258,1,1,0,1,14,20,23,0,0,0,0,62400,12.0,55000,2,0,25550,22000,0.2,6240.0,49,0,0,15,9,7,0,0,0,0,36850,7.2,33000,0,0,-25550,-22000,0.0,3685.0
4854418781,1,42,0,0,18,12,23,0,0,0,0,64800,12.0,55000,0,0,27600,21000,0.0,6480.0,0,0,1,7,13,4,0,0,0,0,37200,7.4,34000,0,0,-27600,-21000,0.0,3720.0
4854410850,1,30,0,1,19,16,19,0,0,0,0,46070,10.0,47500,1,0,18125,19000,0.1,4607.0,0,0,0,9,12,11,0,0,0,0,27945,6.0,28500,1,0,-18125,-19000,0.1,2794.5
4854403953,1,3,0,1,17,18,18,0,0,0,0,63050,12.0,55000,0,0,25500,22000,0.0,6305.0,4,0,0,12,11,11,0,0,0,0,37550,7.2,33000,0,0,-25500,-22000,0.0,3755.0
4854395988,1,0,0,1,18,15,16,0,0,0,0,45950,10.0,47500,0,0,18800,19000,0.0,4595.0,0,0,0,5,8,9,0,0,0,0,27150,6.0,28500,0,0,-18800,-19000,0.0,2715.0
4857098320,1,135,1,0,7,10,10,1,1,0,0,16840,6.4,15844,167,51,-1512,-477,21.8,1684.0,14,5,1,10,7,16,0,0,0,0,18352,6.8,16321,199,44,1512,477,24.3,1835.2
4853334604,1,15,0,1,8,3,4,1,1,0,0,17921,7.0,18688,192,60,2005,1222,25.2,1792.1,8,2,0,3,8,4,0,0,0,0,15916,6.8,17466,160,44,-2005,-1222,20.4,1591.6
4851058443,1,38,0,0,7,2,7,0,0,0,0,15935,6.8,17558,195,39,1297,516,23.4,1593.5,17,0,1,2,7,1,1,1,0,0,14638,6.8,17042,177,68,-1297,-516,24.5,1463.8
4850662245,0,11,0,0,5,9,5,0,0,0,0,14851,6.4,16449,145,36,-3070,-1885,18.1,1485.1,264,0,1,9,5,9,1,1,0,0,17921,7.0,18334,204,52,3070,1885,25.6,1792.1
4849759067,1,1,0,0,29,23,82,0,0,0,1,40904,11.6,43716,109,0,3092,3805,10.9,4090.4,37,0,1,23,29,57,0,0,0,0,37812,10.8,39911,96,0,-3092,-3805,9.6,3781.2
4849076707,1,18,0,0,3,7,2,1,1,0,0,14382,6.2,15242,152,44,-1218,-1525,19.6,1438.2,11,0,1,7,3,6,1,0,1,0,15600,6.4,16767,164,59,1218,1525,22.3,1560.0
4848717258,0,12,0,0,2,7,1,0,0,0,0,15200,6.6,17039,157,56,-500,-1143,21.3,1520.0,11,2,1,7,2,3,0,0,0,0,15700,6.8,18182,177,52,500,1143,22.9,1570.0
4848681486,1,23,2,0,5,5,4,1,1,0,0,16079,7.0,17945,221,52,-33,1431,27.3,1607.9,14,1,1,5,5,3,0,0,0,0,16112,6.6,16514,207,52,33,-1431,25.9,1611.2
4846109441,0,0,0,0,25,26,47,0,0,0,1,38150,11.4,41282,93,0,534,-1787,9.3,3815.0,0,0,1,26,25,63,0,0,0,0,37616,11.6,43069,104,0,-534,1787,10.4,3761.6
4841958447,1,10,2,1,7,3,4,0,0,0,0,15522,6.6,16560,132,56,1068,1060,18.8,1552.2,11,2,0,3,7,4,0,0,0,0,14454,6.4,15500,143,44,-1068,-1060,18.7,1445.4
4841942153,1,12,1,1,8,7,8,0,0,0,0,17099,6.6,16958,186,60,415,28,24.6,1709.9,14,1,0,7,8,3,0,0,0,0,16684,6.8,16930,180,40,-415,-28,22.0,1668.4
4837120333,1,12,1,1,9,4,7,1,1,0,0,17507,6.8,17209,165,54,2307,1192,21.9,1750.7,13,1,0,4,9,5,0,0,0,0,15200,6.6,16017,171,36,-2307,-1192,20.7,1520.0
4836147677,1,12,1,1,5,4,2,0,0,0,0,15298,6.8,18455,157,49,-901,1305,20.6,1529.8,14,1,0,4,5,3,0,0,0,0,16199,6.6,17150,207,54,901,-1305,26.1,1619.9
4836130077,1,8,0,1,5,2,3,0,0,0,0,15842,7.0,18398,204,64,2175,575,26.8,1584.2,6,0,0,2,5,1,1,1,0,0,13667,6.8,17823,195,44,-2175,-575,23.9,1366.7
4835133609,0,13,2,0,2,7,2,0,0,0,0,12700,6.2,15167,145,48,-4305,-3325,19.3,1270.0,15,3,1,7,2,3,0,0,0,0,17005,7.0,18492,219,44,4305,3325,26.3,1700.5
4834737198,0,18,3,0,4,8,2,1,1,0,0,16619,7.0,18197,189,64,-136,601,25.3,1661.9,15,3,1,8,4,2,0,0,0,0,16755,6.6,17596,180,54,136,-601,23.4,1675.5
4834685336,0,132,1,0,2,7,1,0,0,0,0,14217,6.4,15908,188,46,-3069,-1546,23.4,1421.7,11,0,1,7,2,5,0,0,0,0,17286,6.8,17454,218,52,3069,1546,27.0,1728.6
4834298779,1,13,2,1,9,7,5,0,0,0,0,17920,6.8,16437,176,44,1084,575,22.0,1792.0,14,0,0,7,9,4,1,1,0,0,16836,6.2,15862,153,39,-1084,-575,19.2,1683.6
4834245286,1,13,2,0,4,6,5,0,0,0,0,16257,6.6,16583,163,52,-637,-699,21.5,1625.7,17,3,1,6,4,6,1,1,0,0,16894,6.6,17282,187,48,637,699,23.5,1689.4
4840606751,0,11,1,0,1,1,1,0,0,0,0,14943,7.0,18309,211,68,46,-1247,27.9,1494.3,56,2,1,1,1,0,1,1,0,0,14897,7.2,19556,226,76,-46,1247,30.2,1489.7
4840595948,0,12,1,0,3,6,4,0,0,0,0,15470,6.8,17342,179,52,-1036,-743,23.1,1547.0,13,1,1,6,3,3,0,0,0,0,16506,6.8,18085,235,50,1036,743,28.5,1650.6
4812526933,0,13,2,0,3,6,1,0,0,0,0,15634,6.6,17434,196,47,-2274,-694,24.3,1563.4,12,2,1,6,3,5,0,0,0,0,17908,7.0,18128,208,52,2274,694,26.0,1790.8
4809701529,0,14,1,1,8,8,11,1,1,0,0,16819,6.6,16406,188,52,-16,44,24.0,1681.9,80,0,0,8,8,8,0,0,0,0,16835,6.4,16362,154,64,16,-44,21.8,1683.5
4809657782,0,12,1,0,1,7,1,0,0,0,0,15261,6.8,17297,205,52,-3301,-1387,25.7,1526.1,14,2,1,7,1,9,1,1,0,0,18562,7.2,18684,232,63,3301,1387,29.5,1856.2
4808712658,0,11,2,0,3,7,0,0,0,0,0,16090,7.0,18253,194,60,-250,178,25.4,1609.0,10,0,1,7,3,4,0,0,0,0,16340,7.0,18075,207,40,250,-178,24.7,1634.0
4807149504,0,11,0,0,2,5,3,0,0,0,0,14145,6.8,16772,180,56,-527,131,23.6,1414.5,22,0,1,5,2,3,0,0,0,0,14672,6.6,16641,176,43,527,-131,21.9,1467.2
4806770301,1,23,3,1,3,0,4,0,0,0,0,15615,6.8,17896,201,63,1845,-285,26.4,1561.5,11,1,0,0,3,0,0,0,0,0,13770,7.0,18181,185,64,-1845,285,24.9,1377.0
4805746631,1,21,2,1,6,4,1,1,1,0,0,15475,6.6,17373,176,68,-316,-100,24.4,1547.5,9,1,0,4,6,3,0,0,0,0,15791,6.8,17473,198,64,316,100,26.2,1579.1
4787295143,1,15,1,1,1,5,1,0,0,0,0,13572,6.4,17146,174,61,-2522,-934,23.5,1357.2,10,1,0,5,1,4,0,0,0,0,16094,7.0,18080,190,53,2522,934,24.3,1609.4
4787284594,0,9,1,0,4,5,3,0,0,0,0,15349,6.8,17124,187,52,-2378,-2150,23.9,1534.9,14,0,1,5,4,4,1,0,1,0,17727,7.2,19274,199,64,2378,2150,26.3,1772.7
4787282061,1,13,0,1,7,3,3,1,1,0,0,16233,6.8,17679,168,54,1078,227,22.2,1623.3,6,1,0,3,7,3,0,0,0,0,15155,6.8,17452,166,70,-1078,-227,23.6,1515.5
4786332010,0,14,2,1,4,5,2,0,0,0,0,16630,7.0,18406,196,64,135,-1091,26.0,1663.0,11,1,0,5,4,3,1,1,0,0,16495,7.2,19497,192,71,-135,1091,26.3,1649.5
4781317291,1,12,0,1,5,5,2,0,0,0,0,15569,7.0,17662,206,40,-601,-1473,24.6,1556.9,10,1,0,5,5,2,2,1,1,0,16170,7.2,19135,209,64,601,1473,27.3,1617.0
4781295229,1,12,1,1,5,0,1,2,1,1,0,17107,7.2,19408,211,56,3629,3089,26.7,1710.7,47,0,0,0,5,0,0,0,0,0,13478,6.4,16319,186,47,-3629,-3089,23.3,1347.8
4779163886,0,161,2,1,6,4,9,0,0,0,0,15865,6.6,16617,170,60,690,14,23.0,1586.5,18,0,0,4,6,4,0,0,0,0,15175,6.4,16603,202,48,-690,-14,25.0,1517.5
4779146721,1,19,2,0,7,5,8,0,0,0,0,17769,7.2,19173,188,68,1405,2136,25.6,1776.9,13,3,1,5,7,5,1,1,0,0,16364,6.6,17037,167,40,-1405,-2136,20.7,1636.4
4779137388,1,11,1,1,8,2,4,0,0,0,0,18128,7.2,19085,206,60,3118,1737,26.6,1812.8,9,1,0,2,8,1,0,0,0,0,15010,6.6,17348,174,60,-3118,-1737,23.4,1501.0
4779129855,1,11,1,0,10,6,7,1,1,0,0,18450,7.0,18373,189,62,2385,1835,25.1,1845.0,8,0,1,6,10,6,0,0,0,0,16065,6.4,16538,164,53,-2385,-1835,21.7,1606.5
4778928850,0,14,1,0,5,4,3,0,0,0,0,15446,7.0,17620,178,60,235,1079,23.8,1544.6,82,0,1,4,5,2,0,0,0,0,15211,6.8,16541,183,44,-235,-1079,22.7,1521.1
4858204498,0,15,0,0,29,28,74,0,0,0,2,39874,11.8,43007,90,0,-636,-71,9.0,3987.4,0,0,1,28,29,67,0,0,0,0,40510,11.8,43078,118,0,636,71,11.8,4051.0
4858178495,0,0,0,1,22,14,51,0,0,0,1,35646,11.2,39552,103,0,810,1699,10.3,3564.6,6,0,0,14,22,40,0,0,0,0,34836,10.6,37853,83,0,-810,-1699,8.3,3483.6
4857511111,0,0,0,1,35,19,90,0,0,0,1,41055,12.0,44552,120,0,4378,6298,12.0,4105.5,13,0,0,19,35,56,0,0,0,0,36677,10.8,38254,106,0,-4378,-6298,10.6,3667.7
4857489264,0,34,0,0,14,20,35,0,0,0,1,34380,10.4,38299,96,0,-1991,-1609,9.6,3438.0,34,0,1,20,14,43,0,0,0,0,36371,11.0,39908,90,0,1991,1609,9.0,3637.1
4857473141,0,18,1,0,25,33,55,0,0,0,2,38666,11.6,42841,98,0,-1523,-1698,9.8,3866.6,14,3,1,33,25,76,0,0,0,0,40189,11.8,44539,114,0,1523,1698,11.4,4018.9
4857449936,1,2,0,1,33,21,84,0,0,0,1,40185,11.6,42197,101,0,2929,1430,10.1,4018.5,0,0,0,21,33,51,0,0,0,0,37256,11.2,40767,98,0,-2929,-1430,9.8,3725.6
4857424138,0,2,3,0,28,25,78,0,0,0,0,37979,11.2,41286,111,0,-491,-2607,11.1,3797.9,21,0,1,25,28,59,0,0,0,0,38470,11.6,43893,99,0,491,2607,9.9,3847.0
4857404879,0,0,0,0,14,23,28,0,0,0,2,34219,10.6,36644,100,0,-4232,-6935,10.0,3421.9,0,0,1,23,14,50,0,0,0,0,38451,11.4,43579,102,0,4232,6935,10.2,3845.1
4857376525,1,0,21,1,17,10,41,0,0,0,1,36367,10.8,37896,116,0,4432,3335,11.6,3636.7,22,0,0,9,16,23,0,0,0,0,31935,10.2,34561,79,0,-4432,-3335,7.9,3193.5
4855499470,1,37,0,1,2,2,0,0,0,0,0,15105,6.8,18507,204,60,-277,552,26.4,1510.5,32,0,0,2,2,4,0,0,0,0,15382,6.8,17955,201,44,277,-552,24.5,1538.2
4855481314,1,34,1,1,6,4,5,0,0,0,0,17092,6.8,18642,232,60,1158,-383,29.2,1709.2,27,1,0,4,6,3,0,0,0,0,15934,7.0,19025,227,52,-1158,383,27.9,1593.4
4855461911,1,48,0,0,5,3,5,0,0,0,0,16916,7.2,18751,219,60,1965,1748,27.9,1691.6,19,0,1,3,5,2,0,0,0,0,14951,6.8,17003,184,47,-1965,-1748,23.1,1495.1
4855425401,1,37,1,1,2,3,1,0,0,0,0,15165,6.8,17635,219,60,468,-72,27.9,1516.5,32,1,0,3,2,4,0,0,0,0,14697,6.8,17707,185,56,-468,72,24.1,1469.7
4855359779,1,19,0,1,8,5,6,0,0,0,0,17450,6.8,17394,191,48,-227,-1745,23.9,1745.0,116,0,0,5,8,5,0,0,0,0,17677,7.0,19139,235,76,227,1745,31.1,1767.7
4855319758,0,13,1,0,1,5,1,0,0,0,0,14790,6.8,17753,218,68,-1704,-1677,28.6,1479.0,9,1,1,5,1,4,0,0,0,0,16494,7.2,19430,230,72,1704,1677,30.2,1649.4
4855279211,1,11,0,1,8,0,6,1,1,0,0,17605,7.2,19523,189,56,3559,1011,24.5,1760.5,10,0,0,0,8,0,0,0,0,0,14046,7.2,18512,236,64,-3559,-1011,30.0,1404.6
4855230319,0,9,0,0,5,7,5,0,0,0,0,16964,7.0,18663,218,66,711,253,28.4,1696.4,14,1,1,7,5,3,0,0,0,0,16253,7.0,18410,201,40,-711,-253,24.1,1625.3
4855186239,1,15,1,0,2,2,2,0,0,0,0,16082,7.2,19117,241,76,777,1130,31.7,1608.2,9,1,1,2,2,1,0,0,0,0,15305,7.2,17987,220,52,-777,-1130,27.2,1530.5
4855149113,1,0,0,0,28,28,62,0,0,0,0,40334,11.8,44735,102,0,2232,1723,10.2,4033.4,0,0,1,28,28,66,0,0,0,0,38102,11.4,43012,109,0,-2232,-1723,10.9,3810.2
4854091386,0,19,2,0,6,13,6,0,0,0,0,14865,6.4,15706,154,52,-4332,-2136,20.6,1486.5,25,3,1,13,6,14,0,0,0,0,19197,7.0,17842,200,55,4332,2136,25.5,1919.7
4851140043,0,15,0,0,3,10,1,1,1,0,0,14519,6.8,16491,161,60,-4597,-2431,22.1,1451.9,45,4,1,10,3,9,0,0,0,0,19116,7.2,18922,214,44,4597,2431,25.8,1911.6
4851117887,1,11,1,1,8,7,3,0,0,0,0,17464,7.0,17856,202,64,-188,-107,26.6,1746.4,10,0,0,7,8,8,0,0,0,0,17652,7.0,17963,192,40,188,107,23.2,1765.2
4849076690,1,103,2,1,11,5,11,0,0,0,0,18749,7.0,18135,218,40,3275,1121,25.8,1874.9,16,4,0,5,11,7,0,0,0,0,15474,6.6,17014,207,27,-3275,-1121,23.4,1547.4
4848657339,1,13,2,1,9,4,16,1,1,0,0,17855,6.8,18074,225,43,3738,1876,26.8,1785.5,13,2,0,4,9,2,0,0,0,0,14117,6.6,16198,168,44,-3738,-1876,21.2,1411.7
4848430438,1,10,0,0,2,8,4,0,0,0,0,14875,6.6,16747,164,52,-2827,-2904,21.6,1487.5,9,0,1,8,2,4,0,0,0,0,17702,7.2,19651,219,68,2827,2904,28.7,1770.2
4848310818,1,27,2,1,3,0,3,0,0,0,0,15348,6.8,18046,224,48,2319,605,27.2,1534.8,22,2,0,0,3,0,0,0,0,0,13029,6.8,17441,222,44,-2319,-605,26.6,1302.9
4847345412,0,12,2,0,3,5,3,0,0,0,0,15944,6.4,16822,147,57,-20,-237,20.4,1594.4,12,0,1,5,3,5,1,1,0,0,15964,7.0,17059,175,58,20,237,23.3,1596.4
4847330490,1,28,0,1,2,5,2,1,0,1,0,14575,6.6,16688,188,49,-2609,-1504,23.7,1457.5,13,17,0,5,2,6,1,1,0,0,17184,7.2,18192,209,60,2609,1504,26.9,1718.4
4847313081,1,14,2,1,7,5,7,0,0,0,0,17228,6.8,18531,187,46,1129,1849,23.3,1722.8,13,0,0,5,7,2,0,0,0,0,16099,6.6,16682,193,49,-1129,-1849,24.2,1609.9
4830801963,1,12,1,1,13,14,25,0,0,0,0,34121,11.6,41358,80,67,-481,-1951,14.7,3412.1,22,0,0,14,13,18,0,0,0,0,34602,11.4,43309,94,67,481,1951,16.1,3460.2
4830777466,1,23,0,0,12,15,34,0,0,0,1,37154,11.4,41657,111,63,2297,4065,17.4,3715.4,16,0,1,15,12,42,0,0,0,0,34857,10.8,37592,81,67,-2297,-4065,14.8,3485.7
4829925675,1,10,0,0,11,15,26,0,0,0,1,31150,10.6,36838,83,55,-3518,-2677,13.8,3115.0,15,0,1,15,11,38,0,0,0,0,34668,11.0,39515,79,58,3518,2677,13.7,3466.8
4826513885,1,14,1,1,15,8,33,0,0,0,0,35596,10.8,38376,103,56,3259,526,15.9,3559.6,8,0,0,8,15,11,0,0,0,0,32337,10.8,37850,91,60,-3259,-526,15.1,3233.7
4826483387,1,18,0,0,10,12,16,0,0,0,0,30359,10.4,35638,86,51,-2193,-552,13.7,3035.9,36,0,1,12,10,26,0,0,0,0,32552,10.4,36190,73,59,2193,552,13.2,3255.2
4826458468,1,13,0,1,15,10,24,0,0,0,0,32993,10.6,37887,102,55,-1238,-1476,15.7,3299.3,18,0,0,10,15,18,0,0,0,0,34231,11.2,39363,69,71,1238,1476,14.0,3423.1
4826440819,0,7,0,1,22,12,53,0,0,0,1,36139,11.4,41042,81,68,-3458,-2969,14.9,3613.9,10,0,0,12,22,26,0,0,0,0,39597,11.6,44011,103,47,3458,2969,15.0,3959.7
4826410671,0,13,0,0,2,12,4,0,0,0,0,28071,10.8,37795,75,67,-6291,-5396,14.2,2807.1,11,0,1,12,2,34,0,0,0,0,34362,11.6,43191,107,67,6291,5396,17.4,3436.2
4824168095,1,47,2,0,22,21,57,0,0,0,0,31965,10.4,36210,77,45,-1208,-7,12.2,3196.5,43,0,1,20,21,36,0,0,0,0,33173,10.6,36217,80,49,1208,7,12.9,3317.3
4803766872,0,11,0,1,10,11,4,2,1,1,0,17563,6.6,16423,162,56,1630,1428,21.8,1756.3,167,0,0,11,10,7,0,0,0,0,15933,6.0,14995,120,32,-1630,-1428,15.2,1593.3
4803728098,0,39,0,0,3,8,2,1,0,1,0,14128,6.6,16537,187,44,-4521,-2801,23.1,1412.8,12,13,1,8,3,6,0,0,0,0,18649,7.2,19338,206,64,4521,2801,27.0,1864.9
4803691743,1,14,1,1,6,3,5,0,0,0,0,17106,7.0,18267,216,55,3300,1857,27.1,1710.6,9,0,0,3,6,0,0,0,0,0,13806,6.8,16410,188,48,-3300,-1857,23.6,1380.6
4803604690,1,12,0,0,3,5,1,0,0,0,0,13703,6.6,16639,173,56,-2064,-1682,22.9,1370.3,8,1,1,5,3,4,0,0,0,0,15767,7.0,18321,186,48,2064,1682,23.4,1576.7
4787733471,1,15,1,1,7,6,6,1,1,0,0,15417,6.8,16656,184,52,175,-1701,23.6,1541.7,13,1,0,5,6,3,0,0,0,0,15242,6.8,18357,198,56,-175,1701,25.4,1524.2
4786811161,0,11,1,1,11,4,9,0,0,0,0,19421,6.8,17563,191,52,3175,564,24.3,1942.1,11,1,0,4,11,6,0,0,0,0,16246,6.6,16999,171,52,-3175,-564,22.3,1624.6
4782087618,1,10,0,0,1,3,1,0,0,0,0,14370,6.8,17800,211,52,-607,810,26.3,1437.0,16,1,1,3,1,1,1,0,1,0,14977,6.8,16990,203,67,607,-810,27.0,1497.7
4781494109,1,15,0,1,4,3,2,0,0,0,0,15879,7.0,17603,213,64,1839,912,27.7,1587.9,9,0,0,3,4,2,1,1,0,0,14040,6.6,16691,194,52,-1839,-912,24.6,1404.0
4781161163,1,13,0,1,5,5,6,0,0,0,0,16136,6.8,17871,203,48,-1198,-93,25.1,1613.6,11,0,0,5,5,6,0,0,0,0,17334,6.8,17964,240,56,1198,93,29.6,1733.4
4780686451,1,11,2,1,4,2,4,0,0,0,0,15279,6.6,17679,216,48,-925,-1580,26.4,1527.9,18,2,0,2,4,2,0,0,0,0,16204,7.4,19259,208,80,925,1580,28.8,1620.4
4780624484,0,12,0,0,6,3,2,0,0,0,0,15833,6.8,17500,180,56,1239,115,23.6,1583.3,13,0,1,3,6,2,0,0,0,0,14594,6.6,17385,187,44,-1239,-115,23.1,1459.4
4775715828,0,13,2,1,4,0,1,0,0,0,0,15283,6.8,18305,226,48,1892,945,27.4,1528.3,11,4,0,0,4,0,0,0,0,0,13391,7.0,17360,194,48,-1892,-945,24.2,1339.1
4775154554,0,14,1,0,2,8,1,0,0,0,0,15094,6.8,17280,180,56,-2668,-843,23.6,1509.4,12,1,1,8,2,8,0,0,0,0,17762,7.0,18123,218,52,2668,843,27.0,1776.2
4775109441,0,51,3,0,3,1,1,0,0,0,0,15177,6.8,17730,203,40,-218,514,24.3,1517.7,47,0,1,1,3,1,0,0,0,0,15395,6.6,17216,210,52,218,-514,26.2,1539.5
4775083204,1,13,0,1,7,2,4,1,0,1,0,18470,6.6,17667,200,48,4752,1121,24.8,1847.0,9,0,0,2,7,3,1,1,0,0,13718,6.6,16546,168,56,-4752,-1121,22.4,1371.8
4774811733,0,15,0,1,4,5,2,0,0,0,0,14477,6.2,15492,194,17,-1820,-2969,21.1,1447.7,10,2,0,5,4,4,1,1,0,0,16297,7.0,18461,206,54,1820,2969,26.0,1629.7
4771282970,0,13,13,1,7,7,2,0,0,0,0,15748,6.6,17122,164,52,-1900,-278,21.6,1574.8,38,2,0,7,7,10,0,0,0,0,17648,6.6,17400,195,44,1900,278,23.9,1764.8
4770720425,0,12,3,0,1,8,0,0,0,0,0,13952,6.4,16181,154,42,-3129,-1693,19.6,1395.2,24,2,1,8,1,6,0,0,0,0,17081,7.2,17874,202,64,3129,1693,26.6,1708.1
4770698715,1,10,0,1,15,7,16,0,0,0,0,21641,7.4,19426,244,52,5155,2540,29.6,2164.1,12,1,0,7,15,5,0,0,0,0,16486,6.6,16886,157,44,-5155,-2540,20.1,1648.6
4770588600,0,10,1,0,1,4,0,0,0,0,0,14162,7.0,17440,202,64,-2081,-773,26.6,1416.2,13,2,1,4,1,3,0,0,0,0,16243,7.0,18213,215,48,2081,773,26.3,1624.3
4799519662,1,13,0,0,7,4,7,0,0,0,0,17988,7.2,19292,205,70,3391,3381,27.5,1798.8,6,0,1,4,7,2,0,0,0,0,14597,6.4,15911,171,40,-3391,-3381,21.1,1459.7
4799469630,1,13,1,0,4,3,3,0,0,0,0,14888,6.8,17481,186,36,-268,502,22.2,1488.8,15,1,1,3,4,2,1,1,0,0,15156,6.4,16979,189,56,268,-502,24.5,1515.6
4799291338,0,16,0,0,2,4,3,0,0,0,0,14732,6.8,16417,175,44,-1997,-334,21.9,1473.2,71,1,1,4,2,2,0,0,0,0,16729,6.6,16751,178,60,1997,334,23.8,1672.9
4799263709,1,17,1,0,7,10,4,1,1,0,0,16421,6.8,17389,172,44,-2400,-1583,21.6,1642.1,14,1,1,10,7,8,0,0,0,0,18821,6.8,18972,219,68,2400,1583,28.7,1882.1
4798541522,1,19,0,0,2,2,2,0,0,0,0,15893,6.8,17736,209,48,1765,395,25.7,1589.3,10,2,1,2,2,0,0,0,0,0,14128,7.0,17341,198,48,-1765,-395,24.6,1412.8
4798406497,1,10,3,1,9,8,11,0,0,0,0,17230,6.8,17815,192,44,256,-10,23.6,1723.0,14,2,0,8,9,7,2,1,1,0,16974,7.0,17825,200,40,-256,10,24.0,1697.4
4798091155,1,11,1,0,0,4,0,0,0,0,0,12830,6.6,15939,174,52,-1920,-2323,22.6,1283.0,11,0,1,4,0,1,1,1,0,0,14750,7.0,18262,184,48,1920,2323,23.2,1475.0
4798064735,1,14,4,1,2,3,1,0,0,0,0,14297,7.0,17991,182,52,-85,670,23.4,1429.7,14,3,0,3,2,1,1,1,0,0,14382,6.6,17321,189,59,85,-670,24.8,1438.2
4797949445,1,10,4,1,7,0,9,1,1,0,0,16570,6.4,16556,177,40,2670,-378,21.7,1657.0,16,0,0,0,7,0,0,0,0,0,13900,6.6,16934,170,43,-2670,378,21.3,1390.0
4797861815,1,10,2,0,11,4,7,0,0,0,0,18281,7.2,19061,204,60,2607,1699,26.4,1828.1,12,1,1,4,11,1,0,0,0,0,15674,6.8,17362,200,60,-2607,-1699,26.0,1567.4
4797809115,1,17,1,1,5,2,4,1,0,1,0,16315,6.8,16976,193,67,2724,934,26.0,1631.5,13,0,0,2,5,4,1,1,0,0,13591,6.4,16042,167,56,-2724,-934,22.3,1359.1
4797588713,1,20,2,1,5,5,4,0,0,0,0,16546,6.8,18810,227,40,-80,305,26.7,1654.6,10,2,0,5,5,7,0,0,0,0,16626,7.0,18505,220,68,80,-305,28.8,1662.6
4797535960,0,13,0,1,6,3,7,1,0,1,0,17049,6.8,18067,210,48,2536,606,25.8,1704.9,16,1,0,3,6,1,1,1,0,0,14513,6.8,17461,190,58,-2536,-606,24.8,1451.3
4797253677,0,6,0,0,2,5,1,0,0,0,0,12985,6.4,15535,169,25,-4744,-3604,19.4,1298.5,7,0,1,5,2,4,0,0,0,0,17729,7.2,19139,238,52,4744,3604,29.0,1772.9
4797236142,0,25,2,1,5,3,6,1,1,0,0,16306,6.6,16901,195,46,526,-850,24.1,1630.6,17,1,0,3,5,6,0,0,0,0,15780,6.8,17751,227,66,-526,850,29.3,1578.0
4797183711,1,10,1,0,3,2,2,1,1,0,0,14937,7.2,18299,194,71,1276,1230,26.5,1493.7,13,0,1,2,3,0,0,0,0,0,13661,6.8,17069,193,44,-1276,-1230,23.7,1366.1
4797158993,0,15,2,0,1,8,0,0,0,0,0,13916,6.6,16568,200,56,-2598,-449,25.6,1391.6,151,2,1,8,1,10,1,1,0,0,16514,6.6,17017,209,40,2598,449,24.9,1651.4
4796724691,1,15,2,0,3,7,4,0,0,0,0,14974,6.6,16838,200,52,-2101,-1247,25.2,1497.4,13,1,1,7,3,10,1,1,0,0,17075,7.0,18085,205,52,2101,1247,25.7,1707.5
4759463619,1,0,0,1,29,22,70,0,0,0,1,40322,11.8,44293,120,0,5007,6448,12.0,4032.2,80,0,0,22,29,52,0,0,0,0,35315,10.8,37845,94,0,-5007,-6448,9.4,3531.5
4759456247,1,23,0,1,21,15,57,0,0,0,1,37622,11.0,40580,115,0,2980,4925,11.5,3762.2,0,3,0,15,21,34,0,0,0,0,34642,10.2,35655,99,0,-2980,-4925,9.9,3464.2
4748377972,1,13,0,0,6,9,4,0,0,0,0,15732,6.4,15997,189,56,-981,-818,24.5,1573.2,9,1,1,9,6,7,1,1,0,0,16713,6.6,16815,193,40,981,818,23.3,1671.3
4748345824,1,13,0,1,7,3,5,1,1,0,0,16032,6.8,17601,197,51,853,-574,24.8,1603.2,11,2,0,3,7,2,0,0,0,0,15179,7.0,18175,210,64,-853,574,27.4,1517.9
4748309586,1,8,0,1,10,5,12,1,1,0,0,20697,7.0,19070,218,68,5500,2184,28.6,2069.7,4,1,0,5,10,4,0,0,0,0,15197,6.8,16886,184,60,-5500,-2184,24.4,1519.7
4747300085,0,12,2,0,4,3,4,0,0,0,0,15319,7.0,18298,191,56,-464,-289,24.7,1531.9,12,1,1,3,4,2,0,0,0,0,15783,7.2,18587,216,64,464,289,28.0,1578.3
4747261117,0,17,0,1,6,1,3,0,0,0,0,15355,6.4,15588,151,48,347,-654,19.9,1535.5,13,0,0,1,6,1,0,0,0,0,15008,6.6,16242,203,52,-347,654,25.5,1500.8
4746161582,1,12,1,0,4,2,3,0,0,0,0,16579,7.0,18956,217,64,2609,1317,28.1,1657.9,62,1,1,2,4,1,1,1,0,0,13970,7.0,17639,205,48,-2609,-1317,25.3,1397.0
4746137885,1,21,2,1,9,3,8,1,1,0,0,18790,7.4,19514,221,60,4896,2427,28.1,1879.0,11,3,0,3,9,2,0,0,0,0,13894,6.6,17087,167,52,-4896,-2427,21.9,1389.4
4746071787,1,17,0,0,15,15,16,0,0,0,0,63425,12.0,55000,1,0,26225,22000,0.1,6342.5,16,0,1,9,9,6,0,0,0,0,37200,7.2,33000,0,0,-26225,-22000,0.0,3720.0
4746058006,1,0,0,1,17,16,12,0,0,0,0,47165,10.0,47500,5,0,17555,19000,0.5,4716.5,0,0,0,8,9,12,0,0,0,0,29610,6.0,28500,0,0,-17555,-19000,0.0,2961.0
4744292749,1,10,1,1,4,4,7,0,0,0,0,16775,7.0,18240,208,62,766,-447,27.0,1677.5,12,0,0,4,4,3,1,1,0,0,16009,7.2,18687,206,58,-766,447,26.4,1600.9
4743836581,1,67,1,1,7,1,7,2,1,1,0,17679,7.0,18173,194,64,3869,1885,25.8,1767.9,14,0,0,1,7,0,0,0,0,0,13810,6.6,16288,168,40,-3869,-1885,20.8,1381.0
4743816351,0,108,1,0,4,3,6,2,1,1,0,16107,6.8,16792,200,55,-160,-1853,25.5,1610.7,10,1,1,3,4,1,0,0,0,0,16267,6.8,18645,190,56,160,1853,24.6,1626.7
4742469355,1,13,3,1,7,2,8,0,0,0,0,17652,6.8,17523,222,58,3379,398,28.0,1765.2,16,1,0,2,7,1,0,0,0,0,14273,6.6,17125,197,56,-3379,-398,25.3,1427.3
4741377033,1,14,1,1,4,7,6,1,1,0,0,16092,6.4,16754,192,55,-1120,-1363,24.7,1609.2,7,2,0,7,4,5,0,0,0,0,17212,6.6,18117,215,55,1120,1363,27.0,1721.2
4741344117,0,17,2,1,2,4,2,0,0,0,0,15242,7.0,17369,190,60,-725,-1138,25.0,1524.2,21,3,0,4,2,2,1,0,1,0,15967,7.0,18507,221,52,725,1138,27.3,1596.7
4739694516,0,4,0,0,7,28,15,0,0,0,0,31666,10.0,32560,97,0,-4841,-7535,9.7,3166.6,0,4,1,28,7,69,0,0,0,0,36507,11.0,40095,105,0,4841,7535,10.5,3650.7
4739452111,1,226,1,1,5,4,4,0,0,0,0,16223,6.2,16203,181,56,451,-41,23.7,1622.3,11,7,0,4,5,8,1,1,0,0,15772,6.6,16244,162,40,-451,41,20.2,1577.2
4738650248,1,0,1,0,33,19,81,0,0,0,0,38299,11.4,43146,104,0,2352,1966,10.4,3829.9,11,0,1,19,33,48,0,0,0,0,35947,11.0,41180,91,0,-2352,-1966,9.1,3594.7
4776263263,1,0,0,1,15,16,39,0,0,0,1,35705,10.8,38798,118,0,741,818,11.8,3570.5,0,0,0,16,15,38,0,0,0,0,34964,10.6,37980,86,0,-741,-818,8.6,3496.4
4776205118,0,12,0,0,10,31,24,0,0,0,1,33172,10.0,34417,101,0,-6471,-9246,10.1,3317.2,0,3,1,31,10,94,0,0,0,0,39643,11.8,43663,104,0,6471,9246,10.4,3964.3
4776166620,1,86,0,1,31,23,70,0,0,0,0,38517,11.6,43790,105,0,1442,1698,10.5,3851.7,0,0,0,23,31,51,0,0,0,0,37075,11.2,42092,118,0,-1442,-1698,11.8,3707.5
4775377274,1,31,1,1,6,5,3,0,0,0,0,17401,7.0,17988,187,56,398,20,24.3,1740.1,10,14,0,5,6,4,0,0,0,0,17003,7.0,17968,216,56,-398,-20,27.2,1700.3
4775336015,0,35,1,0,1,8,2,0,0,0,0,14536,6.6,16528,200,56,-2903,-1197,25.6,1453.6,18,9,1,8,1,11,0,0,0,0,17439,6.8,17725,186,60,2903,1197,24.6,1743.9
4767958707,1,19,1,0,3,5,1,1,1,0,0,15371,6.8,17434,229,48,-480,-304,27.7,1537.1,10,2,1,5,3,3,0,0,0,0,15851,6.8,17738,224,52,480,304,27.6,1585.1
4767932938,1,16,0,0,5,3,4,2,1,1,0,17808,7.0,18826,248,52,2300,1824,30.0,1780.8,9,1,1,3,5,5,0,0,0,0,15508,6.6,17002,181,48,-2300,-1824,22.9,1550.8
4767885922,1,12,2,1,4,6,3,1,1,0,0,16052,7.0,18086,222,44,-955,73,26.6,1605.2,10,0,0,6,4,5,1,0,1,0,17007,7.0,18013,188,68,955,-73,25.6,1700.7
4767845359,0,11,0,0,3,3,4,1,1,0,0,16018,6.8,17991,207,54,577,-47,26.1,1601.8,12,0,1,3,3,1,0,0,0,0,15441,7.0,18038,198,65,-577,47,26.3,1544.1
4765118725,0,14,0,0,3,8,4,1,1,0,0,15665,6.6,16708,180,60,-1800,-670,24.0,1566.5,10,1,1,8,3,5,1,0,1,0,17465,6.6,17378,168,48,1800,670,21.6,1746.5
4765112581,1,10,0,0,4,5,4,2,1,1,0,16151,7.0,17459,207,52,444,58,25.9,1615.1,297,1,1,5,4,6,0,0,0,0,15707,7.0,17401,226,56,-444,-58,28.2,1570.7
4765102871,1,13,1,1,9,6,4,0,0,0,0,17344,7.0,17881,215,44,-391,-349,25.9,1734.4,10,0,0,6,9,7,1,1,0,0,17735,7.0,18230,186,64,391,349,25.0,1773.5
4765078521,1,7,2,0,7,6,7,0,0,0,0,17025,6.8,16869,188,52,763,-490,24.0,1702.5,22,1,1,6,7,4,0,0,0,0,16262,6.6,17359,206,56,-763,490,26.2,1626.2
4763416740,0,16,1,1,4,2,3,0,0,0,0,16008,6.8,17827,218,51,900,283,26.9,1600.8,11,4,0,2,4,2,1,1,0,0,15108,6.8,17544,206,64,-900,-283,27.0,1510.8
4763394953,0,16,1,0,3,8,4,1,1,0,0,15896,6.8,17980,211,60,-2124,-419,27.1,1589.6,14,3,1,8,3,13,0,0,0,0,18020,7.0,18399,184,52,2124,419,23.6,1802.0
4762919406,1,13,4,1,8,2,12,1,1,0,0,18129,6.8,17804,214,44,2553,887,25.8,1812.9,12,2,0,2,8,2,0,0,0,0,15576,6.8,16917,207,64,-2553,-887,27.1,1557.6
4762896805,0,13,0,0,5,7,3,0,0,0,0,15318,6.8,16935,193,45,-1160,-1401,23.8,1531.8,10,0,1,7,5,2,1,1,0,0,16478,7.0,18336,192,78,1160,1401,27.0,1647.8
4762856840,0,8,0,1,5,8,5,0,0,0,0,16655,6.8,18049,203,52,-2747,-897,25.5,1665.5,12,0,0,8,5,7,0,0,0,0,19402,7.2,18946,223,64,2747,897,28.7,1940.2
4250534169,1,10,1,1,6,4,3,1,1,0,0,16597,7.0,18200,186,56,-628,-374,24.2,1659.7,15,1,0,4,6,2,0,0,0,0,17225,7.0,18574,206,55,628,374,26.1,1722.5
4846230372,1,139,1,1,9,7,9,0,0,0,0,17587,6.6,16653,186,48,968,-760,23.4,1758.7,11,1,0,7,9,5,0,0,0,0,16619,6.8,17413,197,52,-968,760,24.9,1661.9
4846197536,1,21,2,1,9,5,5,0,0,0,0,17544,6.6,17114,162,44,1503,1909,20.6,1754.4,260,2,0,5,9,4,0,0,0,0,16041,6.2,15205,184,56,-1503,-1909,24.0,1604.1
4846179892,0,0,0,1,15,18,45,0,0,0,0,34533,10.6,37224,102,0,1181,-478,10.2,3453.3,0,0,0,18,15,41,0,0,0,0,33352,10.4,37702,102,0,-1181,478,10.2,3335.2
4846139607,0,12,2,1,5,5,8,0,0,0,0,15324,6.6,16854,151,48,-932,-878,19.9,1532.4,10,2,0,5,5,4,1,1,0,0,16256,6.6,17732,197,48,932,878,24.5,1625.6
4846103642,0,12,2,1,7,6,12,1,0,1,0,15992,6.2,15123,145,48,-373,-2499,19.3,1599.2,12,3,0,6,7,6,1,1,0,0,16365,6.6,17622,185,40,373,2499,22.5,1636.5
4843096399,1,13,1,0,7,4,3,1,1,0,0,17184,7.0,18422,197,60,753,749,25.7,1718.4,74,0,1,4,7,4,0,0,0,0,16431,6.8,17673,184,50,-753,-749,23.4,1643.1
4843078523,0,0,3,1,17,24,40,0,0,0,0,35653,10.8,38617,110,0,-1102,-3381,11.0,3565.3,16,0,0,24,17,70,0,0,0,0,36755,11.2,41998,101,0,1102,3381,10.1,3675.5
4843061231,1,10,2,1,6,4,7,1,1,0,0,18617,7.0,18791,228,64,3691,2702,29.2,1861.7,13,0,0,4,6,4,0,0,0,0,14926,6.6,16089,178,47,-3691,-2702,22.5,1492.6
4840940309,1,0,0,0,25,31,64,0,0,0,0,36768,11.4,41718,86,0,-1947,-1594,8.6,3676.8,0,0,1,31,25,70,0,0,0,0,38715,11.6,43312,95,0,1947,1594,9.5,3871.5
4840909332,1,12,0,0,3,8,0,0,0,0,0,16962,7.2,18494,210,56,-578,1416,26.6,1696.2,8,4,1,8,3,14,0,0,0,0,17540,6.6,17078,213,48,578,-1416,26.1,1754.0
4840875289,1,16,1,1,10,3,9,0,0,0,0,19743,7.4,19629,258,51,5805,3824,30.9,1974.3,64,1,0,3,10,0,0,0,0,0,13938,6.4,15805,159,44,-5805,-3824,20.3,1393.8
4835302231,1,15,0,0,12,12,23,0,0,0,1,33947,10.2,34671,108,0,697,-240,10.8,3394.7,2,4,1,12,12,20,0,0,0,0,33250,10.4,34911,105,0,-697,240,10.5,3325.0
4835293766,0,0,0,0,11,13,30,0,0,0,0,33758,10.6,36165,104,0,-2112,-2019,10.4,3375.8,13,0,1,13,11,22,0,0,0,0,35870,10.8,38184,100,0,2112,2019,10.0,3587.0
4835255248,1,13,0,1,5,3,7,0,0,0,0,16328,7.0,17875,224,56,1131,742,28.0,1632.8,8,1,0,3,5,4,0,0,0,0,15197,6.6,17133,234,52,-1131,-742,28.6,1519.7
4835216638,0,12,1,0,7,7,7,1,1,0,0,15781,6.6,16463,171,44,-458,-169,21.5,1578.1,24,2,1,7,7,7,0,0,0,0,16239,6.4,16632,163,51,458,169,21.4,1623.9
4835178293,0,13,2,1,1,3,1,0,0,0,0,15446,6.8,17942,223,48,-492,-412,27.1,1544.6,9,0,0,3,1,3,2,1,1,0,15938,7.0,18354,179,64,492,412,24.3,1593.8
4835153299,0,16,0,0,0,5,0,1,1,0,0,13588,6.4,15953,204,52,-1949,-2956,25.6,1358.8,12,0,1,5,0,1,0,0,0,0,15537,7.0,18909,228,56,1949,2956,28.4,1553.7
4835118305,0,13,0,0,3,7,2,0,0,0,0,14899,6.8,18082,196,52,-1407,-350,24.8,1489.9,10,2,1,7,3,8,0,0,0,0,16306,7.0,18432,197,44,1407,350,24.1,1630.6
4835089506,0,1,0,0,32,24,80,0,0,0,0,39409,11.6,44616,93,0,2432,4328,9.3,3940.9,34,0,1,24,32,66,0,0,0,0,36977,11.0,40288,91,0,-2432,-4328,9.1,3697.7
4835067080,0,13,0,0,24,28,52,0,0,0,1,36692,11.2,40850,88,0,-2509,-2423,8.8,3669.2,92,0,1,28,24,60,0,0,0,0,39201,11.6,43273,104,0,2509,2423,10.4,3920.1
4854819599,1,11,2,0,5,6,4,0,0,0,0,16677,6.8,17457,199,38,1098,120,23.7,1667.7,12,0,1,6,5,4,0,0,0,0,15579,6.8,17337,170,48,-1098,-120,21.8,1557.9
4854794898,1,39,1,1,6,1,3,0,0,0,0,16004,6.8,18353,199,53,1404,876,25.2,1600.4,9,0,0,1,6,0,2,1,1,0,14600,6.8,17477,194,56,-1404,-876,25.0,1460.0
4854762924,0,19,0,0,3,5,2,0,0,0,0,14315,6.8,16694,204,48,-1232,-1457,25.2,1431.5,30,0,1,5,3,8,1,1,0,0,15547,7.0,18151,180,48,1232,1457,22.8,1554.7
4854731354,0,11,0,0,1,5,0,0,0,0,0,13731,6.6,16477,181,44,-3211,-2493,22.5,1373.1,13,0,1,5,1,2,0,0,0,0,16942,7.2,18970,205,60,3211,2493,26.5,1694.2
4854708226,0,15,1,0,4,5,5,1,0,1,0,14490,6.2,15953,151,44,-2585,-2135,19.5,1449.0,10,3,1,5,4,7,0,0,0,0,17075,7.0,18088,219,44,2585,2135,26.3,1707.5
4854665494,0,13,2,1,6,2,8,1,1,0,0,16989,7.2,18605,202,60,1297,787,26.2,1698.9,25,2,0,2,6,3,1,0,1,0,15692,7.0,17818,217,40,-1297,-787,25.7,1569.2
4854587293,0,36,2,0,7,3,7,0,0,0,0,16535,6.8,17089,160,52,2020,892,21.2,1653.5,39,0,1,2,6,2,0,0,0,0,14515,6.4,16197,149,44,-2020,-892,19.3,1451.5
4851718000,1,152,0,1,10,4,9,0,0,0,0,17213,7.0,18677,190,56,2544,2899,24.6,1721.3,8,0,0,4,10,3,0,0,0,0,14669,6.2,15778,124,52,-2544,-2899,17.6,1466.9
4849225495,1,13,0,0,8,5,4,1,1,0,0,16919,7.2,19263,191,72,176,2517,26.3,1691.9,8,1,1,5,8,5,0,0,0,0,16743,6.8,16746,188,44,-176,-2517,23.2,1674.3
4849194187,0,17,0,0,2,3,2,0,0,0,0,15041,6.6,17525,191,60,-489,-329,25.1,1504.1,10,2,1,3,2,2,0,0,0,0,15530,6.8,17854,206,60,489,329,26.6,1553.0
4849149328,1,44,0,0,4,8,4,0,0,0,0,14761,6.4,16279,180,40,-2006,-2121,22.0,1476.1,16,11,1,8,4,6,0,0,0,0,16767,7.0,18400,199,52,2006,2121,25.1,1676.7
4849110835,0,46,1,1,5,3,2,1,1,0,0,15499,6.6,18017,176,53,-825,271,22.9,1549.9,12,1,0,3,5,6,0,0,0,0,16324,7.0,17746,186,66,825,-271,25.2,1632.4
4848676012,0,14,1,0,1,9,0,1,1,0,0,12497,6.0,14131,132,56,-4695,-2193,18.8,1249.7,24,1,1,9,1,8,0,0,0,0,17192,6.6,16324,174,45,4695,2193,21.9,1719.2
4848635765,1,13,1,0,5,5,2,0,0,0,0,15408,6.8,18001,190,48,594,557,23.8,1540.8,15,0,1,5,5,2,0,0,0,0,14814,6.8,17444,160,56,-594,-557,21.6,1481.4
4847787713,0,17,2,0,3,3,2,0,0,0,0,15072,6.8,17998,192,56,792,1316,24.8,1507.2,15,2,1,3,3,2,0,0,0,0,14280,6.6,16682,176,44,-792,-1316,22.0,1428.0
4847764164,1,16,1,1,6,4,0,0,0,0,0,15644,7.0,18344,193,60,1756,932,25.3,1564.4,11,3,0,3,5,1,0,0,0,0,13888,6.8,17412,197,44,-1756,-932,24.1,1388.8
4847551472,0,10,1,0,5,4,2,0,0,0,0,14686,6.8,16763,164,44,-533,-248,20.8,1468.6,8,1,1,4,5,3,0,0,0,0,15219,6.6,17011,202,52,533,248,25.4,1521.9
4847522442,1,10,0,0,5,8,4,0,0,0,0,14949,6.4,16171,160,48,-1442,-1255,20.8,1494.9,13,0,1,8,5,3,1,1,0,0,16391,6.6,17426,190,56,1442,1255,24.6,1639.1
4847083982,1,26,0,1,10,4,6,0,0,0,0,17349,6.6,17631,167,60,2833,1049,22.7,1734.9,10,10,0,4,10,3,1,1,0,0,14516,6.8,16582,175,44,-2833,-1049,21.9,1451.6
4847027677,1,55,2,1,6,1,2,1,1,0,0,15481,6.8,18538,170,52,2316,1879,22.2,1548.1,15,1,0,1,6,1,0,0,0,0,13165,6.8,16659,172,64,-2316,-1879,23.6,1316.5
4858244531,1,21,0,1,22,13,18,0,0,0,0,64100,12.0,55000,0,0,26880,18000,0.0,6410.0,0,2,0,6,15,9,0,0,0,0,37220,8.0,37000,2,0,-26880,-18000,0.2,3722.0
4857918274,1,13,0,0,4,3,4,0,0,0,0,14820,6.6,16646,151,60,513,-261,21.1,1482.0,289,0,1,3,4,1,0,0,0,0,14307,6.4,16907,186,37,-513,261,22.3,1430.7
4857908245,1,3,0,1,13,22,14,0,0,0,0,59961,12.0,55000,0,0,21226,22000,0.0,5996.1,0,0,0,15,6,14,0,0,0,0,38735,7.2,33000,3,0,-21226,-22000,0.3,3873.5
4857427613,1,0,0,0,12,17,13,0,0,0,0,45950,10.0,47500,0,0,18100,19000,0.0,4595.0,62,0,1,12,7,11,0,0,0,0,27850,6.0,28500,0,0,-18100,-19000,0.0,2785.0
4857368574,0,14,1,0,10,8,13,1,1,0,0,16729,6.6,16287,176,48,459,-1587,22.4,1672.9,12,1,1,7,9,3,0,0,0,0,16270,7.0,17874,176,44,-459,1587,22.0,1627.0
4857324260,1,17,2,0,6,4,6,1,1,0,0,16439,7.0,17710,193,60,2045,755,25.3,1643.9,13,1,1,4,6,3,0,0,0,0,14394,6.4,16955,182,52,-2045,-755,23.4,1439.4
4856873001,1,0,0,1,17,11,18,0,0,0,0,47937,10.0,47500,0,0,20437,19000,0.0,4793.7,0,0,0,6,12,4,0,0,0,0,27500,6.0,28500,0,0,-20437,-19000,0.0,2750.0
4856863767,1,0,0,1,21,15,19,0,0,0,0,49100,10.0,47500,0,0,20175,19000,0.0,4910.0,3,0,0,7,13,5,0,0,0,0,28925,6.0,28500,1,0,-20175,-19000,0.1,2892.5
4856848488,1,77,0,0,20,25,29,0,0,0,0,63258,12.6,59500,0,0,24288,22000,0.0,6325.8,100,0,1,16,11,15,0,0,0,0,38970,7.8,37500,0,0,-24288,-22000,0.0,3897.0
4856446639,1,10,0,0,2,6,3,0,0,0,0,14931,6.8,18094,190,52,-1850,770,24.2,1493.1,168,2,1,6,2,5,0,0,0,0,16781,6.8,17324,200,44,1850,-770,24.4,1678.1
4856389966,1,23,5,0,18,18,19,0,0,0,0,47385,10.0,47500,0,0,17974,19000,0.0,4738.5,37,1,1,13,13,10,0,0,0,0,29411,6.0,28500,6,0,-17974,-19000,0.6,2941.1
4856370227,1,6,0,0,16,21,23,0,0,0,0,62746,13.8,66500,0,0,24784,29000,0.0,6274.6,0,0,1,15,10,11,0,0,0,0,37962,7.8,37500,0,0,-24784,-29000,0.0,3796.2
4856344372,1,90,0,1,14,16,11,0,0,0,0,45256,10.0,47500,0,0,17385,19000,0.0,4525.6,1,0,0,10,8,10,0,0,0,0,27871,6.0,28500,0,0,-17385,-19000,0.0,2787.1
4856320934,1,0,0,0,26,12,24,0,0,0,0,63750,12.0,55000,0,0,28300,22000,0.0,6375.0,0,0,1,4,18,7,0,0,0,0,35450,7.2,33000,0,0,-28300,-22000,0.0,3545.0
4856299764,1,19,0,1,10,20,10,0,0,0,0,60750,12.4,57000,2,0,21430,24000,0.2,6075.0,28,2,0,14,4,15,0,0,0,0,39320,7.2,33000,2,0,-21430,-24000,0.2,3932.0
4856105831,0,0,0,0,17,18,47,0,0,0,0,35379,10.8,39248,103,0,-2376,315,10.3,3537.9,2,0,1,18,17,45,0,0,0,0,37755,11.0,38933,113,0,2376,-315,11.3,3775.5
4856063334,0,0,0,1,20,13,51,0,0,0,0,35939,11.0,39870,90,0,1873,2584,9.0,3593.9,0,0,0,13,20,37,0,0,0,0,34066,10.8,37286,106,0,-1873,-2584,10.6,3406.6
4856029777,1,10,0,0,16,16,41,0,0,0,1,34015,10.8,37425,81,0,-863,1093,8.1,3401.5,0,3,1,16,16,41,0,0,0,0,34878,10.6,36332,130,0,863,-1093,13.0,3487.8
4855963198,0,191,3,0,7,10,12,1,0,1,0,16917,7.0,17817,221,64,-1944,-375,28.5,1691.7,12,3,1,10,7,14,1,1,0,0,18861,7.0,18192,211,56,1944,375,26.7,1886.1
4855936816,1,0,0,1,19,17,18,0,0,0,0,62025,12.0,55000,1,0,24825,22000,0.1,6202.5,0,0,0,9,11,9,0,0,0,0,37200,7.2,33000,0,0,-24825,-22000,0.0,3720.0
4835099559,0,10,0,0,0,4,0,0,0,0,0,13959,6.4,17352,206,60,-2456,-1408,26.6,1395.9,3,0,1,4,0,3,1,1,0,0,16415,7.0,18760,229,72,2456,1408,30.1,1641.5
4833194177,1,11,2,0,5,3,5,0,0,0,0,15532,7.0,17341,184,56,1769,557,24.0,1553.2,14,0,1,3,5,2,1,1,0,0,13763,6.4,16784,166,52,-1769,-557,21.8,1376.3
4833154288,1,7,0,0,3,3,4,1,1,0,0,15738,7.0,17898,204,68,1136,-814,27.2,1573.8,13,0,1,3,3,1,0,0,0,0,14602,7.2,18712,188,68,-1136,814,25.6,1460.2
4832912985,0,12,0,0,5,2,4,0,0,0,0,16596,6.8,17693,183,60,783,-83,24.3,1659.6,9,0,1,2,5,3,1,1,0,0,15813,6.8,17776,171,47,-783,83,21.8,1581.3
4830938943,1,58,3,1,5,1,4,0,0,0,0,16587,7.0,18389,187,44,2555,1531,23.1,1658.7,12,0,0,1,5,1,0,0,0,0,14032,6.8,16858,189,64,-2555,-1531,25.3,1403.2
4830598517,1,12,1,1,6,5,6,0,0,0,0,17054,6.8,17703,202,44,-275,-881,24.6,1705.4,220,1,0,5,6,3,1,0,1,0,17329,7.2,18584,188,48,275,881,23.6,1732.9
4830472268,1,17,0,0,4,2,1,0,0,0,0,14672,6.8,17651,192,44,1405,1273,23.6,1467.2,12,1,1,2,4,1,0,0,0,0,13267,6.4,16378,175,48,-1405,-1273,22.3,1326.7
4830409312,1,13,3,1,6,2,7,1,1,0,0,16240,6.8,17335,214,55,2552,1161,26.9,1624.0,14,0,0,2,6,1,0,0,0,0,13688,6.6,16174,188,52,-2552,-1161,24.0,1368.8
4830334054,1,12,1,1,8,5,4,0,0,0,0,18304,7.0,18511,208,60,3470,1480,26.8,1830.4,9,0,0,5,8,4,1,1,0,0,14834,6.8,17031,193,26,-3470,-1480,21.9,1483.4
4830250891,0,12,1,1,4,4,4,0,0,0,0,14735,6.8,17048,187,48,-487,-568,23.5,1473.5,11,0,0,4,4,3,1,0,1,0,15222,6.8,17616,183,68,487,568,25.1,1522.2
4830086469,0,11,1,0,9,2,7,0,0,0,0,17732,7.0,18344,238,48,4333,2711,28.6,1773.2,14,2,1,2,9,0,0,0,0,0,13399,6.4,15633,164,53,-4333,-2711,21.7,1339.9
4830027254,0,8,1,1,4,2,6,0,0,0,0,15198,6.8,17015,191,48,816,-681,23.9,1519.8,14,0,0,2,4,2,0,0,0,0,14382,6.8,17696,188,56,-816,681,24.4,1438.2
4829702950,0,17,0,1,1,2,1,0,0,0,0,14877,6.8,17664,222,49,-97,-514,27.1,1487.7,12,1,0,2,1,0,1,1,0,0,14974,7.0,18178,218,56,97,514,27.4,1497.4
4829654911,1,71,1,1,8,4,6,0,0,0,0,17420,7.0,17802,190,52,2366,1571,24.2,1742.0,11,0,0,4,8,0,0,0,0,0,15054,6.6,16231,155,48,-2366,-1571,20.3,1505.4
4829612311,1,16,0,0,0,5,0,0,0,0,0,13469,6.6,16713,220,48,-2150,-395,26.8,1346.9,11,1,1,5,0,2,1,0,1,0,15619,6.6,17108,191,52,2150,395,24.3,1561.9
4829557110,0,16,0,0,2,10,2,1,1,0,0,14933,6.6,16722,207,48,-2705,-1091,25.5,1493.3,15,1,1,10,2,6,0,0,0,0,17638,6.8,17813,202,52,2705,1091,25.4,1763.8
4829480330,1,11,1,1,3,4,3,1,1,0,0,14691,6.4,15940,183,54,-91,-782,23.7,1469.1,65,0,0,4,3,4,0,0,0,0,14782,6.4,16722,181,44,91,782,22.5,1478.2
4829379838,0,89,2,1,6,11,7,0,0,0,0,17712,6.8,17505,180,55,-1478,406,23.5,1771.2,18,4,0,11,6,12,0,0,0,0,19190,6.6,17099,200,52,1478,-406,25.2,1919.0
4809684290,1,11,1,1,10,2,10,1,1,0,0,17436,7.0,18058,179,56,4204,2165,23.5,1743.6,14,0,0,2,10,0,0,0,0,0,13232,6.6,15893,159,51,-4204,-2165,21.0,1323.2
4809660456,0,13,1,0,7,5,6,0,0,0,0,17271,7.0,17878,187,56,1811,-1231,24.3,1727.1,6,0,1,5,7,2,0,0,0,0,15460,7.2,19109,173,72,-1811,1231,24.5,1546.0
4800973015,1,9,3,1,6,2,7,0,0,0,0,17232,7.2,19759,213,52,3007,2645,26.5,1723.2,11,1,0,1,5,2,0,0,0,0,14225,6.8,17114,198,46,-3007,-2645,24.4,1422.5
4800843639,0,57,1,0,6,10,6,0,0,0,0,15960,7.0,18138,221,48,-2750,-973,26.9,1596.0,15,0,1,9,5,17,0,0,0,0,18710,7.0,19111,226,52,2750,973,27.8,1871.0
4741014763,0,9,1,0,3,6,5,0,0,0,0,14571,6.6,17209,191,40,-2281,-1314,23.1,1457.1,14,3,1,6,3,6,0,0,0,0,16852,7.0,18523,196,80,2281,1314,27.6,1685.2
4735961593,1,14,2,1,3,5,0,0,0,0,0,16107,6.6,17366,219,60,-255,1832,27.9,1610.7,10,1,0,5,3,5,0,0,0,0,16362,6.4,15534,196,36,255,-1832,23.2,1636.2
4731773562,1,13,0,0,6,5,4,0,0,0,0,16452,6.8,16600,191,44,1481,-201,23.5,1645.2,41,1,1,4,5,6,1,1,0,0,14971,6.8,16801,155,60,-1481,201,21.5,1497.1
4731754481,1,16,0,0,7,4,3,2,1,1,0,18857,7.6,20216,225,69,3825,2895,29.4,1885.7,10,1,1,4,7,2,0,0,0,0,15032,6.8,17321,181,52,-3825,-2895,23.3,1503.2
4723615386,1,12,3,0,5,5,6,1,1,0,0,16200,6.6,16478,183,44,-316,270,22.7,1620.0,12,1,1,5,5,9,0,0,0,0,16516,6.6,16208,184,56,316,-270,24.0,1651.6
4723584835,0,10,0,1,4,4,5,0,0,0,0,17038,7.0,17986,220,44,1566,428,26.4,1703.8,9,0,0,4,4,2,0,0,0,0,15472,6.6,17558,202,52,-1566,-428,25.4,1547.2
4653465040,1,11,1,0,2,1,1,1,1,0,0,15090,7.0,18613,230,64,-1084,738,29.4,1509.0,12,2,1,1,2,1,1,0,1,0,16174,7.0,17875,222,56,1084,-738,27.8,1617.4
4629349848,1,13,0,0,6,6,10,0,0,0,0,16703,6.8,17677,188,66,956,1339,25.4,1670.3,10,1,1,6,6,8,0,0,0,0,15747,6.4,16338,213,12,-956,-1339,22.5,1574.7
4626889708,1,11,0,0,11,5,12,0,0,0,0,19489,7.0,17988,207,34,2980,1337,24.1,1948.9,10,0,1,5,11,9,1,1,0,0,16509,6.8,16651,213,42,-2980,-1337,25.5,1650.9
4626148131,0,13,1,1,10,8,7,0,0,0,0,17845,7.2,18006,175,44,363,1366,21.9,1784.5,15,0,0,8,10,10,1,1,0,0,17482,6.8,16640,190,52,-363,-1366,24.2,1748.2
4623162697,0,46,0,0,4,7,4,0,0,0,0,14972,6.8,17397,208,52,-2959,-1651,26.0,1497.2,12,1,1,7,4,5,0,0,0,0,17931,7.2,19048,217,64,2959,1651,28.1,1793.1
4623127862,1,43,2,0,7,6,5,0,0,0,0,18098,7.0,18867,222,48,1660,43,27.0,1809.8,32,1,1,6,7,3,0,0,0,0,16438,7.2,18824,173,76,-1660,-43,24.9,1643.8
4623048438,1,11,1,1,6,4,8,0,0,0,0,18063,7.0,18192,209,60,3353,1167,26.9,1806.3,13,1,0,4,6,2,1,1,0,0,14710,6.8,17025,191,56,-3353,-1167,24.7,1471.0
4622889449,1,9,6,0,4,2,4,0,0,0,0,14665,6.8,17265,203,47,-1176,-673,25.0,1466.5,30,1,1,2,4,1,0,0,0,0,15841,6.8,17938,228,59,1176,673,28.7,1584.1
4622332551,1,11,1,1,4,9,1,0,0,0,0,15202,6.2,15842,195,52,-2021,-833,24.7,1520.2,5,1,0,9,4,12,1,1,0,0,17223,6.6,16675,171,52,2021,833,22.3,1722.3
4622304620,0,12,0,0,6,4,6,0,0,0,0,16164,6.6,16695,202,45,-538,-797,24.7,1616.4,9,0,1,4,6,2,1,1,0,0,16702,6.8,17492,202,62,538,797,26.4,1670.2
4812534909,1,17,2,0,25,17,55,0,0,0,0,34511,10.8,38241,88,47,865,1988,13.5,3451.1,18,0,1,17,25,34,0,0,0,0,33646,10.6,36253,98,47,-865,-1988,14.5,3364.6
4806053758,0,13,1,1,3,5,2,1,0,1,0,14903,6.8,17565,202,43,-261,2087,24.5,1490.3,74,0,0,5,3,4,0,0,0,0,15164,6.2,15478,153,40,261,-2087,19.3,1516.4
4806028030,1,14,3,1,7,10,5,0,0,0,0,17153,6.8,17339,185,48,383,793,23.3,1715.3,12,3,0,10,7,7,0,0,0,0,16770,6.6,16546,152,52,-383,-793,20.4,1677.0
4805996258,0,16,0,1,5,2,6,0,0,0,0,15713,6.6,17635,182,56,1195,891,23.8,1571.3,10,2,0,2,5,1,0,0,0,0,14518,6.6,16744,181,52,-1195,-891,23.3,1451.8
4803811151,0,15,2,0,7,7,13,1,1,0,0,16161,6.6,16024,174,56,-602,-880,23.0,1616.1,194,4,1,7,7,7,0,0,0,0,16763,6.8,16904,212,44,602,880,25.6,1676.3
4802690720,0,15,1,0,8,9,12,0,0,0,0,16728,6.4,16457,181,32,-474,-10,21.3,1672.8,15,2,1,9,8,8,1,1,0,0,17202,6.4,16467,168,55,474,10,22.3,1720.2
4754590166,1,11,2,0,5,6,4,0,0,0,0,17388,7.0,18635,200,64,1185,1072,26.4,1738.8,12,1,1,6,5,4,1,1,0,0,16203,6.6,17563,190,44,-1185,-1072,23.4,1620.3
4752938702,1,16,1,1,3,4,4,1,1,0,0,15700,6.4,17252,197,52,822,556,24.9,1570.0,10,1,0,4,3,7,0,0,0,0,14878,6.6,16696,174,52,-822,-556,22.6,1487.8
4752885245,0,8,2,1,5,5,5,0,0,0,0,16377,7.0,18286,200,64,444,-71,26.4,1637.7,14,2,0,5,5,2,0,0,0,0,15933,7.2,18357,194,56,-444,71,25.0,1593.3
4752836062,0,68,2,0,4,8,2,0,0,0,0,15941,7.0,17351,168,42,-385,-264,21.0,1594.1,14,2,1,8,4,4,1,1,0,0,16326,6.6,17615,197,56,385,264,25.3,1632.6
4749842901,1,12,2,1,5,6,3,0,0,0,0,16851,6.8,17512,216,56,940,209,27.2,1685.1,44,1,0,6,5,10,0,0,0,0,15911,6.6,17303,186,52,-940,-209,23.8,1591.1
4749809642,0,10,0,1,2,1,1,1,0,1,0,15548,7.2,18516,209,64,2331,1040,27.3,1554.8,13,1,0,1,2,1,0,0,0,0,13217,6.8,17476,188,48,-2331,-1040,23.6,1321.7
4749792160,0,115,3,0,3,12,2,0,0,0,0,14795,6.6,16250,170,48,-5805,-2884,21.8,1479.5,14,3,1,12,3,9,1,1,0,0,20600,7.2,19134,224,59,5805,2884,28.3,2060.0
4749765738,0,12,1,0,3,3,4,0,0,0,0,14813,6.6,18124,195,64,-289,-775,25.9,1481.3,18,1,1,3,3,5,0,0,0,0,15102,7.0,18899,233,48,289,775,28.1,1510.2
4747963447,1,15,1,1,4,1,4,0,0,0,0,17410,6.8,17225,194,52,3881,556,24.6,1741.0,10,3,0,1,4,0,0,0,0,0,13529,6.6,16669,177,52,-3881,-556,22.9,1352.9
4747940095,1,18,0,1,6,1,6,0,0,0,0,17381,7.0,18384,218,55,3385,1887,27.3,1738.1,10,0,0,1,6,1,0,0,0,0,13996,6.6,16497,197,52,-3385,-1887,24.9,1399.6
4747901703,1,12,2,0,6,7,7,0,0,0,0,17560,7.0,18506,224,64,519,-288,28.8,1756.0,12,1,1,7,6,7,0,0,0,0,17041,7.0,18794,196,56,-519,288,25.2,1704.1
4747884336,0,68,1,1,6,4,10,1,1,0,0,16691,7.0,17210,173,48,1154,-735,22.1,1669.1,11,1,0,4,6,2,0,0,0,0,15537,7.0,17945,190,52,-1154,735,24.2,1553.7
4716604820,1,57,0,0,4,7,4,1,1,0,0,15132,6.6,15831,185,36,-2526,-470,22.1,1513.2,10,2,1,7,4,10,0,0,0,0,17658,6.4,16301,174,44,2526,470,21.8,1765.8
4715150861,0,8,0,1,4,5,4,0,0,0,0,14744,6.8,17400,182,48,-2358,-1544,23.0,1474.4,12,0,0,5,4,3,0,0,0,0,17102,7.0,18944,225,60,2358,1544,28.5,1710.2
4857593518,1,14,0,1,20,20,20,0,0,0,0,48859,10.0,47500,0,0,20609,19000,0.0,4885.9,0,0,0,11,11,9,0,0,0,0,28250,6.0,28500,1,0,-20609,-19000,0.1,2825.0
4857581385,1,10,0,0,15,23,22,0,0,0,0,62000,12.0,55000,0,0,24100,22000,0.0,6200.0,0,0,1,17,9,9,0,0,0,0,37900,7.2,33000,0,0,-24100,-22000,0.0,3790.0
4857433191,1,7,0,1,19,17,18,0,0,0,0,62700,12.0,55000,0,0,24800,22000,0.0,6270.0,15,0,0,11,13,11,0,0,0,0,37900,7.2,33000,0,0,-24800,-22000,0.0,3790.0
4856534294,1,0,0,1,17,17,21,0,0,0,0,46300,10.6,50500,2,0,18100,22000,0.2,4630.0,0,0,0,13,13,9,0,0,0,0,28200,6.0,28500,0,0,-18100,-22000,0.0,2820.0
4856513362,1,0,0,0,12,17,9,0,0,0,0,45250,10.0,47500,0,0,16700,19000,0.0,4525.0,18,0,1,12,7,11,0,0,0,0,28550,6.0,28500,0,0,-16700,-19000,0.0,2855.0
4856186730,1,17,0,0,18,20,47,0,0,0,0,36203,11.0,40164,108,0,-519,1249,10.8,3620.3,0,0,1,20,18,45,0,0,0,0,36722,11.0,38915,92,0,519,-1249,9.2,3672.2
4856160737,1,19,0,1,30,26,74,0,0,0,0,39857,12.0,46010,120,0,1791,2490,12.0,3985.7,2,1,0,26,30,74,0,0,0,0,38066,11.6,43520,92,0,-1791,-2490,9.2,3806.6
4856115415,1,4,0,0,24,20,68,0,0,0,1,37803,10.8,38955,116,0,2611,744,11.6,3780.3,0,0,1,20,24,57,0,0,0,0,35192,11.0,38211,96,0,-2611,-744,9.6,3519.2
4856056982,1,0,0,1,25,17,24,0,0,0,0,48406,10.0,47500,0,0,20906,19000,0.0,4840.6,0,0,0,7,15,7,0,0,0,0,27500,6.0,28500,0,0,-20906,-19000,0.0,2750.0
4855977441,1,0,0,1,16,18,18,0,0,0,0,46650,10.0,47500,0,0,18100,16000,0.0,4665.0,0,0,0,10,8,8,0,0,0,0,28550,6.6,31500,0,0,-18100,-16000,0.0,2855.0
4855960888,1,34,2,0,18,12,18,0,0,0,0,46566,10.0,47500,4,0,19706,19000,0.4,4656.6,0,0,1,8,14,6,0,0,0,0,26860,6.0,28500,2,0,-19706,-19000,0.2,2686.0
4855559998,1,8,0,1,21,20,16,0,0,0,0,48450,10.6,50500,1,0,20850,22000,0.1,4845.0,0,0,0,9,10,9,0,0,0,0,27600,6.0,28500,2,0,-20850,-22000,0.2,2760.0
4855557855,1,2,0,1,17,20,10,0,0,0,0,43325,10.0,47500,1,0,13700,19000,0.1,4332.5,0,0,0,10,7,14,0,0,0,0,29625,6.0,28500,1,0,-13700,-19000,0.1,2962.5
4855551915,1,0,0,1,9,20,17,0,0,0,0,61300,12.0,55000,0,0,22700,22000,0.0,6130.0,0,0,0,17,6,10,0,0,0,0,38600,7.2,33000,0,0,-22700,-22000,0.0,3860.0
4855543141,1,0,0,0,15,20,17,0,0,0,0,46650,10.0,47500,0,0,18100,19000,0.0,4665.0,0,0,1,12,7,12,0,0,0,0,28550,6.0,28500,0,0,-18100,-19000,0.0,2855.0
4855537214,1,0,0,0,14,17,15,0,0,0,0,46917,10.0,47500,0,0,19059,19000,0.0,4691.7,0,0,1,9,6,11,0,0,0,0,27858,6.0,28500,0,0,-19059,-19000,0.0,2785.8
4855532830,1,0,0,0,11,17,15,0,0,0,0,44965,10.0,47500,3,0,15955,19000,0.3,4496.5,0,0,1,13,7,9,0,0,0,0,29010,6.0,28500,5,0,-15955,-19000,0.5,2901.0
4855520126,1,0,1,1,20,7,24,0,0,0,0,62705,12.0,55000,0,0,28955,22000,0.0,6270.5,29,0,0,3,16,1,0,0,0,0,33750,7.2,33000,2,0,-28955,-22000,0.2,3375.0
4855127292,1,23,0,1,39,33,114,0,0,0,1,44004,12.6,49624,117,0,5353,7710,11.7,4400.4,0,0,0,33,39,75,0,0,0,0,38651,11.2,41914,78,0,-5353,-7710,7.8,3865.1
4855097768,0,0,0,0,31,27,70,0,0,0,1,42301,11.6,43818,113,0,4034,4424,11.3,4230.1,0,0,1,27,31,63,0,0,0,0,38267,11.0,39394,105,0,-4034,-4424,10.5,3826.7
4804559544,0,16,1,1,5,2,4,1,1,0,0,15905,7.0,18851,207,68,363,-318,27.5,1590.5,11,0,0,2,5,2,0,0,0,0,15542,7.2,19169,210,64,-363,318,27.4,1554.2
4804511639,1,79,1,1,9,3,6,0,0,0,0,20426,7.6,20627,229,60,6206,4796,28.9,2042.6,15,2,0,3,9,4,1,1,0,0,14220,6.6,15831,168,56,-6206,-4796,22.4,1422.0
4797894542,0,65,2,0,6,5,6,0,0,0,0,17598,6.6,17647,207,40,-10,307,24.7,1759.8,96,0,1,5,6,7,1,1,0,0,17608,6.8,17340,185,52,10,-307,23.7,1760.8
4792224033,0,11,0,1,7,8,7,0,0,0,0,15427,6.2,15220,176,34,-1823,-1308,21.0,1542.7,13,0,0,7,6,7,1,1,0,0,17250,6.4,16528,197,56,1823,1308,25.3,1725.0
4792199799,1,17,1,1,8,2,6,1,1,0,0,17423,7.0,18542,208,60,4338,2306,26.8,1742.3,14,2,0,1,7,1,0,0,0,0,13085,6.4,16236,169,52,-4338,-2306,22.1,1308.5
4792149210,1,11,5,1,5,7,5,0,0,0,0,17868,6.8,17086,224,44,1478,-766,26.8,1786.8,12,3,0,7,5,2,1,1,0,0,16390,7.0,17852,188,56,-1478,766,24.4,1639.0
4791450306,0,13,2,0,1,6,0,0,0,0,0,13884,6.6,16175,173,52,-3363,-2349,22.5,1388.4,14,3,1,6,1,4,0,0,0,0,17247,7.0,18524,234,56,3363,2349,29.0,1724.7
4790622323,1,12,1,1,5,6,2,0,0,0,0,16881,7.0,18371,213,56,2315,2408,26.9,1688.1,77,1,0,6,5,3,1,1,0,0,14566,6.4,15963,145,48,-2315,-2408,19.3,1456.6
4790575235,1,10,0,0,4,11,3,0,0,0,0,14467,6.2,15708,150,56,-3644,-1638,20.6,1446.7,11,1,1,11,4,12,1,1,0,0,18111,7.0,17346,158,56,3644,1638,21.4,1811.1
4786901587,0,14,0,1,8,8,7,1,1,0,0,17769,6.8,17332,191,62,1013,-150,25.3,1776.9,9,0,0,8,8,10,1,0,1,0,16756,6.8,17482,160,50,-1013,150,21.0,1675.6
4783674531,1,31,0,1,4,6,5,0,0,0,0,15845,6.4,16198,184,48,-160,-1257,23.2,1584.5,15,20,0,6,4,8,1,1,0,0,16005,6.8,17455,174,48,160,1257,22.2,1600.5
4783631562,0,75,0,1,4,5,4,0,0,0,0,15867,6.8,16958,202,44,176,-1061,24.6,1586.7,9,1,0,5,4,4,1,1,0,0,15691,6.8,18019,196,64,-176,1061,26.0,1569.1
4783607855,1,13,0,1,12,3,8,1,1,0,0,19618,7.6,19575,197,60,4795,3707,25.7,1961.8,11,0,0,3,12,1,1,0,1,0,14823,6.6,15868,172,52,-4795,-3707,22.4,1482.3
4744610466,0,12,0,1,3,2,4,0,0,0,0,15931,6.8,17478,242,44,919,-172,28.6,1593.1,9,2,0,2,3,2,0,0,0,0,15012,6.8,17650,216,32,-919,172,24.8,1501.2
4742404640,1,16,1,1,3,6,3,0,0,0,0,17137,7.0,18646,251,52,675,-343,30.3,1713.7,13,0,0,6,3,6,0,0,0,0,16462,7.0,18989,210,56,-675,343,26.6,1646.2
4742174527,1,17,4,1,7,7,3,0,0,0,0,17532,6.8,17224,209,48,-323,-357,25.7,1753.2,13,3,0,7,7,9,0,0,0,0,17855,6.8,17581,184,44,323,357,22.8,1785.5
4730287339,1,81,0,0,7,3,6,0,0,0,1,18392,6.8,17506,189,62,3884,3021,25.1,1839.2,9,1,1,3,7,1,1,1,0,0,14508,6.0,14485,158,56,-3884,-3021,21.4,1450.8
4730249484,1,79,0,0,10,9,2,0,0,0,0,18367,7.2,18674,202,56,99,1041,25.8,1836.7,11,0,1,9,10,7,0,0,0,0,18268,6.8,17633,184,52,-99,-1041,23.6,1826.8
4729287656,1,11,2,0,4,7,5,0,0,0,0,15709,7.0,17555,199,65,-1024,-872,26.4,1570.9,9,0,1,7,4,3,0,0,0,0,16733,6.8,18427,209,57,1024,872,26.6,1673.3
4856634134,0,12,1,0,7,4,5,0,0,0,0,16208,7.2,18502,223,48,801,1995,27.1,1620.8,14,0,1,4,7,4,0,0,0,0,15407,7.0,16507,178,44,-801,-1995,22.2,1540.7
4856613456,0,15,1,1,6,5,3,1,1,0,0,16908,7.0,18415,211,52,1389,1942,26.3,1690.8,14,0,0,5,6,5,0,0,0,0,15519,6.6,16473,173,44,-1389,-1942,21.7,1551.9
4856593499,0,16,0,1,7,6,7,1,1,0,0,16747,6.8,17194,215,52,1029,1231,26.7,1674.7,10,4,0,6,7,3,0,0,0,0,15718,6.6,15963,184,48,-1029,-1231,23.2,1571.8
4855051810,1,12,1,1,8,4,12,0,0,0,0,17393,6.6,16385,180,36,-402,-1655,21.6,1739.3,11,3,0,4,8,4,0,0,0,0,17795,6.8,18040,236,36,402,1655,27.2,1779.5
4855023997,1,8,2,0,12,4,10,1,1,0,0,21584,7.0,19593,245,48,5763,2949,29.3,2158.4,11,1,1,4,12,3,0,0,0,0,15821,6.8,16644,157,72,-5763,-2949,22.9,1582.1
4854990490,1,11,0,1,9,3,8,1,1,0,0,18363,7.2,18701,228,62,3272,1901,29.0,1836.3,13,1,0,3,9,2,0,0,0,0,15091,6.8,16800,204,50,-3272,-1901,25.4,1509.1
4854244814,1,14,1,0,6,12,4,0,0,0,0,15999,6.2,14776,166,32,-2975,-1765,19.8,1599.9,199,0,1,12,6,12,0,0,0,0,18974,6.8,16541,176,40,2975,1765,21.6,1897.4
4854198574,0,11,0,0,8,3,5,1,1,0,0,17853,7.0,18068,190,40,2932,1297,23.0,1785.3,31,0,1,3,8,2,0,0,0,0,14921,6.6,16771,172,56,-2932,-1297,22.8,1492.1
4854153602,1,14,0,1,7,4,7,1,1,0,0,16921,6.4,16628,166,56,2363,1314,22.2,1692.1,14,0,0,4,7,2,0,0,0,0,14558,6.4,15314,199,28,-2363,-1314,22.7,1455.8
4850470935,1,98,0,1,11,2,13,0,0,0,0,19386,6.8,18015,208,48,3466,991,25.6,1938.6,13,7,0,2,11,1,1,1,0,0,15920,6.6,17024,177,52,-3466,-991,22.9,1592.0
4849725519,1,38,1,1,4,5,3,1,1,0,0,16402,7.0,17709,215,52,97,162,26.7,1640.2,21,11,0,5,4,4,0,0,0,0,16305,7.0,17547,201,45,-97,-162,24.6,1630.5
4849691533,1,15,0,1,3,5,1,0,0,0,0,14968,6.6,17489,226,62,-903,41,28.8,1496.8,12,2,0,5,3,6,0,0,0,0,15871,6.8,17448,193,50,903,-41,24.3,1587.1
4849663129,1,12,2,0,10,5,8,1,1,0,0,18221,7.0,18526,170,56,2473,2109,22.6,1822.1,8,1,1,5,10,4,0,0,0,0,15748,6.8,16417,168,50,-2473,-2109,21.8,1574.8
4849625359,0,18,0,0,3,7,2,0,0,0,0,15584,6.8,18614,212,56,-1087,-1570,26.8,1558.4,11,1,1,7,3,4,0,0,0,0,16671,7.2,20184,232,51,1087,1570,28.3,1667.1
4847787472,0,12,2,0,6,8,3,1,1,0,0,16296,6.8,18073,182,56,-2038,1729,23.8,1629.6,12,0,1,8,6,9,0,0,0,0,18334,6.4,16344,199,48,2038,-1729,24.7,1833.4
4847759234,0,8,0,0,2,4,1,0,0,0,0,13355,6.8,16707,176,48,-3279,-1986,22.4,1335.5,13,0,1,4,2,3,0,0,0,0,16634,6.8,18693,226,48,3279,1986,27.4,1663.4
4847715954,0,13,0,0,3,3,4,0,0,0,0,15167,7.0,18275,216,52,116,-522,26.8,1516.7,9,0,1,3,3,0,0,0,0,0,15051,7.2,18797,248,52,-116,522,30.0,1505.1
4845320565,0,119,1,0,5,7,5,1,1,0,0,14950,6.8,17170,218,44,-2926,-377,26.2,1495.0,10,1,1,6,4,4,0,0,0,0,17876,6.8,17547,221,52,2926,377,27.3,1787.6
4820899914,0,13,1,1,10,3,13,1,1,0,0,17770,7.0,17119,199,48,951,-407,24.7,1777.0,14,0,0,3,10,3,1,0,1,0,16819,6.8,17526,207,56,-951,407,26.3,1681.9
4820836129,0,10,2,0,2,4,3,0,0,0,0,13885,6.8,17685,177,64,-2155,-730,24.1,1388.5,17,3,1,4,2,12,1,1,0,0,16040,7.0,18415,224,76,2155,730,30.0,1604.0
4820808115,1,14,0,1,26,11,67,0,0,0,0,37491,11.2,40725,89,56,3490,5030,14.5,3749.1,24,0,0,11,26,20,0,0,0,0,34001,10.4,35695,81,67,-3490,-5030,14.8,3400.1
4819522165,0,36,0,1,8,6,7,0,0,0,0,17301,6.8,17946,217,48,506,-536,26.5,1730.1,7,17,0,6,8,5,0,0,0,0,16795,6.8,18482,181,60,-506,536,24.1,1679.5
4819493165,1,15,2,1,3,8,9,0,0,0,0,14797,6.8,17117,196,56,-3828,-2504,25.2,1479.7,15,2,0,8,3,12,1,1,0,0,18625,7.2,19621,245,64,3828,2504,30.9,1862.5
4819481441,1,35,2,1,20,6,26,0,0,0,0,33224,10.8,37241,87,51,-612,200,13.8,3322.4,16,0,0,6,20,7,0,0,0,0,33836,10.4,37041,86,63,612,-200,14.9,3383.6
4818886282,0,15,0,1,17,16,23,0,0,0,1,34970,11.0,40010,97,55,-1650,-1201,15.2,3497.0,10,0,0,15,16,40,0,0,0,0,36620,11.2,41211,115,47,1650,1201,16.2,3662.0
4818864015,1,14,0,1,15,12,18,0,0,0,1,36575,11.2,39274,82,67,3677,3804,14.9,3657.5,174,0,0,12,15,21,0,0,0,0,32898,10.2,35470,99,59,-3677,-3804,15.8,3289.8
4818838253,0,35,0,0,9,12,20,0,0,0,0,28153,10.2,34120,82,51,-6634,-3360,13.3,2815.3,15,4,1,12,9,14,0,0,0,0,34787,10.6,37480,96,71,6634,3360,16.7,3478.7
4817753986,0,10,1,1,6,9,10,0,0,0,0,30033,10.6,35673,81,59,-4022,-5027,14.0,3003.3,26,0,0,9,6,15,0,0,0,0,34055,11.4,40700,115,72,4022,5027,18.7,3405.5
4817746798,1,24,1,1,20,19,40,0,0,0,0,35799,11.4,41415,84,67,-2186,-3337,15.1,3579.9,110,2,0,19,20,54,0,0,0,0,37985,11.8,44752,123,55,2186,3337,17.8,3798.5
4817723004,0,10,1,0,13,20,30,0,0,0,0,30488,11.0,40129,68,58,-9268,-6163,12.6,3048.8,11,0,1,20,13,39,0,0,0,0,39756,12.0,46292,85,79,9268,6163,16.4,3975.6
4817716811,1,15,2,0,23,10,36,0,0,0,2,39143,12.0,46713,124,63,5389,7302,18.7,3914.3,98,0,1,10,23,16,0,0,0,0,33754,11.0,39411,78,62,-5389,-7302,14.0,3375.4
4779955412,1,13,1,1,9,5,11,1,0,1,0,19161,7.0,18699,226,56,3745,1772,28.2,1916.1,13,1,0,5,9,5,1,1,0,0,15416,6.8,16927,213,40,-3745,-1772,25.3,1541.6
4778055568,0,13,1,0,3,7,4,0,0,0,0,14717,6.6,16448,179,51,-3297,-1733,23.0,1471.7,14,1,1,7,3,5,0,0,0,0,18014,6.8,18181,223,49,3297,1733,27.2,1801.4
4778003065,0,28,2,0,4,4,7,0,0,0,0,17055,7.0,17658,203,48,2435,1257,25.1,1705.5,25,6,1,4,4,3,1,1,0,0,14620,6.6,16401,194,52,-2435,-1257,24.6,1462.0
4777481914,0,17,1,1,9,10,15,1,0,1,0,19629,6.8,17003,186,48,1255,297,23.4,1962.9,21,0,0,10,9,16,1,1,0,0,18374,6.6,16706,192,58,-1255,-297,25.0,1837.4
4776221103,1,15,1,1,6,1,4,2,1,1,0,18965,7.0,18245,214,56,4320,1800,27.0,1896.5,12,2,0,1,6,0,0,0,0,0,14645,6.8,16445,216,46,-4320,-1800,26.2,1464.5
4776164465,0,33,2,1,1,1,1,0,0,0,0,14577,6.6,17442,194,52,1374,988,24.6,1457.7,73,7,0,1,1,0,1,1,0,0,13203,6.6,16454,181,60,-1374,-988,24.1,1320.3
4851088669,0,0,0,0,30,18,80,0,0,0,0,40607,11.6,44013,113,0,4814,5853,11.3,4060.7,0,0,1,18,30,37,0,0,0,0,35793,10.8,38160,94,0,-4814,-5853,9.4,3579.3
4841605696,1,34,0,0,24,28,55,0,0,0,0,37276,11.4,42237,105,0,-134,-1259,10.5,3727.6,34,0,1,28,24,71,0,0,0,0,37410,11.4,43496,121,0,134,1259,12.1,3741.0
4841522817,1,5,0,0,40,37,91,0,0,0,0,41415,12.4,47736,91,0,-424,921,9.1,4141.5,0,0,1,37,40,71,0,0,0,0,41839,12.0,46815,91,0,424,-921,9.1,4183.9
4841161475,1,26,0,1,28,15,83,0,0,0,1,40183,11.8,44167,117,0,6778,7995,11.7,4018.3,0,9,0,15,28,33,0,0,0,0,33405,10.4,36172,98,0,-6778,-7995,9.8,3340.5
4840923815,1,55,0,0,26,22,74,0,0,0,0,37759,11.4,41758,106,0,2402,3234,10.6,3775.9,0,0,1,22,26,58,0,0,0,0,35357,11.0,38524,113,0,-2402,-3234,11.3,3535.7
4840896909,1,9,0,1,22,29,49,0,0,0,2,38167,11.2,40807,114,0,-580,-3070,11.4,3816.7,0,0,0,29,22,76,0,0,0,0,38747,11.8,43877,89,0,580,3070,8.9,3874.7
4840587367,1,0,3,0,23,29,59,0,0,0,1,38255,11.2,41252,123,0,-171,-1083,12.3,3825.5,16,0,1,28,22,57,0,0,0,0,38426,11.2,42335,108,0,171,1083,10.8,3842.6
4840567419,0,0,0,0,27,33,68,0,0,0,2,38155,11.2,40902,109,0,-2936,-2133,10.9,3815.5,0,0,1,33,27,91,0,0,0,0,41091,11.4,43035,120,0,2936,2133,12.0,4109.1
4840540373,1,0,0,1,27,21,63,0,0,0,0,36875,11.4,42206,102,0,-55,323,10.2,3687.5,0,0,0,21,27,57,0,0,0,0,36930,11.4,41883,104,0,55,-323,10.4,3693.0
4838445425,0,53,1,0,3,6,1,0,0,0,0,14233,6.6,16692,150,52,-2923,-1571,20.2,1423.3,10,2,1,6,3,6,1,1,0,0,17156,7.0,18263,205,58,2923,1571,26.3,1715.6
4835578493,1,13,1,0,5,2,6,0,0,0,0,17160,7.2,18805,203,52,3046,2332,25.5,1716.0,12,1,1,2,5,3,0,0,0,0,14114,6.6,16473,176,52,-3046,-2332,22.8,1411.4
4835446139,0,0,0,0,19,31,57,0,0,0,0,36849,11.0,40987,89,0,-2956,-3996,8.9,3684.9,0,0,1,31,19,84,0,0,0,0,39805,11.8,44983,123,0,2956,3996,12.3,3980.5
4835382375,0,11,0,0,4,3,3,0,0,0,0,15385,6.8,17187,191,64,-679,-297,25.5,1538.5,112,1,1,3,4,2,0,0,0,0,16064,6.8,17484,185,52,679,297,23.7,1606.4
4835345272,1,11,1,0,7,6,8,1,1,0,0,16355,7.0,18208,180,59,44,705,23.9,1635.5,13,1,1,6,7,5,0,0,0,0,16311,7.0,17503,214,52,-44,-705,26.6,1631.1
4835328300,1,0,0,1,28,18,74,0,0,0,1,38556,11.4,41318,99,0,2031,1214,9.9,3855.6,0,0,0,18,28,44,0,0,0,0,36525,11.4,40104,94,0,-2031,-1214,9.4,3652.5
4835307699,0,37,0,1,26,34,52,0,0,0,0,37930,11.4,41934,105,0,-2464,-4804,10.5,3793.0,34,2,0,34,26,79,0,0,0,0,40394,12.0,46738,99,0,2464,4804,9.9,4039.4
4834714710,0,5,2,0,2,7,1,0,0,0,0,14046,6.6,17148,184,48,-2636,-1581,23.2,1404.6,17,0,1,7,2,4,1,1,0,0,16682,7.0,18729,220,60,2636,1581,28.0,1668.2
4833304546,0,14,0,0,2,7,2,0,0,0,0,13915,6.8,17237,172,52,-3188,-599,22.4,1391.5,12,0,1,7,2,8,0,0,0,0,17103,7.0,17836,194,40,3188,599,23.4,1710.3
4824128934,0,0,0,0,28,24,70,0,0,0,1,38680,11.0,41120,109,0,2937,2536,10.9,3868.0,0,0,1,24,28,61,0,0,0,0,35743,10.6,38584,98,0,-2937,-2536,9.8,3574.3
4813385908,1,0,0,0,29,29,71,0,0,0,0,38643,11.2,42560,107,0,214,-1453,10.7,3864.3,0,0,1,29,29,56,0,0,0,0,38429,11.6,44013,117,0,-214,1453,11.7,3842.9
4857589173,1,8,0,1,17,16,22,0,0,0,0,63110,13.0,62500,0,0,26960,25000,0.0,6311.0,0,0,0,10,11,7,0,0,0,0,36150,7.8,37500,0,0,-26960,-25000,0.0,3615.0
4857576857,1,0,5,1,22,15,16,0,0,0,0,48305,10.0,47500,8,0,21855,19000,0.8,4830.5,20,0,0,3,10,7,0,0,0,0,26450,6.0,28500,0,0,-21855,-19000,0.0,2645.0
4857556350,1,39,0,1,18,18,18,0,0,0,0,48200,10.0,47500,3,0,18950,19000,0.3,4820.0,0,0,0,11,11,11,0,0,0,0,29250,6.0,28500,0,0,-18950,-19000,0.0,2925.0
4857492845,1,17,4,1,18,14,18,0,0,0,0,55325,12.2,56000,1,0,18500,23000,0.1,5532.5,30,0,0,8,12,8,0,0,0,0,36825,7.2,33000,13,0,-18500,-23000,1.3,3682.5
4857469642,1,36,1,0,16,23,13,0,0,0,0,59955,12.6,59500,2,0,20655,22000,0.2,5995.5,0,0,1,13,6,17,0,0,0,0,39300,7.8,37500,0,0,-20655,-22000,0.0,3930.0
4856672288,1,1,0,0,17,23,26,0,0,0,0,64600,12.0,55000,0,0,24856,22000,0.0,6460.0,0,0,1,17,11,8,0,0,0,0,39744,7.2,33000,0,0,-24856,-22000,0.0,3974.4
4856671922,1,0,0,0,18,13,22,0,0,0,0,63711,13.0,61500,0,0,27861,27000,0.0,6371.1,0,0,1,7,12,6,0,0,0,0,35850,7.4,34500,1,0,-27861,-27000,0.1,3585.0
4856663278,1,0,0,0,15,17,22,0,0,0,0,50545,12.0,55000,0,0,22270,22000,0.0,5054.5,0,0,1,14,12,9,0,0,0,0,28275,7.2,33000,0,0,-22270,-22000,0.0,2827.5
4856653707,1,11,0,0,14,13,13,0,0,0,0,45600,10.2,48680,0,0,18100,20180,0.0,4560.0,264,0,1,8,9,8,0,0,0,0,27500,6.0,28500,0,0,-18100,-20180,0.0,2750.0
4856648535,1,0,0,1,13,16,17,0,0,0,0,47400,10.0,47500,5,0,19550,19000,0.5,4740.0,6,0,0,12,9,12,0,0,0,0,27850,6.0,28500,6,0,-19550,-19000,0.6,2785.0
4856642300,1,0,0,1,19,17,24,0,0,0,0,48050,10.0,47500,0,0,18900,19000,0.0,4805.0,0,0,0,11,13,7,0,0,0,0,29150,6.0,28500,0,0,-18900,-19000,0.0,2915.0
4856631651,1,0,0,0,26,14,16,0,0,0,0,49100,12.0,55000,0,0,20200,22000,0.0,4910.0,0,0,1,8,20,16,0,0,0,0,28900,7.2,33000,0,0,-20200,-22000,0.0,2890.0
4856629764,1,28,4,1,20,15,16,0,0,0,0,51752,10.4,49000,5,0,23844,20500,0.5,5175.2,0,6,0,7,12,10,0,0,0,0,27908,6.0,28500,0,0,-23844,-20500,0.0,2790.8
4856451852,1,5,0,0,16,18,22,0,0,0,0,46425,10.0,47500,0,0,16805,19000,0.0,4642.5,2,0,1,11,9,7,0,0,0,0,29620,6.0,28500,0,0,-16805,-19000,0.0,2962.0
4856424829,1,0,0,1,23,18,18,0,0,0,0,63750,13.0,62500,0,0,26200,28000,0.0,6375.0,0,0,0,8,13,9,0,0,0,0,37550,7.4,34500,0,0,-26200,-28000,0.0,3755.0
4855502789,1,486,0,0,13,21,19,0,0,0,0,48780,10.4,49000,0,0,20098,20500,0.0,4878.0,0,0,1,15,7,10,0,0,0,0,28682,6.0,28500,2,0,-20098,-20500,0.2,2868.2
4855485359,1,0,1,0,17,17,21,0,0,0,0,61032,12.0,55000,1,0,32782,22000,0.1,6103.2,24,0,1,10,10,11,0,0,0,0,28250,7.2,33000,0,0,-32782,-22000,0.0,2825.0
4855479753,1,0,1,1,19,14,19,0,0,0,0,46810,10.0,47500,3,0,19660,19000,0.3,4681.0,15,0,0,9,14,7,0,0,0,0,27150,6.0,28500,0,0,-19660,-19000,0.0,2715.0
4855458605,1,0,0,1,18,17,15,0,0,0,0,48167,10.2,48680,0,1,19617,20180,0.1,4816.7,0,0,0,8,9,8,0,0,0,0,28550,6.0,28500,0,0,-19617,-20180,0.0,2855.0
4855418275,1,0,0,0,23,21,22,0,0,0,0,66644,12.0,55000,0,0,26990,22000,0.0,6664.4,0,0,1,13,15,12,0,0,0,0,39654,7.2,33000,0,0,-26990,-22000,0.0,3965.4
4856255542,1,8,0,0,9,9,5,0,0,0,0,16347,6.8,17722,214,48,-532,326,26.2,1634.7,11,0,1,9,9,8,0,0,0,0,16879,6.8,17396,191,44,532,-326,23.5,1687.9
4856167448,1,14,0,0,2,3,3,1,1,0,0,14924,6.6,16514,209,44,-893,-2180,25.3,1492.4,8,1,1,3,2,3,0,0,0,0,15817,7.0,18694,210,44,893,2180,25.4,1581.7
4856097709,1,11,0,0,1,3,0,0,0,0,0,13741,6.6,16782,167,52,-1114,-1095,21.9,1374.1,134,0,1,3,1,3,0,0,0,0,14855,6.8,17877,194,40,1114,1095,23.4,1485.5
4856067823,1,9,0,1,2,5,0,0,0,0,0,15298,6.8,18246,189,56,237,-456,24.5,1529.8,83,0,0,5,2,2,1,1,0,0,15061,7.2,18702,174,64,-237,456,23.8,1506.1
4856027560,0,13,2,1,5,7,3,1,1,0,0,16260,7.2,18300,223,46,60,282,26.9,1626.0,12,1,0,7,5,5,0,0,0,0,16200,7.0,18018,186,49,-60,-282,23.5,1620.0
4856000785,1,13,1,0,3,5,2,0,0,0,0,14375,7.0,18366,173,52,-1629,-371,22.5,1437.5,9,0,1,5,3,3,0,0,0,0,16004,7.0,18737,184,52,1629,371,23.6,1600.4
4855337689,1,1,0,1,24,11,20,0,0,0,0,64300,12.0,55000,0,0,28500,21000,0.0,6430.0,7,0,0,4,17,7,0,0,0,0,35800,7.4,34000,0,0,-28500,-21000,0.0,3580.0
4855323800,1,31,0,0,16,16,15,0,0,0,0,46725,10.0,47500,3,0,17470,19000,0.3,4672.5,0,0,1,12,12,12,0,0,0,0,29255,6.0,28500,0,0,-17470,-19000,0.0,2925.5
4854161065,1,9,1,0,7,3,5,0,0,0,0,16724,7.2,18725,195,48,1989,436,24.3,1672.4,12,0,1,3,7,1,1,1,0,0,14735,6.8,18289,205,64,-1989,-436,26.9,1473.5
4854078572,1,5,2,1,6,3,6,0,0,0,0,16069,6.8,17660,182,56,1093,63,23.8,1606.9,14,1,0,3,6,2,0,0,0,0,14976,6.8,17597,186,48,-1093,-63,23.4,1497.6
4854026039,1,7,1,1,5,5,5,0,0,0,0,15404,6.6,17151,185,56,-66,-545,24.1,1540.4,11,0,0,5,5,6,0,0,0,0,15470,6.8,17696,218,40,66,545,25.8,1547.0
4850995154,0,37,0,0,2,8,0,0,0,0,0,13965,7.0,18204,189,68,-4082,-478,25.7,1396.5,14,9,1,8,2,5,1,1,0,0,18047,7.0,18682,227,64,4082,478,29.1,1804.7
4850940951,0,13,0,1,7,2,2,1,1,0,0,14942,6.6,17362,154,60,764,182,21.4,1494.2,14,0,0,2,7,1,0,0,0,0,14178,7.0,17180,193,40,-764,-182,23.3,1417.8
4850895574,1,12,0,1,6,4,10,1,1,0,0,16226,7.0,17832,195,40,720,-283,23.5,1622.6,8,0,0,4,6,2,0,0,0,0,15506,6.8,18115,185,64,-720,283,24.9,1550.6
4850851024,1,9,0,1,4,1,2,0,0,0,0,14497,7.0,17265,188,40,1690,359,22.8,1449.7,11,0,0,1,4,1,0,0,0,0,12807,6.6,16906,160,52,-1690,-359,21.2,1280.7
4849754762,1,7,1,1,10,1,11,1,1,0,0,17734,7.2,19469,191,52,3528,2101,24.3,1773.4,19,0,0,1,10,0,0,0,0,0,14206,6.6,17368,204,56,-3528,-2101,26.0,1420.6
4849692396,1,8,0,0,5,7,0,0,0,0,0,16180,7.0,18886,186,68,715,1216,25.4,1618.0,9,0,1,7,5,4,0,0,0,0,15465,6.8,17670,182,56,-715,-1216,23.8,1546.5
4849659693,0,8,0,1,4,9,0,0,0,0,0,14754,6.8,16818,173,52,-2758,-868,22.5,1475.4,11,0,0,9,4,7,0,0,0,0,17512,7.0,17686,185,56,2758,868,24.1,1751.2
4849171083,1,20,0,0,2,5,0,0,0,0,0,14217,6.4,17061,181,62,-50,-515,24.3,1421.7,6,4,1,5,2,0,0,0,0,0,14267,6.6,17576,166,57,50,515,22.3,1426.7
4854939071,1,9,1,0,5,4,4,0,0,0,0,16237,7.2,18040,201,52,563,790,25.3,1623.7,49,2,1,4,5,6,1,1,0,0,15674,7.0,17250,187,52,-563,-790,23.9,1567.4
4854897276,1,12,0,1,7,7,10,1,0,1,0,17574,7.0,17799,222,60,595,-1148,28.2,1757.4,7,0,0,7,7,2,1,1,0,0,16979,7.2,18947,213,56,-595,1148,26.9,1697.9
4848503169,0,12,0,0,4,19,5,0,0,0,0,16586,6.2,14366,139,44,-5117,-3777,18.3,1658.6,11,1,1,19,4,20,1,1,0,0,21703,7.0,18143,197,48,5117,3777,24.5,2170.3
4848489304,0,11,0,1,5,6,5,0,0,0,0,16396,6.4,16476,173,51,200,-546,22.4,1639.6,15,2,0,6,5,5,1,1,0,0,16196,6.6,17022,182,56,-200,546,23.8,1619.6
4848149232,1,10,0,0,3,4,3,0,0,0,0,12922,6.0,15047,150,39,-3350,-2466,18.9,1292.2,12,2,1,4,3,4,0,0,0,0,16272,6.8,17513,194,52,3350,2466,24.6,1627.2
4848112592,1,11,2,0,5,3,4,0,0,0,0,15672,6.6,16855,199,52,1537,471,25.1,1567.2,12,1,1,3,5,1,1,1,0,0,14135,6.6,16384,173,60,-1537,-471,23.3,1413.5
4848079238,1,14,3,1,8,7,5,0,0,0,0,17034,6.8,17135,191,44,-755,-1238,23.5,1703.4,15,0,0,7,8,6,0,0,0,0,17789,6.8,18373,184,56,755,1238,24.0,1778.9
4848037746,0,11,1,1,4,6,5,0,0,0,0,15321,6.6,17302,192,44,-1584,-1081,23.6,1532.1,14,1,0,5,3,6,1,1,0,0,16905,7.0,18383,184,60,1584,1081,24.4,1690.5
4847975181,0,8,1,0,7,8,4,1,1,0,0,16319,6.4,15323,141,48,-341,-629,18.9,1631.9,71,1,1,8,7,8,0,0,0,0,16660,6.4,15952,174,31,341,629,20.5,1666.0
4845820161,0,10,15,0,4,4,2,1,0,1,0,15230,7.0,18107,184,59,-969,-722,24.3,1523.0,26,1,1,4,4,2,1,1,0,0,16199,7.2,18829,223,56,969,722,27.9,1619.9
4845780171,0,72,0,0,3,3,1,1,1,0,0,15803,7.6,20129,203,72,630,2444,27.5,1580.3,10,1,1,3,3,2,0,0,0,0,15173,6.8,17685,198,56,-630,-2444,25.4,1517.3
4845703899,1,18,1,1,3,6,1,0,0,0,0,15329,7.0,18286,214,52,-1895,-496,26.6,1532.9,13,2,0,6,3,5,0,0,0,0,17224,7.0,18782,224,48,1895,496,27.2,1722.4
4845676599,1,14,2,0,6,3,6,1,1,0,0,17413,6.6,16688,202,51,3539,2662,25.3,1741.3,40,2,1,3,6,6,1,0,1,0,13874,6.0,14026,135,36,-3539,-2662,17.1,1387.4
4834321914,0,0,1,1,24,26,54,0,0,0,1,38782,11.2,40917,108,0,-554,-1339,10.8,3878.2,19,0,0,26,24,70,0,0,0,0,39336,11.6,42256,104,0,554,1339,10.4,3933.6
4834299591,0,0,0,0,30,33,86,0,0,0,2,38359,11.6,43201,96,0,-2586,-1303,9.6,3835.9,0,0,1,33,30,73,0,0,0,0,40945,11.8,44504,94,0,2586,1303,9.4,4094.5
4834281260,1,0,0,0,23,30,54,0,0,0,1,36734,11.2,40817,97,0,-2208,-4028,9.7,3673.4,0,0,1,30,23,74,0,0,0,0,38942,11.8,44845,99,0,2208,4028,9.9,3894.2
4832867695,0,34,0,1,27,26,51,0,0,0,0,39277,11.0,40648,101,0,2535,-1472,10.1,3927.7,41,0,0,25,26,61,0,0,0,0,36742,11.2,42120,96,0,-2535,1472,9.6,3674.2
4832853103,0,10,0,1,18,27,50,0,0,0,1,37626,11.2,39373,112,0,54,-2080,11.2,3762.6,0,1,0,27,18,82,0,0,0,0,37572,11.0,41453,109,0,-54,2080,10.9,3757.2
4832835268,0,0,0,1,17,18,38,0,0,0,0,34500,10.6,36507,106,0,290,-1213,10.6,3450.0,0,0,0,18,17,38,0,0,0,0,34210,10.8,37720,108,0,-290,1213,10.8,3421.0
4832823771,0,37,0,0,28,35,70,0,0,0,1,39063,11.2,42274,93,0,-2671,-3352,9.3,3906.3,34,0,1,35,28,108,0,0,0,0,41734,11.8,45626,114,0,2671,3352,11.4,4173.4
4828696379,0,12,2,0,4,4,6,0,0,0,0,15785,6.8,17166,203,48,-205,-1455,25.1,1578.5,16,4,1,4,4,0,0,0,0,0,15990,6.8,18621,220,64,205,1455,28.4,1599.0
4827333210,1,12,17,0,9,8,7,0,0,0,0,18786,7.2,18405,185,48,1526,293,23.3,1878.6,34,0,1,8,9,10,0,0,0,0,17260,7.0,18112,200,48,-1526,-293,24.8,1726.0
4827295213,0,14,1,0,4,8,4,0,0,0,0,15970,6.8,17682,180,56,-2617,-816,23.6,1597.0,138,3,1,8,4,14,1,1,0,0,18587,7.0,18498,238,44,2617,816,28.2,1858.7
4826689773,0,23,0,0,5,6,0,0,0,0,0,16473,7.0,18543,209,47,308,734,25.6,1647.3,20,1,1,6,5,4,0,0,0,0,16165,7.0,17809,197,58,-308,-734,25.5,1616.5
4824369321,1,51,0,1,5,2,2,1,1,0,0,16356,7.2,19128,238,52,2167,2105,29.0,1635.6,11,1,0,2,5,0,0,0,0,0,14189,6.6,17023,203,64,-2167,-2105,26.7,1418.9
4822679287,0,28,0,1,4,2,1,0,0,0,0,16122,7.0,17792,222,64,948,-516,28.6,1612.2,30,0,0,2,4,1,0,0,0,0,15174,7.0,18308,214,52,-948,516,26.6,1517.4
4820240064,1,16,1,0,3,4,2,0,0,0,0,14900,6.8,18285,205,62,-478,899,26.7,1490.0,19,1,1,4,3,3,0,0,0,0,15378,6.8,17386,209,57,478,-899,26.6,1537.8
4810057130,0,12,0,0,6,4,8,0,0,0,0,16279,6.8,16981,192,52,24,-888,24.4,1627.9,18,0,1,4,6,3,0,0,0,0,16255,6.8,17869,202,66,-24,888,26.8,1625.5
4810039812,0,13,1,0,7,9,6,0,0,0,0,17164,7.0,18345,228,52,-688,-879,28.0,1716.4,13,2,1,9,7,5,0,0,0,0,17852,7.4,19224,216,56,688,879,27.2,1785.2
4810000579,0,69,1,0,3,5,2,2,1,1,0,15363,7.0,17812,179,56,-1114,-966,23.5,1536.3,10,0,1,5,3,3,0,0,0,0,16477,7.0,18778,226,54,1114,966,28.0,1647.7
4809114558,1,10,0,1,9,4,7,0,0,0,0,18212,7.2,18548,213,56,3163,2207,26.9,1821.2,10,1,0,4,9,4,0,0,0,0,15049,6.6,16341,159,48,-3163,-2207,20.7,1504.9
4809100150,1,14,9,1,9,5,8,1,1,0,0,18373,6.8,17477,197,40,1302,-1752,23.7,1837.3,51,2,0,5,9,0,0,0,0,0,17071,7.2,19229,196,72,-1302,1752,26.8,1707.1
4809071208,0,12,0,1,3,4,1,1,1,0,0,15540,7.2,19449,206,72,-89,1134,27.8,1554.0,13,0,0,4,3,3,0,0,0,0,15629,7.0,18315,222,64,89,-1134,28.6,1562.9
4809048782,1,15,0,0,5,4,3,0,0,0,0,15396,6.8,18274,212,52,-64,-40,26.4,1539.6,11,1,1,4,5,2,0,0,0,0,15460,7.0,18314,221,60,64,40,28.1,1546.0
4487191978,1,11,1,1,6,3,8,1,1,0,0,17400,6.8,17878,185,59,2713,1019,24.4,1740.0,18,1,0,3,6,3,0,0,0,0,14687,6.6,16859,198,48,-2713,-1019,24.6,1468.7
4465512205,1,41,1,1,5,4,5,1,1,0,0,18193,7.2,18270,177,56,1721,497,23.3,1819.3,9,3,0,4,5,5,0,0,0,0,16472,6.8,17773,204,64,-1721,-497,26.8,1647.2
4465419317,1,152,2,0,8,4,4,0,0,0,0,18187,7.2,19615,183,63,1991,2717,24.6,1818.7,19,0,1,4,8,3,0,0,0,0,16196,6.6,16898,189,44,-1991,-2717,23.3,1619.6
4465444235,1,12,0,0,2,2,3,0,0,0,0,15524,7.0,18273,202,44,1039,606,24.6,1552.4,16,1,1,2,2,0,0,0,0,0,14485,7.0,17667,200,52,-1039,-606,25.2,1448.5
4465237037,0,12,0,0,3,7,1,0,0,0,0,14828,6.4,16290,180,44,-1668,-1091,22.4,1482.8,8,1,1,7,3,6,0,0,0,0,16496,6.8,17381,191,40,1668,1091,23.1,1649.6
4772977950,0,16,2,0,5,2,4,0,0,0,0,16342,7.0,18286,209,44,1402,393,25.3,1634.2,11,1,1,2,5,1,1,1,0,0,14940,7.2,17893,204,68,-1402,-393,27.2,1494.0
4771969463,1,16,4,1,6,5,4,0,0,0,0,16209,7.0,17563,184,56,-811,-830,24.0,1620.9,13,5,0,5,6,3,0,0,0,0,17020,7.2,18393,218,56,811,830,27.4,1702.0
4754137640,1,162,0,1,26,28,61,0,0,0,2,38739,11.4,41695,112,0,1387,-424,11.2,3873.9,16,0,0,28,26,61,0,0,0,0,37352,11.4,42119,92,0,-1387,424,9.2,3735.2
4753484060,1,0,1,1,16,18,12,0,0,0,0,60955,12.0,55000,0,0,22289,22000,0.0,6095.5,36,0,0,9,7,11,0,0,0,0,38666,7.2,33000,9,0,-22289,-22000,0.9,3866.6
4753468944,1,20,0,1,11,16,8,0,0,0,0,46004,10.0,47500,2,0,17284,19000,0.2,4600.4,3,6,0,10,5,13,0,0,0,0,28720,6.0,28500,6,0,-17284,-19000,0.6,2872.0
4753429824,1,15,0,0,4,2,2,0,0,0,0,14932,7.2,18201,203,57,-376,-505,26.0,1493.2,14,0,1,2,4,1,0,0,0,0,15308,7.0,18706,196,68,376,505,26.4,1530.8
4753411667,0,38,0,0,7,3,2,0,0,0,0,15604,6.6,17600,202,40,231,-245,24.2,1560.4,12,0,1,3,7,3,1,1,0,0,15373,7.0,17845,183,68,-231,245,25.1,1537.3
4753305797,0,22,0,0,2,5,1,0,0,0,0,13911,7.0,17933,185,44,-3707,-931,22.9,1391.1,21,3,1,5,2,4,0,0,0,0,17618,7.2,18864,226,52,3707,931,27.8,1761.8
4753282015,1,12,1,1,8,3,2,1,1,0,0,17724,6.8,18151,196,52,1301,769,24.8,1772.4,16,1,0,3,8,3,0,0,0,0,16423,6.8,17382,178,44,-1301,-769,22.2,1642.3
4753269388,0,21,0,0,2,9,5,0,0,0,0,13861,6.6,15912,181,56,-3312,-2242,23.7,1386.1,19,3,1,9,2,3,1,1,0,0,17173,6.8,18154,205,52,3312,2242,25.7,1717.3
4752451993,1,17,1,0,9,3,9,1,1,0,0,18419,7.0,18547,205,60,3539,1148,26.5,1841.9,10,1,1,3,9,5,0,0,0,0,14880,6.8,17399,196,52,-3539,-1148,24.8,1488.0
4752430479,1,41,1,1,5,2,3,0,0,0,0,15020,7.0,17957,156,72,1502,-13,22.8,1502.0,12,0,0,2,5,1,1,1,0,0,13518,6.8,17970,184,48,-1502,13,23.2,1351.8
4733200697,0,10,0,0,1,9,1,0,0,0,0,14367,6.6,16851,191,60,-4213,-1713,25.1,1436.7,85,1,1,9,1,7,1,0,1,0,18580,7.0,18564,192,56,4213,1713,24.8,1858.0
4731962289,0,101,2,0,2,5,2,0,0,0,0,15772,7.0,18184,193,64,-316,1628,25.7,1577.2,12,2,1,5,2,8,1,1,0,0,16088,6.6,16556,166,60,316,-1628,22.6,1608.8
4731941672,0,13,2,0,3,3,3,0,0,0,0,14678,6.8,17261,182,44,-1961,-929,22.6,1467.8,13,2,1,3,3,2,1,1,0,0,16639,6.8,18190,214,72,1961,929,28.6,1663.9
4503500950,1,35,2,1,8,2,6,0,0,0,0,18075,7.4,19803,219,48,4252,1899,26.7,1807.5,9,15,0,2,8,0,0,0,0,0,13823,7.0,17904,159,56,-4252,-1899,21.5,1382.3
4446506059,0,12,1,1,6,4,2,0,0,0,0,15885,7.0,18539,188,56,773,1304,24.4,1588.5,9,0,0,4,6,2,1,1,0,0,15112,6.8,17235,205,68,-773,-1304,27.3,1511.2
4446483275,1,11,3,1,6,3,5,1,1,0,0,16931,7.0,18931,222,60,2064,2058,28.2,1693.1,17,0,0,3,6,2,0,0,0,0,14867,6.6,16873,198,48,-2064,-2058,24.6,1486.7
4446429412,0,11,0,1,4,4,7,1,1,0,0,17198,6.8,17694,199,40,255,-75,23.9,1719.8,9,0,0,4,4,4,0,0,0,0,16943,6.8,17769,211,56,-255,75,26.7,1694.3
4434721299,1,15,3,0,4,6,6,1,1,0,0,15206,6.8,16821,162,51,-1691,-1856,21.3,1520.6,15,2,1,6,4,5,0,0,0,0,16897,7.0,18677,221,68,1691,1856,28.9,1689.7
4837235594,1,0,4,1,20,26,36,0,0,0,1,37309,11.4,40064,124,0,-641,-2018,12.4,3730.9,11,0,0,26,20,42,0,0,0,0,37950,11.6,42082,109,0,641,2018,10.9,3795.0
4837204597,0,29,0,1,34,35,88,0,0,0,0,42264,12.2,47649,106,0,3148,1483,10.6,4226.4,0,5,0,35,34,86,0,0,0,0,39116,12.0,46166,108,0,-3148,-1483,10.8,3911.6
4837174870,1,0,0,0,32,37,58,0,0,0,1,40170,11.8,46312,97,0,-1909,-780,9.7,4017.0,26,0,1,37,32,80,0,0,0,0,42079,12.0,47092,95,0,1909,780,9.5,4207.9
4833843582,1,46,0,0,33,34,88,0,0,0,0,39413,11.8,44500,97,0,-892,-2043,9.7,3941.3,0,20,1,34,33,83,0,0,0,0,40305,11.8,46543,95,0,892,2043,9.5,4030.5
4833835966,0,1,0,0,29,31,71,0,0,0,0,38337,11.8,44809,88,0,-1982,670,8.8,3833.7,57,0,1,31,29,74,0,0,0,0,40319,11.8,44139,100,0,1982,-670,10.0,4031.9
4833813114,1,19,0,1,36,33,79,0,0,0,1,40298,11.6,44755,93,0,-560,-1678,9.3,4029.8,0,2,0,32,35,82,0,0,0,0,40858,12.2,46433,112,0,560,1678,11.2,4085.8
4833796805,1,0,3,0,23,39,58,0,0,0,1,37412,11.2,40349,90,0,-6111,-5792,9.0,3741.2,25,0,1,39,23,114,0,0,0,0,43523,12.0,46141,110,0,6111,5792,11.0,4352.3
4833771372,0,0,0,0,33,34,70,0,0,0,1,41502,12.0,47037,104,0,403,1878,10.4,4150.2,0,0,1,34,33,81,0,0,0,0,41099,11.8,45159,103,0,-403,-1878,10.3,4109.9
4833755207,0,0,0,0,12,21,28,0,0,0,0,34046,10.6,36295,114,0,-2114,-2760,11.4,3404.6,2,0,1,21,12,47,0,0,0,0,36160,11.0,39055,110,0,2114,2760,11.0,3616.0
4833726246,0,0,0,1,24,28,59,0,0,0,1,36793,11.0,40942,89,0,-3365,-4182,8.9,3679.3,0,0,0,28,24,55,0,0,0,0,40158,12.0,45124,112,0,3365,4182,11.2,4015.8
4833423216,0,0,0,0,26,35,62,0,0,0,1,37843,11.4,42968,102,0,-2658,-2743,10.2,3784.3,0,0,1,35,26,96,0,0,0,0,40501,12.0,45711,112,0,2658,2743,11.2,4050.1
4831617636,1,342,0,1,39,32,104,0,0,0,1,41413,12.2,47441,103,0,412,2431,10.3,4141.3,13,0,0,32,39,57,0,0,0,0,41001,11.6,45010,107,0,-412,-2431,10.7,4100.1
4831616105,0,12,0,0,27,32,48,0,0,0,1,39225,11.4,43200,98,0,-430,877,9.8,3922.5,0,0,1,32,27,82,0,0,0,0,39655,11.6,42323,99,0,430,-877,9.9,3965.5
4831612047,0,1,0,0,16,22,32,0,0,0,1,34248,10.6,37361,83,0,-3042,-3826,8.3,3424.8,130,0,1,22,16,58,0,0,0,0,37290,11.2,41187,98,0,3042,3826,9.8,3729.0
4831598164,0,0,18,1,27,24,71,0,0,0,0,36408,11.2,40448,104,0,-1105,-2508,10.4,3640.8,26,0,0,24,27,42,0,0,0,0,37513,11.6,42956,115,0,1105,2508,11.5,3751.3
4830239373,0,0,3,1,30,19,79,0,0,0,0,37731,11.0,39813,126,0,2452,1861,12.6,3773.1,16,0,0,19,30,48,0,0,0,0,35279,10.8,37952,92,0,-2452,-1861,9.2,3527.9
4830228835,1,34,0,1,30,23,69,0,0,0,1,38647,11.6,42182,118,0,240,1066,11.8,3864.7,34,0,0,23,30,71,0,0,0,0,38407,11.0,41116,95,0,-240,-1066,9.5,3840.7
4830209695,1,324,0,0,35,32,103,0,0,0,1,41248,11.8,45207,106,0,1703,2313,10.6,4124.8,3,0,1,32,35,88,0,0,0,0,39545,11.6,42894,109,0,-1703,-2313,10.9,3954.5
4858220837,1,0,0,1,15,14,17,0,0,0,0,46875,10.0,47500,2,0,19000,19000,0.2,4687.5,0,0,0,8,9,7,0,0,0,0,27875,6.0,28500,1,0,-19000,-19000,0.1,2787.5
4858181431,1,0,4,0,12,15,15,0,0,0,0,32035,10.0,47500,2,0,11355,19000,0.2,3203.5,28,0,1,11,8,7,0,0,0,0,20680,6.0,28500,7,0,-11355,-19000,0.7,2068.0
4858167858,1,162,0,0,18,21,13,0,0,0,0,48124,10.0,47500,1,0,18848,19000,0.1,4812.4,0,0,1,12,9,13,0,0,0,0,29276,6.0,28500,0,0,-18848,-19000,0.0,2927.6
4858141280,1,5,0,0,10,19,16,0,0,0,0,46650,10.0,47500,3,0,18100,19000,0.3,4665.0,0,0,1,17,8,10,0,0,0,0,28550,6.0,28500,7,0,-18100,-19000,0.7,2855.0
4857166113,1,0,0,1,19,12,14,0,0,0,0,47000,10.0,47500,0,0,20200,19000,0.0,4700.0,0,0,0,5,12,5,0,0,0,0,26800,6.0,28500,0,0,-20200,-19000,0.0,2680.0
4857145151,1,0,0,1,17,16,19,0,0,0,0,62700,12.0,55000,0,0,25859,22000,0.0,6270.0,0,0,0,11,12,10,0,0,0,0,36841,7.2,33000,0,0,-25859,-22000,0.0,3684.1
4857093308,1,12,0,0,10,8,8,0,0,0,0,18197,6.6,16784,155,51,2366,238,20.6,1819.7,5,1,1,8,10,5,0,0,0,0,15831,6.8,16546,160,48,-2366,-238,20.8,1583.1
4857064328,1,75,1,1,7,3,5,0,0,0,0,18073,7.2,18772,235,60,3526,2330,29.5,1807.3,14,1,0,3,7,3,1,1,0,0,14547,6.6,16442,182,44,-3526,-2330,22.6,1454.7
4857039795,0,23,0,1,2,3,1,0,0,0,0,15856,6.6,17570,210,48,773,-262,25.8,1585.6,72,9,0,3,2,1,0,0,0,0,15083,7.0,17832,177,46,-773,262,22.3,1508.3
4856966033,1,9,0,1,6,4,5,0,0,0,0,16649,7.0,17901,220,48,1649,42,26.8,1664.9,10,1,0,4,6,4,0,0,0,0,15000,6.8,17859,183,64,-1649,-42,24.7,1500.0
4856533179,1,12,1,1,7,2,9,0,0,0,0,17950,6.8,17213,210,60,2364,-256,27.0,1795.0,64,1,0,2,7,3,0,0,0,0,15586,6.8,17469,199,48,-2364,256,24.7,1558.6
4856514739,1,8,0,1,4,2,3,1,1,0,0,16887,7.0,18564,226,56,2871,32,28.2,1688.7,10,0,0,2,4,1,0,0,0,0,14016,6.8,18532,184,64,-2871,-32,24.8,1401.6
4856456691,0,13,0,0,3,7,6,0,0,0,0,14077,6.4,16112,174,60,-4262,-1557,23.4,1407.7,156,1,1,7,3,3,1,1,0,0,18339,6.8,17669,193,60,4262,1557,25.3,1833.9
4856432983,1,0,0,1,26,27,27,0,0,0,0,65500,12.2,56000,0,0,26200,23000,0.0,6550.0,0,0,0,11,10,13,0,0,0,0,39300,7.2,33000,0,0,-26200,-23000,0.0,3930.0
4856212359,1,11,0,0,4,4,3,0,0,0,0,16114,6.8,17889,227,50,175,-1,27.7,1611.4,67,0,1,3,3,2,0,0,0,0,15939,6.8,17890,180,53,-175,1,23.3,1593.9
4856168754,1,28,2,1,3,2,1,1,1,0,0,15261,6.8,17037,183,48,-96,761,23.1,1526.1,10,0,0,2,3,2,0,0,0,0,15357,6.6,16276,180,48,96,-761,22.8,1535.7
4856121810,1,11,0,1,5,7,3,1,1,0,0,17708,7.0,18488,204,60,1419,1215,26.4,1770.8,10,0,0,7,5,5,0,0,0,0,16289,6.6,17273,192,44,-1419,-1215,23.6,1628.9
4855207587,1,8,0,0,7,5,6,0,0,0,0,17386,7.0,18789,214,52,2562,1680,26.6,1738.6,8,1,1,5,7,4,1,1,0,0,14824,6.4,17109,183,52,-2562,-1680,23.5,1482.4
4855139665,0,17,1,1,3,2,5,0,0,0,0,14945,6.8,18032,204,50,-75,-353,25.4,1494.5,21,0,0,2,3,2,1,1,0,0,15020,7.0,18385,236,56,75,353,29.2,1502.0
4856331499,1,12,1,0,2,5,2,0,0,0,0,16115,7.0,18809,227,52,655,1280,27.9,1611.5,147,2,1,5,2,3,1,1,0,0,15460,6.8,17529,187,59,-655,-1280,24.6,1546.0
4856304083,0,0,0,0,22,25,47,0,0,0,0,35082,11.0,39427,114,0,-1695,-342,11.4,3508.2,0,0,1,25,22,49,0,0,0,0,36777,11.0,39769,117,0,1695,342,11.7,3677.7
4856263577,1,0,0,0,20,14,54,0,0,0,1,36708,11.0,38540,113,0,1624,4108,11.3,3670.8,0,0,1,14,20,36,0,0,0,0,35084,10.0,34432,97,0,-1624,-4108,9.7,3508.4
4856207575,1,21,0,1,31,27,70,0,0,0,1,40292,11.6,44641,113,0,2360,2939,11.3,4029.2,0,0,0,27,31,77,0,0,0,0,37932,11.2,41702,94,0,-2360,-2939,9.4,3793.2
4855160393,1,13,1,0,7,2,6,0,0,0,0,16731,6.4,16692,224,40,2116,3108,26.4,1673.1,16,0,1,2,7,2,1,0,1,0,14615,5.8,13584,158,68,-2116,-3108,22.6,1461.5
4855116478,1,1,0,0,27,24,66,0,0,0,0,38419,11.4,42296,123,0,2475,1889,12.3,3841.9,28,0,1,24,27,49,0,0,0,0,35944,11.2,40407,86,0,-2475,-1889,8.6,3594.4
4855071568,0,0,0,1,22,15,65,0,0,0,0,37196,11.0,40904,105,0,1758,2548,10.5,3719.6,0,0,0,15,22,45,0,0,0,0,35438,10.6,38356,105,0,-1758,-2548,10.5,3543.8
4855051775,0,0,1,0,22,23,59,0,0,0,1,35529,10.4,36646,85,0,-3751,-4095,8.5,3552.9,2,0,1,23,22,78,0,0,0,0,39280,11.0,40741,113,0,3751,4095,11.3,3928.0
4837945095,1,0,2,1,38,28,83,0,0,0,1,41466,12.2,48181,112,0,2830,5344,11.2,4146.6,8,0,0,28,38,58,0,0,0,0,38636,11.6,42837,98,0,-2830,-5344,9.8,3863.6
4837921177,0,0,0,0,11,23,25,0,0,0,0,32233,10.0,33696,81,0,-5694,-4823,8.1,3223.3,8,0,1,23,11,63,0,0,0,0,37927,10.8,38519,121,0,5694,4823,12.1,3792.7
4837889648,0,0,0,1,16,20,40,0,0,0,0,35586,11.0,38371,108,0,-1534,-216,10.8,3558.6,0,0,0,20,16,55,0,0,0,0,37120,10.8,38587,119,0,1534,216,11.9,3712.0
4820841810,0,10,1,1,4,0,2,0,0,0,0,16927,7.0,18286,226,54,2513,1089,28.0,1692.7,77,0,0,0,4,0,0,0,0,0,14414,6.6,17197,187,54,-2513,-1089,24.1,1441.4
4820779473,1,10,3,1,6,2,3,0,0,0,0,16546,7.4,19702,237,66,2047,2334,30.3,1654.6,11,2,0,2,6,2,0,0,0,0,14499,6.6,17368,211,57,-2047,-2334,26.8,1449.9
4818821683,0,45,0,0,35,21,105,0,0,0,1,40438,11.8,43570,101,0,3698,4728,10.1,4043.8,0,0,1,21,35,57,0,0,0,0,36740,10.8,38842,97,0,-3698,-4728,9.7,3674.0
4818807761,1,17,0,1,24,10,67,0,0,0,0,41687,12.0,43711,83,80,7918,8397,16.3,4168.7,11,0,0,10,24,21,0,0,0,0,33769,10.4,35314,84,50,-7918,-8397,13.4,3376.9
4818780492,0,14,1,0,17,23,30,0,0,0,0,36897,11.4,40183,91,59,2335,1558,15.0,3689.7,18,0,1,23,17,53,0,0,0,0,34562,10.8,38625,44,67,-2335,-1558,11.1,3456.2
4818750818,1,11,0,0,5,9,3,0,0,0,0,16016,6.8,17546,195,56,-1886,857,25.1,1601.6,13,1,1,9,5,8,1,1,0,0,17902,6.4,16689,170,56,1886,-857,22.6,1790.2
4816370622,1,10,0,1,12,12,20,0,0,0,0,39851,12.0,45575,123,69,6100,5362,19.2,3985.1,15,0,0,12,12,24,0,0,0,0,33751,11.2,40213,99,63,-6100,-5362,16.2,3375.1
4811209891,0,13,0,0,6,6,7,0,0,0,0,16538,6.8,17432,168,44,-954,-1546,21.2,1653.8,10,1,1,6,6,5,0,0,0,0,17492,7.2,18978,226,64,954,1546,29.0,1749.2
4811154870,0,11,1,0,4,5,5,0,0,0,0,15717,7.2,18283,191,51,-133,607,24.2,1571.7,126,4,1,5,4,7,0,0,0,0,15850,7.0,17676,176,68,133,-607,24.4,1585.0
4847746842,0,12,1,0,6,7,1,0,0,0,0,15012,6.6,17055,172,48,-1181,1066,22.0,1501.2,14,2,1,7,6,6,1,1,0,0,16193,6.6,15989,206,44,1181,-1066,25.0,1619.3
4847704665,1,26,2,0,4,3,3,1,1,0,0,16015,7.0,18323,203,53,1146,1281,25.6,1601.5,122,2,1,3,4,1,0,0,0,0,14869,6.8,17042,214,44,-1146,-1281,25.8,1486.9
4847656125,1,12,0,1,7,5,4,1,1,0,0,17472,7.0,18957,222,64,1088,1097,28.6,1747.2,10,2,0,5,7,4,0,0,0,0,16384,7.0,17860,195,59,-1088,-1097,25.4,1638.4
4846823362,1,11,5,0,31,16,81,0,0,0,1,40461,11.8,44107,123,0,6435,6945,12.3,4046.1,33,0,1,15,30,27,0,0,0,0,34026,10.8,37162,86,0,-6435,-6945,8.6,3402.6
4846800279,1,12,0,1,5,3,4,0,0,0,0,17164,7.0,18260,215,56,2119,650,27.1,1716.4,12,1,0,3,5,4,0,0,0,0,15045,6.8,17610,193,56,-2119,-650,24.9,1504.5
4846774967,1,41,0,1,7,2,7,0,0,0,0,17784,7.0,17697,173,52,3372,405,22.5,1778.4,12,1,0,2,7,1,0,0,0,0,14412,6.8,17292,196,52,-3372,-405,24.8,1441.2
4846719314,1,7,0,1,3,0,2,1,0,1,0,16027,7.0,18943,230,48,2241,1405,27.8,1602.7,17,0,0,0,3,0,0,0,0,0,13786,6.6,17538,229,60,-2241,-1405,28.9,1378.6
4846687451,1,11,2,1,8,5,9,0,0,0,0,19663,7.0,17712,222,52,3575,134,27.4,1966.3,13,1,0,5,8,4,0,0,0,0,16088,6.8,17578,174,52,-3575,-134,22.6,1608.8
4846652960,1,2,0,1,33,33,93,0,0,0,2,41198,12.0,44917,93,0,241,1505,9.3,4119.8,0,0,0,33,33,96,0,0,0,0,40957,11.6,43412,90,0,-241,-1505,9.0,4095.7
4846626860,0,12,8,1,9,1,6,0,0,0,0,17858,7.2,19586,210,72,3213,1963,28.2,1785.8,35,2,0,1,9,2,0,0,0,0,14645,7.0,17623,199,64,-3213,-1963,26.3,1464.5
4846586647,0,20,0,0,7,6,10,0,0,0,0,16945,6.4,16045,162,48,-217,-650,21.0,1694.5,11,2,1,6,7,6,1,1,0,0,17162,6.6,16695,193,52,217,650,24.5,1716.2
4846571252,1,13,1,1,2,1,0,1,1,0,0,14365,7.0,17755,214,56,1375,787,27.0,1436.5,16,1,0,1,2,1,0,0,0,0,12990,6.8,16968,178,39,-1375,-787,21.7,1299.0
4846550946,0,10,4,1,7,4,2,0,0,0,0,16515,6.8,17327,175,60,932,636,23.5,1651.5,11,1,0,4,7,4,0,0,0,0,15583,6.8,16691,184,48,-932,-636,23.2,1558.3
4842902768,1,55,1,1,6,7,4,0,0,0,0,16080,6.6,16761,138,57,-82,-703,19.5,1608.0,12,3,0,7,6,3,1,1,0,0,16162,7.0,17464,194,55,82,703,24.9,1616.2
4841279961,1,8,2,1,3,5,2,0,0,0,0,15270,6.8,17418,224,52,-425,-642,27.6,1527.0,60,1,0,5,3,4,0,0,0,0,15695,6.8,18060,189,52,425,642,24.1,1569.5
4841229036,0,9,1,0,4,3,7,0,0,0,0,15722,6.8,18075,202,52,113,279,25.4,1572.2,14,0,1,3,4,3,0,0,0,0,15609,6.8,17796,205,60,-113,-279,26.5,1560.9
4840806530,1,12,0,0,0,5,0,0,0,0,0,15848,7.0,18340,220,56,-1729,-669,27.6,1584.8,9,1,1,5,0,5,0,0,0,0,17577,7.2,19009,224,52,1729,669,27.6,1757.7
4840218524,1,22,2,0,22,16,65,0,0,0,0,38569,11.2,42647,114,0,5210,6688,11.4,3856.9,15,0,1,16,22,42,0,0,0,0,33359,10.2,35959,92,0,-5210,-6688,9.2,3335.9
4840188344,0,30,0,0,19,21,48,0,0,0,0,36426,11.0,39467,87,0,-47,-389,8.7,3642.6,0,1,1,21,19,55,0,0,0,0,36473,11.0,39856,111,0,47,389,11.1,3647.3
4840157816,1,13,1,1,8,2,3,1,1,0,0,17849,7.2,18724,208,56,2740,3085,26.4,1784.9,11,1,0,2,8,2,0,0,0,0,15109,6.4,15639,164,51,-2740,-3085,21.5,1510.9
4856057998,1,10,0,0,23,26,20,0,0,0,0,62700,12.6,59500,0,0,24100,22000,0.0,6270.0,0,0,1,13,10,17,0,0,0,0,38600,7.8,37500,0,0,-24100,-22000,0.0,3860.0
4856038836,1,7,0,0,16,28,21,0,0,0,0,62025,12.0,55000,1,0,23425,22000,0.1,6202.5,0,0,1,18,6,13,0,0,0,0,38600,7.2,33000,0,0,-23425,-22000,0.0,3860.0
4854894974,1,0,0,1,17,21,12,0,0,0,0,46000,10.0,47500,0,0,16461,19000,0.0,4600.0,1,0,0,13,9,16,0,0,0,0,29539,6.0,28500,0,0,-16461,-19000,0.0,2953.9
4854867303,1,12,1,0,18,18,21,0,0,0,0,47710,10.0,47500,1,0,19510,17820,0.1,4771.0,0,0,1,12,12,7,0,0,0,0,28200,6.2,29680,0,0,-19510,-17820,0.0,2820.0
4854856785,1,0,0,0,21,15,21,0,0,0,0,48400,10.0,47500,0,0,18785,19000,0.0,4840.0,0,0,1,8,14,9,0,0,0,0,29615,6.0,28500,0,0,-18785,-19000,0.0,2961.5
4852247472,1,11,1,0,7,4,6,0,0,0,0,16851,6.8,17779,182,48,2106,1946,23.0,1685.1,9,0,1,4,7,4,1,0,1,0,14745,6.4,15833,149,40,-2106,-1946,18.9,1474.5
4852198705,0,12,3,0,3,6,1,0,0,0,0,13977,6.6,16992,168,56,-2922,-1474,22.4,1397.7,9,3,1,6,3,7,0,0,0,0,16899,7.0,18466,221,64,2922,1474,28.5,1689.9
4851225622,1,9,2,0,5,2,5,1,1,0,0,15791,7.0,17891,202,56,339,-1271,25.8,1579.1,11,0,1,2,5,0,0,0,0,0,15452,7.0,19162,207,68,-339,1271,27.5,1545.2
4850561341,1,13,2,1,6,5,8,0,0,0,0,16626,6.8,17335,203,55,1309,-691,25.8,1662.6,274,0,0,5,6,2,1,1,0,0,15317,7.0,18026,178,52,-1309,691,23.0,1531.7
4850525730,0,12,2,0,0,5,0,0,0,0,0,15093,7.2,18589,230,68,-2936,-1139,29.8,1509.3,13,3,1,5,0,2,1,1,0,0,18029,7.4,19728,281,56,2936,1139,33.7,1802.9
4849790201,0,8,0,0,2,9,1,0,0,0,0,14340,6.8,17086,167,55,-3526,-1246,22.2,1434.0,9,2,1,9,2,5,0,0,0,0,17866,7.0,18332,207,60,3526,1246,26.7,1786.6
4849749353,1,46,0,1,4,3,9,1,1,0,0,16171,7.0,18619,220,48,-738,-116,26.8,1617.1,15,1,0,3,4,0,1,0,1,0,16909,7.0,18735,234,67,738,116,30.1,1690.9
4848657399,0,10,0,1,7,3,6,0,0,0,0,15910,6.8,17102,182,57,1443,63,23.9,1591.0,12,0,0,2,6,0,0,0,0,0,14467,6.6,17039,175,52,-1443,-63,22.7,1446.7
4847531593,1,14,2,1,4,1,3,1,1,0,0,17022,7.0,18986,237,59,3300,1292,29.6,1702.2,22,1,0,1,4,0,0,0,0,0,13722,6.6,17694,202,56,-3300,-1292,25.8,1372.2
4847504021,1,16,3,1,11,3,24,1,1,0,0,19440,6.8,17833,192,60,4103,1321,25.2,1944.0,13,2,0,3,11,1,0,0,0,0,15337,6.4,16512,192,56,-4103,-1321,24.8,1533.7
4845630755,1,13,0,1,3,2,5,1,1,0,0,15392,6.8,18473,211,52,1472,1392,26.3,1539.2,11,0,0,2,3,2,0,0,0,0,13920,6.8,17081,188,56,-1472,-1392,24.4,1392.0
4840910060,0,15,0,1,7,3,6,0,0,0,0,16099,6.6,17219,186,60,1403,-295,24.6,1609.9,11,1,0,3,7,1,0,0,0,0,14696,6.8,17514,196,48,-1403,295,24.4,1469.6
4840873877,0,14,5,0,5,6,5,0,0,0,0,15779,7.0,18479,193,64,-104,568,25.7,1577.9,13,0,1,6,5,1,1,1,0,0,15883,6.8,17911,195,52,104,-568,24.7,1588.3
4840059038,0,13,0,0,2,6,2,0,0,0,0,15694,6.8,17074,223,48,-949,-947,27.1,1569.4,41,1,1,6,2,5,0,0,0,0,16643,6.8,18021,191,52,949,947,24.3,1664.3
4840025220,1,10,1,1,8,10,6,0,0,0,0,17321,6.6,16551,184,44,-867,-1885,22.8,1732.1,13,1,0,10,8,5,0,0,0,0,18188,7.2,18436,176,68,867,1885,24.4,1818.8
4828509615,1,9,0,1,6,5,4,1,1,0,0,16921,7.0,18529,198,68,687,1044,26.6,1692.1,7,0,0,5,6,3,1,0,1,0,16234,6.8,17485,210,52,-687,-1044,26.2,1623.4
4828482168,1,9,0,1,3,2,1,0,0,0,0,14748,7.0,18334,214,56,-639,-268,27.0,1474.8,12,0,0,2,3,1,1,0,1,0,15387,7.0,18602,221,60,639,268,28.1,1538.7
4828315369,0,11,0,1,3,6,3,1,1,0,0,15702,6.8,17276,195,52,-1655,-1026,24.7,1570.2,74,0,0,6,3,4,0,0,0,0,17357,6.8,18302,198,47,1655,1026,24.5,1735.7
4826951568,0,10,2,1,6,6,5,1,1,0,0,16079,6.6,16544,164,44,475,-487,20.8,1607.9,11,3,0,6,6,4,0,0,0,0,15604,6.6,17031,187,52,-475,487,23.9,1560.4
4824770662,0,14,0,0,6,6,7,1,1,0,0,16572,7.0,18438,174,52,283,1317,22.6,1657.2,11,0,1,6,6,8,0,0,0,0,16289,6.8,17121,164,68,-283,-1317,23.2,1628.9
4823920594,1,42,0,0,31,20,94,0,0,0,0,40141,12.0,44270,111,0,3848,6001,11.1,4014.1,8,25,1,20,31,57,0,0,0,0,36293,10.6,38269,80,0,-3848,-6001,8.0,3629.3
4823619629,1,13,0,1,9,3,7,0,0,0,0,17386,6.8,17764,202,48,1235,-213,25.0,1738.6,9,1,0,3,9,4,0,0,0,0,16151,7.0,17977,171,64,-1235,213,23.5,1615.1
4822592295,1,11,0,0,4,5,1,1,1,0,0,14346,6.6,17238,187,55,-518,-615,24.2,1434.6,13,0,1,5,4,3,0,0,0,0,14864,7.0,17853,181,40,518,615,22.1,1486.4
4817715175,1,20,0,0,6,5,4,1,1,0,0,16797,6.8,17743,210,52,129,-83,26.2,1679.7,9,1,1,5,6,6,0,0,0,0,16668,7.2,17826,211,52,-129,83,26.3,1666.8
4816985426,0,14,2,1,4,4,3,1,1,0,0,15359,7.0,18103,187,60,-3,-64,24.7,1535.9,14,0,0,4,4,3,0,0,0,0,15362,7.0,18167,201,48,3,64,24.9,1536.2
4816823296,1,12,0,1,20,9,36,0,0,0,0,36431,11.6,43812,86,54,6147,10819,14.0,3643.1,103,0,0,9,20,17,0,0,0,0,30284,10.2,32993,64,52,-6147,-10819,11.6,3028.4
4816815350,0,16,0,1,10,16,17,0,0,0,1,29158,10.0,31785,50,43,-5327,-6601,9.3,2915.8,234,2,0,16,10,31,0,0,0,0,34485,10.6,38386,78,63,5327,6601,14.1,3448.5
4815382474,0,14,0,1,31,23,71,0,0,0,0,38463,11.0,39120,83,47,-6097,-397,13.0,3846.3,12,0,0,23,31,46,0,0,0,0,44560,11.0,39517,77,44,6097,397,12.1,4456.0
4815356903,1,17,0,1,28,7,57,0,0,0,0,37948,11.6,42502,80,51,6868,8462,13.1,3794.8,87,3,0,7,28,24,0,0,0,0,31080,10.2,34040,68,59,-6868,-8462,12.7,3108.0
4815329036,0,7,0,1,25,9,48,0,0,0,0,35193,11.4,41450,52,67,971,5222,11.9,3519.3,16,0,0,9,25,15,0,0,0,0,34222,10.4,36228,96,55,-971,-5222,15.1,3422.2
4815306897,1,36,0,1,22,21,43,0,0,0,1,39958,11.0,41206,104,67,3227,2765,17.1,3995.8,12,9,0,21,22,37,0,0,0,0,36731,10.8,38441,65,47,-3227,-2765,11.2,3673.1
4815286062,0,92,0,0,18,27,33,0,0,0,2,34030,10.4,35037,91,47,-5374,-5083,13.8,3403.0,6,0,1,27,18,54,0,0,0,0,39404,11.4,40120,102,47,5374,5083,14.9,3940.4
4815265142,0,11,6,0,18,20,43,0,0,0,0,37636,11.2,41034,73,75,407,-555,14.8,3763.6,14,0,1,20,18,39,0,0,0,0,37229,11.6,41589,91,51,-407,555,14.2,3722.9
4814915705,0,13,0,0,4,4,2,0,0,0,0,14318,7.0,17696,181,48,-731,151,22.9,1431.8,12,0,1,4,4,5,0,0,0,0,15049,6.8,17545,208,44,731,-151,25.2,1504.9
4858159966,1,22,1,1,17,14,19,0,0,0,0,63820,12.4,57000,1,0,26590,24000,0.1,6382.0,0,0,0,9,12,7,0,0,0,0,37230,7.2,33000,0,0,-26590,-24000,0.0,3723.0
4858137390,1,24,0,0,19,20,14,0,0,0,0,48843,10.0,47500,3,0,19833,19000,0.3,4884.3,0,4,1,10,9,14,0,0,0,0,29010,6.0,28500,5,0,-19833,-19000,0.5,2901.0
4858118804,1,373,0,1,20,14,22,0,0,0,0,47805,10.0,47550,0,0,21690,19050,0.0,4780.5,0,0,0,6,12,5,0,0,0,0,26115,6.0,28500,0,0,-21690,-19050,0.0,2611.5
4858060810,0,53,1,0,5,7,2,0,0,0,0,14967,6.4,15615,147,44,-1523,-401,19.1,1496.7,17,3,1,7,5,8,1,1,0,0,16490,6.6,16016,185,52,1523,401,23.7,1649.0
4858036141,0,14,0,0,0,3,0,0,0,0,0,13867,6.4,16346,185,58,-1724,-2296,24.3,1386.7,72,0,1,3,0,2,1,1,0,0,15591,7.0,18642,196,54,1724,2296,25.0,1559.1
4856031907,0,11,3,0,4,8,5,1,1,0,0,14543,6.6,17064,184,48,-2540,-511,23.2,1454.3,20,2,1,8,4,4,0,0,0,0,17083,6.6,17575,211,60,2540,511,27.1,1708.3
4855828430,0,33,1,0,4,9,3,1,1,0,0,14920,6.4,15986,166,56,-1902,-715,22.2,1492.0,44,2,1,9,4,6,0,0,0,0,16822,6.6,16701,180,24,1902,715,20.4,1682.2
4855747744,1,47,0,0,7,7,5,1,1,0,0,17476,6.8,17696,217,52,1253,1780,26.9,1747.6,29,1,1,7,7,9,0,0,0,0,16223,6.2,15916,143,56,-1253,-1780,19.9,1622.3
4855680346,0,9,1,0,0,6,0,0,0,0,0,14376,6.8,17501,218,54,-1168,-903,27.2,1437.6,17,0,1,6,0,3,1,1,0,0,15544,7.0,18404,205,52,1168,903,25.7,1554.4
4855449280,0,70,1,0,6,5,3,0,0,0,0,16153,6.8,17363,178,56,646,1213,23.4,1615.3,10,0,1,5,6,7,1,1,0,0,15507,6.4,16150,169,56,-646,-1213,22.5,1550.7
4855401149,0,16,4,1,9,5,10,1,1,0,0,17521,6.8,17659,184,72,474,-1064,25.6,1752.1,13,3,0,5,9,8,0,0,0,0,17047,7.0,18723,225,48,-474,1064,27.3,1704.7
4855372502,0,14,3,0,5,7,5,0,0,0,0,16788,6.8,17230,216,56,-730,-844,27.2,1678.8,22,3,1,7,5,8,0,0,0,0,17518,6.8,18074,213,49,730,844,26.2,1751.8
4855328681,0,199,2,1,7,5,3,0,0,0,0,15628,6.8,17727,198,48,-507,330,24.6,1562.8,20,4,0,4,6,6,1,1,0,0,16135,6.8,17397,198,60,507,-330,25.8,1613.5
4854723521,0,150,1,0,3,6,1,0,0,0,0,14359,6.6,16492,194,44,-2808,-1614,23.8,1435.9,12,4,1,6,3,6,0,0,0,0,17167,7.2,18106,185,60,2808,1614,24.5,1716.7
4854698881,0,13,0,1,6,7,4,0,0,0,0,16910,7.0,18182,185,56,39,677,24.1,1691.0,14,0,0,7,6,7,1,1,0,0,16871,7.0,17505,177,48,-39,-677,22.5,1687.1
4854572066,0,11,1,1,10,6,11,0,0,0,0,16974,6.2,15307,161,40,908,-27,20.1,1697.4,21,1,0,6,10,7,0,0,0,0,16066,6.4,15334,149,31,-908,27,18.0,1606.6
4854067144,0,12,1,0,9,8,5,0,0,0,0,17242,6.6,17099,169,40,-337,-251,20.9,1724.2,9,4,1,8,9,5,0,0,0,0,17579,6.6,17350,175,56,337,251,23.1,1757.9
4853932206,1,47,3,0,5,3,9,1,1,0,0,17183,7.0,18194,213,60,1792,529,27.3,1718.3,17,1,1,3,5,3,0,0,0,0,15391,6.8,17665,206,60,-1792,-529,26.6,1539.1
4853808779,0,18,0,1,3,1,3,1,1,0,0,14511,6.6,16402,162,56,631,-240,21.8,1451.1,10,1,0,1,3,1,0,0,0,0,13880,6.6,16642,186,56,-631,240,24.2,1388.0
4853748630,1,13,1,0,5,3,9,0,0,0,0,15988,6.2,15684,160,48,1902,163,20.8,1598.8,12,0,1,3,5,2,0,0,0,0,14086,6.4,15521,172,56,-1902,-163,22.8,1408.6
4858089869,1,0,0,1,17,12,16,0,0,0,0,32000,9.0,40000,0,0,14200,16000,0.0,3200.0,0,0,0,7,12,7,0,0,0,0,17800,5.4,24000,0,0,-14200,-16000,0.0,1780.0
4858071784,1,0,0,1,14,16,17,0,0,0,0,45775,10.2,48680,3,0,18210,20180,0.3,4577.5,0,0,0,11,9,8,0,0,0,0,27565,6.0,28500,1,0,-18210,-20180,0.1,2756.5
4858051600,1,4,0,0,17,19,27,0,0,0,0,63050,12.6,59500,11,0,25467,22000,1.1,6305.0,0,0,1,13,11,8,0,0,0,0,37583,7.8,37500,5,0,-25467,-22000,0.5,3758.3
4858044992,1,28,0,0,14,14,20,0,0,0,0,47050,10.0,47500,1,0,18100,19000,0.1,4705.0,0,0,1,10,10,7,0,0,0,0,28950,6.0,28500,1,0,-18100,-19000,0.1,2895.0
4858025514,1,32,6,0,16,21,20,0,0,0,0,46830,10.0,47500,6,0,16845,19000,0.6,4683.0,0,2,1,15,10,9,0,0,0,0,29985,6.0,28500,1,0,-16845,-19000,0.1,2998.5
4858010366,1,352,0,1,15,17,7,0,0,0,0,60600,12.0,55000,0,0,22700,22000,0.0,6060.0,2,0,0,10,8,15,0,0,0,0,37900,7.2,33000,0,0,-22700,-22000,0.0,3790.0
4857998867,1,0,0,1,25,19,23,0,0,0,0,49450,10.0,47500,0,0,20900,19000,0.0,4945.0,14,0,0,8,14,10,0,0,0,0,28550,6.0,28500,0,0,-20900,-19000,0.0,2855.0
4857087933,1,16,1,1,12,18,18,0,0,0,0,46960,10.0,47500,1,0,17810,16000,0.1,4696.0,0,0,0,13,7,7,0,0,0,0,29150,6.6,31500,0,0,-17810,-16000,0.0,2915.0
4857072775,1,0,0,1,18,17,15,0,0,0,0,47500,10.6,50500,0,0,18600,22000,0.0,4750.0,0,0,0,11,12,14,0,0,0,0,28900,6.0,28500,0,0,-18600,-22000,0.0,2890.0
4857046707,1,0,0,0,20,21,12,0,0,0,0,45975,10.2,48680,1,0,16025,20180,0.1,4597.5,0,0,1,10,9,13,0,0,0,0,29950,6.0,28500,0,0,-16025,-20180,0.0,2995.0
4857032024,1,0,0,1,23,12,26,0,0,0,0,65295,12.0,55000,2,0,29815,22000,0.2,6529.5,0,0,0,5,16,7,0,0,0,0,35480,7.2,33000,0,0,-29815,-22000,0.0,3548.0
4854846010,1,1,0,1,24,24,18,0,0,0,0,67250,12.0,55000,0,0,29650,22000,0.0,6725.0,0,0,0,13,13,11,0,0,0,0,37600,7.2,33000,1,0,-29650,-22000,0.1,3760.0
4854828850,1,0,0,1,20,17,22,0,0,0,0,47872,10.0,47500,3,0,19622,19000,0.3,4787.2,0,0,0,10,13,8,0,0,0,0,28250,6.0,28500,1,0,-19622,-19000,0.1,2825.0
4838725105,0,2,2,1,23,28,53,0,0,0,0,38845,11.0,41425,104,0,1291,-596,10.4,3884.5,6,0,0,28,23,67,0,0,0,0,37554,11.4,42021,110,0,-1291,596,11.0,3755.4
4831851400,1,54,1,0,21,17,54,0,0,0,0,35132,11.4,42158,100,72,4462,710,17.2,3513.2,13,6,1,17,21,30,0,0,0,0,30670,11.2,41448,92,47,-4462,-710,13.9,3067.0
4821412153,0,12,0,0,9,7,5,0,0,0,0,16967,6.8,18272,179,53,51,1006,23.2,1696.7,17,0,1,7,9,3,0,0,0,0,16916,6.6,17266,183,57,-51,-1006,24.0,1691.6
4821401966,0,13,1,0,5,9,2,0,0,0,0,14982,6.6,16546,161,52,-3325,-1804,21.3,1498.2,12,2,1,9,5,8,1,1,0,0,18307,7.2,18350,187,60,3325,1804,24.7,1830.7
4821386341,1,34,0,1,6,4,6,1,1,0,0,16445,6.8,17471,172,56,1843,1127,22.8,1644.5,33,1,0,4,6,2,0,0,0,0,14602,6.4,16344,183,48,-1843,-1127,23.1,1460.2
4821037801,1,71,3,0,6,6,2,0,0,0,0,15664,7.0,18221,182,60,468,508,24.2,1566.4,12,2,1,6,6,1,0,0,0,0,15196,6.8,17713,172,54,-468,-508,22.6,1519.6
4820983682,1,9,1,1,6,6,3,0,0,0,0,16725,7.2,18785,192,60,706,1902,25.2,1672.5,8,1,0,6,6,3,1,1,0,0,16019,6.6,16883,125,48,-706,-1902,17.3,1601.9
4765892113,0,42,0,1,3,6,2,0,0,0,0,15241,6.6,16765,199,56,-638,-1103,25.5,1524.1,35,0,0,6,3,7,0,0,0,0,15879,7.0,17868,203,64,638,1103,26.7,1587.9
4755350447,1,10,1,0,1,6,1,0,0,0,0,14601,7.2,17956,209,63,-3714,-1144,27.2,1460.1,10,0,1,6,1,6,1,0,1,0,18315,7.4,19100,230,52,3714,1144,28.2,1831.5
4755316796,0,99,2,0,2,5,3,0,0,0,0,13896,6.6,16664,177,44,-3531,-1528,22.1,1389.6,13,2,1,5,2,3,0,0,0,0,17427,6.8,18192,224,55,3531,1528,27.9,1742.7
4754870142,1,16,2,1,4,2,2,0,0,0,0,15698,7.0,18152,210,52,663,139,26.2,1569.8,11,1,0,2,4,1,0,0,0,0,15035,7.0,18013,200,68,-663,-139,26.8,1503.5
4754358073,1,60,1,1,7,3,7,1,1,0,0,16730,7.0,17624,203,48,1519,52,25.1,1673.0,19,0,0,3,7,4,0,0,0,0,15211,6.6,17572,185,52,-1519,-52,23.7,1521.1
4753239560,1,15,0,0,4,4,0,1,0,1,0,15422,7.0,18460,225,72,105,-302,29.7,1542.2,13,3,1,4,4,2,0,0,0,0,15317,7.2,18762,211,52,-105,302,26.3,1531.7
4751990871,1,32,0,1,6,3,7,0,0,0,0,17615,7.0,18187,212,60,3225,1396,27.2,1761.5,162,2,0,3,6,3,0,0,0,0,14390,6.8,16791,183,56,-3225,-1396,23.9,1439.0
4751936784,1,17,1,0,1,6,1,0,0,0,0,15218,6.8,17154,220,48,447,1293,26.8,1521.8,16,2,1,6,1,3,1,0,1,0,14771,6.4,15861,181,34,-447,-1293,21.5,1477.1
4751462113,1,18,4,1,8,3,10,1,1,0,0,18439,7.2,17649,202,64,4192,1376,26.6,1843.9,15,1,0,3,8,1,0,0,0,0,14247,6.6,16273,173,43,-4192,-1376,21.6,1424.7
4751189528,0,12,3,1,1,4,1,0,0,0,0,13749,7.0,17465,194,61,-1376,-496,25.5,1374.9,14,2,0,4,1,2,0,0,0,0,15125,6.8,17961,211,52,1376,496,26.3,1512.5
4750525875,0,31,2,0,7,8,6,0,0,0,0,17146,6.6,17072,202,44,-1045,-1381,24.6,1714.6,17,3,1,8,7,6,0,0,0,0,18191,7.0,18453,193,54,1045,1381,24.7,1819.1
4750506315,0,11,4,0,2,8,2,1,0,1,0,14888,7.0,17470,236,56,-3444,489,29.2,1488.8,12,1,1,8,2,14,1,1,0,0,18332,6.6,16981,220,44,3444,-489,26.4,1833.2
4750318200,1,14,0,1,6,1,6,0,0,0,0,16946,7.2,19248,212,60,1262,1224,27.2,1694.6,77,0,0,1,6,1,0,0,0,0,15684,6.8,18024,225,44,-1262,-1224,26.9,1568.4
4750294781,0,16,0,1,8,7,5,1,1,0,0,16058,6.6,17675,195,52,-265,-32,24.7,1605.8,11,1,0,7,8,6,0,0,0,0,16323,6.8,17707,198,43,265,32,24.1,1632.3
4750268018,0,9,1,1,2,8,1,0,0,0,0,14540,6.8,17658,219,60,-3159,-848,27.9,1454.0,14,1,0,8,2,10,0,0,0,0,17699,6.8,18506,230,51,3159,848,28.1,1769.9
4750225324,1,89,2,1,7,4,7,2,1,1,0,17346,7.2,18769,199,64,1694,-79,26.3,1734.6,8,1,0,4,7,1,0,0,0,0,15652,7.2,18848,213,55,-1694,79,26.8,1565.2
4745905058,1,12,1,0,1,5,1,0,0,0,0,14419,6.6,16968,222,52,-1248,-984,27.4,1441.9,9,0,1,5,1,4,0,0,0,0,15667,7.0,17952,185,52,1248,984,23.7,1566.7
4744958131,1,17,2,1,7,2,11,1,1,0,0,16677,6.8,16964,216,52,1429,-1077,26.8,1667.7,10,2,0,2,7,3,0,0,0,0,15248,7.0,18041,229,64,-1429,1077,29.3,1524.8
4744913511,1,380,1,1,6,5,5,2,1,1,0,17457,7.2,18837,178,68,2508,1164,24.6,1745.7,16,1,0,5,6,3,0,0,0,0,14949,6.8,17673,206,40,-2508,-1164,24.6,1494.9
4744907308,1,12,0,1,4,5,2,1,0,1,0,16275,7.0,18069,220,51,858,895,27.1,1627.5,14,1,0,5,4,5,1,1,0,0,15417,7.0,17174,191,60,-858,-895,25.1,1541.7
4858242991,0,14,4,0,22,31,48,0,0,0,1,37093,11.4,40996,87,0,-2346,-3255,8.7,3709.3,28,0,1,31,22,91,0,0,0,0,39439,11.6,44251,98,0,2346,3255,9.8,3943.9
4858208304,1,0,0,0,39,26,103,0,0,0,2,41350,12.0,46786,112,0,1479,3395,11.2,4135.0,0,0,1,26,39,66,0,0,0,0,39871,11.4,43391,89,0,-1479,-3395,8.9,3987.1
4858155684,0,245,0,0,15,36,25,0,0,0,0,34137,10.4,36405,97,0,-5485,-7935,9.7,3413.7,0,0,1,36,15,103,0,0,0,0,39622,11.6,44340,110,0,5485,7935,11.0,3962.2
4857553866,0,0,0,0,29,38,82,0,0,0,1,38461,11.4,43017,94,0,-3704,-3266,9.4,3846.1,19,0,1,38,29,94,0,0,0,0,42165,12.0,46283,122,0,3704,3266,12.2,4216.5
4857527524,1,0,0,1,29,24,83,0,0,0,1,39205,11.8,42579,116,0,1685,2048,11.6,3920.5,0,0,0,24,29,54,0,0,0,0,37520,11.2,40531,97,0,-1685,-2048,9.7,3752.0
4857514904,1,112,0,1,18,20,55,0,0,0,1,35592,10.8,37851,97,0,-273,-962,9.7,3559.2,111,0,0,20,18,62,0,0,0,0,35865,10.8,38813,89,0,273,962,8.9,3586.5
4857472046,1,34,0,0,22,25,60,0,0,0,1,37807,11.2,42135,89,0,-2365,-506,8.9,3780.7,34,0,1,25,22,63,0,0,0,0,40172,11.6,42641,101,0,2365,506,10.1,4017.2
4857446307,0,0,24,1,35,20,101,0,0,0,1,40976,11.4,43325,115,0,5229,4102,11.5,4097.6,30,0,0,20,35,43,0,0,0,0,35747,11.0,39223,102,0,-5229,-4102,10.2,3574.7
4857315991,0,1,0,0,33,28,84,0,0,0,1,39749,12.0,45604,97,0,1119,2839,9.7,3974.9,9,0,1,28,33,60,0,0,0,0,38630,11.4,42765,78,0,-1119,-2839,7.8,3863.0
4857281338,0,0,0,0,22,31,48,0,0,0,1,35926,10.8,39553,93,0,-3780,-4121,9.3,3592.6,0,0,1,31,22,87,0,0,0,0,39706,11.8,43674,93,0,3780,4121,9.3,3970.6
4857257865,0,0,0,1,24,26,57,0,0,0,0,36753,11.2,40595,111,0,-1123,-1973,11.1,3675.3,0,0,0,26,24,71,0,0,0,0,37876,11.4,42568,96,0,1123,1973,9.6,3787.6
4856454542,0,0,0,1,24,31,72,0,0,0,1,37885,11.0,40515,75,0,-4514,-6721,7.5,3788.5,3,0,0,31,24,83,0,0,0,0,42399,12.0,47236,105,0,4514,6721,10.5,4239.9
4856416224,1,7,0,1,23,15,70,0,0,0,0,37085,11.0,38701,106,0,2320,1325,10.6,3708.5,220,0,0,15,23,33,0,0,0,0,34765,10.6,37376,106,0,-2320,-1325,10.6,3476.5
4856388826,1,19,0,0,19,18,32,0,0,0,2,36782,11.4,41908,96,0,287,3085,9.6,3678.2,0,0,1,18,19,34,0,0,0,0,36495,11.0,38823,101,0,-287,-3085,10.1,3649.5
4856353701,0,83,0,1,33,43,63,0,0,0,1,41633,12.0,46815,92,0,-1939,-2570,9.2,4163.3,0,4,0,43,33,121,0,0,0,0,43572,12.6,49385,109,0,1939,2570,10.9,4357.2
4855414155,0,16,0,1,25,20,52,0,0,0,1,39545,11.6,44424,117,0,1662,3217,11.7,3954.5,0,1,0,20,25,43,0,0,0,0,37883,11.2,41207,104,0,-1662,-3217,10.4,3788.3
4855395220,1,0,0,1,17,28,31,0,0,0,1,35309,11.0,39246,102,0,-2008,-1758,10.2,3530.9,219,0,0,28,17,66,0,0,0,0,37317,11.2,41004,91,0,2008,1758,9.1,3731.7
4855360664,1,2,16,0,30,22,88,0,0,0,0,39917,11.6,43160,106,0,2501,1369,10.6,3991.7,11,0,1,22,30,49,0,0,0,0,37416,11.4,41791,102,0,-2501,-1369,10.2,3741.6
4855340391,0,0,0,0,26,33,68,0,0,0,2,38178,11.0,41248,101,0,-2968,-3774,10.1,3817.8,0,0,1,33,26,86,0,0,0,0,41146,11.8,45022,112,0,2968,3774,11.2,4114.6
4853776435,1,0,0,1,13,19,11,0,0,0,0,36150,10.0,47500,0,0,13200,19000,0.0,3615.0,0,0,0,13,7,12,0,0,0,0,22950,6.0,28500,0,0,-13200,-19000,0.0,2295.0
4853761018,1,231,0,1,22,18,26,0,0,0,0,63750,13.0,62500,0,0,26900,25000,0.0,6375.0,0,0,0,8,12,8,0,0,0,0,36850,7.8,37500,0,0,-26900,-25000,0.0,3685.0
4847610312,0,0,0,0,11,22,26,0,0,0,0,33428,10.4,35785,92,0,-2192,-5039,9.2,3342.8,0,0,1,22,11,61,0,0,0,0,35620,11.0,40824,102,0,2192,5039,10.2,3562.0
4847562802,0,31,0,1,19,22,55,0,0,0,0,34818,10.8,37605,95,0,-2715,-4528,9.5,3481.8,0,0,0,22,19,66,0,0,0,0,37533,11.4,42133,100,0,2715,4528,10.0,3753.3
4846662813,0,0,0,1,27,26,63,0,0,0,1,38921,11.6,43322,108,0,962,1662,10.8,3892.1,89,0,0,26,27,54,0,0,0,0,37959,11.4,41660,112,0,-962,-1662,11.2,3795.9
4846634844,0,12,0,0,7,8,5,0,0,0,0,16125,6.6,16556,127,48,-1861,-891,17.5,1612.5,12,0,1,8,7,8,0,0,0,0,17986,6.8,17447,214,48,1861,891,26.2,1798.6
4846585705,1,8,1,0,5,4,3,1,0,1,0,15558,6.8,17844,191,44,1616,1689,23.5,1555.8,18,0,1,4,5,5,1,1,0,0,13942,6.4,16155,169,48,-1616,-1689,21.7,1394.2
4846574282,1,8,3,1,13,5,16,1,1,0,0,18823,6.8,18315,201,51,3592,2164,25.2,1882.3,15,1,0,5,13,7,0,0,0,0,15231,6.6,16151,178,44,-3592,-2164,22.2,1523.1
4846548599,1,11,2,0,8,5,7,0,0,0,0,16993,7.0,18101,209,64,821,751,27.3,1699.3,11,1,1,5,8,4,0,0,0,0,16172,6.6,17350,212,32,-821,-751,24.4,1617.2
4843351369,0,14,0,0,5,6,1,0,0,0,0,15410,7.0,17795,185,40,89,423,22.5,1541.0,14,1,1,6,5,3,0,0,0,0,15321,6.6,17372,194,52,-89,-423,24.6,1532.1
4843300458,0,13,2,0,7,6,6,1,1,0,0,17695,6.6,16908,166,52,1054,-755,21.8,1769.5,104,1,1,6,7,5,0,0,0,0,16641,6.8,17663,212,64,-1054,755,27.6,1664.1
4838894668,0,15,1,0,4,3,5,0,0,0,0,15441,6.6,17216,201,61,908,297,26.2,1544.1,14,1,1,3,4,1,1,1,0,0,14533,6.6,16919,203,58,-908,-297,26.1,1453.3
4836728695,1,35,0,0,24,15,45,0,0,0,2,40369,12.2,47922,88,67,9336,8684,15.5,4036.9,13,0,1,14,23,19,0,0,0,0,31033,11.0,39238,92,51,-9336,-8684,14.3,3103.3
4836712309,1,35,0,0,25,10,51,0,0,0,2,35952,11.4,40927,48,55,1176,2434,10.3,3595.2,10,0,1,10,25,22,0,0,0,0,34776,11.0,38493,79,63,-1176,-2434,14.2,3477.6
4836686488,1,11,1,0,8,25,13,0,0,0,0,33436,9.8,32831,74,59,-574,-1709,13.3,3343.6,9,1,1,24,7,50,0,0,0,0,34010,10.4,34540,59,48,574,1709,10.7,3401.0
4836061754,1,19,0,1,17,13,28,0,0,0,0,36045,11.4,43141,107,55,3374,3566,16.2,3604.5,12,0,0,12,16,25,0,0,0,0,32671,11.0,39575,95,44,-3374,-3566,13.9,3267.1
4830517710,0,11,2,0,5,9,4,0,0,0,0,16449,6.6,16453,167,48,-1189,-1273,21.5,1644.9,13,0,1,9,5,14,1,1,0,0,17638,7.0,17726,187,60,1189,1273,24.7,1763.8
4826930731,0,10,0,0,15,16,33,0,0,0,1,29586,10.0,31026,68,35,-9698,-9010,10.3,2958.6,11,0,1,16,15,37,0,0,0,0,39284,11.0,40036,87,67,9698,9010,15.4,3928.4
4849735037,1,17,0,1,5,4,3,1,1,0,0,14458,6.4,15511,155,52,-805,-1021,20.7,1445.8,89,1,0,4,5,1,0,0,0,0,15263,6.4,16532,165,56,805,1021,22.1,1526.3
4849489601,1,19,1,0,7,5,8,0,0,0,0,17492,6.6,17012,178,44,1404,-3,22.2,1749.2,13,0,1,5,7,2,0,0,0,0,16088,6.6,17015,168,60,-1404,3,22.8,1608.8
4849473630,1,7,0,0,4,4,3,0,0,0,0,15868,6.8,17981,198,60,188,900,25.8,1586.8,8,1,1,4,4,4,0,0,0,0,15680,6.8,17081,190,51,-188,-900,24.1,1568.0
4849453664,0,13,2,1,5,3,4,0,0,0,0,16078,7.2,18791,203,42,935,831,24.5,1607.8,47,1,0,3,5,3,0,0,0,0,15143,7.0,17960,202,56,-935,-831,25.8,1514.3
4849406393,0,135,1,1,9,3,10,1,1,0,0,16784,6.6,16887,174,56,1438,9,23.0,1678.4,15,2,0,3,9,2,0,0,0,0,15346,6.4,16878,209,36,-1438,-9,24.5,1534.6
4849068118,0,25,0,0,7,5,3,0,0,0,0,14750,6.8,16861,139,49,-995,-633,18.8,1475.0,10,2,1,5,7,0,1,1,0,0,15745,6.6,17494,179,64,995,633,24.3,1574.5
4849035817,1,6,0,1,9,4,7,1,1,0,0,17608,7.4,18586,189,56,2317,1352,24.5,1760.8,12,0,0,4,9,1,0,0,0,0,15291,6.8,17234,203,32,-2317,-1352,23.5,1529.1
4848991834,1,11,0,1,4,3,5,0,0,0,0,15050,6.8,18102,190,52,1304,698,24.2,1505.0,8,0,0,3,4,2,0,0,0,0,13746,7.0,17404,181,52,-1304,-698,23.3,1374.6
4847354661,0,11,1,1,4,5,4,0,0,0,0,14823,6.8,17313,198,44,-1677,-1223,24.2,1482.3,10,1,0,5,4,3,2,1,1,0,16500,6.8,18536,220,70,1677,1223,29.0,1650.0
4847347824,0,12,0,0,10,5,16,0,0,0,0,18684,7.0,17584,216,44,2145,774,26.0,1868.4,18,1,1,5,10,11,0,0,0,0,16539,6.4,16810,162,52,-2145,-774,21.4,1653.9
4847328596,0,12,0,0,0,5,0,0,0,0,0,12405,6.2,15857,173,40,-4171,-3071,21.3,1240.5,18,3,1,5,0,2,1,1,0,0,16576,7.0,18928,223,64,4171,3071,28.7,1657.6
4847323986,0,13,0,0,4,11,1,0,0,0,0,13639,6.2,14869,149,44,-4443,-3075,19.3,1363.9,14,0,1,11,4,10,0,0,0,0,18082,6.8,17944,181,46,4443,3075,22.7,1808.2
4847307449,0,25,1,0,5,3,2,0,0,0,0,16074,7.0,17867,213,44,3159,1834,25.7,1607.4,9,11,1,3,5,0,0,0,0,0,12915,6.6,16033,132,56,-3159,-1834,18.8,1291.5
4846699442,0,10,0,0,7,7,6,0,0,0,0,16912,6.6,16658,176,44,215,-2259,22.0,1691.2,12,1,1,6,6,5,1,1,0,0,16697,7.0,18917,175,64,-215,2259,23.9,1669.7
4844705721,1,9,0,1,7,1,2,0,0,0,0,16915,7.0,18856,236,56,4937,4995,29.2,1691.5,14,3,0,1,7,0,0,0,0,0,11978,6.2,13861,136,39,-4937,-4995,17.5,1197.8
4844698055,0,10,0,1,5,9,2,2,1,1,0,15515,6.8,17364,181,49,-2643,-1378,23.0,1551.5,16,1,0,9,5,9,0,0,0,0,18158,7.2,18742,176,63,2643,1378,23.9,1815.8
4844670961,1,11,2,1,7,3,3,1,1,0,0,16624,7.2,18787,168,66,340,655,23.4,1662.4,19,1,0,3,7,1,0,0,0,0,16284,6.8,18132,223,56,-340,-655,27.9,1628.4
4844086966,1,11,0,1,8,4,7,1,1,0,1,18753,7.2,18507,224,60,4400,2989,28.4,1875.3,8,1,0,4,8,1,0,0,0,0,14353,6.0,15518,165,48,-4400,-2989,21.3,1435.3
4858157536,1,18,1,0,4,4,5,1,1,0,0,15711,6.4,16331,173,48,-686,-1111,22.1,1571.1,9,3,1,4,4,5,0,0,0,0,16397,6.8,17442,199,48,686,1111,24.7,1639.7
4855006545,0,10,4,0,9,11,7,0,0,0,0,17151,6.8,16336,167,42,-1931,-746,20.9,1715.1,18,1,1,11,9,18,1,1,0,0,19082,6.8,17082,163,66,1931,746,22.9,1908.2
4854956071,0,18,2,1,5,3,3,0,0,0,0,15173,6.8,18305,206,54,-490,129,26.0,1517.3,15,4,0,2,4,2,0,0,0,0,15663,7.0,18176,229,58,490,-129,28.7,1566.3
4854154572,1,14,2,1,22,16,18,0,0,0,0,63070,12.0,55000,2,0,26210,22000,0.2,6307.0,23,1,0,8,14,11,0,0,0,0,36860,7.2,33000,1,0,-26210,-22000,0.1,3686.0
4854133327,1,0,1,1,15,18,15,0,0,0,0,60955,12.0,55000,0,0,22756,22000,0.0,6095.5,35,0,0,13,10,12,0,0,0,0,38199,7.2,33000,3,0,-22756,-22000,0.3,3819.9
4853550386,1,40,0,1,14,17,18,0,0,0,0,63050,12.0,55000,0,0,24800,22000,0.0,6305.0,26,0,0,15,12,9,0,0,0,0,38250,7.2,33000,0,0,-24800,-22000,0.0,3825.0
4853537574,1,1,0,1,18,17,21,0,0,0,0,62820,12.0,55000,1,0,26318,22000,0.1,6282.0,364,0,0,11,12,11,0,0,0,0,36502,7.2,33000,0,0,-26318,-22000,0.0,3650.2
4853526655,1,0,0,0,21,19,17,0,0,0,0,61035,12.0,55000,1,0,22680,22000,0.1,6103.5,0,0,1,9,11,15,0,0,0,0,38355,7.2,33000,1,0,-22680,-22000,0.1,3835.5
4853524863,1,0,0,1,12,21,13,0,0,0,0,60720,12.8,61000,2,0,22629,25000,0.2,6072.0,0,0,0,15,6,13,0,0,0,0,38091,7.6,36000,1,0,-22629,-25000,0.1,3809.1
4853335829,1,15,0,1,24,17,24,0,0,0,0,64450,12.4,57000,0,0,26200,23000,0.0,6445.0,5,0,0,10,17,9,0,0,0,0,38250,7.4,34000,0,0,-26200,-23000,0.0,3825.0
4853326964,1,5,0,0,17,20,17,0,0,0,0,63767,12.0,55000,0,0,26217,22000,0.0,6376.7,1,0,1,12,9,10,0,0,0,0,37550,7.2,33000,0,0,-26217,-22000,0.0,3755.0
4853314249,1,17,0,1,16,20,14,0,0,0,0,63050,12.0,55000,0,0,24800,18000,0.0,6305.0,0,0,0,13,9,12,0,0,0,0,38250,8.0,37000,0,0,-24800,-18000,0.0,3825.0
4853307474,1,36,7,1,11,21,13,0,0,0,0,59635,12.0,55000,1,0,21185,22000,0.1,5963.5,34,0,0,14,4,13,0,0,0,0,38450,7.2,33000,6,0,-21185,-22000,0.6,3845.0
4853009592,1,16,0,1,15,12,14,0,0,0,0,46300,10.0,47500,0,1,19500,19000,0.1,4630.0,0,0,0,7,10,5,0,0,0,0,26800,6.0,28500,0,0,-19500,-19000,0.0,2680.0
4852993944,1,0,0,0,13,17,23,0,0,0,0,63700,12.0,55000,0,0,25790,22000,0.0,6370.0,29,0,1,14,10,9,0,0,0,0,37910,7.2,33000,1,0,-25790,-22000,0.1,3791.0
4851976060,0,34,4,0,4,9,6,0,0,0,0,14821,6.6,16054,191,48,-3218,-1922,23.9,1482.1,16,3,1,9,4,6,1,1,0,0,18039,6.8,17976,196,56,3218,1922,25.2,1803.9
4851945040,1,11,3,1,7,2,7,1,1,0,0,16135,6.8,16350,198,40,2217,-656,23.8,1613.5,14,1,0,2,7,0,0,0,0,0,13918,6.4,17006,187,60,-2217,656,24.7,1391.8
4850964290,1,13,1,1,7,5,3,0,0,0,0,16019,7.0,18283,189,52,-236,862,24.1,1601.9,11,1,0,5,7,6,1,1,0,0,16255,6.8,17421,183,60,236,-862,24.3,1625.5
4850903172,0,15,0,0,2,3,1,0,0,0,0,13990,6.8,17334,204,48,-345,-234,25.2,1399.0,13,1,1,3,2,1,0,0,0,0,14335,6.8,17568,181,51,345,234,23.2,1433.5
4850852605,1,14,0,0,9,4,11,1,1,0,0,19163,7.2,18864,191,48,5043,2588,23.9,1916.3,9,0,1,4,9,0,0,0,0,0,14120,6.4,16276,160,60,-5043,-2588,22.0,1412.0
4857633912,0,9,0,1,1,1,1,0,0,0,0,13761,7.0,17486,184,64,-2165,-1208,24.8,1376.1,14,2,0,1,1,0,0,0,0,0,15926,6.8,18694,230,52,2165,1208,28.2,1592.6
4857605320,1,16,3,1,3,3,4,0,0,0,0,15300,6.6,16210,205,56,-581,-656,26.1,1530.0,17,3,0,3,3,3,0,0,0,0,15881,6.6,16866,195,40,581,656,23.5,1588.1
4857581809,1,17,2,0,0,4,0,0,0,0,0,14203,6.8,17907,226,48,-2229,378,27.4,1420.3,16,2,1,4,0,4,0,0,0,0,16432,6.8,17529,223,52,2229,-378,27.5,1643.2
4856638820,0,11,1,1,2,9,2,0,0,0,0,13811,6.6,16343,194,62,-5107,-2043,25.6,1381.1,13,2,0,9,2,12,0,0,0,0,18918,7.0,18386,221,46,5107,2043,26.7,1891.8
4856608604,0,10,1,1,4,8,4,0,0,0,0,15604,6.4,16820,196,40,-1972,-1803,23.6,1560.4,70,2,0,8,4,9,0,0,0,0,17576,7.0,18623,224,48,1972,1803,27.2,1757.6
4856594963,0,7,1,0,1,2,0,0,0,0,0,14876,7.0,18753,230,60,-83,629,29.0,1487.6,54,1,1,2,1,0,0,0,0,0,14959,7.0,18124,224,52,83,-629,27.6,1495.9
4856575589,1,25,1,1,7,6,9,1,0,1,0,19730,7.0,17941,202,52,4002,938,25.4,1973.0,11,3,0,6,7,5,1,1,0,0,15728,6.8,17003,179,68,-4002,-938,24.7,1572.8
4856550507,0,11,0,0,0,3,0,0,0,0,0,14407,7.2,18910,231,64,-632,1041,29.5,1440.7,15,0,1,3,0,2,1,1,0,0,15039,7.0,17869,234,48,632,-1041,28.2,1503.9
4856532100,1,0,0,1,22,10,23,0,0,0,0,48810,10.0,47500,0,0,23060,19000,0.0,4881.0,0,0,0,3,15,3,0,0,0,0,25750,6.0,28500,0,0,-23060,-19000,0.0,2575.0
4856517909,1,0,0,0,15,17,18,0,0,0,0,61300,12.0,55000,0,0,23070,22000,0.0,6130.0,0,0,1,12,10,10,0,0,0,0,38230,7.2,33000,0,0,-23070,-22000,0.0,3823.0
4856470229,1,12,0,0,3,6,0,0,0,0,0,15074,6.8,17251,207,48,-1971,-1729,25.5,1507.4,10,2,1,6,3,6,0,0,0,0,17045,7.2,18980,196,67,1971,1729,26.3,1704.5
4849239400,1,11,0,1,7,6,10,1,1,0,0,17479,7.0,18331,193,52,-369,-366,24.5,1747.9,10,1,0,6,7,7,0,0,0,0,17848,7.2,18697,213,60,369,366,27.3,1784.8
4849217755,1,10,0,1,6,8,4,0,0,0,0,16911,6.8,16443,212,46,548,-1322,25.8,1691.1,17,1,0,8,6,3,0,0,0,0,16363,7.0,17765,233,46,-548,1322,27.9,1636.3
4849184002,1,11,3,0,6,5,5,0,0,0,0,17619,7.2,19287,232,56,2192,730,28.8,1761.9,13,0,1,5,6,4,1,1,0,0,15427,6.8,18557,198,52,-2192,-730,25.0,1542.7
4849158468,1,8,2,1,9,5,8,1,1,0,0,18428,7.0,19146,220,66,3115,1669,28.6,1842.8,13,0,0,5,9,6,0,0,0,0,15313,7.0,17477,178,56,-3115,-1669,23.4,1531.3
4849124289,0,6,1,1,7,4,4,0,0,0,0,15904,6.6,17084,180,44,171,-556,22.4,1590.4,11,1,0,4,7,1,0,0,0,0,15733,6.8,17640,193,52,-171,556,24.5,1573.3
4849084202,1,20,1,0,9,7,2,1,1,0,1,18967,7.2,19202,235,64,2707,2419,29.9,1896.7,10,0,1,7,9,6,0,0,0,0,16260,6.6,16783,200,48,-2707,-2419,24.8,1626.0
4846284193,1,10,0,0,6,4,2,0,0,0,0,17139,7.0,17285,185,54,513,-223,23.9,1713.9,10,0,1,4,6,7,1,1,0,0,16626,6.8,17508,184,62,-513,223,24.6,1662.6
4846273062,0,11,0,0,1,12,0,0,0,0,0,12526,6.2,15034,143,52,-8486,-5697,19.5,1252.6,13,0,1,12,1,9,1,1,0,0,21012,7.4,20731,230,72,8486,5697,30.2,2101.2
4843221530,0,6,0,1,27,28,62,0,0,0,1,38617,11.8,44008,109,0,-667,-454,10.9,3861.7,0,0,0,28,27,64,0,0,0,0,39284,11.6,44462,107,0,667,454,10.7,3928.4
4843198374,1,0,0,0,24,25,63,0,0,0,0,38969,11.4,42489,95,0,3279,3679,9.5,3896.9,0,0,1,25,24,50,0,0,0,0,35690,11.0,38810,88,0,-3279,-3679,8.8,3569.0
4842936041,1,2,0,0,30,25,72,0,0,0,1,38734,11.6,43808,95,0,53,474,9.5,3873.4,14,0,1,25,30,68,0,0,0,0,38681,11.4,43334,118,0,-53,-474,11.8,3868.1
4842855487,0,0,0,0,32,29,94,0,0,0,1,42221,11.8,45079,118,0,1795,2830,11.8,4222.1,0,0,1,29,32,69,0,0,0,0,40426,11.6,42249,101,0,-1795,-2830,10.1,4042.6
4841326720,1,0,0,0,13,25,32,0,0,0,0,33871,10.0,34972,91,0,-3877,-6384,9.1,3387.1,0,0,1,25,13,65,0,0,0,0,37748,11.2,41356,92,0,3877,6384,9.2,3774.8
4841303438,1,15,0,1,30,26,79,0,0,0,2,38980,11.2,41555,104,0,569,110,10.4,3898.0,0,0,0,26,30,71,0,0,0,0,38411,11.2,41445,94,0,-569,-110,9.4,3841.1
4841289884,0,0,0,0,22,21,50,0,0,0,1,37744,11.0,39549,125,0,921,-105,12.5,3774.4,0,0,1,21,22,51,0,0,0,0,36823,11.0,39654,108,0,-921,105,10.8,3682.3
4841264316,0,0,0,1,16,31,47,0,0,0,1,35687,11.2,39148,101,0,-4484,-4324,10.1,3568.7,0,0,0,31,16,92,0,0,0,0,40171,11.6,43472,123,0,4484,4324,12.3,4017.1
4840914294,1,0,0,0,29,30,76,0,0,0,1,38973,11.4,42449,108,0,736,371,10.8,3897.3,0,0,1,30,29,77,0,0,0,0,38237,11.2,42078,115,0,-736,-371,11.5,3823.7
4840900379,0,76,0,0,24,36,62,0,0,0,1,36335,10.8,38231,95,0,-5447,-9084,9.5,3633.5,0,0,1,36,24,77,0,0,0,0,41782,12.2,47315,97,0,5447,9084,9.7,4178.2
4840853997,1,0,0,0,26,23,80,0,0,0,0,37629,11.4,41654,111,0,-286,185,11.1,3762.9,2,0,1,23,26,54,0,0,0,0,37915,11.2,41469,110,0,286,-185,11.0,3791.5
4840838235,1,14,0,1,24,22,56,0,0,0,0,37686,11.2,41122,117,0,-338,-939,11.7,3768.6,0,5,0,22,24,60,0,0,0,0,38024,11.4,42061,113,0,338,939,11.3,3802.4
4840634355,0,19,0,0,23,32,61,0,0,0,1,37278,11.0,40785,90,0,-3317,-2651,9.0,3727.8,0,0,1,31,22,82,0,0,0,0,40595,11.4,43436,119,0,3317,2651,11.9,4059.5
4840623526,1,68,0,0,26,25,49,0,0,0,1,37630,11.4,42302,99,0,-132,-1248,9.9,3763.0,0,0,1,25,26,66,0,0,0,0,37762,11.8,43550,112,0,132,1248,11.2,3776.2
4840615693,0,2,0,0,24,33,53,0,0,0,1,38564,11.4,41210,132,0,-1142,-1898,13.2,3856.4,0,0,1,33,24,83,0,0,0,0,39706,11.6,43108,113,0,1142,1898,11.3,3970.6
4840276074,1,24,0,1,26,33,70,0,0,0,1,38502,11.4,41749,105,0,-159,-2775,10.5,3850.2,0,0,0,33,26,77,0,0,0,0,38661,11.6,44524,104,0,159,2775,10.4,3866.1
4840255041,1,14,0,1,22,23,74,0,0,0,1,37895,10.8,39071,98,0,631,-1813,9.8,3789.5,0,0,0,23,22,67,0,0,0,0,37264,11.2,40884,73,0,-631,1813,7.3,3726.4
4840223366,1,0,0,1,38,28,108,0,0,0,0,41731,12.0,47152,91,0,1581,2434,9.1,4173.1,0,0,0,28,38,82,0,0,0,0,40150,11.8,44718,91,0,-1581,-2434,9.1,4015.0
4840198361,0,0,2,0,19,29,54,0,0,0,1,36041,10.8,36765,116,0,-4071,-5449,11.6,3604.1,13,0,1,29,19,71,0,0,0,0,40112,11.4,42214,117,0,4071,5449,11.7,4011.2
4840171257,1,0,0,0,17,24,32,0,0,0,0,35515,10.6,37600,109,0,-1367,-3397,10.9,3551.5,0,0,1,24,17,61,0,0,0,0,36882,11.2,40997,115,0,1367,3397,11.5,3688.2
4847747221,0,12,0,1,7,6,6,0,0,0,0,15842,6.6,16999,160,44,-566,-1797,20.4,1584.2,17,0,0,6,7,4,0,0,0,0,16408,7.2,18796,211,80,566,1797,29.1,1640.8
4847702619,0,12,1,1,5,3,8,0,0,0,0,16056,6.6,17206,162,56,914,416,21.8,1605.6,16,2,0,3,5,2,1,1,0,0,15142,6.6,16790,225,52,-914,-416,27.7,1514.2
4846948187,0,17,3,1,6,6,6,0,0,0,0,15592,6.8,16430,175,44,-1802,-2175,21.9,1559.2,13,1,0,6,6,4,0,0,0,0,17394,7.0,18605,206,48,1802,2175,25.4,1739.4
4846888704,0,14,1,0,1,3,1,0,0,0,0,14700,6.8,17349,204,44,-527,37,24.8,1470.0,21,0,1,3,1,2,1,1,0,0,15227,6.6,17312,180,56,527,-37,23.6,1522.7
4840168054,0,11,1,0,9,4,10,1,1,0,0,18488,7.0,18720,222,60,2519,443,28.2,1848.8,18,2,1,4,9,3,0,0,0,0,15969,7.0,18277,229,44,-2519,-443,27.3,1596.9
4840127381,0,18,2,0,3,7,6,0,0,0,0,14122,6.0,15220,153,44,-2940,-3232,19.7,1412.2,16,4,1,7,3,8,0,0,0,0,17062,7.2,18452,193,68,2940,3232,26.1,1706.2
4840086278,1,133,1,0,4,2,6,0,0,0,0,15376,6.8,17686,196,43,465,894,23.9,1537.6,88,1,1,2,4,5,1,1,0,0,14911,6.6,16792,188,52,-465,-894,24.0,1491.1
4840040789,1,13,1,0,5,6,5,0,0,0,0,16018,6.6,16260,186,52,-324,-260,23.8,1601.8,13,1,1,6,5,7,0,0,0,0,16342,6.6,16520,203,28,324,260,23.1,1634.2
4838215774,1,117,12,1,12,7,13,1,1,0,0,20136,6.8,16772,153,60,3455,-594,21.3,2013.6,34,3,0,7,12,7,0,0,0,0,16681,6.8,17366,194,44,-3455,594,23.8,1668.1
4838137727,0,173,2,0,10,13,9,0,0,0,0,17137,7.0,17509,189,44,-1734,-466,23.3,1713.7,21,0,1,12,9,13,1,1,0,0,18871,6.8,17975,196,52,1734,466,24.8,1887.1
4838093875,1,13,1,1,4,5,2,2,1,1,0,15963,6.6,17215,192,52,-344,92,24.4,1596.3,12,2,0,5,4,6,0,0,0,0,16307,6.8,17123,229,40,344,-92,26.9,1630.7
4834583978,0,14,1,1,6,1,7,0,0,0,0,16727,6.8,18197,209,52,1350,-161,26.1,1672.7,76,2,0,1,6,1,1,1,0,0,15377,7.0,18358,201,60,-1350,161,26.1,1537.7
4834556783,0,54,0,0,1,5,2,1,1,0,0,14108,6.8,17553,182,60,-1761,-812,24.2,1410.8,13,2,1,5,1,5,0,0,0,0,15869,7.0,18365,197,48,1761,812,24.5,1586.9
4834529034,1,11,2,0,2,5,2,0,0,0,0,14586,6.6,16723,166,40,-1165,187,20.6,1458.6,14,1,1,5,2,3,0,0,0,0,15751,6.6,16536,191,36,1165,-187,22.7,1575.1
4834069741,0,14,5,0,6,9,5,1,1,0,0,17099,6.8,17278,208,48,-595,-111,25.6,1709.9,15,1,1,9,6,6,0,0,0,0,17694,6.8,17389,192,56,595,111,24.8,1769.4
4834006354,1,10,0,0,2,6,1,0,0,0,0,15630,7.2,18030,199,59,-561,199,25.8,1563.0,15,0,1,6,2,6,1,1,0,0,16191,6.8,17831,195,52,561,-199,24.7,1619.1
4833962609,1,180,0,1,7,3,4,0,0,0,0,17487,7.2,18953,253,64,3298,2689,31.7,1748.7,117,0,0,3,7,3,0,0,0,0,14189,6.6,16264,183,40,-3298,-2689,22.3,1418.9
4833570798,1,15,2,0,6,8,10,1,1,0,0,16300,6.8,16462,160,60,-741,-570,22.0,1630.0,20,2,1,8,6,10,0,0,0,0,17041,6.8,17032,192,44,741,570,23.6,1704.1
4833540679,0,12,0,0,4,6,1,0,0,0,0,13692,6.8,16924,173,44,-2606,-1696,21.7,1369.2,24,0,1,5,3,4,1,1,0,0,16298,7.2,18620,198,68,2606,1696,26.6,1629.8
4833521310,0,13,1,0,1,7,1,0,0,0,0,12882,6.4,16233,171,52,-4006,-3152,22.3,1288.2,15,3,1,7,1,2,1,1,0,0,16888,7.2,19385,205,56,4006,3152,26.1,1688.8
4832151790,1,9,2,1,1,8,0,0,0,0,0,14017,6.6,16754,190,56,-2125,-732,24.6,1401.7,15,1,0,7,0,4,1,1,0,0,16142,6.6,17486,198,48,2125,732,24.6,1614.2
4831526073,1,72,1,0,7,7,7,1,1,0,0,17112,6.8,17248,189,68,-502,-1201,25.7,1711.2,14,0,1,7,7,6,0,0,0,0,17614,7.0,18449,230,56,502,1201,28.6,1761.4
4831120911,1,9,1,1,5,3,2,0,0,0,0,16525,7.0,18205,191,52,1118,955,24.3,1652.5,12,0,0,3,5,4,1,1,0,0,15407,6.6,17250,188,56,-1118,-955,24.4,1540.7
4830600752,1,33,1,0,3,7,3,0,0,0,0,14774,6.8,16747,205,40,-1867,-2604,24.5,1477.4,33,0,1,7,3,4,0,0,0,0,16641,7.2,19351,185,72,1867,2604,25.7,1664.1
4830559817,1,10,1,0,7,4,6,1,1,0,0,17272,7.0,17919,202,60,2327,1496,26.2,1727.2,11,1,1,4,7,2,1,0,1,0,14945,6.6,16423,190,44,-2327,-1496,23.4,1494.5
4830519465,1,16,29,1,28,20,74,0,0,0,0,37847,11.4,41945,98,0,2173,1954,9.8,3784.7,31,1,0,20,28,45,0,0,0,0,35674,11.0,39991,75,0,-2173,-1954,7.5,3567.4
4830502866,1,0,0,1,27,24,83,0,0,0,2,41856,11.6,43163,124,0,4449,2877,12.4,4185.6,0,0,0,24,27,71,0,0,0,0,37407,10.8,40286,83,0,-4449,-2877,8.3,3740.7
4830479842,1,10,0,0,15,8,28,0,0,0,0,32377,11.4,40553,96,55,-1039,2618,15.1,3237.7,10,0,1,8,15,18,0,0,0,0,33416,11.0,37935,99,63,1039,-2618,16.2,3341.6
4830449447,0,48,0,0,22,16,52,0,0,0,0,35081,11.2,40473,54,67,2584,5687,12.1,3508.1,15,1,1,15,21,14,0,0,0,0,32497,10.4,34786,80,47,-2584,-5687,12.7,3249.7
4829638993,1,0,0,0,25,30,67,0,0,0,1,39231,11.4,42037,113,0,1210,-35,11.3,3923.1,0,0,1,30,25,74,0,0,0,0,38021,11.2,42072,89,0,-1210,35,8.9,3802.1
4829617169,0,14,0,1,11,9,22,0,0,0,0,31837,11.0,38177,72,52,-2737,-839,12.4,3183.7,15,0,0,9,11,17,0,0,0,0,34574,11.0,39016,108,47,2737,839,15.5,3457.4
4829565654,0,30,2,0,17,9,28,0,0,0,1,33965,10.8,37248,83,47,2876,3779,13.0,3396.5,24,0,1,9,17,13,0,0,0,0,31089,10.0,33469,84,55,-2876,-3779,13.9,3108.9
4829538689,0,23,1,1,9,17,6,0,0,0,1,32403,10.6,37075,112,60,-4646,-4590,17.2,3240.3,22,1,0,17,9,31,0,0,0,0,37049,11.2,41665,109,64,4646,4590,17.3,3704.9
4829516039,0,13,0,0,13,24,22,0,0,0,2,33306,10.6,36867,107,43,-5517,-4789,15.0,3330.6,13,0,1,23,12,53,0,0,0,0,38823,11.4,41656,92,75,5517,4789,16.7,3882.3
4828943619,1,0,0,1,35,22,74,0,0,0,0,40103,11.8,46776,99,0,2418,6143,9.9,4010.3,0,0,0,22,35,59,0,0,0,0,37685,11.4,40633,99,0,-2418,-6143,9.9,3768.5
4828927547,0,0,0,1,21,27,63,0,0,0,2,36128,11.0,38772,94,0,-3514,-5551,9.4,3612.8,0,0,0,27,21,83,0,0,0,0,39642,11.6,44323,94,0,3514,5551,9.4,3964.2
4839193775,1,9,1,0,6,6,3,0,0,0,0,15558,7.2,18685,187,68,-770,1235,25.5,1555.8,14,2,1,6,6,5,1,1,0,0,16328,6.6,17450,202,56,770,-1235,25.8,1632.8
4839150358,1,176,1,0,12,1,10,2,1,1,0,18196,7.0,18200,213,40,4559,2037,25.3,1819.6,15,0,1,1,12,3,0,0,0,0,13637,6.6,16163,201,56,-4559,-2037,25.7,1363.7
4839113765,0,13,1,0,4,11,5,0,0,0,1,14816,6.8,17572,180,48,-6471,-2376,22.8,1481.6,89,3,1,11,4,14,1,1,0,0,21287,7.6,19948,220,56,6471,2376,27.6,2128.7
4839083100,1,11,1,1,7,4,10,0,0,0,0,17588,6.8,17535,207,44,1749,902,25.1,1758.8,8,2,0,4,7,3,1,1,0,0,15839,6.6,16633,212,56,-1749,-902,26.8,1583.9
4835114036,0,10,6,0,7,6,5,1,1,0,0,16953,6.4,16698,193,48,-897,-1588,24.1,1695.3,44,0,1,6,7,8,0,0,0,0,17850,7.0,18286,198,53,897,1588,25.1,1785.0
4835080226,1,18,2,0,4,7,6,0,0,0,0,16469,6.8,17466,184,53,631,1282,23.7,1646.9,17,1,1,7,4,4,1,1,0,0,15838,6.4,16184,196,44,-631,-1282,24.0,1583.8
4833755558,1,12,6,1,6,2,7,0,0,0,0,16389,7.0,17949,221,48,1475,91,26.9,1638.9,89,0,0,2,6,2,1,1,0,0,14914,6.8,17858,201,56,-1475,-91,25.7,1491.4
4824521857,1,23,5,1,14,11,13,0,0,0,0,20101,7.0,17760,217,32,2578,-141,24.9,2010.1,12,0,0,11,14,4,0,0,0,0,17523,7.0,17901,164,52,-2578,141,21.6,1752.3
4824391486,1,11,0,1,6,7,1,0,0,0,0,15137,6.6,16758,216,27,-2138,-637,24.3,1513.7,9,1,0,7,6,8,0,0,0,0,17275,6.8,17395,220,56,2138,637,27.6,1727.5
4824236688,0,9,1,0,5,8,4,0,0,0,0,15824,6.4,16005,191,44,-1986,-1727,23.5,1582.4,15,0,1,8,5,6,0,0,0,0,17810,6.8,17732,225,48,1986,1727,27.3,1781.0
4824229100,1,21,1,0,8,4,4,0,0,0,0,16846,7.0,18340,196,72,1643,2225,26.8,1684.6,12,2,1,4,8,8,0,0,0,0,15203,6.4,16115,187,50,-1643,-2225,23.7,1520.3
4823654914,0,11,0,1,8,4,11,1,1,0,0,16715,6.6,16287,188,52,1700,-23,24.0,1671.5,12,0,0,4,8,2,0,0,0,0,15015,6.4,16310,192,60,-1700,23,25.2,1501.5
4823620906,0,32,0,0,4,5,4,0,0,0,0,15632,6.6,17812,168,58,-214,349,22.6,1563.2,14,0,1,5,4,5,1,1,0,0,15846,6.8,17463,194,50,214,-349,24.4,1584.6
4823597072,1,11,0,1,8,5,3,0,0,0,0,16211,7.0,17713,188,56,506,223,24.4,1621.1,14,1,0,5,8,6,0,0,0,0,15705,6.6,17490,215,52,-506,-223,26.7,1570.5
4823579344,1,15,1,0,16,8,17,0,0,0,0,19321,7.0,18493,184,55,2911,2876,23.9,1932.1,9,4,1,7,15,7,0,0,0,0,16410,6.4,15617,186,52,-2911,-2876,23.8,1641.0
4823533434,1,9,1,1,11,7,9,0,0,0,0,18021,6.8,17188,211,16,2497,348,22.7,1802.1,10,2,0,7,11,8,1,1,0,0,15524,6.6,16840,139,56,-2497,-348,19.5,1552.4
4823516510,1,77,1,1,9,3,8,0,0,0,0,18657,7.0,18217,222,48,4309,1197,27.0,1865.7,14,0,0,3,9,0,1,1,0,0,14348,6.6,17020,203,52,-4309,-1197,25.5,1434.8
4822597991,1,8,4,1,6,3,4,0,0,0,0,17084,6.6,16856,190,47,2025,1463,23.7,1708.4,9,3,0,3,6,5,0,0,0,0,15059,6.4,15393,170,44,-2025,-1463,21.4,1505.9
4822372107,0,11,0,0,1,7,0,0,0,0,0,15062,6.6,15978,152,53,-2643,-2822,20.5,1506.2,21,2,1,7,1,3,0,0,0,0,17705,7.0,18800,237,52,2643,2822,28.9,1770.5
4819060930,0,15,0,1,4,3,4,1,1,0,0,16499,7.0,18082,220,68,597,-871,28.8,1649.9,12,1,0,3,4,2,0,0,0,0,15902,7.0,18953,218,67,-597,871,28.5,1590.2
4855449315,1,13,0,1,5,5,8,1,1,0,0,16460,6.8,17137,202,48,0,-1520,25.0,1646.0,10,0,0,5,5,1,0,0,0,0,16460,7.4,18657,185,60,0,1520,24.5,1646.0
4855408869,1,12,2,1,6,2,5,0,0,0,0,16858,6.8,17714,231,44,2677,1437,27.5,1685.8,18,2,0,2,6,1,0,0,0,0,14181,6.4,16277,182,56,-2677,-1437,23.8,1418.1
4839436134,1,9,0,1,9,5,7,0,0,0,0,18731,7.4,19788,212,53,3503,2171,26.5,1873.1,16,1,0,5,9,1,0,0,0,0,15228,6.8,17617,198,42,-3503,-2171,24.0,1522.8
4839415048,1,199,0,1,20,15,51,0,0,0,1,37347,10.8,39373,111,0,2824,2290,11.1,3734.7,0,0,0,15,20,30,0,0,0,0,34523,10.6,37083,89,0,-2824,-2290,8.9,3452.3
4838475212,1,0,0,1,25,30,45,0,0,0,0,38470,11.2,41540,92,0,812,-2393,9.2,3847.0,0,0,0,30,25,60,0,0,0,0,37658,11.8,43933,99,0,-812,2393,9.9,3765.8
4838445881,0,273,2,0,1,4,1,0,0,0,0,15103,7.0,17869,223,56,-916,-1352,27.9,1510.3,11,0,1,4,1,6,0,0,0,0,16019,7.2,19221,201,64,916,1352,26.5,1601.9
4838428024,1,17,0,1,2,1,2,0,0,0,0,17530,7.0,18576,220,56,3587,915,27.6,1753.0,71,1,0,1,2,0,0,0,0,0,13943,6.8,17661,207,52,-3587,-915,25.9,1394.3
4838408042,0,8,1,0,3,4,5,0,0,0,0,15354,6.8,17692,207,54,-1333,-310,26.1,1535.4,15,1,1,4,3,5,1,1,0,0,16687,6.8,18002,193,48,1333,310,24.1,1668.7
4838354242,0,7,1,0,2,4,1,1,1,0,0,14803,7.0,18891,229,56,-926,-191,28.5,1480.3,11,0,1,4,2,3,0,0,0,0,15729,7.2,19082,221,71,926,191,29.2,1572.9
4837131614,0,17,1,1,10,8,9,0,0,0,0,18321,6.6,16672,176,32,715,-359,20.8,1832.1,12,1,0,8,10,9,0,0,0,0,17606,6.6,17031,180,47,-715,359,22.7,1760.6
4836235740,1,15,0,0,4,5,4,0,0,0,0,15902,6.6,17034,179,48,-580,-851,22.7,1590.2,11,1,1,5,4,2,0,0,0,0,16482,6.8,17885,211,56,580,851,26.7,1648.2
4836200781,0,11,2,1,7,1,11,0,0,0,0,16501,6.8,17791,174,60,1951,-354,23.4,1650.1,139,0,0,1,7,2,0,0,0,0,14550,6.8,18145,226,44,-1951,354,27.0,1455.0
4836160184,1,10,0,0,2,4,1,0,0,0,0,14314,7.0,17960,196,50,-2606,-103,24.6,1431.4,15,0,1,4,2,8,0,0,0,0,16920,6.8,18063,196,52,2606,103,24.8,1692.0
4836106682,1,14,10,1,3,3,3,0,0,0,0,16130,7.4,19401,219,56,1583,1232,27.5,1613.0,36,2,0,3,3,2,0,0,0,0,14547,7.0,18169,203,48,-1583,-1232,25.1,1454.7
4721615142,0,12,0,0,6,9,3,0,0,0,0,15898,6.6,16443,164,48,-2742,-1694,21.2,1589.8,7,2,1,9,6,4,0,0,0,0,18640,6.6,18137,190,40,2742,1694,23.0,1864.0
4721572193,0,11,3,0,6,5,6,0,0,0,0,16975,7.0,17854,200,64,2152,885,26.4,1697.5,13,0,1,5,6,4,0,0,0,0,14823,6.8,16969,165,44,-2152,-885,20.9,1482.3
4719425424,0,65,2,0,5,4,2,1,1,0,0,16162,7.0,18643,192,59,822,1025,25.1,1616.2,9,0,1,4,5,1,0,0,0,0,15340,7.0,17618,199,68,-822,-1025,26.7,1534.0
4719363498,1,9,2,0,2,5,2,0,0,0,0,15935,7.0,18322,214,55,306,1027,26.9,1593.5,26,1,1,5,2,4,0,0,0,0,15629,6.8,17295,210,48,-306,-1027,25.8,1562.9
4719295722,0,12,0,1,6,6,5,1,0,1,0,18432,7.2,18594,216,60,522,143,27.6,1843.2,12,0,0,6,6,6,1,1,0,0,17910,7.0,18451,181,59,-522,-143,24.0,1791.0
4717152557,1,10,0,1,9,3,12,2,1,1,0,17363,7.0,18025,215,40,2129,68,25.5,1736.3,12,0,0,3,9,2,0,0,0,0,15234,7.0,17957,185,48,-2129,-68,23.3,1523.4
4815827796,0,12,0,0,3,3,1,0,0,0,0,16197,6.8,18314,230,64,320,136,29.4,1619.7,10,2,1,3,3,6,1,1,0,0,15877,7.0,18178,208,64,-320,-136,27.2,1587.7
4815456043,0,12,1,1,3,6,3,0,0,0,0,15494,6.8,18047,216,48,301,606,26.4,1549.4,52,0,0,6,3,4,1,1,0,0,15193,6.6,17441,198,60,-301,-606,25.8,1519.3
4808612796,1,10,0,1,5,3,4,0,0,0,0,16954,7.2,18475,230,56,2312,1063,28.6,1695.4,9,2,0,2,4,1,0,0,0,0,14642,6.6,17412,178,47,-2312,-1063,22.5,1464.2
4774706443,0,9,0,0,4,7,1,0,0,0,0,15832,6.8,17164,166,68,-1903,-714,23.4,1583.2,15,1,1,7,4,7,1,1,0,0,17735,6.8,17878,192,55,1903,714,24.7,1773.5
4771055566,0,98,3,1,3,10,3,0,0,0,0,15461,6.4,16800,201,40,-2689,-1676,24.1,1546.1,11,0,0,10,3,7,0,0,0,0,18150,7.0,18476,223,60,2689,1676,28.3,1815.0
4759875640,1,31,0,0,7,8,9,1,1,0,0,18151,6.8,18601,212,48,-58,237,26.0,1815.1,10,3,1,8,7,7,0,0,0,0,18209,7.0,18364,192,56,58,-237,24.8,1820.9
4759250716,0,10,0,0,5,10,3,0,0,0,0,14814,6.6,16796,207,52,-4285,-2125,25.9,1481.4,12,1,1,10,5,10,1,1,0,0,19099,7.0,18921,236,55,4285,2125,29.1,1909.9
4759035341,0,120,0,1,8,4,6,1,0,1,0,17692,6.8,17493,189,52,2676,889,24.1,1769.2,10,0,0,4,8,3,1,1,0,0,15016,6.6,16604,184,48,-2676,-889,23.2,1501.6
4756064122,1,88,1,0,5,5,7,0,0,0,0,15711,6.6,16443,201,36,647,-1059,23.7,1571.1,14,1,1,5,5,1,1,1,0,0,15064,6.8,17502,193,64,-647,1059,25.7,1506.4
4755824469,1,89,4,1,4,7,2,0,0,0,0,16674,6.8,17555,215,52,352,-530,26.7,1667.4,35,2,0,7,4,7,0,0,0,0,16322,7.0,18085,180,56,-352,530,23.6,1632.2
4755545084,1,81,0,0,2,7,1,0,0,0,0,17204,6.8,17852,223,55,1742,922,27.8,1720.4,17,1,1,7,2,5,0,0,0,0,15462,6.8,16930,159,44,-1742,-922,20.3,1546.2
4754540425,1,10,0,1,7,5,5,1,0,1,0,16986,7.2,18493,167,56,1262,443,22.3,1698.6,13,0,0,5,7,3,1,1,0,0,15724,7.0,18050,187,68,-1262,-443,25.5,1572.4
4754516742,0,0,17,0,26,33,69,0,0,0,2,38705,11.6,42965,106,0,250,-1081,10.6,3870.5,23,0,1,33,26,62,0,0,0,0,38455,11.6,44046,98,0,-250,1081,9.8,3845.5
4750571674,0,217,0,0,3,4,1,1,1,0,0,14613,7.2,17865,199,62,-110,1382,26.1,1461.3,9,2,1,4,3,5,0,0,0,0,14723,6.8,16483,177,46,110,-1382,22.3,1472.3
4748327289,1,18,1,1,6,3,4,0,0,0,0,16939,7.2,17961,191,60,2183,1710,25.1,1693.9,15,2,0,3,6,2,1,0,1,0,14756,6.4,16251,180,52,-2183,-1710,23.2,1475.6
4748272117,1,16,0,1,11,4,8,0,0,0,0,17677,7.0,18283,191,60,2951,470,25.1,1767.7,14,1,0,4,11,3,0,0,0,0,14726,6.8,17813,181,52,-2951,-470,23.3,1472.6
4747507288,1,18,0,1,8,4,6,0,0,0,0,16867,7.0,17787,175,60,2261,1855,23.5,1686.7,10,0,0,4,8,2,0,0,0,0,14606,6.4,15932,159,52,-2261,-1855,21.1,1460.6
4747445451,0,13,2,1,1,1,1,0,0,0,0,15976,7.0,17828,202,48,2649,1475,25.0,1597.6,10,2,0,1,1,1,0,0,0,0,13327,6.8,16353,158,56,-2649,-1475,21.4,1332.7
4746895715,1,12,2,0,5,7,6,2,1,1,0,16021,6.8,18154,183,60,-1653,618,24.3,1602.1,231,2,1,7,5,8,0,0,0,0,17674,6.8,17536,217,42,1653,-618,25.9,1767.4
4746622545,0,13,1,0,4,8,2,0,0,0,0,16400,6.8,18231,214,56,-627,-1300,27.0,1640.0,12,0,1,8,4,4,0,0,0,0,17027,7.2,19531,212,69,627,1300,28.1,1702.7
4782686373,1,14,0,1,4,5,3,0,0,0,0,14071,6.6,17075,143,44,-1376,-1376,18.7,1407.1,12,1,0,4,3,4,0,0,0,0,15447,7.0,18451,221,52,1376,1376,27.3,1544.7
4760850149,1,12,1,0,5,7,4,0,0,0,0,16841,6.8,17996,188,48,-542,915,23.6,1684.1,11,1,1,7,5,3,0,0,0,0,17383,6.6,17081,197,47,542,-915,24.4,1738.3
4760611731,1,142,2,0,9,6,3,0,0,0,0,17651,7.0,18708,204,72,2286,2964,27.6,1765.1,6,3,1,6,9,4,1,1,0,0,15365,6.6,15744,166,48,-2286,-2964,21.4,1536.5
4760543326,0,13,0,1,6,4,5,0,0,0,0,16704,7.0,18103,204,48,663,186,25.2,1670.4,14,2,0,4,6,4,0,0,0,0,16041,6.8,17917,179,63,-663,-186,24.2,1604.1
4760502185,0,11,3,1,2,7,3,0,0,0,0,16145,6.8,16701,210,56,-534,-610,26.6,1614.5,12,1,0,7,2,5,1,1,0,0,16679,7.0,17311,183,48,534,610,23.1,1667.9
4760466346,1,9,2,1,2,0,1,1,1,0,0,15175,7.0,18492,198,56,1698,1087,25.4,1517.5,14,2,0,0,2,0,0,0,0,0,13477,7.0,17405,184,52,-1698,-1087,23.6,1347.7
4759564524,1,124,0,1,4,1,1,0,0,0,0,15783,7.0,19102,202,52,2624,2996,25.4,1578.3,12,0,0,1,4,1,1,1,0,0,13159,6.6,16106,158,56,-2624,-2996,21.4,1315.9
4759545250,0,10,3,0,3,5,4,0,0,0,0,15277,6.4,16412,199,52,78,-748,25.1,1527.7,83,1,1,5,3,4,0,0,0,0,15199,6.8,17160,164,52,-78,748,21.6,1519.9
4759497269,1,12,3,1,4,7,1,0,0,0,0,14910,6.8,17406,185,48,-1501,-600,23.3,1491.0,13,2,0,7,4,5,1,1,0,0,16411,6.8,18006,200,56,1501,600,25.6,1641.1
4759384852,0,160,5,1,4,6,1,0,0,0,0,15539,6.6,16607,180,52,381,244,23.2,1553.9,32,1,0,5,3,7,0,0,0,0,15158,6.6,16363,191,44,-381,-244,23.5,1515.8
4759362370,1,15,4,1,5,4,4,0,0,0,0,16871,7.0,18763,239,44,1552,1507,28.3,1687.1,8,2,0,4,5,4,0,0,0,0,15319,6.8,17256,203,56,-1552,-1507,25.9,1531.9
4759339695,0,9,0,1,7,11,9,0,0,0,0,17015,6.6,16811,177,40,-1759,-1216,21.7,1701.5,11,0,0,11,7,10,0,0,0,0,18774,7.2,18027,191,52,1759,1216,24.3,1877.4
4759041820,1,16,1,0,4,5,4,1,1,0,0,15947,7.0,17384,169,52,-1136,-1648,22.1,1594.7,12,1,1,5,4,2,0,0,0,0,17083,7.4,19032,220,56,1136,1648,27.6,1708.3
4759002803,1,11,1,0,6,5,4,0,0,0,0,18443,7.2,18248,230,56,1940,-352,28.6,1844.3,15,0,1,5,6,4,0,0,0,0,16503,7.0,18600,204,50,-1940,352,25.4,1650.3
4758907997,0,12,3,1,10,7,4,0,0,0,0,17740,7.0,17950,174,44,45,826,21.8,1774.0,11,2,0,7,10,7,0,0,0,0,17695,6.8,17124,199,60,-45,-826,25.9,1769.5
4758819288,1,29,0,0,7,3,7,1,1,0,0,17104,6.8,17550,202,60,1496,195,26.2,1710.4,29,2,1,3,7,2,0,0,0,0,15608,6.6,17355,194,44,-1496,-195,23.8,1560.8
4758777538,0,13,3,0,3,7,1,0,0,0,0,14970,6.6,16776,202,56,-3110,-943,25.8,1497.0,15,3,1,7,3,3,0,0,0,0,18080,6.6,17719,183,44,3110,943,22.7,1808.0
4758685162,1,0,0,1,28,15,46,0,0,0,1,39508,11.4,42529,108,0,5692,7485,10.8,3950.8,0,0,0,13,26,27,0,0,0,0,33816,10.2,35044,100,0,-5692,-7485,10.0,3381.6
4758662311,1,38,0,1,3,1,4,0,0,0,0,14445,6.8,17947,168,52,924,1235,22.0,1444.5,14,0,0,1,3,1,0,0,0,0,13521,6.8,16712,206,48,-924,-1235,25.4,1352.1
4854926957,1,15,1,0,4,7,1,1,1,0,0,14536,6.6,17248,209,44,-2315,-52,25.3,1453.6,10,3,1,7,4,5,0,0,0,0,16851,6.8,17300,215,51,2315,52,26.6,1685.1
4854893893,0,8,1,0,12,5,11,0,0,0,0,18656,6.8,17685,194,55,3418,1400,24.9,1865.6,10,0,1,5,12,4,1,1,0,0,15238,6.4,16285,162,61,-3418,-1400,22.3,1523.8
4854850798,0,12,0,0,5,5,4,0,0,0,0,15430,6.6,17301,180,48,-956,-1342,22.8,1543.0,7,0,1,5,5,3,0,0,0,0,16386,6.8,18643,196,60,956,1342,25.6,1638.6
4852840065,1,0,0,0,18,16,17,0,0,0,0,46300,10.0,47500,0,0,18775,19000,0.0,4630.0,0,0,1,11,13,9,0,0,0,0,27525,6.0,28500,1,0,-18775,-19000,0.1,2752.5
4852768612,1,10,0,1,5,3,4,0,0,0,0,15049,6.8,17050,164,63,62,-354,22.7,1504.9,21,0,0,3,5,4,1,1,0,0,14987,6.6,17404,214,68,-62,354,28.2,1498.7
4852388027,0,11,0,1,6,6,8,0,0,0,0,16979,6.8,17515,192,48,-581,-1126,24.0,1697.9,12,2,0,6,6,5,0,0,0,0,17560,7.0,18641,184,64,581,1126,24.8,1756.0
4851974839,1,0,0,0,23,29,65,0,0,0,0,37701,11.2,41598,109,0,41,-215,10.9,3770.1,31,0,1,29,23,79,0,0,0,0,37660,11.4,41813,92,0,-41,215,9.2,3766.0
4851953077,0,0,0,1,22,21,61,0,0,0,2,37613,10.6,37540,126,0,526,-649,12.6,3761.3,0,0,0,21,22,58,0,0,0,0,37087,11.0,38189,103,0,-526,649,10.3,3708.7
4851918581,0,26,0,1,23,23,53,0,0,0,0,37706,11.8,42942,95,0,568,2273,9.5,3770.6,17,0,0,23,23,42,0,0,0,0,37138,11.0,40669,107,0,-568,-2273,10.7,3713.8
4851896707,1,0,0,0,30,21,73,0,0,0,0,40880,12.0,45979,118,0,4155,5054,11.8,4088.0,0,0,1,21,30,53,0,0,0,0,36725,11.0,40925,104,0,-4155,-5054,10.4,3672.5
4851060263,0,10,0,0,4,4,5,0,0,0,0,15934,6.6,17511,201,42,-1216,-1808,24.3,1593.4,194,0,1,4,4,5,1,1,0,0,17150,6.8,19319,250,52,1216,1808,30.2,1715.0
4851018488,1,12,0,1,7,6,4,1,1,0,0,17069,7.2,18665,207,64,243,394,27.1,1706.9,12,0,0,6,7,7,0,0,0,0,16826,7.2,18271,218,54,-243,-394,27.2,1682.6
4850989699,0,21,2,0,3,6,3,0,0,0,0,14920,6.4,15787,190,44,-2546,-3635,23.4,1492.0,10,2,1,6,3,3,0,0,0,0,17466,7.2,19422,241,72,2546,3635,31.3,1746.6
4850951413,0,9,0,0,9,10,4,0,0,0,0,17450,6.8,17160,155,60,-1522,-845,21.5,1745.0,9,1,1,10,9,8,1,1,0,0,18972,6.8,18005,219,55,1522,845,27.4,1897.2
4849147322,1,13,0,1,5,1,5,0,0,0,0,16421,7.0,18024,241,48,2504,905,28.9,1642.1,7,1,0,1,5,1,0,0,0,0,13917,6.6,17119,210,59,-2504,-905,26.9,1391.7
4848815727,1,0,0,0,34,18,78,0,0,0,1,41237,12.0,44894,117,0,4921,5960,11.7,4123.7,0,0,1,18,34,55,0,0,0,0,36316,10.8,38934,106,0,-4921,-5960,10.6,3631.6
4848789766,1,0,0,0,18,22,37,0,0,0,0,36032,11.4,41210,100,0,-330,683,10.0,3603.2,0,0,1,22,18,55,0,0,0,0,36362,11.0,40527,107,0,330,-683,10.7,3636.2
4848047139,0,0,0,1,16,18,46,0,0,0,0,36227,10.8,37921,99,0,1725,154,9.9,3622.7,0,0,0,18,16,40,0,0,0,0,34502,10.8,37767,105,0,-1725,-154,10.5,3450.2
4848011650,1,0,0,0,19,19,39,0,0,0,2,36075,10.8,38988,102,0,-28,887,10.2,3607.5,0,0,1,18,18,52,0,0,0,0,36103,10.8,38101,114,0,28,-887,11.4,3610.3
4838038764,0,10,0,1,1,3,1,1,0,1,0,13934,6.8,17336,199,48,-575,-902,24.7,1393.4,12,0,0,3,1,0,0,0,0,0,14509,7.2,18238,192,48,575,902,24.0,1450.9
4837975882,0,11,1,0,1,3,2,0,0,0,0,13964,7.0,17896,200,60,-2789,-609,26.0,1396.4,14,0,1,3,1,5,1,1,0,0,16753,7.0,18505,240,60,2789,609,30.0,1675.3
4836155991,1,10,1,0,2,7,0,0,0,0,0,13748,6.6,16603,164,59,-3278,-3080,22.3,1374.8,12,1,1,7,2,4,1,1,0,0,17026,7.2,19683,254,69,3278,3080,32.3,1702.6
4836109390,0,12,1,1,6,2,9,1,1,0,0,17452,7.0,18212,227,60,2884,682,28.7,1745.2,9,1,0,2,6,2,0,0,0,0,14568,6.8,17530,196,60,-2884,-682,25.6,1456.8
4835943245,0,12,1,1,6,4,3,0,0,0,0,16401,6.8,18081,210,46,1406,667,25.6,1640.1,11,1,0,4,6,1,0,0,0,0,14995,6.8,17414,210,50,-1406,-667,26.0,1499.5
4835219209,0,0,0,0,17,22,32,0,0,0,0,34853,10.6,36950,88,0,1079,-738,8.8,3485.3,0,0,1,22,17,57,0,0,0,0,33774,10.8,37688,89,0,-1079,738,8.9,3377.4
4834165917,1,13,1,1,7,7,0,0,0,0,0,15395,6.6,16893,178,48,-1498,-1568,22.6,1539.5,10,0,0,7,7,5,0,0,0,0,16893,7.2,18461,196,56,1498,1568,25.2,1689.3
4834119240,0,13,1,1,6,5,2,0,0,0,0,15848,6.6,16485,190,40,1193,70,23.0,1584.8,16,1,0,5,6,4,0,0,0,0,14655,6.6,16415,189,40,-1193,-70,22.9,1465.5
4799899167,0,9,18,1,7,9,5,0,0,0,0,15470,6.6,17512,140,56,-2201,-920,19.6,1547.0,100,2,0,9,7,7,0,0,0,0,17671,7.0,18432,158,56,2201,920,21.4,1767.1
4799854419,1,11,0,1,4,6,6,2,1,1,0,15405,6.4,16039,144,49,204,-967,19.3,1540.5,17,2,0,6,4,1,0,0,0,0,15201,6.6,17006,159,56,-204,967,21.5,1520.1
4799813401,1,14,1,1,2,2,1,0,0,0,0,15578,7.0,18853,173,64,605,905,23.7,1557.8,12,1,0,2,2,1,1,1,0,0,14973,7.0,17948,191,48,-605,-905,23.9,1497.3
4799625579,0,11,1,0,2,3,3,0,0,0,0,14323,7.0,17321,175,60,-1089,-111,23.5,1432.3,14,0,1,3,2,4,0,0,0,0,15412,6.8,17432,213,40,1089,111,25.3,1541.2
4798819608,1,14,1,1,7,5,7,0,0,0,0,16885,7.0,17943,198,60,2250,2415,25.8,1688.5,11,1,0,5,7,6,0,0,0,0,14635,6.4,15528,154,40,-2250,-2415,19.4,1463.5
4798763701,0,10,0,0,7,9,4,0,0,0,0,16266,6.8,17236,163,52,-468,503,21.5,1626.6,9,0,1,9,7,8,0,0,0,0,16734,6.4,16733,122,60,468,-503,18.2,1673.4
4798729855,1,9,1,0,9,8,5,0,0,0,0,16945,6.8,16658,171,36,252,-1355,20.7,1694.5,10,0,1,8,9,6,1,1,0,0,16693,7.0,18013,163,66,-252,1355,22.9,1669.3
4798686331,1,12,13,0,3,5,1,0,0,0,0,13795,7.0,17800,179,64,-1179,-15,24.3,1379.5,28,1,1,5,3,1,0,0,0,0,14974,7.0,17815,200,38,1179,15,23.8,1497.4
4795207832,1,8,0,0,4,5,4,0,0,0,0,14231,6.2,15296,141,36,-859,-2059,17.7,1423.1,12,0,1,5,4,3,0,0,0,0,15090,7.0,17355,166,48,859,2059,21.4,1509.0
4792308670,1,11,0,0,8,5,6,1,1,0,0,15915,6.8,16499,133,60,912,-831,19.3,1591.5,7,0,1,4,7,1,0,0,0,0,15003,6.6,17330,157,52,-912,831,20.9,1500.3
4792267505,0,58,0,0,2,7,2,0,0,0,0,14259,6.4,16551,156,48,-1267,-872,20.4,1425.9,28,1,1,7,2,4,2,1,1,0,15526,6.8,17423,140,64,1267,872,20.4,1552.6
4792188883,1,10,1,1,5,5,2,0,0,0,0,15745,6.8,17484,187,36,1158,614,22.3,1574.5,10,0,0,5,5,4,0,0,0,0,14587,6.6,16870,143,64,-1158,-614,20.7,1458.7
4839207551,1,0,0,1,21,10,54,0,0,0,1,35156,10.8,37432,72,0,966,1581,7.2,3515.6,344,0,0,10,21,21,0,0,0,0,34190,10.6,35851,110,0,-966,-1581,11.0,3419.0
4827606648,0,10,0,0,6,25,5,0,0,0,0,32450,10.2,33725,59,47,238,-5716,10.6,3245.0,10,0,1,25,6,44,0,0,0,0,32212,11.0,39441,54,43,-238,5716,9.7,3221.2
4800450053,0,3,0,1,31,28,82,0,0,0,0,40407,11.8,45612,81,0,2309,4694,8.1,4040.7,12,0,0,28,31,80,0,0,0,0,38098,11.2,40918,92,0,-2309,-4694,9.2,3809.8
4800431795,0,0,0,0,29,30,71,0,0,0,1,36398,11.0,40526,85,0,-3188,-682,8.5,3639.8,18,0,1,30,29,55,0,0,0,0,39586,11.2,41208,94,0,3188,682,9.4,3958.6
4794784931,1,0,0,1,27,19,61,0,0,0,0,37184,11.0,39459,109,0,773,-2897,10.9,3718.4,0,0,0,19,27,38,0,0,0,0,36411,11.2,42356,107,0,-773,2897,10.7,3641.1
4794761438,1,0,21,1,20,13,52,0,0,0,0,35516,10.6,37979,114,0,1502,1122,11.4,3551.6,15,0,0,13,20,36,0,0,0,0,34014,10.6,36857,95,0,-1502,-1122,9.5,3401.4
4789419678,0,0,0,0,16,19,49,0,0,0,1,34312,10.4,35835,91,0,-2057,-3715,9.1,3431.2,1,0,1,19,16,41,0,0,0,0,36369,11.0,39550,97,0,2057,3715,9.7,3636.9
4789412176,1,14,4,1,21,19,38,0,0,0,1,37957,11.2,41138,123,0,1911,2346,12.3,3795.7,6,0,0,19,21,44,0,0,0,0,36046,11.0,38792,66,0,-1911,-2346,6.6,3604.6
4788331060,1,24,0,1,28,19,65,0,0,0,1,38716,11.2,41120,108,0,2087,1311,10.8,3871.6,0,28,0,19,28,35,0,0,0,0,36629,11.0,39809,96,0,-2087,-1311,9.6,3662.9
4787507574,0,0,0,0,19,27,51,0,0,0,0,35908,10.8,38276,95,0,-3539,-5345,9.5,3590.8,0,0,1,27,19,56,0,0,0,0,39447,11.6,43621,96,0,3539,5345,9.6,3944.7
4787491635,0,0,0,0,18,18,44,0,0,0,0,35661,11.2,40700,76,0,922,2425,7.6,3566.1,0,0,1,18,18,41,0,0,0,0,34739,10.8,38275,93,0,-922,-2425,9.3,3473.9
4787481135,1,15,0,0,22,20,47,0,0,0,1,35624,11.0,39784,99,0,-398,-453,9.9,3562.4,10,0,1,20,22,47,0,0,0,0,36022,11.0,40237,91,0,398,453,9.1,3602.2
4787450943,0,0,0,1,25,21,45,0,0,0,3,38486,11.0,39870,104,0,209,182,10.4,3848.6,7,0,0,21,25,56,0,0,0,0,38277,11.0,39688,112,0,-209,-182,11.2,3827.7
4787385878,0,216,0,1,21,21,40,0,0,0,0,34838,11.0,39184,106,0,-570,600,10.6,3483.8,0,0,0,21,21,48,0,0,0,0,35408,11.0,38584,102,0,570,-600,10.2,3540.8
4787361478,0,0,0,1,25,20,53,0,0,0,0,37332,11.4,42610,83,0,1981,3334,8.3,3733.2,0,0,0,20,25,44,0,0,0,0,35351,11.0,39276,83,0,-1981,-3334,8.3,3535.1
4785822074,0,0,0,0,31,31,58,0,0,0,0,40303,11.6,45432,95,0,2226,536,9.5,4030.3,0,0,1,31,31,63,0,0,0,0,38077,12.0,44896,87,0,-2226,-536,8.7,3807.7
4785803413,1,0,0,0,24,22,47,0,0,0,1,37476,11.4,40442,102,0,-174,-1461,10.2,3747.6,0,0,1,22,24,51,0,0,0,0,37650,11.2,41903,119,0,174,1461,11.9,3765.0
4785795874,0,87,1,1,19,25,45,0,0,0,1,36067,10.6,39026,107,0,-735,-1769,10.7,3606.7,13,4,0,25,19,44,0,0,0,0,36802,11.2,40795,108,0,735,1769,10.8,3680.2
4785782991,1,0,0,0,18,17,47,0,0,0,1,34899,10.6,37659,96,0,-1065,-708,9.6,3489.9,17,0,1,16,17,50,0,0,0,0,35964,10.8,38367,102,0,1065,708,10.2,3596.4
4858105059,1,42,0,1,19,12,15,0,0,0,0,46650,10.0,47500,0,0,20200,19000,0.0,4665.0,0,0,0,5,12,8,0,0,0,0,26450,6.0,28500,0,0,-20200,-19000,0.0,2645.0
4858008293,1,0,0,0,16,18,14,0,0,0,0,47418,10.0,47500,0,0,18164,19000,0.0,4741.8,0,0,1,13,11,10,0,0,0,0,29254,6.0,28500,0,0,-18164,-19000,0.0,2925.4
4857579373,1,0,0,1,20,13,17,0,0,0,0,46650,10.0,47500,0,0,20200,19000,0.0,4665.0,0,0,0,6,13,11,0,0,0,0,26450,6.0,28500,0,0,-20200,-19000,0.0,2645.0
4857560721,1,19,1,1,17,18,13,0,0,0,0,44910,10.0,47500,1,0,15990,19000,0.1,4491.0,0,0,0,10,9,14,0,0,0,0,28920,6.0,28500,2,0,-15990,-19000,0.2,2892.0
4857544401,1,0,0,1,16,14,13,0,0,0,0,30251,9.0,40000,0,0,11401,16000,0.0,3025.1,0,0,0,5,7,5,0,0,0,0,18850,5.4,24000,0,0,-11401,-16000,0.0,1885.0
4857248383,1,0,0,1,19,20,15,0,0,0,0,48050,10.0,47500,0,0,18800,19000,0.0,4805.0,6,0,0,12,11,12,0,0,0,0,29250,6.0,28500,0,0,-18800,-19000,0.0,2925.0
4857229900,1,0,0,0,14,12,16,0,0,0,0,31348,9.0,40000,0,0,13548,16000,0.0,3134.8,0,0,1,7,9,5,0,0,0,0,17800,5.4,24000,0,0,-13548,-16000,0.0,1780.0
4856505896,1,0,0,1,17,17,19,0,0,0,0,47350,10.0,47500,0,0,19500,19000,0.0,4735.0,0,0,0,11,11,8,0,0,0,0,27850,6.0,28500,0,0,-19500,-19000,0.0,2785.0
4856476707,1,1,0,0,20,19,25,0,0,0,0,63750,12.2,56000,0,0,26900,21000,0.0,6375.0,0,0,1,12,13,7,0,0,0,0,36850,7.6,35000,0,0,-26900,-21000,0.0,3685.0
4856465461,1,0,0,1,21,16,25,0,0,0,0,67250,12.0,55000,0,0,29700,22000,0.0,6725.0,0,0,0,8,13,5,0,0,0,0,37550,7.2,33000,0,0,-29700,-22000,0.0,3755.0
4856454862,1,252,0,0,16,12,18,0,0,0,0,47026,10.0,47500,0,0,20214,19000,0.0,4702.6,0,0,1,7,11,7,0,0,0,0,26812,6.0,28500,0,0,-20214,-19000,0.0,2681.2
4856437790,1,0,0,1,15,12,14,0,0,0,0,45950,10.0,47500,0,0,18100,19000,0.0,4595.0,0,0,0,8,11,11,0,0,0,0,27850,6.0,28500,0,0,-18100,-19000,0.0,2785.0
4855249019,1,18,0,1,28,15,25,0,0,0,0,65200,13.0,62500,9,0,29000,28000,0.9,6520.0,0,0,0,5,18,6,0,0,0,0,36200,7.4,34500,1,0,-29000,-28000,0.1,3620.0
4854330717,1,0,0,1,17,17,15,0,0,0,0,60518,12.0,55000,0,0,23668,22000,0.0,6051.8,5,0,0,9,9,14,0,0,0,0,36850,7.2,33000,0,0,-23668,-22000,0.0,3685.0
4854174725,1,0,0,1,16,15,18,0,0,0,0,61650,12.0,55000,0,0,25500,22000,0.0,6165.0,29,0,0,8,9,9,0,0,0,0,36150,7.2,33000,0,0,-25500,-22000,0.0,3615.0
4854158047,1,0,0,1,14,23,13,0,0,0,0,60863,12.0,55000,1,0,22263,22000,0.1,6086.3,0,0,0,14,5,13,0,0,0,0,38600,7.2,33000,0,0,-22263,-22000,0.0,3860.0
4854137018,1,0,0,1,13,16,22,0,0,0,0,62340,12.0,55000,0,0,25490,22000,0.0,6234.0,0,0,0,12,9,5,0,0,0,0,36850,7.2,33000,0,0,-25490,-22000,0.0,3685.0
4854110399,1,0,0,1,20,14,20,0,0,0,0,51650,12.0,55000,0,0,10600,22000,0.0,5165.0,0,0,0,8,14,11,0,0,0,0,41050,7.2,33000,0,0,-10600,-22000,0.0,4105.0
4854089262,1,0,0,0,16,23,17,0,0,0,0,60705,12.0,55000,3,0,22740,22000,0.3,6070.5,12,0,1,15,8,15,0,0,0,0,37965,7.2,33000,1,0,-22740,-22000,0.1,3796.5
4853618572,1,7,0,1,22,16,24,0,0,0,0,54450,13.0,62500,0,0,17600,25000,0.0,5445.0,0,0,0,8,14,7,0,0,0,0,36850,7.8,37500,0,0,-17600,-25000,0.0,3685.0
4856535492,0,67,1,1,5,4,3,0,0,0,0,15481,6.8,17738,176,52,429,94,22.8,1548.1,18,1,0,4,5,4,0,0,0,0,15052,6.8,17644,219,56,-429,-94,27.5,1505.2
4856511316,0,12,12,1,3,7,1,0,0,0,0,13445,6.4,16379,219,18,-1605,-2560,23.7,1344.5,34,1,0,5,1,3,1,1,0,0,15050,7.0,18939,189,64,1605,2560,25.3,1505.0
4747915189,0,14,1,1,10,7,17,0,0,0,0,16166,6.4,15309,147,56,-2311,-3073,20.3,1616.6,13,1,0,7,10,5,1,1,0,0,18477,7.2,18382,216,55,2311,3073,27.1,1847.7
4731728477,0,12,2,0,2,12,2,1,1,0,0,14817,6.4,15497,169,42,-5894,-3455,21.1,1481.7,106,1,1,12,2,9,1,0,1,0,20711,7.2,18952,230,52,5894,3455,28.2,2071.1
4731705019,1,12,0,1,12,10,9,0,0,0,0,19609,7.2,18968,210,52,626,736,26.2,1960.9,13,2,0,10,12,11,0,0,0,0,18983,7.0,18232,214,55,-626,-736,26.9,1898.3
4731691948,1,0,0,0,12,20,16,0,0,0,0,63074,13.2,63500,0,0,24124,26000,0.0,6307.4,0,0,1,16,8,9,0,0,0,0,38950,7.8,37500,0,0,-24124,-26000,0.0,3895.0
4731177415,1,0,0,1,16,19,18,0,0,0,0,62030,12.0,55000,0,0,24082,20000,0.0,6203.0,60,0,0,12,9,9,0,0,0,0,37948,7.6,35000,0,0,-24082,-20000,0.0,3794.8
4730987837,0,78,3,1,2,3,1,1,1,0,0,15771,7.0,17934,194,64,-57,-784,25.8,1577.1,14,2,0,3,2,3,0,0,0,0,15828,6.8,18718,210,56,57,784,26.6,1582.8
4730940070,0,13,2,1,8,8,6,1,1,0,0,16762,6.8,17589,180,60,-485,383,24.0,1676.2,14,1,0,8,8,5,0,0,0,0,17247,6.8,17206,205,51,485,-383,25.6,1724.7
4730900651,1,23,0,1,20,18,18,0,0,0,0,64459,12.6,59500,0,0,26134,22000,0.0,6445.9,72,0,0,10,12,11,0,0,0,0,38325,7.8,37500,0,0,-26134,-22000,0.0,3832.5
4728574815,1,0,0,1,16,14,17,0,0,0,0,64422,12.2,56000,0,0,28272,23000,0.0,6442.2,0,0,0,8,10,4,0,0,0,0,36150,7.2,33000,0,0,-28272,-23000,0.0,3615.0
4728569761,1,0,0,0,20,19,19,0,0,0,0,63115,12.0,55000,0,0,25525,21000,0.0,6311.5,0,0,1,10,11,9,0,0,0,0,37590,7.4,34000,0,0,-25525,-21000,0.0,3759.0
4727651817,1,62,0,1,15,17,12,0,0,0,0,47350,10.0,47500,0,0,19500,19000,0.0,4735.0,0,0,0,9,7,11,0,0,0,0,27850,6.0,28500,0,0,-19500,-19000,0.0,2785.0
4727629490,1,111,0,1,19,18,19,0,0,0,0,63574,13.0,62500,1,0,35568,25000,0.1,6357.4,0,0,0,10,11,7,0,0,0,0,28006,7.8,37500,2,0,-35568,-25000,0.2,2800.6
4727621064,1,20,1,1,20,12,24,0,0,0,0,62857,12.0,55000,1,0,25507,20000,0.1,6285.7,0,0,0,6,14,5,0,0,0,0,37350,7.6,35000,0,0,-25507,-20000,0.0,3735.0
4727215586,1,93,0,1,18,21,18,0,0,0,0,65174,12.6,59500,0,0,26162,22000,0.0,6517.4,81,2,0,14,11,10,0,0,0,0,39012,7.8,37500,2,0,-26162,-22000,0.2,3901.2
4727201645,1,0,0,0,12,19,12,0,0,0,0,46366,10.0,47500,0,0,17116,19000,0.0,4636.6,0,0,1,12,5,12,0,0,0,0,29250,6.0,28500,0,0,-17116,-19000,0.0,2925.0
4727028669,1,0,0,1,21,17,17,0,0,0,0,63841,12.0,55000,3,0,25066,22000,0.3,6384.1,0,0,0,6,10,13,0,0,0,0,38775,7.2,33000,3,0,-25066,-22000,0.3,3877.5
4727005389,1,7,0,0,17,16,17,0,0,0,0,50950,12.0,55000,0,0,12700,22000,0.0,5095.0,108,0,1,9,10,12,0,0,0,0,38250,7.2,33000,0,0,-12700,-22000,0.0,3825.0
4726978625,1,1,0,0,14,16,18,0,0,0,0,63209,12.0,55000,1,0,26334,22000,0.1,6320.9,0,0,1,11,9,5,0,0,0,0,36875,7.2,33000,0,0,-26334,-22000,0.0,3687.5
4853810180,1,105,0,0,10,8,5,0,0,0,0,18273,6.8,17181,186,48,257,-151,23.4,1827.3,101,0,1,8,10,7,0,0,0,0,18016,6.8,17332,189,56,-257,151,24.5,1801.6
4853778092,0,14,0,0,1,5,0,0,0,0,0,13853,6.4,16599,208,60,-1784,-1117,26.8,1385.3,10,0,1,5,1,5,1,1,0,0,15637,7.0,17716,224,44,1784,1117,26.8,1563.7
4853744045,1,9,1,0,5,3,6,1,1,0,0,17189,7.0,19442,202,68,3106,3254,27.0,1718.9,11,0,1,3,5,2,0,0,0,0,14083,6.4,16188,168,48,-3106,-3254,21.6,1408.3
4853719596,0,11,1,0,2,6,1,0,0,0,0,14401,6.6,17671,202,56,-2860,-1134,25.8,1440.1,9,1,1,6,2,5,0,0,0,0,17261,7.0,18805,215,56,2860,1134,27.1,1726.1
4853693473,0,46,0,1,4,12,2,0,0,0,0,14525,6.6,16693,174,48,-4687,-2408,22.2,1452.5,14,0,0,12,4,11,0,0,0,0,19212,7.2,19101,204,54,4687,2408,25.8,1921.2
4853673525,0,16,0,0,30,29,78,0,0,0,2,39355,12.0,44510,92,0,-1483,1583,9.2,3935.5,0,0,1,29,30,71,0,0,0,0,40838,11.4,42927,96,0,1483,-1583,9.6,4083.8
4852417511,0,15,5,0,5,10,8,0,0,0,0,15270,6.4,15812,152,56,-2713,-2589,20.8,1527.0,15,0,1,10,5,9,0,0,0,0,17983,7.2,18401,194,48,2713,2589,24.2,1798.3
4852402755,1,12,1,0,6,4,8,0,0,0,0,16837,6.8,17402,191,48,-163,-515,23.9,1683.7,18,2,1,4,6,3,0,0,0,0,17000,6.8,17917,225,56,163,515,28.1,1700.0
4852380453,0,12,0,0,3,4,2,0,0,0,0,14765,6.4,15888,178,38,-2996,-1924,21.6,1476.5,15,1,1,4,3,3,0,0,0,0,17761,7.0,17812,214,48,2996,1924,26.2,1776.1
4850723092,0,0,13,1,30,37,81,0,0,0,1,39648,11.4,42736,89,0,-2630,-3268,8.9,3964.8,124,0,0,37,30,111,0,0,0,0,42278,11.8,46004,116,0,2630,3268,11.6,4227.8
4850704890,1,9,0,0,33,22,81,0,0,0,0,41433,11.8,45432,100,0,6149,6674,10.0,4143.3,174,2,1,22,33,61,0,0,0,0,35284,11.0,38758,71,0,-6149,-6674,7.1,3528.4
4850690998,0,0,9,1,30,27,67,0,0,0,1,35752,11.2,40545,42,0,-3801,-2495,4.2,3575.2,27,0,0,27,30,56,0,0,0,0,39553,11.4,43040,109,0,3801,2495,10.9,3955.3
4850665663,1,0,3,1,22,23,55,0,0,0,0,35046,11.0,39560,101,0,-1847,-2004,10.1,3504.6,20,0,0,23,22,52,0,0,0,0,36893,11.4,41564,94,0,1847,2004,9.4,3689.3
4850647306,0,34,0,1,24,28,63,0,0,0,0,37419,11.6,42977,97,0,-913,-1393,9.7,3741.9,34,0,0,28,24,77,0,0,0,0,38332,11.8,44370,88,0,913,1393,8.8,3833.2
4850393765,1,88,0,1,33,24,86,0,0,0,1,41389,11.6,45013,90,0,4522,6056,9.0,4138.9,0,0,0,24,33,59,0,0,0,0,36867,11.0,38957,78,0,-4522,-6056,7.8,3686.7
4850355555,0,0,0,0,25,33,51,0,0,0,0,38190,11.2,41175,112,0,-1799,-3674,11.2,3819.0,0,0,1,33,25,73,0,0,0,0,39989,11.8,44849,112,0,1799,3674,11.2,3998.9
4849391610,0,4,0,1,25,23,56,0,0,0,0,38529,11.6,42008,106,0,1940,-259,10.6,3852.9,0,0,0,23,25,55,0,0,0,0,36589,11.4,42267,100,0,-1940,259,10.0,3658.9
4849391032,1,34,0,1,29,19,72,0,0,0,1,40078,11.6,42891,127,0,5592,4759,12.7,4007.8,34,0,0,19,29,42,0,0,0,0,34486,10.8,38132,77,0,-5592,-4759,7.7,3448.6
4849382346,0,0,0,0,23,34,53,0,0,0,1,37805,11.4,41675,98,0,-2703,-3282,9.8,3780.5,16,0,1,34,23,88,0,0,0,0,40508,12.0,44957,106,0,2703,3282,10.6,4050.8
4849377860,1,0,24,1,24,22,70,0,0,0,0,37326,11.0,39967,81,0,1022,72,8.1,3732.6,27,0,0,22,24,55,0,0,0,0,36304,11.0,39895,104,0,-1022,-72,10.4,3630.4
4858245532,1,16,1,1,5,7,3,0,0,0,0,17682,7.2,19043,210,52,1680,1597,26.2,1768.2,14,2,0,7,5,4,0,0,0,0,16002,7.0,17446,175,60,-1680,-1597,23.5,1600.2
4857948383,1,66,2,1,2,1,0,0,0,0,0,15638,7.2,19229,226,56,2953,2855,28.2,1563.8,21,0,0,1,2,0,0,0,0,0,12685,6.4,16374,160,56,-2953,-2855,21.6,1268.5
4857925578,1,15,0,0,4,10,2,0,0,0,0,16492,6.4,16363,157,56,-891,-926,21.3,1649.2,98,0,1,10,4,10,0,0,0,0,17383,6.6,17289,179,52,891,926,23.1,1738.3
4857913414,1,13,1,1,11,4,7,1,1,0,0,19262,7.4,19196,199,60,5759,3749,25.9,1926.2,9,1,0,4,11,2,0,0,0,0,13503,6.4,15447,158,32,-5759,-3749,19.0,1350.3
4857232377,0,22,3,1,1,3,2,1,1,0,0,13108,6.2,15449,161,38,-1957,-2685,19.9,1310.8,74,0,0,3,1,2,0,0,0,0,15065,6.8,18134,190,57,1957,2685,24.7,1506.5
4857122521,1,58,1,0,9,21,13,0,0,0,0,45705,10.0,47500,4,0,16070,19000,0.4,4570.5,0,5,1,16,4,11,0,0,0,0,29635,6.0,28500,1,0,-16070,-19000,0.1,2963.5
4857107947,1,0,0,0,13,14,13,0,0,0,0,50600,12.0,55000,0,0,14100,22000,0.0,5060.0,0,0,1,9,8,8,0,0,0,0,36500,7.2,33000,0,0,-14100,-22000,0.0,3650.0
4857081240,1,0,3,1,21,17,17,0,0,0,0,61758,12.0,55000,0,0,24798,18000,0.0,6175.8,36,2,0,7,11,9,0,0,0,0,36960,8.0,37000,4,0,-24798,-18000,0.4,3696.0
4857059684,1,0,0,1,17,23,20,0,0,0,0,62710,12.0,55000,0,0,24110,22000,0.0,6271.0,16,0,0,16,10,13,0,0,0,0,38600,7.2,33000,0,0,-24110,-22000,0.0,3860.0
4856976315,1,36,0,1,15,18,15,0,0,0,0,46300,10.4,49000,0,0,18040,20500,0.0,4630.0,0,1,0,12,9,10,0,0,0,0,28260,6.0,28500,2,0,-18040,-20500,0.2,2826.0
4856959418,1,0,0,1,18,14,20,0,0,0,0,47700,10.6,50500,0,0,19275,22000,0.0,4770.0,1,0,0,11,15,8,0,0,0,0,28425,6.0,28500,1,0,-19275,-22000,0.1,2842.5
4856943060,1,39,0,1,13,22,13,0,0,0,0,45313,10.0,47500,0,0,16054,19000,0.0,4531.3,0,0,0,15,6,14,0,0,0,0,29259,6.0,28500,0,0,-16054,-19000,0.0,2925.9
4856920017,1,27,3,1,17,13,13,0,0,0,0,33212,9.0,40000,3,0,13997,16000,0.3,3321.2,0,3,0,6,10,8,0,0,0,0,19215,5.4,24000,0,0,-13997,-16000,0.0,1921.5
4856886482,0,10,2,1,5,5,4,1,1,0,0,16258,6.8,16873,194,48,-438,-611,24.2,1625.8,14,1,0,5,5,3,0,0,0,0,16696,7.0,17484,202,52,438,611,25.4,1669.6
4856848705,1,15,1,0,6,6,6,0,0,0,0,16180,6.6,16646,185,52,-387,-408,23.7,1618.0,14,1,1,6,6,5,0,0,0,0,16567,6.6,17054,212,60,387,408,27.2,1656.7
4856828261,1,16,0,0,4,3,2,0,0,0,0,16527,7.4,19195,215,56,1073,807,27.1,1652.7,96,2,1,3,4,1,1,1,0,0,15454,6.8,18388,220,60,-1073,-807,28.0,1545.4
4855818093,1,13,2,0,7,5,7,0,0,0,0,16627,6.8,16831,199,44,-1123,-1143,24.3,1662.7,13,2,1,5,7,5,0,0,0,0,17750,7.0,17974,208,56,1123,1143,26.4,1775.0
4855776591,0,7,1,0,3,9,1,0,0,0,0,15382,6.6,17739,214,52,-1486,649,26.6,1538.2,99,0,1,9,3,10,1,1,0,0,16868,6.8,17090,170,54,1486,-649,22.4,1686.8
4855745058,1,17,1,1,14,17,17,0,0,0,0,61140,12.0,55000,5,0,24260,22000,0.5,6114.0,0,2,0,11,8,9,0,0,0,0,36880,7.2,33000,3,0,-24260,-22000,0.3,3688.0
4855731199,1,44,0,0,19,19,20,0,0,0,0,63200,13.0,62500,6,0,26340,25000,0.6,6320.0,0,2,1,11,11,11,0,0,0,0,36860,7.8,37500,0,0,-26340,-25000,0.0,3686.0
4858194210,0,14,14,1,6,11,5,2,1,1,0,14770,6.4,16097,134,56,-4360,-3288,19.0,1477.0,34,2,0,11,6,4,0,0,0,0,19130,7.2,19385,214,64,4360,3288,27.8,1913.0
4858152488,0,216,2,0,2,6,1,0,0,0,0,15672,7.0,18546,202,45,423,2353,24.7,1567.2,14,1,1,6,2,9,1,1,0,0,15249,6.6,16193,182,53,-423,-2353,23.5,1524.9
4858068442,1,32,2,1,9,3,9,0,0,0,0,18044,7.0,17770,235,41,3051,898,27.6,1804.4,284,0,0,3,9,1,0,0,0,0,14993,6.6,16872,200,48,-3051,-898,24.8,1499.3
4857979919,0,14,2,1,8,5,9,1,1,0,0,16553,6.8,17212,190,64,-1184,-1251,25.4,1655.3,19,1,0,5,8,4,0,0,0,0,17737,7.0,18463,216,52,1184,1251,26.8,1773.7
4857675038,0,8,0,0,31,30,68,0,0,0,1,39231,11.4,42922,96,0,-62,-2457,9.6,3923.1,13,0,1,30,31,73,0,0,0,0,39293,11.8,45379,108,0,62,2457,10.8,3929.3
4856597888,0,38,1,1,8,3,4,0,0,0,0,16342,6.6,17368,195,52,664,617,24.7,1634.2,31,0,0,3,8,3,1,1,0,0,15678,6.6,16751,161,52,-664,-617,21.3,1567.8
4855491438,1,0,0,0,14,19,19,0,0,0,0,65150,12.0,55000,0,0,26900,22000,0.0,6515.0,7,0,1,14,9,13,0,0,0,0,38250,7.2,33000,0,0,-26900,-22000,0.0,3825.0
4855481629,1,0,0,0,23,26,23,0,0,0,0,65200,12.8,60500,2,0,26250,23000,0.2,6520.0,4,0,1,18,15,13,0,0,0,0,38950,7.8,37500,0,0,-26250,-23000,0.0,3895.0
4855464710,1,308,0,0,26,15,20,0,0,0,0,48925,10.0,47500,2,0,21647,19000,0.2,4892.5,0,0,1,4,15,7,0,0,0,0,27278,6.0,28500,2,0,-21647,-19000,0.2,2727.8
4855031948,0,28,0,0,24,24,69,0,0,0,0,36501,11.0,39650,103,0,-438,-1013,10.3,3650.1,0,31,1,24,24,59,0,0,0,0,36939,11.0,40663,103,0,438,1013,10.3,3693.9
4854844114,0,15,2,1,6,6,2,0,0,0,0,16287,7.0,18040,205,50,54,338,25.5,1628.7,19,1,0,6,6,5,0,0,0,0,16233,6.8,17702,205,43,-54,-338,24.8,1623.3
4854809090,1,12,0,1,7,5,6,1,1,0,0,17373,6.8,17546,175,50,1209,-29,22.5,1737.3,11,0,0,5,7,3,0,0,0,0,16164,6.8,17575,199,46,-1209,29,24.5,1616.4
4854774237,0,10,0,1,5,2,7,1,1,0,0,16668,6.6,17631,174,51,775,-369,22.5,1666.8,7,2,0,2,5,1,0,0,0,0,15893,7.0,18000,182,63,-775,369,24.5,1589.3
4854220081,0,74,1,0,3,5,5,0,0,0,0,14362,6.6,16515,164,52,-3268,-4113,21.6,1436.2,13,0,1,5,3,2,1,1,0,0,17630,7.4,20628,253,80,3268,4113,33.3,1763.0
4854174591,0,17,0,1,5,7,7,0,0,0,0,16095,6.2,15184,166,33,659,-1164,19.9,1609.5,12,2,0,7,5,3,0,0,0,0,15436,6.4,16348,167,56,-659,1164,22.3,1543.6
4853931693,1,102,0,0,3,1,4,0,0,0,0,15464,7.0,18720,190,80,1897,1847,27.0,1546.4,13,0,1,1,3,0,0,0,0,0,13567,6.8,16873,200,48,-1897,-1847,24.8,1356.7
4853699308,1,13,11,1,3,2,2,1,1,0,0,15442,7.0,18140,195,56,1655,1285,25.1,1544.2,33,2,0,2,3,1,0,0,0,0,13787,6.8,16855,188,44,-1655,-1285,23.2,1378.7
4853537883,0,16,1,0,4,5,2,0,0,0,0,15324,6.8,17685,177,44,-143,1588,22.1,1532.4,15,0,1,5,4,4,0,0,0,0,15467,6.4,16097,194,40,143,-1588,23.4,1546.7
4853238707,0,10,0,0,22,26,44,0,0,0,0,34991,11.0,39164,84,0,-2350,-3528,8.4,3499.1,0,5,1,26,22,57,0,0,0,0,37341,11.6,42692,108,0,2350,3528,10.8,3734.1
4853972584,1,13,2,1,6,3,6,0,0,0,0,17238,6.8,18095,218,68,2727,199,28.6,1723.8,10,2,0,3,6,3,0,0,0,0,14511,6.8,17896,197,44,-2727,-199,24.1,1451.1
4853929622,1,8,0,1,6,4,1,0,0,0,0,16652,7.0,18523,199,60,1738,2222,25.9,1665.2,11,1,0,4,6,2,0,0,0,0,14914,6.6,16301,149,44,-1738,-2222,19.3,1491.4
4850771011,0,0,0,1,29,28,64,0,0,0,1,36788,11.2,40679,107,0,-1021,-590,10.7,3678.8,0,0,0,28,29,66,0,0,0,0,37809,11.0,41269,98,0,1021,590,9.8,3780.9
4850726432,1,19,0,1,32,24,78,0,0,0,1,38994,11.4,42861,125,0,1695,1308,12.5,3899.4,8,0,0,24,32,47,0,0,0,0,37299,11.4,41553,107,0,-1695,-1308,10.7,3729.9
4850680663,1,13,1,1,3,4,3,1,1,0,0,15064,6.8,17634,207,60,638,-256,26.7,1506.4,12,2,0,4,3,0,0,0,0,0,14426,6.8,17890,195,56,-638,256,25.1,1442.6
4850661242,1,9,1,0,11,5,12,0,0,0,0,18203,6.8,17115,182,60,3286,2336,24.2,1820.3,10,0,1,5,11,5,0,0,0,0,14917,6.2,14779,139,28,-3286,-2336,16.7,1491.7
4844326749,0,11,1,1,3,2,2,0,0,0,0,14803,7.2,18340,209,52,800,822,26.1,1480.3,12,1,0,2,3,1,1,1,0,0,14003,6.6,17518,165,59,-800,-822,22.4,1400.3
4844284781,0,14,0,0,2,4,2,1,1,0,0,14540,7.2,17887,237,60,-617,-305,29.7,1454.0,14,0,1,4,2,3,0,0,0,0,15157,7.0,18192,204,52,617,305,25.6,1515.7
4844150303,0,0,0,0,15,20,37,0,0,0,0,35414,10.6,37636,110,0,-177,919,11.0,3541.4,0,0,1,20,15,58,0,0,0,0,35591,10.4,36717,105,0,177,-919,10.5,3559.1
4844112882,0,14,1,0,8,8,5,0,0,0,0,16492,6.8,18047,199,59,-1088,915,25.8,1649.2,11,1,1,7,7,5,2,1,1,0,17580,6.8,17132,193,55,1088,-915,24.8,1758.0
4844073511,0,14,3,1,9,4,2,1,1,0,0,17689,7.0,18723,201,56,688,528,25.7,1768.9,13,0,0,4,9,4,0,0,0,0,17001,7.0,18195,211,64,-688,-528,27.5,1700.1
4844060883,0,12,3,1,5,6,5,0,0,0,0,15642,6.8,17753,205,59,-814,-750,26.4,1564.2,12,1,0,6,5,8,0,0,0,0,16456,7.0,18503,192,58,814,750,25.0,1645.6
4844028363,1,9,0,1,5,2,5,1,1,0,0,16395,7.0,18795,207,60,1556,1847,26.7,1639.5,10,0,0,2,5,1,0,0,0,0,14839,6.8,16948,181,52,-1556,-1847,23.3,1483.9
4843317022,0,14,12,0,3,4,0,0,0,0,0,14234,6.8,17409,178,52,-1007,-385,23.0,1423.4,31,2,1,4,3,1,0,0,0,0,15241,7.0,17794,187,48,1007,385,23.5,1524.1
4843283777,1,12,0,1,6,6,5,1,1,0,0,16062,6.8,17026,198,56,274,127,25.4,1606.2,11,0,0,6,6,5,0,0,0,0,15788,6.6,16899,184,48,-274,-127,23.2,1578.8
4842447998,0,11,0,0,3,7,1,0,0,0,0,15020,6.8,17900,187,48,-1317,-136,23.5,1502.0,14,0,1,7,3,8,0,0,0,0,16337,6.8,18036,165,56,1317,136,22.1,1633.7
4842398992,1,11,1,0,3,2,1,0,0,0,0,14520,6.8,17907,182,52,-1,1990,23.4,1452.0,12,1,1,2,3,0,1,1,0,0,14521,6.6,15917,191,48,1,-1990,23.9,1452.1
4842205427,0,112,2,1,5,5,4,0,0,0,0,16326,6.8,17749,204,39,414,-93,24.3,1632.6,16,0,0,5,5,5,1,1,0,0,15912,6.6,17842,188,60,-414,93,24.8,1591.2
4842158316,0,69,0,1,3,1,2,0,0,0,0,13787,6.8,17183,170,56,484,-676,22.6,1378.7,12,0,0,1,3,0,1,1,0,0,13303,7.0,17859,183,44,-484,676,22.7,1330.3
4857312488,1,64,4,1,8,3,10,1,1,0,0,18263,7.0,18716,232,52,3011,1044,28.4,1826.3,21,0,0,3,8,1,0,0,0,0,15252,6.8,17672,218,60,-3011,-1044,27.8,1525.2
4857273586,0,16,1,1,6,11,9,0,0,0,0,15602,6.4,16429,181,52,-3771,-3428,23.3,1560.2,13,1,0,11,6,5,1,1,0,0,19373,7.4,19857,257,68,3771,3428,32.5,1937.3
4851642587,0,14,3,1,6,9,3,0,0,0,0,15468,6.6,16587,195,52,-4041,-2460,24.7,1546.8,16,1,0,9,6,8,1,1,0,0,19509,7.2,19047,221,48,4041,2460,26.9,1950.9
4851571762,1,13,1,0,2,5,2,0,0,0,0,15161,6.8,18092,246,52,-1144,101,29.8,1516.1,13,1,1,5,2,4,0,0,0,0,16305,7.0,17991,195,64,1144,-101,25.9,1630.5
4851529755,1,15,0,1,8,3,3,1,0,1,0,17871,7.4,18809,218,56,2516,2173,27.4,1787.1,15,0,0,3,8,3,0,0,0,0,15355,6.8,16636,167,56,-2516,-2173,22.3,1535.5
4851483697,0,14,2,1,8,4,9,0,0,0,0,17677,7.0,18245,190,56,2514,1812,24.6,1767.7,18,1,0,4,8,1,0,0,0,0,15163,6.6,16433,180,63,-2514,-1812,24.3,1516.3
4810037225,1,18,1,1,9,2,10,1,1,0,0,18567,7.4,19003,225,68,3691,1220,29.3,1856.7,8,3,0,2,9,3,0,0,0,0,14876,6.8,17783,189,48,-3691,-1220,23.7,1487.6
4808077583,0,9,2,0,5,8,3,0,0,0,0,14725,6.6,17106,191,60,-3847,-2424,25.1,1472.5,12,3,1,8,5,4,0,0,0,0,18572,7.0,19530,242,56,3847,2424,29.8,1857.2
4734279418,0,14,1,1,4,6,8,0,0,0,0,14449,6.6,16007,180,48,-1423,-1652,22.8,1444.9,168,2,0,6,4,6,0,0,0,0,15872,7.0,17659,194,52,1423,1652,24.6,1587.2
4734256184,0,188,2,1,5,8,7,1,1,0,0,15001,6.2,15780,161,40,-2056,-1554,20.1,1500.1,16,0,0,8,5,6,0,0,0,0,17057,6.6,17334,170,56,2056,1554,22.6,1705.7
4731613642,1,8,1,0,7,13,6,1,1,0,0,17293,6.8,17525,164,40,-1801,4,20.4,1729.3,17,1,1,13,7,12,0,0,0,0,19094,6.8,17521,181,58,1801,-4,23.9,1909.4
4731570061,1,14,1,1,4,6,4,0,0,0,0,14812,6.6,16139,207,28,-729,552,23.5,1481.2,16,3,0,5,3,8,0,0,0,0,15541,6.2,15587,157,64,729,-552,22.1,1554.1
4557353312,0,10,0,0,1,5,0,0,0,0,0,13731,6.6,17340,204,50,-3423,-942,25.4,1373.1,16,0,1,5,1,4,0,0,0,0,17154,7.0,18282,216,38,3423,942,25.4,1715.4
4557309487,0,10,0,0,6,6,8,0,0,0,0,16673,6.8,18417,203,52,-773,-903,25.5,1667.3,168,1,1,6,6,5,0,0,0,0,17446,7.2,19320,251,68,773,903,31.9,1744.6
4556202970,0,15,0,0,4,7,8,0,0,0,0,14649,6.8,16267,173,64,-4257,-2840,23.7,1464.9,14,1,1,7,4,6,0,0,0,0,18906,7.4,19107,222,61,4257,2840,28.3,1890.6
4556164175,0,10,1,0,5,4,4,0,0,0,0,15580,7.4,18794,184,48,237,1124,23.2,1558.0,205,4,1,4,5,2,0,0,0,0,15343,6.8,17670,219,52,-237,-1124,27.1,1534.3
4390880356,0,18,0,0,15,21,36,0,0,0,2,35058,10.2,35398,89,0,-3865,-5255,8.9,3505.8,12,5,1,21,15,42,0,0,0,0,38923,11.2,40653,110,0,3865,5255,11.0,3892.3
4214114693,1,13,3,1,8,5,6,0,0,0,0,17811,7.0,19044,210,47,2534,1119,25.7,1781.1,15,3,0,5,8,1,1,1,0,0,15277,6.8,17925,204,53,-2534,-1119,25.7,1527.7
4214072658,0,47,1,0,2,7,2,0,0,0,0,13793,6.4,16201,188,48,-5156,-4609,23.6,1379.3,15,2,1,7,2,6,1,1,0,0,18949,7.6,20810,234,60,5156,4609,29.4,1894.9
4214039456,1,11,1,0,4,7,3,1,1,0,0,14650,6.6,16339,177,40,-3378,-2057,21.7,1465.0,14,0,1,7,4,6,0,0,0,0,18028,7.0,18396,195,56,3378,2057,25.1,1802.8
4856055442,1,377,0,1,20,13,20,0,0,0,0,46704,10.6,50500,0,0,20204,22000,0.0,4670.4,0,0,0,6,13,6,0,0,0,0,26500,6.0,28500,0,0,-20204,-22000,0.0,2650.0
4856028704,1,0,3,1,16,20,12,0,0,0,0,46665,10.0,47500,0,0,17960,19000,0.0,4666.5,31,1,0,13,9,12,0,0,0,0,28705,6.0,28500,6,0,-17960,-19000,0.6,2870.5
4855237570,1,8,0,0,22,24,47,0,0,0,0,37664,11.0,39720,107,0,-156,-2837,10.7,3766.4,0,4,1,24,22,68,0,0,0,0,37820,11.4,42557,100,0,156,2837,10.0,3782.0
4855214208,1,86,0,1,16,19,14,0,0,0,0,47424,10.0,47500,0,0,16716,19000,0.0,4742.4,0,0,0,12,9,11,0,0,0,0,30708,6.0,28500,0,0,-16716,-19000,0.0,3070.8
4855189666,1,0,0,0,15,21,18,0,0,0,0,61354,12.0,55000,0,0,22730,22000,0.0,6135.4,0,0,1,13,7,11,0,0,0,0,38624,7.2,33000,0,0,-22730,-22000,0.0,3862.4
4854954557,1,15,0,1,19,23,18,0,0,0,0,48122,10.0,47500,0,0,18172,19000,0.0,4812.2,0,0,0,14,10,17,0,0,0,0,29950,6.0,28500,0,0,-18172,-19000,0.0,2995.0
4854093972,1,0,0,1,14,18,20,0,0,0,0,46010,10.0,47500,3,0,16240,19000,0.3,4601.0,0,0,0,12,8,7,0,0,0,0,29770,6.0,28500,3,0,-16240,-19000,0.3,2977.0
4854056475,1,0,0,0,21,17,24,0,0,0,0,63750,14.4,67000,0,0,26200,28000,0.0,6375.0,0,0,1,9,13,9,0,0,0,0,37550,8.4,39000,0,0,-26200,-28000,0.0,3755.0
4853662779,1,12,0,1,27,15,31,0,0,0,0,65242,12.8,61000,2,0,29744,25000,0.2,6524.2,0,0,0,4,16,4,0,0,0,0,35498,7.6,36000,0,0,-29744,-25000,0.0,3549.8
4851942831,1,0,0,0,22,26,56,0,0,0,1,36952,10.8,38633,109,0,1467,-909,10.9,3695.2,0,0,1,26,22,75,0,0,0,0,35485,11.0,39542,78,0,-1467,909,7.8,3548.5
4851919191,0,83,20,0,18,29,40,0,0,0,1,35279,10.8,38205,76,0,-3899,-6295,7.6,3527.9,21,0,1,29,18,67,0,0,0,0,39178,11.6,44500,123,0,3899,6295,12.3,3917.8
4851901106,1,0,0,1,30,22,78,0,0,0,2,41218,11.6,43675,98,0,4852,4413,9.8,4121.8,0,0,0,22,30,57,0,0,0,0,36366,10.6,39262,85,0,-4852,-4413,8.5,3636.6
4851858594,0,82,0,1,20,24,42,0,0,0,1,36453,11.0,40011,100,0,-1588,-1487,10.0,3645.3,0,0,0,24,20,66,0,0,0,0,38041,11.4,41498,121,0,1588,1487,12.1,3804.1
4851307091,0,14,7,0,1,11,1,0,0,0,0,14238,6.2,15117,167,56,-4950,-2319,22.3,1423.8,31,1,1,11,1,12,1,1,0,0,19188,6.8,17436,181,48,4950,2319,22.9,1918.8
4851108713,1,9,0,1,18,11,39,0,0,0,0,34951,10.8,39162,110,0,285,1080,11.0,3495.1,0,0,0,11,18,23,0,0,0,0,34666,10.8,38082,110,0,-285,-1080,11.0,3466.6
4850656939,0,0,0,0,26,22,68,0,0,0,0,38502,11.2,41800,109,0,653,-299,10.9,3850.2,3,0,1,22,26,55,0,0,0,0,37849,11.4,42099,99,0,-653,299,9.9,3784.9
4850635669,1,0,0,1,40,24,105,0,0,0,1,42657,11.8,45757,121,0,4468,4185,12.1,4265.7,0,0,0,24,40,59,0,0,0,0,38189,11.2,41572,105,0,-4468,-4185,10.5,3818.9
4850619391,0,82,0,0,20,26,49,0,0,0,0,36021,11.0,38970,110,0,-3143,-3403,11.0,3602.1,0,0,1,26,20,59,0,0,0,0,39164,11.4,42373,115,0,3143,3403,11.5,3916.4
4850327938,1,0,0,0,21,33,64,0,0,0,1,35934,11.0,39841,102,0,-2418,-3064,10.2,3593.4,0,0,1,33,21,77,0,0,0,0,38352,11.4,42905,81,0,2418,3064,8.1,3835.2
4849754058,0,15,0,0,23,34,57,0,0,0,1,36236,11.0,40731,78,0,-5887,-7305,7.8,3623.6,0,1,1,34,23,86,0,0,0,0,42123,12.2,48036,98,0,5887,7305,9.8,4212.3
4856223534,1,0,23,1,24,24,73,0,0,0,1,38312,11.4,41799,100,0,948,3341,10.0,3831.2,27,0,0,24,24,61,0,0,0,0,37364,11.0,38458,98,0,-948,-3341,9.8,3736.4
4856182036,0,0,0,1,22,30,42,0,0,0,2,35918,11.0,40384,98,0,-4868,-5279,9.8,3591.8,0,0,0,30,22,78,0,0,0,0,40786,12.0,45663,116,0,4868,5279,11.6,4078.6
4856104469,1,0,8,0,33,21,102,0,0,0,1,39361,12.0,45596,117,0,3894,7117,11.7,3936.1,11,0,1,21,33,56,0,0,0,0,35467,11.0,38479,104,0,-3894,-7117,10.4,3546.7
4856068171,1,0,0,1,19,15,54,0,0,0,1,36963,11.2,40466,104,0,2147,4301,10.4,3696.3,0,0,0,15,19,40,0,0,0,0,34816,10.6,36165,82,0,-2147,-4301,8.2,3481.6
4856030365,1,33,0,1,23,10,67,0,0,0,0,36514,11.0,39577,95,0,3518,5588,9.5,3651.4,80,3,0,10,23,29,0,0,0,0,32996,10.2,33989,99,0,-3518,-5588,9.9,3299.6
4855442196,1,8,3,0,17,15,19,0,0,0,0,46480,10.0,47500,6,0,18140,19000,0.6,4648.0,13,1,1,9,11,9,0,0,0,0,28340,6.0,28500,3,0,-18140,-19000,0.3,2834.0
4855424308,1,29,4,1,17,19,15,0,0,0,0,62475,12.0,55000,4,0,24925,22000,0.4,6247.5,0,0,0,11,9,12,0,0,0,0,37550,7.2,33000,0,0,-24925,-22000,0.0,3755.0
4855402333,1,15,0,0,18,19,24,0,0,0,0,41945,10.0,47500,3,0,13960,19000,0.3,4194.5,0,0,1,12,11,7,0,0,0,0,27985,6.0,28500,2,0,-13960,-19000,0.2,2798.5
4855380493,1,0,0,1,27,14,21,0,0,0,0,49200,10.2,48680,2,0,21652,20180,0.2,4920.0,4,0,0,3,16,10,0,0,0,0,27548,6.0,28500,0,0,-21652,-20180,0.0,2754.8
4855206852,1,18,1,1,3,2,3,1,1,0,0,14723,6.8,17254,195,56,671,-580,25.1,1472.3,8,0,0,2,3,0,0,0,0,0,14052,6.8,17834,186,52,-671,580,23.8,1405.2
4855141787,0,36,1,0,2,4,2,1,0,1,0,14291,6.6,16917,195,48,-1818,-906,24.3,1429.1,117,16,1,4,2,4,0,0,0,0,16109,6.6,17823,212,56,1818,906,26.8,1610.9
4855086882,0,15,0,0,0,3,0,0,0,0,0,13153,6.6,16905,197,58,-2595,-1758,25.5,1315.3,14,3,1,3,0,1,1,1,0,0,15748,7.0,18663,229,58,2595,1758,28.7,1574.8
4855009593,1,2,0,1,29,21,74,0,0,0,2,40173,11.8,44176,110,0,2711,4601,11.0,4017.3,0,0,0,21,29,50,0,0,0,0,37462,10.8,39575,90,0,-2711,-4601,9.0,3746.2
4854986527,1,0,0,1,32,21,83,0,0,0,0,37359,11.6,42912,108,0,2213,2706,10.8,3735.9,0,0,0,21,32,40,0,0,0,0,35146,11.2,40206,75,0,-2213,-2706,7.5,3514.6
4854946566,1,0,0,0,17,23,41,0,0,0,1,34815,10.8,38208,85,0,-1055,-955,8.5,3481.5,0,0,1,23,17,60,0,0,0,0,35870,10.8,39163,84,0,1055,955,8.4,3587.0
4854919548,1,0,0,1,34,27,75,0,0,0,0,41208,12.4,46605,104,0,3008,3935,10.4,4120.8,0,0,0,27,34,56,0,0,0,0,38200,11.6,42670,84,0,-3008,-3935,8.4,3820.0
4854894866,1,0,0,0,22,29,65,0,0,0,2,39012,11.2,41364,102,0,1619,-799,10.2,3901.2,0,0,1,29,22,87,0,0,0,0,37393,11.2,42163,82,0,-1619,799,8.2,3739.3
4854877752,1,5,0,1,42,26,96,0,0,0,3,43705,12.0,47162,105,0,4634,3602,10.5,4370.5,0,2,0,26,42,56,0,0,0,0,39071,11.6,43560,85,0,-4634,-3602,8.5,3907.1
4854736203,1,14,0,0,6,3,4,0,0,0,0,15198,6.6,16083,175,48,126,263,22.3,1519.8,19,0,1,3,6,3,0,0,0,0,15072,6.2,15820,226,34,-126,-263,26.0,1507.2
4854709589,1,12,1,0,8,7,8,0,0,0,0,18465,7.0,18594,215,56,2218,2060,27.1,1846.5,12,0,1,6,7,10,0,0,0,0,16247,6.6,16534,158,44,-2218,-2060,20.2,1624.7
4785437458,0,177,0,1,4,1,3,1,1,0,0,15783,7.2,18282,193,52,1457,-788,24.5,1578.3,73,1,0,1,4,0,0,0,0,0,14326,7.2,19070,192,68,-1457,788,26.0,1432.6
4785408068,1,167,0,0,6,2,6,0,0,0,0,15178,6.8,17815,181,46,1315,1068,22.7,1517.8,7,0,1,2,6,1,0,0,0,0,13863,6.6,16747,161,53,-1315,-1068,21.4,1386.3
4785376553,0,17,0,0,1,2,1,0,0,0,0,13800,6.8,17325,192,56,-1339,-1622,24.8,1380.0,271,1,1,2,1,4,1,1,0,0,15139,7.0,18947,185,52,1339,1622,23.7,1513.9
4785346879,1,23,0,0,6,7,2,0,0,0,0,16575,7.0,18623,185,60,576,433,24.5,1657.5,10,0,1,7,6,4,0,0,0,0,15999,7.0,18190,165,68,-576,-433,23.3,1599.9
4785233243,1,4,0,1,20,25,50,0,0,0,1,37843,11.2,40973,100,0,1413,2070,10.0,3784.3,0,0,0,25,20,72,0,0,0,0,36430,10.8,38903,71,0,-1413,-2070,7.1,3643.0
4785204234,1,0,0,0,16,15,26,0,0,0,1,35853,10.8,38818,95,0,1774,1678,9.5,3585.3,0,0,1,15,16,32,0,0,0,0,34079,10.8,37140,88,0,-1774,-1678,8.8,3407.9
4784554162,0,0,0,1,23,34,54,0,0,0,1,37656,11.4,42109,100,0,-1217,-2522,10.0,3765.6,0,0,0,34,23,90,0,0,0,0,38873,11.8,44631,105,0,1217,2522,10.5,3887.3
4784473946,0,13,0,0,16,28,34,0,0,0,1,35497,10.8,38864,81,0,-3164,-2857,8.1,3549.7,0,3,1,28,16,65,0,0,0,0,38661,11.4,41721,117,0,3164,2857,11.7,3866.1
4784447667,0,0,0,0,13,34,32,0,0,0,0,33237,10.4,34636,81,0,-6726,-8802,8.1,3323.7,0,0,1,34,13,89,0,0,0,0,39963,11.6,43438,102,0,6726,8802,10.2,3996.3
4783838588,0,69,0,0,5,9,5,0,0,0,0,15156,6.4,15918,147,48,-3931,-2930,19.5,1515.6,9,0,1,9,5,5,1,0,1,0,19087,7.2,18848,187,48,3931,2930,23.5,1908.7
4783835063,1,9,0,0,6,3,3,1,0,1,0,17740,7.2,18435,219,60,2526,1525,27.9,1774.0,9,0,1,2,5,2,0,0,0,0,15214,6.6,16910,186,43,-2526,-1525,22.9,1521.4
4774951660,0,13,1,0,8,5,5,1,1,0,0,17143,6.8,17926,183,52,-586,-552,23.5,1714.3,9,1,1,5,8,3,0,0,0,0,17729,7.2,18478,220,68,586,552,28.8,1772.9
4774926518,1,33,2,1,7,8,3,1,1,0,0,18664,6.8,17979,216,52,2205,1346,26.8,1866.4,18,7,0,7,6,7,0,0,0,0,16459,6.4,16633,138,48,-2205,-1346,18.6,1645.9
4774903542,0,12,0,1,9,2,8,0,0,0,0,17483,6.8,17409,205,47,2651,319,25.2,1748.3,346,1,0,2,9,2,0,0,0,0,14832,6.8,17090,205,52,-2651,-319,25.7,1483.2
4766946051,1,15,0,0,1,1,1,1,1,0,0,15559,7.2,19563,193,64,2350,2257,25.7,1555.9,12,1,1,1,1,2,0,0,0,0,13209,7.0,17306,194,40,-2350,-2257,23.4,1320.9
4766919680,1,11,0,1,7,1,12,0,0,0,0,16870,6.8,17587,177,48,3720,1007,22.5,1687.0,17,0,0,1,7,0,0,0,0,0,13150,6.8,16580,195,52,-3720,-1007,24.7,1315.0
4766900823,0,11,1,0,5,8,2,0,0,0,0,16481,7.0,18059,180,60,-437,-1623,24.0,1648.1,10,0,1,8,5,3,0,0,0,0,16918,7.6,19682,183,64,437,1623,24.7,1691.8
4766580412,1,205,0,1,5,1,2,1,1,0,0,16630,7.0,18448,212,52,3136,1977,26.4,1663.0,84,0,0,1,5,0,0,0,0,0,13494,6.4,16471,169,44,-3136,-1977,21.3,1349.4
4757951363,0,10,2,0,6,6,4,0,0,0,0,16618,6.6,16782,199,48,-76,-280,24.7,1661.8,12,1,1,6,6,7,0,0,0,0,16694,6.6,17062,191,52,76,280,24.3,1669.4
4757915820,1,11,1,1,8,5,8,0,0,0,0,17308,6.8,17643,194,56,1467,174,25.0,1730.8,9,0,0,5,8,4,1,1,0,0,15841,6.8,17469,197,47,-1467,-174,24.4,1584.1
4843181969,1,63,0,1,7,5,3,0,0,0,0,16411,7.4,19955,181,72,-264,1426,25.3,1641.1,9,3,0,5,7,5,0,0,0,0,16675,7.0,18529,237,59,264,-1426,29.6,1667.5
4840364005,0,9,1,0,3,7,2,0,0,0,0,15525,6.6,17469,219,56,-1548,-566,27.5,1552.5,12,1,1,7,3,10,0,0,0,0,17073,7.0,18035,209,64,1548,566,27.3,1707.3
4840302552,0,13,0,1,4,7,3,2,1,1,0,15481,7.0,17062,202,56,-1789,-2361,25.8,1548.1,9,1,0,6,3,6,0,0,0,0,17270,7.4,19423,233,52,1789,2361,28.5,1727.0
4840260299,0,12,0,1,3,6,2,0,0,0,0,14403,6.6,16666,192,52,-2141,-539,24.4,1440.3,12,1,0,6,3,5,0,0,0,0,16544,6.8,17205,187,48,2141,539,23.5,1654.4
4834241407,1,21,1,0,5,2,4,0,0,0,0,17410,7.4,19045,212,58,3358,1882,27.0,1741.0,13,1,1,2,5,1,1,1,0,0,14052,6.6,17163,199,56,-3358,-1882,25.5,1405.2
4834194602,1,8,1,1,2,1,0,1,1,0,0,15299,6.8,18589,233,64,1230,962,29.7,1529.9,13,1,0,1,2,0,0,0,0,0,14069,6.8,17627,214,52,-1230,-962,26.6,1406.9
4749770011,0,11,0,0,2,10,2,0,0,0,0,15012,6.8,17149,177,60,-4168,-1369,23.7,1501.2,12,0,1,10,2,13,1,1,0,0,19180,7.0,18518,230,50,4168,1369,28.0,1918.0
4743139706,0,12,2,1,6,7,6,0,0,0,0,17347,6.8,17393,214,48,-118,-248,26.2,1734.7,11,0,0,7,6,7,0,0,0,0,17465,7.0,17641,224,40,118,248,26.4,1746.5
4743129824,0,18,1,1,2,7,2,0,0,0,0,14564,6.8,17311,187,52,-3513,-1676,23.9,1456.4,15,1,0,7,2,9,1,1,0,0,18077,7.4,18987,214,68,3513,1676,28.2,1807.7
4742221170,1,13,1,1,2,0,0,1,1,0,0,15198,7.2,18699,235,56,244,651,29.1,1519.8,12,0,0,0,2,0,0,0,0,0,14954,6.8,18048,245,60,-244,-651,30.5,1495.4
4742194395,0,14,1,1,5,6,6,0,0,0,0,17293,6.8,17562,190,40,727,398,23.0,1729.3,21,2,0,6,5,8,1,1,0,0,16566,6.6,17164,207,48,-727,-398,25.5,1656.6
4741884803,0,11,0,1,4,4,7,0,0,0,0,17192,6.8,17682,207,48,1379,549,25.5,1719.2,10,1,0,4,4,6,1,1,0,0,15813,6.6,17133,169,53,-1379,-549,22.2,1581.3
4741850178,1,10,0,0,5,4,4,1,1,0,0,16811,7.0,19356,243,69,1248,2688,31.2,1681.1,12,0,1,4,5,3,0,0,0,0,15563,6.6,16668,202,48,-1248,-2688,25.0,1556.3
4741800704,0,12,5,0,2,3,3,0,0,0,0,15859,7.0,18220,216,56,-637,137,27.2,1585.9,16,2,1,3,2,5,1,0,1,0,16496,7.0,18083,207,56,637,-137,26.3,1649.6
4741475471,1,16,2,0,1,3,0,0,0,0,0,14463,6.6,16919,200,48,-885,-262,24.8,1446.3,14,1,1,3,1,3,0,0,0,0,15348,6.8,17181,207,44,885,262,25.1,1534.8
4741435620,1,11,0,0,9,6,9,1,1,0,0,18546,6.8,17639,225,51,442,-307,27.6,1854.6,13,0,1,6,9,8,0,0,0,0,18104,7.0,17946,231,52,-442,307,28.3,1810.4
4741288661,1,13,1,1,6,3,5,1,1,0,0,16880,6.8,17129,209,56,2269,918,26.5,1688.0,10,2,0,3,6,2,0,0,0,0,14611,6.4,16211,188,40,-2269,-918,22.8,1461.1
4741260682,1,9,0,1,4,5,0,0,0,0,0,16057,6.8,18262,231,56,-563,321,28.7,1605.7,11,1,0,5,4,6,1,1,0,0,16620,6.8,17941,210,52,563,-321,26.2,1662.0
4741237646,1,15,0,0,4,7,3,0,0,0,0,15592,6.4,16362,218,52,-834,-1115,27.0,1559.2,13,1,1,7,4,4,0,0,0,0,16426,7.0,17477,185,52,834,1115,23.7,1642.6
4740768232,0,14,2,0,3,2,1,1,1,0,0,14423,6.8,17096,196,56,-239,-1279,25.2,1442.3,15,0,1,2,3,0,0,0,0,0,14662,7.2,18375,214,64,239,1279,27.8,1466.2
